Generation,Id,NumStereoIsomers,indegree,outdegree,degree,modularity_class,eigencentrality
G0,C(C(C(C(C(CO)O)O)O)O)=O,16,15,9504,9519,29,0.000814
G0,O,1,21071,16888,37959,29,1.0
G1,C(CO)=O,1,1365,2493,3858,0,0.06479299999999999
G1,C(C(C(CO)O)O)=O,4,60,66,126,0,0.0029100000000000003
G1,C(CO)(C(C(C(CO)O)O)O)=O,8,14,12,26,5,0.000754
G1,C(C(C(C(C(CO)O)O)O)O)(O)=O,16,6191,13,6204,29,0.363693
G1,C(C(C(C(C(CO)O)O)O)O)O,10,3316,5,3321,29,0.19481099999999998
G1,C(C(CC(C(CO)O)O)=O)=O,4,17,18,35,41,0.000874
G1,C(CC(C(C(CO)O)O)=O)=O,4,19,19,38,9,0.000959
G1,C(C(C(CC(CO)O)=O)O)=O,4,16,16,32,2,0.000805
G1,C(CC(C=O)O)(C(CO)O)=O,4,22,20,42,2,0.001093
G1,C(C(C(C=O)O)O)(CCO)=O,4,23,22,45,2,0.001142
G1,C(C(C(CC(CO)=O)O)O)=O,4,21,21,42,2,0.001044
G1,C(C(C(C(C(C)=O)O)O)O)=O,8,21,21,42,1,0.001044
G1,C(CC(C(C(C=O)O)O)O)=O,8,23,25,48,43,0.00115
G1,C(C(C1C(C(C(O)O1)O)O)O)O,32,6,7,13,35,0.00033999999999999997
G1,C(C1C(C(C(C(O)O1)O)O)O)O,32,6,7,13,29,0.00033999999999999997
G1,C1C(C(C(C(C(O)O1)O)O)O)O,32,7,9,16,41,0.000399
G2,C1(C(C(C(C1CO)O)O)O)=O,16,20,17,37,2,0.001031
G2,C1(C(C(C(C(C1)O)O)O)O)=O,16,17,16,33,2,0.0008730000000000001
G2,C(C1C(C(C(C1O)O)O)O)=O,10,11,12,23,43,0.000566
G2,C(C(CC(C(CO)O)O)O)(O)=O,8,10,10,20,29,0.000586
G2,C(C(C(C(C(CO)O)O)O)=O)=O,8,16,19,35,29,0.0008410000000000001
G2,C(CO)(CO)=O,1,251,367,618,5,0.011923999999999999
G2,C(C(CO)O)=O,2,337,394,731,41,0.016033000000000002
G2,C(C(C)=O)=O,1,676,1391,2067,45,0.032081
G2,C(CC(CO)=O)=O,1,201,278,479,49,0.009551
G2,C(C(C(C)=O)O)=O,2,192,236,428,1,0.009112
G2,C(C=O)=O,1,756,951,1707,0,0.035878
G2,C(C)(C(CO)O)=O,2,172,199,371,28,0.008201
G2,C(C(CC(CO)=O)O)=O,2,46,56,102,4,0.002207
G2,C=O,1,3445,5658,9103,2,0.163491
G2,C(C(CCO)=O)=O,1,161,198,359,3,0.007666
G2,C(CO)(CCO)=O,1,171,238,409,3,0.008152
G2,C(C(C(C(C)=O)O)O)=O,4,52,58,110,0,0.002495
G2,C(C(C=O)O)=O,1,263,369,632,1,0.012482
G2,C(C)(CO)=O,1,603,1142,1745,49,0.028629
G2,C(CC(C=O)O)=O,2,201,239,440,43,0.009552
G2,C(C(C(C=O)O)O)=O,3,55,56,111,0,0.002624
G2,C(C)=O,1,2089,4737,6826,4,0.099137
G2,C(CO)(C(CO)O)=O,2,82,94,176,2,0.003941
G2,C(C(C(CO)O)O)(C(CO)O)=O,8,15,13,28,2,0.000807
G2,C(CC(C(C(CO)O)=O)O)=O,4,22,20,42,2,0.001094
G2,C(C(CO)=O)(CC(CO)O)=O,2,16,15,31,0,0.000816
G2,C(C(C(CC(CO)O)O)=O)=O,4,13,15,28,29,0.0006730000000000001
G2,C(C(CO)O)(CC(CO)=O)=O,2,20,17,37,2,0.000998
G2,C(C(CC(C(CO)=O)O)O)=O,4,17,16,33,32,0.00084
G2,C(CCO)(C(C(CO)=O)O)=O,2,17,14,31,2,0.000842
G2,C(C(C(C(CCO)O)=O)O)=O,4,14,13,27,2,0.000698
G2,C(CO)(C(CC(CO)=O)O)=O,2,22,19,41,32,0.0010789999999999999
G2,C(C(C(CC(C=O)O)O)O)=O,8,21,21,42,43,0.0010429999999999999
G2,C(C)(C(C(C(CO)=O)O)O)=O,4,24,21,45,5,0.001175
G2,C(C(C(C=O)O)O)(C(C)O)=O,8,21,19,40,25,0.001033
G2,C(CC(C(C(CO)=O)O)O)=O,4,21,21,42,5,0.001044
G2,C(CO)O,1,33,136,169,46,0.00159
G2,C(C(C(CO)O)O)O,3,4,9,13,6,0.00023500000000000002
G2,C(CO)(CC(C(CO)O)O)=O,4,16,14,30,41,0.00084
G2,C(C(C(CO)O)O)(CCO)=O,4,18,15,33,2,0.000938
G2,C(C(CO)O)(CC(CO)O)=O,4,18,15,33,2,0.0009390000000000001
G2,C(C)(C(C(C(CO)O)O)O)=O,8,17,15,32,41,0.0008880000000000001
G2,C(CC(C(C(CO)O)O)O)=O,8,15,16,31,0,0.0008039999999999999
G2,C(C(C(C(CCO)O)O)O)=O,8,15,15,30,29,0.000792
G2,C(CO)(O)=O,1,149,284,433,33,0.007121
G2,C(C(C(CO)O)O)(O)=O,4,17,24,41,0,0.000897
G2,C(C(CC(C(CO)O)O)=O)(O)=O,4,11,13,24,29,0.000604
G2,C(CC(C(C(CO)O)O)=O)(O)=O,4,12,14,26,0,0.000642
G2,C(C(C(CC(CO)O)=O)O)(O)=O,4,13,12,25,0,0.000701
G2,C(CC(C(O)=O)O)(C(CO)O)=O,4,13,12,25,33,0.0007030000000000001
G2,C(C(C(C(O)=O)O)O)(CCO)=O,4,14,12,26,3,0.000749
G2,C(C(C(CC(CO)=O)O)O)(O)=O,4,13,11,24,49,0.000699
G2,C(C(C(C(C(C)=O)O)O)O)(O)=O,8,14,13,27,17,0.0007469999999999999
G2,C(CC(C(C(C(O)=O)O)O)O)=O,8,16,17,33,43,0.0008529999999999999
G2,C(CC(C(C(C=O)O)O)O)(O)=O,8,12,15,27,29,0.000638
G2,C1(CC(C(C1(CO)O)O)O)=O,8,14,15,29,2,0.000735
G2,C(C1(C(C(CC1O)O)O)O)=O,16,12,16,28,43,0.0006360000000000001
G2,C(C(C(CO)O)(C(CO)O)O)=O,3,7,9,16,0,0.000379
G2,C(CCO)(CC(C=O)=O)=O,1,27,28,55,30,0.001306
G2,C(CO)(CCC(C=O)=O)=O,1,29,28,57,12,0.0013880000000000001
G2,C(C)(C(CC(C=O)=O)O)=O,2,29,27,56,45,0.0013880000000000001
G2,C(CC(CC(C=O)=O)O)=O,2,29,30,59,23,0.001401
G2,C(CC(C(CCO)=O)=O)=O,1,26,27,53,2,0.001258
G2,C(CC(CC(CO)=O)=O)=O,1,31,32,63,4,0.001483
G2,C(CC(C(C(C)=O)O)=O)=O,2,27,27,54,9,0.001281
G2,C(CC(C(CC=O)O)=O)=O,2,32,33,65,4,0.001531
G2,C(C(C=O)O)(CC(C)=O)=O,2,27,27,54,2,0.001281
G2,C(C(C(CCC=O)=O)O)=O,2,27,27,54,4,0.001281
G2,C(C(CC(C(C)=O)=O)O)=O,2,26,25,51,14,0.0012460000000000001
G2,C(CC(CC(C=O)O)=O)=O,2,31,32,63,2,0.001483
G2,C1(CC(C(C(CO)O)O1)O)=O,8,9,4,13,29,0.000472
G2,C1(COC(C(CO)O)C1O)=O,8,13,9,22,2,0.000661
G2,C1(C(O)OC(C(CO)O)C1)=O,8,11,10,21,2,0.0005549999999999999
G2,C1(C(C(CO)O)OC(C1)O)=O,8,13,13,26,9,0.0006519999999999999
G2,C(C)(C1C(C(C(O1)O)O)O)=O,16,11,12,23,35,0.000544
G2,C(CC1C(C(C(O)O1)O)O)=O,16,9,13,22,2,0.000449
G2,C1(CC(C(C(CO)O1)O)O)=O,8,8,5,13,29,0.000424
G2,C1(COC(CO)C(C1O)O)=O,8,14,10,24,2,0.000709
G2,C1(C(O)OC(CO)C(C1)O)=O,8,10,9,19,2,0.0004969999999999999
G2,C1(C(C(CO)OC(C1)O)O)=O,8,10,10,20,9,0.00048600000000000005
G2,C1(C(C(O)OC(CO)C1)O)=O,8,10,12,22,2,0.00048600000000000005
G2,C1(C(CO)OC(C(C1)O)O)=O,8,12,12,24,2,0.000596
G2,C1(CC(C(C(CO1)O)O)O)=O,8,8,8,16,46,0.00043499999999999995
G2,C1(COCC(C(C1O)O)O)=O,8,15,12,27,36,0.000767
G2,C1(C(O)OCC(C(C1)O)O)=O,8,11,11,22,41,0.0005549999999999999
G2,C1(C(C(COC(C1)O)O)O)=O,8,12,13,25,38,0.000592
G2,C1(C(C(O)OCC(C1)O)O)=O,8,10,13,23,19,0.00048600000000000005
G2,C1(C(COC(C(C1)O)O)O)=O,8,11,12,23,2,0.000533
G2,C1(C(C(C(O)OCC1)O)O)=O,8,13,14,27,30,0.0006389999999999999
G2,C1(COC(C(C(C1)O)O)O)=O,8,11,13,24,2,0.0005549999999999999
G2,C(C(CO)O)=CC(C=O)=O,4,13,14,27,29,0.00065
G2,C(C(C(C=CCO)=O)O)=O,4,19,18,37,2,0.0009130000000000001
G2,C(C=CC(C(CO)O)=O)=O,4,32,28,60,2,0.001556
G2,C(C(C(C(C=C)=O)O)O)=O,4,33,31,64,7,0.001592
G2,C(C(C=CC(CO)=O)O)=O,4,26,23,49,32,0.001245
G2,C(C(C(C=CC=O)O)O)=O,8,25,25,50,43,0.0012109999999999998
G2,C1C(C(C(O)O1)O)O,8,3,17,20,18,0.000165
G2,C(C1(C(C(C(CO)O1)O)O)O)O,16,5,5,10,0,0.00028199999999999997
G2,C(C1(CC(C(CO)O1)O)O)=O,8,5,7,12,41,0.00026000000000000003
G2,C(CC1(C(C(CO1)O)O)O)=O,8,8,13,21,9,0.00040199999999999996
G2,C(C(C1(CC(CO1)O)O)O)=O,8,7,12,19,2,0.000343
G2,C(C1C(CC(CO)(O1)O)O)=O,8,9,11,20,40,0.000449
G2,C(C1C(C(C(C)(O1)O)O)O)=O,16,9,12,21,1,0.000449
G2,C(C(C1C(CC(O)O1)O)O)=O,16,8,10,18,2,0.000391
G2,C1C(C(C(C(CO)(O)O1)O)O)O,16,6,7,13,2,0.00033999999999999997
G2,C(C1(CC(C(CO1)O)O)O)=O,8,6,9,15,30,0.00031800000000000003
G2,C(C1C(C(CC(O1)O)O)O)=O,16,10,12,22,37,0.000508
G2,C1(C(C(C(C(CO)O)O1)O)O)=O,16,12,5,17,27,0.00065
G2,C1(C(C(C(C(CO)O1)O)O)O)=O,16,11,6,17,50,0.000603
G2,C1(C(C(C(C(CO1)O)O)O)O)=O,16,10,9,19,40,0.0005549999999999999
G3,C1(C(C(C(C1)O)O)O)=O,8,36,45,81,4,0.0017530000000000002
G3,C1(C(C(C(CC1O)O)O)O)=O,16,16,14,30,32,0.000826
G3,C1(C(C(C(C1)O)(CO)O)O)=O,8,17,15,32,2,0.0008619999999999999
G3,C1(C(CC(CO)(C1O)O)O)=O,8,15,13,28,32,0.0007559999999999999
G3,C1(C(C(C(CO)(C1)O)O)O)=O,8,18,16,34,2,0.000921
G3,C1(C(C(C(C)(C1O)O)O)O)=O,16,17,15,32,2,0.0008619999999999999
G3,C1(C(C(CC(C1O)O)O)O)=O,10,9,8,17,2,0.00045999999999999996
G3,C1(C(CO)C(C(C1)=O)O)=O,4,30,26,56,30,0.00145
G3,C1(CCC(C(C1O)O)=O)=O,3,17,15,32,12,0.0008179999999999999
G3,C(C1(CCC(C1O)=O)O)=O,4,21,22,43,12,0.001019
G3,C1(CC(C(CC1O)=O)O)=O,3,16,14,30,2,0.0007700000000000001
G3,C(C1(CC(C(C1)=O)O)O)=O,4,21,21,42,22,0.00103
G3,C(C1C(CC(C1O)=O)O)=O,8,29,27,56,4,0.0014089999999999999
G3,C1(C(CC(C1CO)O)=O)=O,4,25,23,48,2,0.001224
G3,C1(CC(C(C(C1)=O)O)O)=O,4,31,30,61,4,0.001504
G3,C1(CC(CC(C1O)=O)O)=O,1,18,17,35,9,0.000865
G3,C(C1C(C(CC1O)O)=O)=O,8,22,20,42,4,0.001077
G3,C(C1C(C(C(C1)=O)O)O)=O,8,30,28,58,2,0.001457
G3,C1(C(CC(C(C1)O)O)=O)=O,3,13,13,26,14,0.0006389999999999999
G3,C(C1C(CC(C1O)O)=O)=O,8,25,25,50,2,0.001231
G3,C1C(C(C(C(C=1)=O)O)O)O,8,23,21,44,32,0.0011359999999999999
G3,C1(C(C(C(C(C1CO)O)O)O)O)=O,32,17,16,33,2,0.0009109999999999999
G3,C(CO)(C(C(CO)(CO)O)O)=O,2,9,7,16,5,0.00047300000000000006
G3,C(C(C)(C(C(CO)=O)O)O)=O,4,16,17,33,45,0.000795
G3,C(C(CC(CO)(CO)O)=O)=O,1,12,13,25,5,0.000604
G3,C(CO)(CC(C(C(CO)=O)O)O)=O,4,18,16,34,5,0.0009109999999999999
G3,C(CC(CO)(C(C(CO)=O)O)O)=O,4,16,15,31,5,0.000817
G3,C(C(C(CO)=O)C(CO)(CO)O)=O,2,10,9,19,49,0.0005200000000000001
G3,C(CC(C(C(CO)(CO)O)O)=O)=O,2,10,10,20,49,0.000509
G3,C(C)(C(C(C(C(CO)=O)O)O)O)=O,8,18,17,35,5,0.0009119999999999999
G3,C(C(C(C)(C(C(CO)=O)O)O)O)=O,8,16,16,32,5,0.000807
G3,C(C(C(CC(CO)(CO)O)=O)O)=O,2,9,9,18,5,0.00046100000000000004
G3,C(C(C(C(CO)=O)O)O)=O,4,35,34,69,5,0.001698
G3,C(CO)(C(C(C)(C(CO)O)O)O)=O,8,13,11,24,5,0.000696
G3,C(C(CO)O)(CC(CO)(CO)O)=O,2,11,9,20,5,0.000593
G3,C(C(C(C(CCO)=O)O)O)(CO)=O,4,19,17,36,5,0.0009609999999999999
G3,C(C(CCO)(C(C(CO)=O)O)O)=O,4,15,15,30,5,0.000769
G3,C(C(C(CO)C(CO)(CO)O)=O)=O,2,13,12,25,5,0.000678
G3,C(CO)(C(C(CO)(CCO)O)O)=O,4,13,10,23,3,0.000696
G3,C(C(C(CO)(CO)O)O)(CCO)=O,2,10,8,18,3,0.000533
G3,C(CO)(C(CO)C(CO)(CO)O)=O,2,12,9,21,5,0.000641
G3,C(C(C(C(C(CO)=O)O)O)O)=O,8,17,18,35,5,0.000865
G3,C(CO)(C(C(CO)(C)O)O)=O,4,15,12,27,49,0.000769
G3,C(CO)(CC(CO)(CO)O)=O,1,12,10,22,5,0.000615
G3,C(C)(C(C(CO)(CO)O)O)=O,2,12,10,22,5,0.000604
G3,C(CC(C(C(C(CO)=O)O)O)O)=O,8,21,20,41,51,0.001065
G3,C(C(CC(C(C(CO)=O)O)O)O)=O,8,20,18,38,51,0.001006
G3,C(C(C(CO)(CO)O)C(C=O)O)=O,4,12,13,25,5,0.000616
G3,C(CO)(C(C(C)O)O)=O,4,35,43,78,2,0.0017079999999999999
G3,C(CC(CO)(CO)O)=O,1,21,27,48,5,0.001031
G3,C(C(C(CO)=O)C(C(CO)O)O)=O,8,15,14,29,49,0.000791
G3,C(CC(C(C(C(CO)O)O)O)=O)=O,8,15,15,30,49,0.000791
G3,C(C(C(CC(C(CO)O)O)=O)O)=O,8,13,13,26,29,0.000684
G3,C(C(CO)O)(CC(C(CO)O)O)=O,8,15,13,28,41,0.000816
G3,C(C(C(CO)C(C(CO)O)O)=O)=O,8,18,17,35,41,0.0009480000000000001
G3,C(C(C(C(CO)O)O)O)(CCO)=O,8,15,13,28,3,0.0008150000000000001
G3,C(CO)(C(CO)C(C(CO)O)O)=O,8,16,13,29,41,0.000865
G3,C(C(C(C(CO)O)O)C(C=O)O)=O,16,17,18,35,41,0.0008869999999999999
G3,C(CC(C(CO)O)O)=O,4,26,33,59,41,0.001302
G3,C(C(C)(CC(C=O)=O)O)=O,2,17,20,37,4,0.0008300000000000001
G3,C(CO)(CC(CC(C=O)=O)O)=O,2,17,19,36,20,0.0008410000000000001
G3,C(CC(CO)(CC(C=O)=O)O)=O,2,15,19,34,51,0.000758
G3,C(C(C(CO)=O)C(C(C)=O)O)=O,4,15,16,31,49,0.000736
G3,C(C(C)(C(C=O)C(CO)=O)O)=O,4,12,15,27,49,0.000604
G3,C(CC(C(C(C(C)=O)O)O)=O)=O,4,20,21,41,49,0.000974
G3,C(C(C)(C(C(CC=O)=O)O)O)=O,4,12,17,29,49,0.000593
G3,C(C)(C(C(CC(C=O)=O)O)O)=O,4,18,20,38,49,0.000889
G3,C(C(C(C)(CC(C=O)=O)O)O)=O,4,15,19,34,26,0.0007480000000000001
G3,C(C(C(CC(C(C)=O)O)=O)O)=O,4,16,16,32,29,0.000771
G3,C(C(C)(CC(C(C=O)O)=O)O)=O,4,11,14,25,16,0.000545
G3,C(C(CC(C=O)=O)O)=O,2,36,46,82,0,0.001721
G3,C(C(CC(C)(C(CO)O)O)=O)=O,4,14,16,30,29,0.000732
G3,C(CC(C(C)=O)O)(C(CO)O)=O,4,17,15,32,45,0.0008560000000000001
G3,C(C(C)(CC(C(CO)O)=O)O)=O,4,15,15,30,16,0.000772
G3,C(C(CC(C=O)=O)O)(CCO)=O,2,15,17,32,2,0.0007480000000000001
G3,C(C(CCO)(CC(C=O)=O)O)=O,2,11,15,26,29,0.000567
G3,C(C(C(C(C=O)=O)CO)O)(C)=O,4,16,18,34,45,0.000798
G3,C(C(C)(C(C(C=O)=O)CO)O)=O,4,13,17,30,4,0.000667
G3,C(C(CC(CO)(CCO)O)=O)=O,2,14,15,29,29,0.000732
G3,C(C(C(C(CCO)=O)O)O)(C)=O,4,17,16,33,3,0.0008560000000000001
G3,C(C(C)(C(C(CCO)=O)O)O)=O,4,13,15,28,45,0.000665
G3,C(CO)(C(CO)C(C(C)=O)O)=O,4,17,15,32,45,0.000857
G3,C(C(C)(C(C(CO)=O)CO)O)=O,4,15,15,30,3,0.000773
G3,C(C(C(CC(C=O)=O)O)O)=O,4,21,23,44,15,0.001033
G3,C(C(CC(C)(CO)O)=O)=O,2,19,20,39,49,0.000947
G3,C(C)(C(CC(CO)=O)O)=O,2,34,30,64,45,0.001637
G3,C(C(C)(CC(CO)=O)O)=O,2,23,24,47,16,0.001126
G3,C(C)(C(C(C(C)=O)O)O)=O,3,18,16,34,45,0.000867
G3,C(C(C)(C(C(C)=O)O)O)=O,4,21,22,43,45,0.001021
G3,C(CC(C(CC(C=O)=O)O)O)=O,4,19,24,43,20,0.0009480000000000001
G3,C(C(CC(CC(C=O)=O)O)O)=O,4,17,20,37,20,0.0008410000000000001
G3,C(C(C(C=O)C(C(C)=O)O)O)=O,8,14,18,32,45,0.0006889999999999999
G3,C(C(C(C=O)C(C=O)(C)O)O)=O,8,11,17,28,45,0.000558
G3,C(C(C(C(CC(C=O)=O)O)O)O)=O,8,23,23,46,0,0.001149
G3,C(C(CC(C)O)=O)=O,2,60,80,140,4,0.0028710000000000003
G3,C(CC(C(C)=O)O)=O,2,97,111,208,45,0.0046159999999999994
G3,C(C(C)(CC=O)O)=O,2,60,76,136,45,0.0028710000000000003
G3,C(C(CC(CO)(C(CO)O)O)=O)=O,4,15,14,29,51,0.00079
G3,C(C(C(C(C(CO)O)=O)O)O)(C)=O,8,20,18,38,2,0.001011
G3,C(C(C)(C(C(C(CO)O)=O)O)O)=O,8,17,17,34,2,0.000868
G3,C(C(C(CO)=O)C(C=O)O)=O,4,18,19,37,2,0.000878
G3,C(CC(C(C(C=O)O)O)=O)=O,4,25,26,51,2,0.001212
G3,C(C(C(CO)=O)CO)=O,2,36,41,77,2,0.0017460000000000002
G3,C(CC(C(CO)O)=O)=O,2,43,50,93,2,0.002078
G3,C(C(C(C(C=O)C(CO)=O)O)O)=O,8,16,17,33,49,0.000807
G3,C(CC(C(C(C(C=O)O)O)O)=O)=O,8,20,21,41,1,0.0009960000000000001
G3,C(C(C(CO)=O)C(CO)(C)O)=O,4,13,13,26,49,0.000674
G3,C(CC(C(C(CO)(C)O)O)=O)=O,4,13,14,27,49,0.000663
G3,C(CO)(CC(CC(CO)=O)O)=O,1,8,7,15,49,0.00040300000000000004
G3,C(CC(CO)(CC(CO)=O)O)=O,2,15,15,30,49,0.0007700000000000001
G3,C(C)(C(C(CC(CO)=O)O)O)=O,4,16,15,31,49,0.0008060000000000001
G3,C(CC(CO)(C(C(C)=O)O)O)=O,4,14,15,29,49,0.000711
G3,C(C(C(CO)=O)C(C)O)=O,4,22,21,43,4,0.00108
G3,C(CC(C(C(C)O)O)=O)=O,4,25,26,51,4,0.001222
G3,C(CC(CC(CO)=O)O)=O,2,32,32,64,2,0.0015539999999999998
G3,C(CC(CO)(CC=O)O)=O,1,14,14,28,49,0.000699
G3,C(C(C(CC(C=O)O)=O)O)=O,4,20,20,40,15,0.0009609999999999999
G3,C(C(C(CCO)=O)O)=O,2,40,47,87,27,0.001923
G3,C(CC(C(C=O)O)O)(C(C=O)O)=O,8,19,19,38,1,0.0009369999999999999
G3,C(C(C(CC(CO)(C)O)=O)O)=O,4,11,12,23,49,0.000567
G3,C(C(C(C)(CC(CO)=O)O)O)=O,4,14,15,29,0,0.000711
G3,C(C)(C(C(C(C(C)=O)O)O)O)=O,3,8,8,16,1,0.00040300000000000004
G3,C(C(C(C)(C(C(C)=O)O)O)O)=O,8,13,15,28,49,0.000653
G3,C(C(C(CC(C)O)=O)O)=O,4,22,23,45,4,0.001068
G3,C(CC(C(C(C)=O)O)O)=O,4,31,30,61,45,0.001507
G3,C(CC(C)(C(C=O)O)O)=O,4,25,27,52,6,0.0012230000000000001
G3,C(C(C(C(CO)=O)C(C=O)O)O)=O,3,10,10,20,0,0.0004980000000000001
G3,C(C(C(C(CC(C=O)O)=O)O)O)=O,8,24,23,47,0,0.001176
G3,C(C(C(C(C=O)=O)CO)O)=O,4,17,19,36,0,0.0008460000000000001
G3,C(CO)(C(CO)C(C=O)O)=O,4,21,19,40,2,0.001047
G3,C(C(C(C=O)C(C=O)O)O)=O,3,10,12,22,43,0.000487
G3,C(C(C(C=O)O)O)(C(CO)O)=O,8,19,19,38,5,0.000964
G3,C(C(CO)O)(CCO)=O,2,36,44,80,2,0.001771
G3,C(C(CO)O)(CC(C(C=O)O)O)=O,8,18,17,35,2,0.000927
G3,C(C(CO)O)(CC(CO)(C)O)=O,4,13,11,24,49,0.000699
G3,C(CO)(CC(C)(C(CO)O)O)=O,4,12,10,22,52,0.000648
G3,C(C)(C(C(C)(C(CO)O)O)O)=O,8,12,11,23,28,0.000637
G3,C(C(CO)O)(CC(C)O)=O,4,24,22,46,2,0.0012
G3,C(CC(C)(C(CO)O)O)=O,4,18,18,36,17,0.0009220000000000001
G3,C(CO)(C(C(C)O)C(C=O)O)=O,8,15,16,31,11,0.0007599999999999999
G3,C(CC(C=O)O)(C(C(C)O)O)=O,8,15,16,31,4,0.000759
G3,C(CC(C(CC(CO)=O)O)O)=O,4,18,19,37,21,0.0009119999999999999
G3,C(CC(CO)(CC(C=O)O)O)=O,4,16,18,34,21,0.000816
G3,C(C(C(CO)CO)=O)=O,1,25,26,51,2,0.001213
G3,C(CO)(C(CO)CO)=O,1,29,33,62,2,0.0014140000000000001
G3,C(C(CO)C(C=O)O)=O,4,36,38,74,43,0.001748
G3,C(CCO)=O,1,388,904,1292,18,0.018438999999999997
G3,C(C(CO)O)(C(CO)O)=O,3,14,12,26,2,0.0007019999999999999
G3,C(C(CO)C(C(C(CO)O)=O)O)=O,8,19,18,37,2,0.0009660000000000001
G3,C(C(C(CO)O)=O)(CC(CO)O)=O,4,13,14,27,0,0.000677
G3,C(C(CO)=O)(C(CO)C(CO)O)=O,4,14,14,28,0,0.000726
G3,C(C(CO)O)(CC(C(CO)O)=O)=O,3,7,7,14,2,0.00035800000000000003
G3,C(C(CO)O)(C(C(CO)=O)CO)=O,4,13,12,25,2,0.000669
G3,C(C(CC(C(C(CO)O)=O)O)O)=O,8,16,15,31,32,0.000819
G3,C(CCO)(C(C(C(CO)O)=O)O)=O,4,12,12,24,2,0.000609
G3,C(C(CO)CO)(C(C(CO)=O)O)=O,2,9,8,17,2,0.000453
G3,C(CC(C(C(CO)O)=O)O)(CO)=O,4,18,16,34,32,0.0009029999999999999
G3,C(CO)(C(CO)C(C(CO)=O)O)=O,4,19,16,35,2,0.0009630000000000001
G3,C(CC(C(CO)=O)O)(C(CO)O)=O,4,19,16,35,2,0.000962
G3,C(CC(C(C(C(CO)O)=O)O)O)=O,8,18,17,35,2,0.000927
G3,C(C(CO)C(C(C(CO)=O)O)O)=O,8,19,18,37,5,0.000974
G3,C(C(C(CO)O)O)(C(CO)CO)=O,4,13,11,24,2,0.000701
G3,C(C(CO)O)(C(CO)C(CO)O)=O,8,17,14,31,2,0.000917
G3,C(C(CO)C(C(C(CO)O)O)O)=O,16,17,16,33,0,0.000923
G3,C1(C(CO)(C(C(C1CO)O)O)O)=O,16,14,16,30,2,0.000739
G3,C(CCO)(C(C(C=O)=O)CO)=O,2,15,17,32,2,0.0007509999999999999
G3,C(C(CO)CO)(CC(C=O)=O)=O,1,11,13,24,30,0.000537
G3,C(CC(C(C=O)=O)CO)(CO)=O,2,17,18,35,12,0.000843
G3,C(CO)(C(CO)CC(C=O)=O)=O,2,17,18,35,12,0.000843
G3,C(CCC(C=O)=O)(C(CO)O)=O,2,18,18,36,12,0.000892
G3,C(CC(C(C(C=O)=O)CO)O)=O,4,17,21,38,2,0.000858
G3,C(C(CO)C(CC(C=O)=O)O)=O,4,17,20,37,23,0.000857
G3,C(C(C(C(CCO)=O)=O)CO)=O,2,15,16,31,2,0.0007509999999999999
G3,C(CC(C(C(CO)CO)=O)=O)=O,1,11,12,23,2,0.000537
G3,C(C(C(CC(CO)=O)=O)CO)=O,2,14,15,29,2,0.000691
G3,C(CC=O)(C(C(CO)=O)CO)=O,2,15,15,30,2,0.00075
G3,C(CC(CC(C(CO)O)=O)=O)=O,2,16,16,32,2,0.000797
G3,C(C(C(C(C(C)=O)O)=O)CO)=O,4,12,13,25,9,0.000596
G3,C(CC(C(C(CCO)=O)O)=O)=O,2,12,13,25,9,0.000594
G3,C(CC(C(C(C=O)CO)=O)O)=O,4,16,18,34,2,0.000798
G3,C(C(CO)C(C(CC=O)=O)O)=O,4,18,20,38,23,0.000893
G3,C(C(C=O)O)(C(C(C)=O)CO)=O,4,12,13,25,2,0.000596
G3,C(C(C=O)O)(CC(CCO)=O)=O,2,12,13,25,2,0.000594
G3,C(C(CO)CC=O)(C(C=O)O)=O,4,15,17,32,43,0.000737
G3,C(C(CO)CC(C(C=O)O)=O)=O,4,15,17,32,55,0.000725
G3,C(C(C(C(C(C)=O)=O)CO)O)=O,4,15,16,31,14,0.00075
G3,C(C(CC(C(CCO)=O)=O)O)=O,2,13,14,27,14,0.000653
G3,C(C(CO)C(C=O)O)(CC=O)=O,4,18,20,38,2,0.000893
G3,C(CC(C=O)O)(C(C=O)CO)=O,4,16,17,33,2,0.000797
G3,C1(C(CO)OC(C(CO)O)C1O)=O,16,7,7,14,2,0.00035800000000000003
G3,C1(C(O)OC(C(CO)O)C1CO)=O,16,9,9,18,2,0.00047599999999999997
G3,C1(C(C(CO)O)OC(C1CO)O)=O,16,9,12,21,9,0.000466
G3,C(C1C(C(C(O1)O)O)O)(CCO)=O,16,9,10,19,2,0.00047400000000000003
G3,C(C(CO)C1C(C(C(O)O1)O)O)=O,32,9,12,21,2,0.00046399999999999995
G3,C1(C(CO)OC(C(C1O)O)CO)=O,16,8,8,16,2,0.00040599999999999995
G3,C1(C(O)OC(CO)C(C1CO)O)=O,16,9,9,18,2,0.000465
G3,C1(C(C(CO)OC(C1CO)O)O)=O,16,6,9,15,9,0.0003
G3,C1(C(C(O)OC(CO)C1CO)O)=O,16,6,10,16,2,0.0003
G3,C1(C(CO)OC(C(C1CO)O)O)=O,16,9,11,20,2,0.00045700000000000005
G3,C1(C(CO)OCC(C(C1O)O)O)=O,16,10,10,20,36,0.000523
G3,C1(C(O)OCC(C(C1CO)O)O)=O,16,10,11,21,41,0.000523
G3,C1(C(C(COC(C1CO)O)O)O)=O,16,9,12,21,38,0.00046399999999999995
G3,C1(C(C(O)OCC(C1CO)O)O)=O,16,8,12,20,19,0.00040599999999999995
G3,C1(C(COC(C(C1CO)O)O)O)=O,16,9,11,20,2,0.000453
G3,C1(C(C(C(O)OCC1CO)O)O)=O,16,10,12,22,30,0.000512
G3,C1(COC(C(C(C1CO)O)O)O)=O,16,11,12,23,2,0.000582
G3,C1(C(CO)OC(C(C(C1)O)O)O)=O,16,9,10,19,2,0.00047599999999999997
G3,C(C(C=CC(C(CO)O)=O)O)=O,8,13,13,26,32,0.000654
G3,C(C(CO)C1(C(C(CO1)O)O)O)=O,16,8,13,21,9,0.000417
G3,C(C(C(C(C(C=O)=O)CO)O)O)=O,8,20,20,40,15,0.001011
G3,C(C(C(CO)C(C)(CO)O)=O)=O,4,16,17,33,49,0.000831
G3,C(CC(C(CCO)=O)O)(CO)=O,2,16,14,30,3,0.000807
G3,C(C(CCO)(CC(CO)=O)O)=O,2,13,13,26,3,0.0006730000000000001
G3,C(C(CCO)(C(C(C)=O)O)O)=O,4,12,14,26,3,0.000616
G3,C(C(C(CO)C(C)O)=O)=O,4,19,19,38,4,0.000953
G3,C(CC(C(CCO)=O)O)=O,2,31,29,60,4,0.001508
G3,C(C(CCO)(CC=O)O)=O,2,17,19,36,3,0.0008529999999999999
G3,C(C(C(C(C=O)O)O)O)(CCO)=O,8,17,17,34,2,0.000878
G3,C(C(C(C(C(CO)=O)CO)O)O)=O,8,19,18,37,2,0.000975
G3,C(C(C(CO)(C)O)O)(CCO)=O,4,12,10,22,3,0.00064
G3,C(CO)(C(CO)C(CO)(C)O)=O,4,14,11,25,49,0.0007480000000000001
G3,C(CO)(CC(CO)(CCO)O)=O,2,12,9,21,29,0.000648
G3,C(C)(C(C(CO)(CCO)O)O)=O,4,12,10,22,3,0.000638
G3,C(C(C(C)O)O)(CCO)=O,4,24,22,46,4,0.001199
G3,C(CO)(C(CO)C(C)O)=O,4,23,19,42,4,0.0011539999999999999
G3,C(CC(CO)(CCO)O)=O,2,18,17,35,3,0.0009220000000000001
G3,C(C(C(C=O)O)O)(CC(C)O)=O,8,15,17,32,11,0.0007610000000000001
G3,C(CC(C(C(C(C)=O)O)O)O)=O,8,20,21,41,49,0.001007
G3,C(CC(C)(C(C(C=O)O)O)O)=O,8,18,21,39,16,0.0009130000000000001
G3,C(C(C(C(C=O)C(C=O)O)O)O)=O,16,21,22,43,43,0.001045
G3,C(CC(C(C=O)O)O)=O,4,43,52,95,0,0.002078
G3,C(CO)(CC(CO)(C)O)=O,2,22,20,42,49,0.001101
G3,C(C)(C(C(CO)(C)O)O)=O,4,21,18,39,49,0.0010429999999999999
G3,C(C(CC(CC(CO)=O)O)O)=O,4,16,16,32,21,0.0008039999999999999
G3,C(C(CC(C(C(C)=O)O)O)O)=O,8,18,18,36,49,0.0009
G3,C(C(C(CO)(C)O)C(C=O)O)=O,8,14,17,31,49,0.000722
G3,C(C(C(C(CC(CO)=O)O)O)O)=O,8,21,20,41,20,0.001066
G3,C(C(C(C(C(C(C)=O)O)O)O)O)=O,16,23,22,45,49,0.001161
G3,C(CO)(CC(C)O)=O,2,68,96,164,11,0.0032619999999999997
G3,C(C)(C(C(C)O)O)=O,4,69,82,151,4,0.003311
G3,C(CC(C)(CO)O)=O,2,47,64,111,49,0.002277
G3,C(CO)(CC(CO)(C(CO)O)O)=O,4,13,10,23,29,0.0007070000000000001
G3,C(C)(C(C(CO)(C(CO)O)O)O)=O,8,13,11,24,2,0.000696
G3,C(C(C(CO)(C)O)O)(C(CO)O)=O,8,14,12,26,49,0.0007469999999999999
G3,C(C(C(C)O)C(C=O)O)=O,8,22,22,44,43,0.0010810000000000001
G3,C(CC(C(CC=O)O)O)=O,3,15,16,31,43,0.000735
G3,C(CC(CC(C=O)O)O)=O,4,26,26,52,43,0.001268
G3,C(CC(C)O)=O,2,219,414,633,28,0.010417000000000001
G3,C(CC(CO)(C(CO)O)O)=O,4,14,14,28,2,0.0007440000000000001
G3,C(C(C(C)O)O)(C(CO)O)=O,8,18,15,33,2,0.0009279999999999999
G3,C(CC(C(CC(CCO)=O)=O)O)=O,2,13,14,27,30,0.000642
G3,C(CC(C=O)(CC=O)O)(CCO)=O,2,12,13,25,23,0.000618
G3,C(CC(CCO)(CC(C=O)=O)O)=O,2,12,14,26,30,0.000616
G3,C(CCO)(C(C(C=O)=O)C(C)O)=O,4,11,12,23,30,0.00056
G3,C(C(CO)C(C)O)(CC(C=O)=O)=O,4,13,13,26,4,0.000657
G3,C(CC(C(CCC(CO)=O)=O)O)=O,2,16,16,32,7,0.000772
G3,C(CO)(CCC(C=O)(CC=O)O)=O,2,15,16,31,29,0.0007469999999999999
G3,C(CC(CCC(C=O)=O)(CO)O)=O,2,16,17,33,29,0.000805
G3,C(CC(C(C=O)=O)C(C)O)(CO)=O,4,13,14,27,12,0.000641
G3,C(CO)(C(C(C)O)CC(C=O)=O)=O,4,13,14,27,12,0.000641
G3,C(CCC(C=O)=O)(C(C(C)O)O)=O,4,15,14,29,12,0.0007480000000000001
G3,C(CC(C(CC(C(C)=O)O)=O)O)=O,4,18,17,35,45,0.000878
G3,C(C)(C(CC(C=O)(CC=O)O)O)=O,4,14,15,29,22,0.000699
G3,C(CC(C)(C(CC(C=O)=O)O)O)=O,4,16,18,34,22,0.000805
G3,C(C(C(C(C=O)=O)C(C)O)O)(C)=O,8,13,14,27,45,0.000654
G3,C(C(CC(C=O)=O)O)(CC(C)O)=O,4,12,13,25,22,0.000605
G3,C(CC(C(CC(CC=O)O)=O)O)=O,4,17,18,35,13,0.000843
G3,C(CC(CC(C=O)(CC=O)O)O)=O,4,15,18,33,13,0.000759
G3,C(CC(CC(CC(C=O)=O)O)O)=O,4,16,18,34,13,0.000805
G3,C(CC(C(C(C=O)=O)C(C)O)O)=O,8,14,16,30,4,0.000713
G3,C(C(C(CC(C=O)=O)O)C(C)O)=O,8,14,15,29,23,0.000713
G3,C(CC(CC(C(CCO)=O)=O)O)=O,2,13,13,26,53,0.000665
G3,C(CC(C(CCO)=O)(CC=O)O)=O,1,7,8,15,4,0.00035800000000000003
G3,C(C(CCO)(CC=O)O)(CC=O)=O,2,12,14,26,53,0.000604
G3,C(C(C(C(CCO)=O)=O)C(C)O)=O,4,11,12,23,2,0.00056
G3,C(CC(C(C(CO)C(C)O)=O)=O)=O,4,13,13,26,4,0.000657
G3,C(CC(CC(CC(CO)=O)=O)O)=O,2,14,14,28,26,0.0007
G3,C(CC(CC=O)(CC(CO)=O)O)=O,1,8,9,17,32,0.000404
G3,C(CC(CC(CO)(CC=O)O)=O)=O,2,14,15,29,26,0.000711
G3,C(C(C(CC(CO)=O)=O)C(C)O)=O,4,10,11,21,4,0.000499
G3,C(CC=O)(C(C(CO)=O)C(C)O)=O,4,10,11,21,4,0.000499
G3,C(CC(CC(C(C(C)O)O)=O)=O)=O,4,12,12,24,4,0.000605
G3,C(CC(CC(C(C(C)=O)O)=O)O)=O,4,14,14,28,9,0.000688
G3,C(CC(C(C(C)=O)O)(CC=O)O)=O,2,8,9,17,9,0.000404
G3,C(CC(C)(C(C(CC=O)=O)O)O)=O,4,14,16,30,6,0.0007
G3,C(C(C(C(C(C)=O)O)=O)C(C)O)=O,8,9,10,19,9,0.000452
G3,C(CC(C(C(CC(C)O)=O)O)=O)=O,4,9,10,19,9,0.00045099999999999996
G3,C(CC(C(CC=O)O)(CC=O)O)=O,2,11,13,24,13,0.000558
G3,C(CC(CC(C(CC=O)=O)O)O)=O,4,17,18,35,13,0.0008410000000000001
G3,C(CC(C(C(C=O)C(C)O)=O)O)=O,8,13,14,27,4,0.000654
G3,C(C(C(C)O)C(C(CC=O)=O)O)=O,8,15,16,31,4,0.000749
G3,C(CC(C(C(CC(C)=O)=O)O)O)=O,4,15,16,31,26,0.0007469999999999999
G3,C(CC(C(C=O)O)(CC(C)=O)O)=O,4,12,14,26,27,0.000606
G3,C(C(C(CC(C)(CC=O)O)=O)O)=O,4,14,15,29,6,0.000699
G3,C(C(C=O)O)(C(C(C)=O)C(C)O)=O,8,9,10,19,2,0.000452
G3,C(C(C=O)O)(CC(CC(C)O)=O)=O,4,9,10,19,4,0.00045099999999999996
G3,C(CC(C(C(CCC=O)=O)O)O)=O,4,17,18,35,45,0.000842
G3,C(CCC(C(C=O)O)(CC=O)O)=O,4,18,20,38,44,0.000891
G3,C(C(C(CCC(CC=O)O)=O)O)=O,4,16,17,33,44,0.0007830000000000001
G3,C(C(C(C)O)CC=O)(C(C=O)O)=O,8,13,14,27,4,0.000641
G3,C(C(C(C)O)CC(C(C=O)O)=O)=O,8,14,14,28,46,0.000688
G3,C(CC(C(CC(C(C)=O)=O)O)O)=O,4,17,18,35,21,0.0008529999999999999
G3,C(C)(C(CC(C=O)O)(CC=O)O)=O,4,14,15,29,21,0.000699
G3,C(CC(C=O)O)(C(C)(CC=O)O)=O,4,14,15,29,21,0.000699
G3,C(C(C(C(C(C)=O)=O)C(C)O)O)=O,8,12,13,25,14,0.000606
G3,C(C(CC(C(CC(C)O)=O)=O)O)=O,4,10,11,21,14,0.0005099999999999999
G3,C(CC(CC(C(CC=O)O)O)=O)=O,4,18,20,38,6,0.0009
G3,C(CC(CC(C=O)O)(CC=O)O)=O,2,11,12,23,4,0.000556
G3,C(CC(C=O)O)(CC(CC=O)O)=O,4,16,17,33,26,0.000795
G3,C(C(C(C)O)C(C=O)O)(CC=O)=O,8,15,16,31,4,0.000749
G3,C(CC(C=O)O)(C(C=O)C(C)O)=O,8,13,13,26,2,0.000653
G3,C(CC(C(C=CC(CO)O)=O)O)=O,8,6,7,13,29,0.000319
G3,C(C(C=CC(CO)O)(CC=O)O)=O,8,4,6,10,29,0.00022400000000000002
G3,C(CC(C(C(C=CCO)=O)O)O)=O,8,11,11,22,11,0.0005690000000000001
G3,C(CC(C=CCO)(C(C=O)O)O)=O,8,8,9,17,0,0.00041600000000000003
G3,C(CC(C=CC(C(CO)O)=O)O)=O,8,13,13,26,21,0.000655
G3,C(CC(C=CC=O)(C(CO)O)O)=O,8,10,11,21,21,0.000531
G3,C(CC(C(C(C(C=C)=O)O)O)O)=O,8,20,20,40,7,0.001007
G3,C(C(C(C(C=C)(CC=O)O)O)O)=O,8,16,17,33,7,0.000807
G3,C(CC(C(C=CC(CO)=O)O)O)=O,8,10,11,21,32,0.000509
G3,C(C(C=CC(CO)(CC=O)O)O)=O,8,9,10,19,32,0.00045099999999999996
G3,C(C(C=CC(C(C(C)O)O)=O)O)=O,16,12,12,24,32,0.000605
G3,C(CC(C(C(C=CC=O)O)O)O)=O,16,11,13,24,43,0.000579
G3,C(C(C(C=CC(CC=O)O)O)O)=O,16,12,13,25,43,0.000606
G3,C(C(C(CO)(CO)O)O)=O,2,15,15,30,5,0.0007469999999999999
G3,C(CO)(C(C(CO)O)O)=O,4,25,22,47,2,0.001255
G3,C(C(C(C(CO)O)O)O)=O,8,21,20,41,41,0.001077
G3,C(C(C)(C(C=O)O)O)=O,4,26,35,61,45,0.001259
G3,C(C(CC(CO)O)=O)=O,2,30,37,67,0,0.00147
G3,C(CC(CO)(C(C=O)O)O)=O,4,17,19,36,2,0.0008550000000000001
G3,C(C(C(CO)=O)C(CO)O)=O,4,17,16,33,0,0.000865
G3,C(C(C(C)(C(C=O)O)O)O)=O,3,9,10,19,1,0.00045099999999999996
G3,C(C(C(C)(C(CO)O)O)O)=O,8,14,14,28,28,0.000733
G3,C(C(CC(CO)(C(C=O)O)O)O)=O,8,19,18,37,20,0.000959
G3,C(CO)(C(C(CO)O)C(C=O)O)=O,8,18,17,35,0,0.000924
G3,C(CC(C=O)O)(C(C(CO)O)O)=O,8,17,16,33,0,0.0008759999999999999
G3,C(C(CCO)(C(C=O)O)O)=O,4,13,16,29,3,0.000664
G3,C(C(C(CO)C(CO)O)=O)=O,4,19,18,37,0,0.000975
G3,C(C(C(CO)(CCO)O)O)=O,4,14,13,27,3,0.000733
G3,C(CO)(C(CO)C(CO)O)=O,4,18,14,32,2,0.000938
G3,C(C(C(C(C)(C(C=O)O)O)O)O)=O,16,21,21,42,0,0.001056
G3,C(C(C(C=O)O)O)(CC(CO)O)=O,8,17,17,34,0,0.000877
G3,C(C(C(C(C=O)O)O)O)=O,3,14,15,29,1,0.0006889999999999999
G3,C(C(C(CO)(C)O)O)=O,4,24,30,54,49,0.001186
G3,C(CO)(CC(CO)O)=O,2,33,43,76,0,0.001623
G3,C(C)(C(C(CO)O)O)=O,4,34,38,72,0,0.0016719999999999999
G3,C(C(C(CO)O)C(C=O)O)=O,8,18,19,37,43,0.0009130000000000001
G3,C(C(C(C(C(C=O)O)O)O)O)=O,10,11,12,23,15,0.000557
G3,C(C(C(C)O)O)=O,4,142,160,302,28,0.006776000000000001
G3,C(CC(CO)O)=O,2,104,160,264,6,0.004982
G3,C(C(C(CO)(C(CO)O)O)O)=O,8,13,13,26,2,0.000697
G3,C(C(CC(C(C(CO)O)O)O)=O)=O,8,15,15,30,20,0.000801
G3,C(CO)(CC(C(C(CO)O)O)O)=O,8,14,12,26,49,0.0007650000000000001
G3,C(C)(C(C(C(C(CO)O)O)O)O)=O,16,15,14,29,49,0.000813
G3,C(C(C(C(C(CO)O)O)=O)CO)=O,8,15,15,30,9,0.000784
G3,C(C(C(C(CO)C(CO)O)=O)O)=O,8,15,15,30,2,0.000773
G3,C(C(CO)C(C=O)O)(C(CO)O)=O,8,20,18,38,2,0.001025
G3,C(C(C(C=O)O)O)(C(CO)CO)=O,4,15,14,29,2,0.000763
G3,C(C(CO)C(C(C(C=O)O)O)O)=O,16,23,22,45,43,0.001176
G3,C(C(C)O)(O)=O,2,69,148,217,25,0.0033200000000000005
G3,C(C(CCO)O)(O)=O,2,17,29,46,45,0.000874
G3,C(C(CO)(CC(CO)O)O)(O)=O,4,8,9,17,29,0.000459
G3,C(C(C(CC(CO)O)O)O)(O)=O,8,11,10,21,29,0.000633
G3,C(CC(C(O)=O)O)(CCO)=O,2,16,14,30,30,0.0008289999999999999
G3,C(C(CCC(CO)=O)O)(O)=O,2,14,12,26,12,0.000721
G3,C(C(CC(C(C)=O)O)O)(O)=O,4,13,11,24,45,0.000672
G3,C(CC(CC(C(O)=O)O)O)=O,4,14,15,29,33,0.000732
G3,C(C(CCO)(CC=O)O)(O)=O,2,11,13,24,7,0.000579
G3,C(C(C)(CC(C=O)O)O)(O)=O,4,10,11,21,14,0.00053
G3,C(C(C=CC(CO)O)O)(O)=O,8,9,7,16,29,0.0004940000000000001
G3,C(C(C(CO)O)=O)=O,2,80,79,159,0,0.0038350000000000003
G3,C(C(C(CC(CO)O)=O)=O)=O,2,14,17,31,0,0.000699
G3,C(C(CO)O)(CC(C=O)=O)=O,2,20,21,41,2,0.000975
G3,C(CCO)(C(C(C=O)=O)O)=O,2,15,18,33,2,0.000725
G3,C(CO)(CC(C(C=O)=O)O)=O,2,18,21,39,49,0.000866
G3,C(C)(C(C(C(C=O)=O)O)O)=O,4,20,22,42,1,0.000974
G3,C(CC(C(C(C=O)=O)O)O)=O,4,19,23,42,5,0.0009369999999999999
G3,C(C(CO)=O)=O,1,349,509,858,5,0.016574000000000002
G3,C(CC(C(CO)=O)O)=O,2,47,56,103,2,0.0022429999999999998
G3,C(C(CO)=O)(C)=O,1,170,235,405,25,0.008079000000000001
G3,C(CO)(CC(CO)=O)=O,1,28,37,65,27,0.00134
G3,C(CO)(C(C(C)=O)O)=O,2,44,51,95,0,0.0020989999999999997
G3,C(C(C(C)O)=O)=O,2,145,156,301,25,0.006893000000000001
G3,C(CO)(C(C)O)=O,2,159,196,355,25,0.007568000000000001
G3,C(CC=O)=O,1,442,1291,1733,45,0.020975999999999998
G3,C(C(C(CO)=O)O)=O,2,96,106,202,5,0.004567
G3,C(C(CCO)O)=O,2,105,117,222,29,0.005017
G3,C(C(C)=O)(O)=O,1,159,264,423,28,0.0075569999999999995
G3,C(=O)=O,1,1016,2740,3756,17,0.048216
G3,C(CC(CO)=O)(O)=O,1,67,90,157,0,0.003203
G3,C(C(C(C)=O)O)(O)=O,2,69,74,143,0,0.00331
G3,C(C(O)=O)=O,1,214,336,550,33,0.010168
G3,C(C(CC(CO)=O)O)(O)=O,2,24,23,47,33,0.0011949999999999999
G3,C(C(C(C(C)=O)O)O)(O)=O,4,27,25,52,33,0.0013390000000000001
G3,C(C(C=O)O)(O)=O,2,135,142,277,17,0.006443000000000001
G3,C(C(C(C=O)O)O)(O)=O,4,35,44,79,33,0.001719
G3,C(CC(C=O)O)(O)=O,2,54,58,112,29,0.002585
G3,C(C)(C(CO)(C(C=O)O)O)=O,4,17,19,36,2,0.000848
G3,C(C)(CC(C=O)=O)=O,1,104,131,235,26,0.004935
G3,C(CC(C=O)=O)=O,1,202,279,481,23,0.009586
G3,C(CC(C(C)=O)=O)=O,1,101,130,231,14,0.004793
G3,C(C(C)=O)(C)=O,1,159,273,432,14,0.007546
G3,C(CC(C)=O)=O,1,358,655,1013,6,0.01699
G3,C(OC(C(C)=O)C(CO)O)=O,4,11,9,20,35,0.000546
G3,C1(COC(C1)O)=O,2,149,238,387,35,0.007070999999999999
G3,C(C(C(OCC(C)=O)O)O)=O,4,14,18,32,35,0.000664
G3,C(C(CO)OCC(CO)=O)=O,2,13,13,26,2,0.000621
G3,C(C(CO)OC(C(C)=O)O)=O,4,10,11,21,2,0.000479
G3,C(OC(CO)C(C(C)=O)O)=O,4,8,6,14,9,0.00037999999999999997
G3,C(OC(CO)CC(CO)=O)=O,2,9,7,16,2,0.00042699999999999997
G3,C(C)(C(CO)OC(C=O)O)=O,4,10,11,21,2,0.000479
G3,C1(COC(C(C1)O)O)=O,4,27,42,69,27,0.001292
G3,C(C(COCC(CO)=O)O)=O,2,17,16,33,36,0.000807
G3,C(C(COC(C(C)=O)O)O)=O,4,14,13,27,41,0.000664
G3,C(OCC(C(C(C)=O)O)O)=O,4,14,9,23,28,0.000688
G3,C(CO)(CC(OCC=O)O)=O,2,14,18,32,38,0.000664
G3,C(OCC(CC(CO)=O)O)=O,2,12,8,20,19,0.0005809999999999999
G3,C(C)(C(C(OCC=O)O)O)=O,4,14,18,32,19,0.000664
G3,C(C)(C(COC(C=O)O)O)=O,4,14,13,27,2,0.000664
G3,C(CO)(CCOC(C=O)O)=O,2,14,15,29,30,0.000664
G3,C(C=CC(CO)=O)=O,2,108,139,247,11,0.005137
G3,C=CC(C=O)=O,1,312,588,900,7,0.014806
G3,C=CC(CO)=O,1,313,557,870,7,0.014865999999999999
G3,C(C=CC=O)=O,2,201,400,601,43,0.009539
G3,C1(C(C(CO1)O)O)=O,4,33,44,77,40,0.001588
G3,C1(CC(CO1)O)=O,2,48,66,114,8,0.0022890000000000002
G3,C(CC(CO)(OCC=O)O)=O,2,10,17,27,40,0.000475
G3,C(C(C(C)(OCC=O)O)O)=O,4,11,17,28,1,0.000522
G3,C(C(CC(OCC=O)O)O)=O,4,11,14,25,37,0.000533
G3,C1(C(C(C(CO)C1O)O)O)=O,16,17,14,31,2,0.0008730000000000001
G3,C(C(C(C(C(CO)O)O)=O)O)=O,8,14,15,29,5,0.000722
G3,C(C(CC(C=O)O)O)=O,3,16,18,34,0,0.0007700000000000001
G3,C(C(C(C(C)O)=O)O)=O,4,36,39,75,0,0.00172
G3,C(C(C)O)=O,2,391,662,1053,11,0.018567
G3,C(C(C(CO)O)=O)(CCO)=O,2,18,16,34,2,0.000916
G3,C(C(CO)=O)(C(CCO)O)=O,2,12,12,24,2,0.000603
G3,C(C(C(C(CCO)O)O)=O)=O,4,15,17,32,18,0.000769
G3,C(C(CO)O)(C(C(C)=O)O)=O,4,18,15,33,2,0.000892
G3,C(C(C)O)(C(C(CO)=O)O)=O,4,15,12,27,2,0.000734
G3,C(C(C(C(C(C)O)O)=O)O)=O,8,16,16,32,2,0.000795
G3,C(C(CC(C(CO)O)O)O)=O,8,13,13,26,29,0.000695
G3,C(C(CCO)O)(C(CO)O)=O,4,16,12,28,2,0.0008300000000000001
G3,C(CO)(C(CC(CO)O)O)=O,4,14,11,25,29,0.000731
G3,C(C(C(CO)O)O)(C(C)O)=O,8,16,13,29,2,0.000828
G3,C(CO)(C(C(CCO)O)O)=O,4,16,13,29,2,0.0008269999999999999
G3,C(CC(C(C(CO)O)=O)O)(O)=O,4,9,10,19,2,0.00047599999999999997
G3,C(C(C(CC(CO)O)O)=O)(O)=O,4,8,10,18,29,0.00043499999999999995
G3,C(C(CC(C(CO)=O)O)O)(O)=O,4,9,9,18,5,0.00048300000000000003
G3,C(C(C(C(CCO)O)=O)O)(O)=O,4,11,10,21,31,0.00059
G3,C(C(C(CC(C=O)O)O)O)(O)=O,8,14,15,29,43,0.000742
G3,C(C(C(C(O)=O)O)O)(C(C)O)=O,8,12,11,23,25,0.000637
G3,C(CC(C(C(CO)=O)O)O)(O)=O,4,10,10,20,5,0.000531
G3,C(C(CCC(C=O)=O)O)=O,2,23,22,45,12,0.001104
G3,C(C(C)O)(CC(C=O)=O)=O,2,23,23,46,24,0.001103
G3,C(CC(C(C(C)=O)=O)O)=O,2,25,25,50,25,0.001199
G3,C(CC(C(C(C)O)=O)=O)=O,2,22,22,44,4,0.0010550000000000002
G3,C(C)(CC(C(CO)=O)=O)=O,1,29,28,57,26,0.0013880000000000001
G3,C(C)(CC(C(C=O)=O)O)=O,2,26,27,53,17,0.001245
G3,C(CCC(C(CO)=O)=O)=O,1,25,25,50,17,0.001198
G3,C(CCC(C(C=O)=O)O)=O,2,19,22,41,27,0.0009130000000000001
G3,C(CO)(CC(C(C)=O)=O)=O,1,30,28,58,24,0.0014349999999999999
G3,C1(C(C(CO)O)OCC1O)=O,8,15,10,25,10,0.000758
G3,C1(C(CC(C(CO)O)O1)O)=O,8,9,4,13,46,0.000472
G3,C1(C(C(CO)OCC1O)O)=O,8,11,7,18,2,0.000544
G3,C1(C(CC(C(CO)O1)O)O)=O,8,7,4,11,48,0.000366
G3,C1(C(CO)OC(CC1O)O)=O,8,10,9,19,2,0.00049
G3,C1(C(O)OC(CO)CC1O)=O,8,8,7,15,2,0.000391
G3,C1(C(C(COCC1O)O)O)=O,8,14,10,24,36,0.000709
G3,C1(C(CC(C(CO1)O)O)O)=O,8,7,7,14,48,0.000376
G3,C1(C(CC(O)OCC1O)O)=O,8,10,9,19,38,0.00048600000000000005
G3,C1(C(O)OCC(CC1O)O)=O,8,9,8,17,41,0.000449
G3,C1(COC(C(CC1O)O)O)=O,8,9,10,19,2,0.000449
G3,C1(C(CCOC(C1O)O)O)=O,8,9,11,20,19,0.00043799999999999997
G3,C(CO)=CC(C(CO)=O)=O,2,19,18,37,55,0.0009130000000000001
G3,C(C(C(C=O)=O)O)=CCO,4,13,13,26,29,0.000628
G3,C(CO)(C(C=CC=O)O)=O,4,26,23,49,32,0.001245
G3,C(CO)(C(C(C=C)=O)O)=O,2,28,25,53,32,0.00134
G3,C(C(C(C(C=C)O)=O)O)=O,4,21,19,40,2,0.000997
G3,C(C=CC(CO)=O)(CO)=O,2,18,15,33,32,0.000866
G3,C(C(C=CC(C=O)O)O)=O,6,11,9,20,43,0.000522
G3,C(CO)(C1(CC(CO1)O)O)=O,4,7,7,14,2,0.00035499999999999996
G3,C(CO)(C1C(CC(O1)O)O)=O,8,11,10,21,38,0.000544
G3,C(C1C(C(C(C1O)O)O)O)O,10,6,5,11,29,0.00035099999999999997
G3,C(C(CO)O)O,1,14,44,58,28,0.000698
G3,CO,1,170,423,593,55,0.008081
G3,CCO,1,114,495,609,46,0.0054329999999999995
G3,C(C(C(CC(CO)O)O)O)=O,8,15,15,30,6,0.000791
G3,C(C(C(C(CCO)O)O)O)O,8,10,8,18,29,0.000586
G3,C(C(C(C(CCO)O)O)O)(O)=O,8,11,10,21,18,0.000633
G3,C(CC(C(C(CO)O)O)O)(O)=O,8,9,10,19,29,0.0005269999999999999
G3,C(C1(C(C(CC1O)O)O)O)O,16,8,7,15,29,0.000468
G3,C(C(C(CO)O)(C(CO)O)O)O,3,6,4,10,29,0.000352
G3,C(CCO)(CC(CO)=O)=O,1,30,28,58,30,0.001459
G3,C(CO)(CCC(CO)=O)=O,1,17,15,32,29,0.0008179999999999999
G3,C(C(CC(CCO)O)=O)=O,2,19,20,39,4,0.000947
G3,C(C(CCO)=O)(CCO)=O,1,13,12,25,2,0.000641
G3,C(CCO)(C(C(C)=O)O)=O,2,27,24,51,9,0.001306
G3,C(CC(C(CCO)O)=O)=O,2,22,21,43,4,0.001077
G3,C(C(CO)O)(CC(C)=O)=O,2,30,27,57,26,0.0014609999999999998
G3,C(CCC=O)(C(CO)O)=O,2,31,27,58,7,0.001509
G3,C(C(C(CCCO)=O)O)=O,2,21,20,41,29,0.001019
G3,C(C(C)=O)(CC(CO)O)=O,2,23,21,44,14,0.001137
G3,C(CC(CC(CO)O)=O)=O,2,25,26,51,44,0.001232
G3,C(CC(C=O)O)(CCO)=O,2,30,29,59,29,0.00146
G3,C(CC1C(C(C(O)O1)O)O)O,16,5,6,11,4,0.00028199999999999997
G3,C(C(CO)O)=CC(CO)=O,4,20,16,36,29,0.0009939999999999999
G3,C(CO)=CC(C(CO)O)=O,4,24,19,43,2,0.001188
G3,C=CC(C(C(CO)O)O)=O,4,26,23,49,7,0.001292
G3,C(C(C(CO)O)O)=CC=O,8,13,13,26,29,0.000672
G3,C(C(C(C=CCO)O)O)=O,8,16,16,32,28,0.000795
G3,C(C1(CC(C(CO)O1)O)O)O,8,4,4,8,29,0.000223
G3,C1C(C(C(CCO)(O)O1)O)O,8,5,6,11,29,0.00028199999999999997
G3,C1C(CC(C(CO)O)(O)O1)O,8,5,6,11,29,0.00028199999999999997
G3,CC1(C(C(C(CO)O1)O)O)O,16,4,5,9,14,0.000223
G3,C(C(C1C(CC(O)O1)O)O)O,16,5,5,10,29,0.00028199999999999997
G3,C1C(C(CC(CO)(O)O1)O)O,8,5,6,11,29,0.00028199999999999997
G3,C(C1C(C(CC(O)O1)O)O)O,16,5,5,10,29,0.00028199999999999997
G3,C(C1C(C(C(C1O)O)O)O)(O)=O,10,6,7,13,29,0.00033999999999999997
G3,C(C(C(C(C(CO)O)O)O)=O)(O)=O,8,12,15,27,33,0.000648
G3,C(C(CO)O)(O)=O,2,66,102,168,33,0.0032020000000000004
G3,C(O)=O,1,2,0,2,33,0.00010800000000000001
G3,C(C(CCO)=O)(O)=O,1,43,58,101,7,0.002076
G3,C(C(CC=O)O)(O)=O,2,57,76,133,33,0.002751
G3,C(C)(O)=O,1,16,135,151,18,0.000772
G3,C(C(CC(C(C=O)O)O)O)(O)=O,8,13,15,28,33,0.000697
G3,C(CC(C(C(C(O)=O)O)O)O)(O)=O,8,10,11,21,29,0.000575
G3,C(C1(C(C(CC1O)O)O)O)(O)=O,16,12,13,25,43,0.0006580000000000001
G3,C(C(C(CO)O)(C(CO)O)O)(O)=O,3,8,7,15,0,0.00044800000000000005
G3,C(CCO)(CC(C(O)=O)=O)=O,1,12,13,25,2,0.000594
G3,C(CO)(CCC(C(O)=O)=O)=O,1,12,13,25,29,0.0005809999999999999
G3,C(C)(C(CC(C(O)=O)=O)O)=O,2,13,13,26,45,0.00064
G3,C(CC(CC(C(O)=O)=O)O)=O,2,12,15,27,45,0.000605
G3,C(CC(CC(C=O)=O)O)(O)=O,2,13,15,28,28,0.000651
G3,C(CC(C(CCO)=O)=O)(O)=O,1,14,14,28,2,0.000701
G3,C(CC(CC(CO)=O)=O)(O)=O,1,15,15,30,17,0.000735
G3,C(CC(C(C(C)=O)O)=O)(O)=O,2,13,13,26,17,0.000629
G3,C(CC(C(CC=O)O)=O)(O)=O,2,16,18,34,45,0.000784
G3,C(CC(C(CC(O)=O)O)=O)=O,2,14,14,28,29,0.000687
G3,C(C(C(O)=O)O)(CC(C)=O)=O,2,17,14,31,17,0.000842
G3,C(C(C(CCC=O)=O)O)(O)=O,2,18,16,34,17,0.000889
G3,C(C(C(CCC(O)=O)=O)O)=O,2,10,11,21,29,0.00048600000000000005
G3,C(C(CC(C(C)=O)=O)O)(O)=O,2,15,13,28,14,0.0007570000000000001
G3,C(CC(CC(C(O)=O)O)=O)=O,2,17,17,34,2,0.000852
G3,C(CC(CC(C=O)O)=O)(O)=O,2,16,18,34,17,0.0007830000000000001
G3,C(CC1C(C(C(O)O1)O)O)(O)=O,16,4,8,12,29,0.000223
G3,C(C(CO)O)=CC(C(O)=O)=O,4,6,6,12,29,0.00031800000000000003
G3,C(C(C(C=CCO)=O)O)(O)=O,4,13,9,22,17,0.000663
G3,C(C=CC(C(CO)O)=O)(O)=O,4,14,13,27,2,0.0007019999999999999
G3,C(C(C(C(C=C)=O)O)O)(O)=O,4,19,16,35,33,0.000959
G3,C(C(C=CC(CO)=O)O)(O)=O,4,10,9,19,29,0.000508
G3,C(C(C(C=CC=O)O)O)(O)=O,8,13,13,26,43,0.0006730000000000001
G3,C(C(C(C=CC(O)=O)O)O)=O,8,12,13,25,18,0.000605
G3,C(C1(CC(C(CO)O1)O)O)(O)=O,8,3,6,9,29,0.000165
G3,C(CC1(C(C(CO1)O)O)O)(O)=O,8,4,7,11,29,0.000223
G3,C(C(C1(CC(CO1)O)O)O)(O)=O,8,5,7,12,29,0.00028199999999999997
G3,C(C1C(CC(CO)(O1)O)O)(O)=O,8,4,7,11,29,0.000212
G3,C(C1C(C(C(C)(O1)O)O)O)(O)=O,16,5,8,13,29,0.000271
G3,C(C(C1C(CC(O)O1)O)O)(O)=O,16,5,6,11,5,0.00028199999999999997
G3,C(C1(CC(C(CO1)O)O)O)(O)=O,8,5,8,13,29,0.00028199999999999997
G3,C(C1C(C(CC(O1)O)O)O)(O)=O,16,6,8,14,29,0.00032900000000000003
G3,C1(C(CC(C1(CO)O)O)O)=O,8,11,12,23,2,0.00057
G3,C(C1(C(CCC1O)=O)O)=O,4,12,14,26,4,0.000592
G3,C1C(C(C(C=1)=O)(CO)O)O,4,14,15,29,2,0.000691
G3,C(C1(C(C=CC1O)O)O)=O,3,5,8,13,43,0.000248
G3,C1(C(C(C(C1(CO)CO)O)O)O)=O,8,9,11,20,2,0.00047300000000000006
G3,C1(CC(C(C(C1(CO)O)O)O)O)=O,16,14,15,29,2,0.0007570000000000001
G3,C(C1(CO)C(C(C(C1O)O)O)O)=O,10,7,10,17,2,0.000367
G3,C(C(CO)(C(CO)(CO)O)O)=O,2,9,11,20,5,0.00047699999999999994
G3,C(C(C(C)=O)(C(CO)(CO)O)O)=O,2,6,7,13,1,0.000308
G3,C(C)(C(CO)(C(CO)(CO)O)O)=O,2,9,9,18,5,0.00047699999999999994
G3,C(C(C=O)(C(CO)(CO)O)O)=O,1,5,7,12,1,0.000261
G3,C(C(CO)(C(C(CO)O)O)O)=O,8,14,16,30,41,0.000758
G3,C(C(CO)(C(C(C)=O)O)O)=O,4,17,19,36,2,0.0008470000000000001
G3,C(C(CO)(C(C=O)(C)O)O)=O,4,9,15,24,45,0.00046699999999999997
G3,C(C(CO)(C(CC(CO)=O)O)O)=O,4,16,17,33,2,0.0008210000000000001
G3,C(C(CO)(C(CO)(CC=O)O)O)=O,4,14,16,30,2,0.000726
G3,C(C(C(C)=O)(C(C(CO)O)O)O)=O,8,12,13,25,1,0.000637
G3,C(C(CO)(C(C(C(C)=O)O)O)O)=O,8,16,18,34,1,0.0008210000000000001
G3,C(C(CO)(C(C)(C(C=O)O)O)O)=O,8,14,17,31,1,0.0007160000000000001
G3,C(C(CO)(C(C=O)O)O)=O,4,20,24,44,5,0.00099
G3,C(C)(C(CO)(C(C(CO)O)O)O)=O,8,14,14,28,41,0.000758
G3,C(C(CO)(C(C)(C(CO)O)O)O)=O,8,13,14,27,28,0.0007
G3,C(C(CO)(CO)O)=O,1,20,24,44,41,0.000976
G3,C(C(CO)(C(C(CCO)=O)O)O)=O,4,17,18,35,2,0.0008699999999999999
G3,C(C(CCO)(C(C=O)(CO)O)O)=O,4,13,16,29,3,0.000678
G3,C(C(CO)(C(CO)(CCO)O)O)=O,4,13,13,26,3,0.0007
G3,C(C(C=O)(C(C(CO)O)O)O)=O,4,10,12,22,1,0.000542
G3,C(C(CO)(C(C(C=O)O)O)O)=O,8,15,20,35,1,0.0007740000000000001
G3,C(C(CO)(C(CO)(C)O)O)=O,4,10,12,22,49,0.000536
G3,C(C(CO)(C(C(CC=O)O)O)O)=O,8,17,20,37,43,0.00088
G3,C(C(CO)(C(CC(C=O)O)O)O)=O,8,16,18,34,43,0.00082
G3,C(C(CO)(C(C)O)O)=O,4,12,18,30,41,0.000621
G3,C(C(C(C)=O)(C(C(C)=O)O)O)=O,4,11,14,25,1,0.000536
G3,C(C(C)(C(C=O)(C(C)=O)O)O)=O,4,6,12,18,1,0.000298
G3,C(C)(C(CO)(C(C(C)=O)O)O)=O,4,15,16,31,45,0.000752
G3,C(C(C)(C(C(C)=O)(CO)O)O)=O,4,11,15,26,45,0.0005610000000000001
G3,C(C(C=O)(C(C(C)=O)O)O)=O,2,12,14,26,1,0.000583
G3,C(C(C=O)(C(C=O)(C)O)O)=O,2,4,10,14,1,0.00020299999999999997
G3,C(C(C(C=O)(C(C(C)=O)O)O)O)=O,8,16,20,36,0,0.000787
G3,C(C(C(C=O)(C(C=O)(C)O)O)O)=O,8,12,18,30,45,0.000596
G3,C(CO)(C(CO)(C(C(C)=O)O)O)=O,4,17,17,34,2,0.000858
G3,C(C(C)(C(C(CO)=O)(CO)O)O)=O,4,14,16,30,45,0.000715
G3,C(C(C=O)(C(CC(CO)=O)O)O)=O,2,11,12,23,1,0.000557
G3,C(C(C=O)(C(CO)(CC=O)O)O)=O,2,9,11,20,1,0.000463
G3,C(C(C(C)=O)(C(C=O)O)O)=O,4,12,16,28,1,0.000584
G3,C(C(C(C)=O)(CO)O)=O,2,20,24,44,1,0.000976
G3,C(C(C=O)(C(C(C(C)=O)O)O)O)=O,4,11,13,24,1,0.000557
G3,C(C(C=O)(C(C)(C(C=O)O)O)O)=O,4,9,12,21,1,0.000452
G3,C(C(C(C(C=O)(C(C)=O)O)O)O)=O,8,12,15,27,1,0.000605
G3,C(C(C(C)=O)(C(CO)(C)O)O)=O,4,8,10,18,1,0.000414
G3,C(C(C(C)=O)(C(C)O)O)=O,4,11,13,24,4,0.000547
G3,C(C(C(C(C)=O)(C(C=O)O)O)O)=O,3,8,10,18,0,0.000394
G3,C(C(C=O)(C(C=O)O)O)=O,2,15,19,34,1,0.000726
G3,C(C(C(C=O)(C(C=O)O)O)O)=O,3,7,12,19,0,0.000346
G3,C(CO)(C(CO)(C(C=O)O)O)=O,4,16,18,34,5,0.000811
G3,C(C(C(CO)O)(C(C=O)O)O)(O)=O,8,17,17,34,0,0.0008900000000000001
G3,C(C)(C(CO)(CO)O)=O,1,15,18,33,2,0.0007379999999999999
G3,C(C(C=O)(C(C)(C(CO)O)O)O)=O,4,9,10,19,28,0.000484
G3,C(C(C(C(C(C)=O)(CO)O)O)O)=O,8,16,18,34,1,0.000822
G3,C(C)(C(CO)(C(CO)(C)O)O)=O,4,11,11,22,49,0.000583
G3,C(C)(C(CO)(C(C)O)O)=O,4,14,14,28,4,0.0007160000000000001
G3,C(C(C=O)(CO)O)=O,1,21,24,45,1,0.001023
G3,C(CO)(C(CO)(CO)O)=O,1,13,12,25,2,0.000655
G3,C(CC(C(C(CO)(CO)O)=O)O)=O,2,8,10,18,2,0.000407
G3,C(C(CO)(CO)O)(CC(CO)=O)=O,1,8,8,16,2,0.00040599999999999995
G3,C(CCO)(C(C(CO)=O)(CO)O)=O,2,9,9,18,2,0.00046699999999999997
G3,C(C(C(C(CCO)O)=O)(CO)O)=O,4,10,11,21,2,0.000523
G3,C(C)(C(CO)(C(C(CO)=O)O)O)=O,4,17,17,34,5,0.000857
G3,C(C(CO)(C(C(C(C)O)=O)O)O)=O,8,16,17,33,25,0.00081
G3,C(C(CO)(C(C=O)O)O)(C(C)O)=O,8,16,17,33,2,0.000811
G3,C(CC(C(C(CO)=O)(CO)O)O)=O,4,16,17,33,2,0.0008210000000000001
G3,C(CCO)(C(CO)(C(CO)O)O)=O,4,14,13,27,2,0.0007610000000000001
G3,C(CC(CO)O)(C(CO)(CO)O)=O,2,10,9,19,2,0.000546
G3,C(C(CO)(C(C(CCO)O)O)O)=O,8,14,15,29,29,0.000758
G3,C(C(CO)(C(CO)O)O)(O)=O,4,12,10,22,0,0.000665
G3,C(CC=O)(C(C(C)=O)(CO)O)=O,2,10,12,22,9,0.0005009999999999999
G3,C(C(C(CC(C)=O)=O)(CO)O)=O,2,10,12,22,2,0.0005009999999999999
G3,C(C(C(CCC=O)=O)(CO)O)=O,2,9,13,22,4,0.000453
G3,C1(C(CO)C(C(C(CO)O)O1)O)=O,16,9,6,15,48,0.00048499999999999997
G3,C1(COC(C(CO)O)C1(CO)O)=O,8,7,8,15,2,0.00036899999999999997
G3,C1(CC(OC1(CO)C(CO)O)O)=O,8,8,12,20,9,0.000408
G3,C(C)(C1(CO)C(C(C(O1)O)O)O)=O,16,9,12,21,35,0.000465
G3,C1(C(CO)C(C(C(CO)O1)O)O)=O,16,8,7,15,48,0.000437
G3,C1(COC(CO)C(C1(CO)O)O)=O,8,7,9,16,2,0.00035800000000000003
G3,C1(CC(O)OC(CO)C1(CO)O)=O,8,5,8,13,9,0.000252
G3,C1(CC(CO)OC(C1(CO)O)O)=O,8,5,10,15,2,0.000252
G3,C1(CC(C(OC1(CO)CO)O)O)=O,4,5,8,13,2,0.000252
G3,C1(C(CO)C(C(C(CO1)O)O)O)=O,16,8,10,18,48,0.00044800000000000005
G3,C1(COCC(C(C1(CO)O)O)O)=O,8,9,11,20,36,0.000475
G3,C1(CC(O)OCC(C1(CO)O)O)=O,8,7,11,18,38,0.00035800000000000003
G3,C1(CC(COC(C1(CO)O)O)O)=O,8,6,11,17,19,0.00031099999999999997
G3,C1(CC(C(O)OCC1(CO)O)O)=O,8,7,10,17,2,0.00035800000000000003
G3,C1(CCOC(C(C1(CO)O)O)O)=O,8,8,12,20,30,0.00040599999999999995
G3,C(C(C(C=CCO)=O)(CO)O)=O,4,6,9,15,2,0.0003
G3,C(C=CC(C(CO)(CO)O)=O)=O,2,6,9,15,2,0.0003
G3,C(C(CO)(C(C(C=C)=O)O)O)=O,4,14,17,31,7,0.000704
G3,C(C(C(C(C=C)=O)(CO)O)O)=O,4,15,18,33,7,0.000741
G3,C(C(CO)(C(C=CC=O)O)O)=O,8,9,14,23,43,0.000466
G3,C(C(CO)(C1(CC(CO1)O)O)O)=O,8,6,12,18,2,0.00031099999999999997
G3,C(C1(CO)C(CC(CO)(O1)O)O)=O,8,8,12,20,40,0.00040599999999999995
G3,C(C1(CO)C(C(C(C)(O1)O)O)O)=O,16,9,13,22,1,0.000465
G3,C(C(CO)(C1C(CC(O)O1)O)O)=O,16,8,10,18,2,0.000417
G3,C(C1(CO)C(C(CC(O1)O)O)O)=O,16,10,13,23,37,0.000523
G3,C(C(C=O)(C(C(CCO)=O)O)O)=O,2,12,13,25,3,0.000606
G3,C(C(C=O)(C(C=O)(CCO)O)O)=O,2,8,11,19,3,0.000414
G3,C(C(C=O)(C(CO)(CCO)O)O)=O,2,9,9,18,1,0.000484
G3,C(C(C(C)O)(C(C(C)=O)O)O)=O,8,13,17,30,0,0.000655
G3,C(C)(C(C(C)O)(C(C=O)O)O)=O,8,13,17,30,4,0.000656
G3,C(C(C=O)(C(C(C=O)O)O)O)=O,4,10,15,25,1,0.0005110000000000001
G3,C(C(C=O)(C(CO)(C)O)O)=O,2,6,8,14,1,0.000319
G3,C(C(C=O)(C(C(CC=O)O)O)O)=O,4,12,15,27,43,0.000616
G3,C(C(C=O)(C(CC(C=O)O)O)O)=O,4,11,13,24,1,0.000556
G3,C(C(C=O)(C(C)O)O)=O,2,9,13,22,1,0.000452
G3,C(C(C(CO)(C)O)(C(C=O)O)O)=O,8,14,17,31,49,0.000713
G3,C(CO)(C(CO)(C(CO)(C)O)O)=O,4,12,11,23,49,0.000642
G3,C(C(C(C)O)(C(C=O)O)O)=O,8,14,19,33,25,0.000704
G3,C(CO)(C(CO)(C(C)O)O)=O,4,12,12,24,2,0.0006320000000000001
G3,C(C(C(CO)O)(C(C)O)O)(O)=O,8,12,11,23,4,0.000663
G3,C(CC=O)(C(C(C)=O)(C(C)O)O)=O,4,7,9,16,9,0.000357
G3,C(C(C(CC(C)=O)=O)(C(C)O)O)=O,4,7,9,16,2,0.000357
G3,C(C(C(CCC=O)=O)(C(C)O)O)=O,4,7,10,17,4,0.000357
G3,C(C(C(C=CCO)=O)(C(C)O)O)=O,8,6,8,14,2,0.000309
G3,C(C=CC(C(CO)(C(C)O)O)=O)=O,8,11,14,25,4,0.000562
G3,C(C(C(C)O)(C(C(C=C)=O)O)O)=O,8,13,16,29,7,0.000655
G3,C(C(C(C(C=C)=O)(C(C)O)O)O)=O,8,15,17,32,7,0.0007509999999999999
G3,C(C(C(C)O)(C(C=CC=O)O)O)=O,16,8,12,20,43,0.00041600000000000003
G3,C(C(CO)(C(CO)O)O)=O,4,12,14,26,0,0.000643
G3,C(C(C(C)=O)(C(CO)O)O)=O,4,10,12,22,1,0.000521
G3,C(C)(C(CO)(C(CO)O)O)=O,4,13,13,26,0,0.0006900000000000001
G3,C(C(C(CO)O)(C(C(C)=O)O)O)=O,8,16,18,34,0,0.000819
G3,C(C)(C(C(CO)O)(C(C=O)O)O)=O,8,16,18,34,0,0.00082
G3,C(C(C=O)(C(CO)O)O)=O,2,8,10,18,1,0.000426
G3,C(C(C(CO)O)(C(C=O)O)O)=O,8,15,20,35,0,0.000772
G3,C(CO)(C(CO)(C(CO)O)O)=O,4,13,12,25,2,0.000701
G3,C(C(C(CO)O)(C(C=O)(C)O)O)=O,8,13,17,30,45,0.000676
G3,C(C(C(CO)O)(C(CO)(C)O)O)=O,8,13,14,27,49,0.000698
G3,C(C(C(CO)O)(C(C)O)O)=O,8,11,14,25,4,0.000593
G3,C(CC(C(CO)(C(CO)O)O)=O)=O,4,14,16,30,9,0.000726
G3,C(C(C(CC(CO)O)=O)(CO)O)=O,4,11,12,23,2,0.000582
G3,C(CC(C=O)O)(C(CO)(CO)O)=O,2,9,10,19,2,0.000465
G3,C(C(CO)(C(C=O)O)O)(CCO)=O,4,17,18,35,2,0.000872
G3,C(C1(C(C(C(C1)O)O)O)O)=O,16,12,15,27,43,0.000647
G3,C1(C(C(C(C1(C)O)O)O)O)=O,16,13,13,26,0,0.000683
G3,C(C1(C(CC(C1)=O)O)O)=O,4,22,25,47,17,0.001077
G3,C(C(C(CO)(CO)O)(CC=O)O)=O,2,8,10,18,43,0.00041500000000000006
G3,C(C(C(CO)(CO)O)O)(O)=O,2,9,7,16,5,0.0004940000000000001
G3,C(C(C(C(CO)O)O)(CC=O)O)=O,8,14,16,30,41,0.0007440000000000001
G3,C(C(C(C(CO)O)O)O)(O)=O,8,13,12,25,33,0.000729
G3,C(CC(C=O)(C(C(C)=O)O)O)=O,4,12,17,29,23,0.000595
G3,C(CC(C=O)(C(C=O)(C)O)O)=O,4,7,15,22,23,0.000357
G3,C(C(C)(C(C(O)=O)O)O)=O,4,13,16,29,45,0.000674
G3,C(CC(CO)(C(C(O)=O)O)O)=O,4,13,13,26,29,0.000697
G3,C(C(C(C)(C(C=O)O)O)O)(O)=O,8,12,13,25,0,0.000638
G3,C(C(C(C=O)(CC(CO)=O)O)O)=O,4,16,18,34,51,0.000796
G3,C(CC(C=O)(C(C=O)O)O)=O,4,14,20,34,0,0.000691
G3,C(C(C(C)(C(CO)O)O)O)(O)=O,8,10,9,19,0,0.000575
G3,C(C(CO)(CC(CO)=O)O)=O,2,16,17,33,2,0.000807
G3,C(C(C(C)O)(CC(CO)=O)O)=O,4,12,14,26,41,0.000616
G3,C(C(CO)(CC=O)O)=O,2,26,35,61,43,0.001271
G3,C(C(CO)(CC=O)O)(C(CO)O)=O,4,15,16,31,2,0.000763
G3,C(C(C(CO)(CC(CO)O)O)=O)=O,4,11,14,25,29,0.000579
G3,C(C(CO)(CC(C(CO)=O)O)O)=O,4,12,14,26,43,0.000605
G3,C(C(CC(C(CO)=O)(CO)O)O)=O,4,12,14,26,32,0.000605
G3,C(C(C(C(CO)(CCO)O)=O)O)=O,4,10,12,22,2,0.0005099999999999999
G3,C(CO)(C(CO)(CC(CO)=O)O)=O,2,15,14,29,32,0.000759
G3,C(C(CO)(CC(C(C=O)O)O)O)=O,8,16,18,34,43,0.0008179999999999999
G3,C(C(C(C=O)O)O)(C(CO)(C)O)=O,8,13,15,28,0,0.000666
G3,C(C)(C(CO)(CC(C=O)=O)O)=O,2,13,16,29,45,0.000653
G3,C(C(CO)(CC=O)O)(CC=O)=O,2,15,19,34,2,0.000749
G3,C(C(CO)(CC(C(C)=O)=O)O)=O,2,12,14,26,14,0.000605
G3,C(C(CO)(CC(CC=O)=O)O)=O,2,13,17,30,2,0.000653
G3,C1(C(CO)(O)OC(C(CO)O)C1)=O,8,6,8,14,2,0.000309
G3,C1(C(CO)(O)OC(C(C1)O)CO)=O,8,5,7,12,2,0.00025
G3,C1(C(CO)(O)OCC(C(C1)O)O)=O,8,7,9,16,41,0.000367
G3,C(C(C=CC(CO)=O)(CO)O)=O,4,8,10,18,43,0.000404
G3,C(C(CCO)(C(C(O)=O)O)O)=O,4,11,12,23,29,0.000601
G3,C(C(C(CO)(CCO)O)O)(O)=O,4,10,8,18,29,0.000575
G3,C(C(C(C(C=O)(CC=O)O)O)O)=O,8,18,21,39,1,0.0009019999999999999
G3,C(C(C(C(C=O)O)O)O)(O)=O,8,18,18,36,17,0.0009339999999999999
G3,C(C(C(CO)(C)O)(CC=O)O)=O,4,10,14,24,43,0.000521
G3,C(C(C(CO)(C)O)O)(O)=O,4,12,12,24,49,0.000648
G3,C(C(C(C)O)(CC=O)O)=O,4,16,20,36,4,0.000795
G3,C(C(C(C(C(C=O)O)O)O)O)(O)=O,16,18,19,37,33,0.000956
G3,C(C(C(C)O)O)(O)=O,4,29,46,75,4,0.001444
G3,C(C)(C(C(C)O)(CC(C=O)=O)O)=O,4,10,12,22,45,0.0005099999999999999
G3,C(C(C(C)O)(CC=O)O)(CC=O)=O,4,12,15,27,4,0.000605
G3,C(C(C(C)O)(CC(C(C)=O)=O)O)=O,4,9,11,20,14,0.000462
G3,C(C(C(C)O)(CC(CC=O)=O)O)=O,4,10,13,23,25,0.0005099999999999999
G3,C(C(C=CC(CO)=O)(C(C)O)O)=O,8,6,8,14,32,0.000308
G3,C(C(C(CO)(C(CO)O)O)O)(O)=O,8,11,10,21,29,0.000634
G3,C(C(C(CO)O)(CC(CO)=O)O)=O,4,15,15,30,51,0.00078
G3,C(C(C(CO)O)(CC=O)O)=O,4,13,17,30,0,0.000675
G3,C(C(CO)(CC(C(CO)O)=O)O)=O,4,16,16,32,2,0.0008210000000000001
G3,C(C(C(CO)O)OC(CO)=O)=O,4,6,8,14,40,0.000309
G3,C(C(C(CO)OC(CO)=O)O)=O,4,4,5,9,50,0.00018999999999999998
G3,C(C(C(COC(CO)=O)O)O)=O,4,7,8,15,40,0.000356
G3,C1(CC(C(C1CO)=O)O)=O,4,27,23,50,2,0.001307
G3,C1(C(CO)CC(C1O)=O)=O,4,27,23,50,47,0.001295
G3,C(C(C)=O)(C(C(CO)O)O)=O,4,17,16,33,0,0.0008640000000000001
G3,C1(CCC(C1(CO)O)=O)=O,1,9,9,18,2,0.000442
G3,C1(C(CO)(CC(C1)=O)O)=O,2,23,24,47,2,0.001116
G3,C1(CC(C(C(C)=O)O1)O)=O,4,22,17,39,48,0.0010550000000000002
G3,C1(CC(C(CC=O)O1)O)=O,4,17,16,33,48,0.0008179999999999999
G3,C1(COC(C(C)=O)C1O)=O,4,33,28,61,17,0.0015660000000000001
G3,C(CC1C(C(CO1)=O)O)=O,4,28,27,55,9,0.00134
G3,C(C)(C1CC(C(O)O1)=O)=O,4,26,22,48,22,0.001234
G3,C(CC1CC(C(O)O1)=O)=O,4,25,25,50,23,0.001186
G3,C1(CC(OC1C(C)=O)O)=O,4,22,22,44,9,0.001044
G3,C(CC1C(CC(O1)O)=O)=O,4,25,27,52,17,0.001186
G3,C1(CC(CC(CO)O1)=O)=O,2,20,16,36,19,0.0009599999999999999
G3,C1(CCC(OC1CO)=O)=O,2,19,13,32,2,0.000917
G3,C1(C(COC(CO)C1)=O)=O,2,19,18,37,54,0.0009019999999999999
G3,C1(C(CO)OCC(C1)=O)=O,2,28,25,53,54,0.001333
G3,C1(CC(CC(CO1)O)=O)=O,2,19,18,37,19,0.0009130000000000001
G3,C1(CCC(OCC1O)=O)=O,2,16,13,29,4,0.000759
G3,C1(CC(C(CCO1)=O)O)=O,2,20,16,36,19,0.0009599999999999999
G3,C1(CC(CC(CO1)=O)O)=O,2,22,20,42,48,0.001066
G3,C1(C(COCC(C1)O)=O)=O,2,20,19,39,36,0.0009599999999999999
G3,C1(C(COCC(C1)=O)O)=O,2,27,24,51,36,0.001292
G3,C1(CCOCC(C1O)=O)=O,2,25,23,48,36,0.001186
G3,C1(COCC(CC1O)=O)=O,2,31,27,58,17,0.001482
G3,C1(CCOC(C(C1)=O)O)=O,2,24,23,47,30,0.001139
G3,C1(COC(C(CC1)=O)O)=O,2,24,21,45,12,0.001139
G3,C1(C(CC(O)OCC1)=O)=O,2,19,21,40,17,0.0009019999999999999
G3,C1(CC(OCC(C1)=O)O)=O,2,24,26,50,38,0.001139
G3,C(C(C=CC(C)=O)=O)=O,2,55,72,127,45,0.0026100000000000003
G3,C(CC=CC(C=O)=O)=O,2,44,61,105,45,0.002088
G3,C(C=CC(C(C)=O)=O)=O,2,55,71,126,45,0.0026100000000000003
G3,C(CC(C=CC=O)=O)=O,2,63,85,148,45,0.00299
G3,C=CC(CC(C=O)=O)=O,1,51,71,122,45,0.00242
G3,C(CC(C(C=C)=O)=O)=O,1,52,71,123,45,0.002468
G3,C(CC(C=O)=O)=CC=O,2,44,60,104,27,0.002088
G3,C1(COCC1O)=O,2,174,235,409,10,0.008268000000000001
G3,C1(C(O)OCC1)=O,2,148,196,344,34,0.007023000000000001
G3,C(C1C(C(C(CO)O1)O)O)=O,16,13,10,23,26,0.000672
G3,C1(C(CO)OC(CO)C1O)=O,8,13,8,21,2,0.000643
G3,C1(C(CO)(O)OC(CO)C1)=O,4,7,8,15,0,0.00034500000000000004
G3,C1(C(CO)OC(CO)(C1)O)=O,4,11,12,23,2,0.000537
G3,C(CC1C(C(CO1)O)=O)=O,4,28,24,52,9,0.00134
G3,C(CC1(C(CCO1)=O)O)=O,2,19,23,42,17,0.0009019999999999999
G3,C(CC1(CC(CO1)=O)O)=O,2,25,31,56,48,0.001186
G3,C(C(C1CC(CO1)O)=O)=O,4,12,12,24,39,0.0005809999999999999
G3,C(C1C(CC(C=O)O1)O)=O,8,20,19,39,40,0.0009599999999999999
G3,C(C1C(CC(C)(O1)O)=O)=O,4,17,21,38,26,0.000807
G3,C1(CC(C=O)OC1(C)O)=O,4,15,16,31,14,0.000712
G3,C(C1C(C(C(C)O1)=O)O)=O,8,26,22,48,29,0.001234
G3,C(C1C(C(C(CO1)O)O)O)=O,16,14,12,26,37,0.000731
G3,C1(C(CO)OCC(C1O)O)=O,8,16,11,27,2,0.000808
G3,C1(C(CO)(O)OCC(C1)O)=O,4,8,9,17,2,0.000404
G3,C1(C(COC(CO)(C1)O)O)=O,4,10,11,21,2,0.00048600000000000005
G3,C1(C(C(CO)(O)OCC1)O)=O,4,10,12,22,2,0.00048600000000000005
G3,C1(COC(CO)(C(C1)O)O)=O,4,10,11,21,2,0.0004969999999999999
G3,C1(CC(C=O)(O)OCC1)=O,2,19,23,42,30,0.0009019999999999999
G3,C(C1(CCC(CO1)=O)O)=O,2,15,17,32,12,0.000712
G3,C(C1C(CCC(O1)O)=O)=O,4,16,17,33,37,0.000759
G3,C1(CC(C=O)OC(C1)O)=O,4,24,26,50,37,0.001139
G3,C1(C(CC(C(CO)O)O1)=O)=O,4,10,7,17,27,0.0004969999999999999
G3,C1(CC(C(C(CO)O)O1)=O)=O,4,16,10,26,2,0.0007830000000000001
G3,C1(C(C(C(C(C)=O)O1)O)O)=O,8,16,12,28,2,0.000781
G3,C(CC1C(C(C(O1)=O)O)O)=O,8,14,14,28,27,0.000687
G3,C1(C(CC(C(CO)O1)O)=O)=O,4,9,7,16,50,0.00043799999999999997
G3,C1(CC(C(C(CO)O1)O)=O)=O,4,11,8,19,2,0.000522
G3,C1(C(C(CC(CO)O1)=O)O)=O,4,11,7,18,50,0.000522
G3,C1(CC(C(OC1CO)=O)O)=O,4,15,10,25,2,0.000727
G3,C1(C(CC(C(CO1)O)O)=O)=O,4,10,10,20,27,0.000508
G3,C1(CC(C(C(CO1)O)O)=O)=O,4,13,12,25,2,0.0006389999999999999
G3,C1(C(C(CC(CO1)O)=O)O)=O,4,11,9,20,2,0.000533
G3,C1(CC(C(OCC1O)=O)O)=O,4,12,10,22,2,0.0005809999999999999
G3,C1(C(C(C(OCC1)=O)O)O)=O,4,16,13,29,2,0.000781
G3,C1(C(C(CC(CO1)=O)O)O)=O,4,16,13,29,2,0.000792
G3,C1C(C(C(C=1CO)=O)O)O,4,19,19,38,2,0.000924
G3,C=C1C(C(C(C1O)O)O)=O,8,21,21,42,47,0.001041
G3,C1C(C(C(C=1C=O)O)O)O,8,11,14,25,29,0.000566
G3,C(C(C(CO)O)O)=CC(O)=O,8,9,8,17,29,0.0004940000000000001
G3,C(C(C(C(C=C)O)O)O)=O,8,18,19,37,28,0.0009
G3,C(C1(C=CC(C1O)O)O)=O,8,8,11,19,43,0.000413
G3,C1C(C(CO)O)OC(C=1)=O,4,9,8,17,46,0.00046100000000000004
G3,C1OC(C(C=1)=O)C(CO)O,4,15,13,28,9,0.000736
G3,C1C(C(CO)OC(C=1)=O)O,4,7,6,13,29,0.000343
G3,C1C(CO)OC(C(C=1)=O)O,4,13,11,24,46,0.000617
G3,C1OC(CO)C(C(C=1)=O)O,4,12,10,22,9,0.0005690000000000001
G3,C1C(OC(C(C=1)=O)CO)O,4,18,16,34,2,0.000858
G3,C1C(C(COC(C=1)=O)O)O,4,8,8,16,46,0.00040199999999999996
G3,C1C(COC(C(C=1)=O)O)O,4,13,11,24,41,0.000617
G3,C1OCC(C(C(C=1)=O)O)O,4,15,13,28,38,0.000734
G3,C1COC(C(C(C=1)=O)O)O,4,16,18,34,19,0.000759
G3,C1C(O)OCC(C(C=1)=O)O,4,16,14,30,38,0.000759
G3,C1C(C(OCC(C=1)=O)O)O,4,14,15,29,2,0.000664
G3,C1C(C(CO)OC=1C=O)O,4,2,4,6,29,9.499999999999999e-05
G3,C(C1(C=CC(CO)O1)O)=O,4,3,5,8,41,0.00014199999999999998
G3,C1(C(C(CO1)O)O)=CC=O,8,5,6,11,29,0.000259
G3,C(C(C1OCC(C=1)O)O)=O,4,11,11,22,36,0.000522
G3,C(C(C1(C=CCO1)O)O)=O,4,11,15,26,39,0.000522
G3,C(C1C=CC(CO)(O1)O)=O,4,9,9,18,40,0.00042699999999999997
G3,C(C1C(C=C(CO)O1)O)=O,4,11,12,23,40,0.000522
G3,C(C1C(C(C(O1)=C)O)O)=O,8,14,15,29,26,0.000686
G3,C(C(C1C=CC(O)O1)O)=O,8,11,12,23,43,0.000522
G3,C(C(C1C(C=CO1)O)O)=O,8,11,12,23,36,0.000522
G3,C1C(C(COC=1C=O)O)O,4,4,6,10,30,0.000212
G3,C(C1(C=CC(CO1)O)O)=O,4,3,5,8,30,0.00014199999999999998
G3,C(C1C(C=CC(O)O1)O)=O,8,12,13,25,37,0.0005690000000000001
G3,C(C1C(C(C=CO1)O)O)=O,8,14,15,29,37,0.000686
G3,C(C1(C(C(C(C1O)O)O)O)O)O,10,6,5,11,29,0.00035099999999999997
G3,C1(C(C(C(C(C1O)O)O)O)O)O,1,1,1,2,2,5.9e-05
G3,C1C(C(C(C(CO)O)(O)O1)O)O,16,6,7,13,29,0.00033999999999999997
G3,C12C(C(C(CC1O)(O)O2)O)O,32,4,5,9,32,0.000223
G3,C1(C2C(C(C(C2O)O1)O)O)O,64,4,4,8,43,0.000212
G3,C1(C(O)OC(C(CO)O)C1O)=O,16,6,7,13,5,0.000307
G3,C(C1(C(C(C(CO)O1)O)O)O)=O,16,6,10,16,0,0.000307
G3,C(C1(C(CC(CO)O1)O)O)=O,8,4,8,12,41,0.00020099999999999998
G3,C1(COC(C(CO)O)(C1)O)=O,4,10,13,23,2,0.0004969999999999999
G3,C(C1CC(C(CO)(O1)O)O)=O,8,6,9,15,40,0.000296
G3,C(CO)(C1CC(C(O1)O)O)=O,8,8,9,17,32,0.000391
G3,C1(COC(CCO)(C1O)O)=O,4,9,12,21,2,0.00043799999999999997
G3,C1(C(CCO)OC(C1O)O)=O,8,9,11,20,2,0.00043799999999999997
G3,C(C(C1(C(CCO1)O)O)O)=O,8,7,12,19,2,0.000343
G3,C(C(C1CC(C(O)O1)O)O)=O,16,8,11,19,43,0.000391
G3,C1(C(CC(C(CO)O)(O)O1)O)=O,8,4,6,10,29,0.000223
G3,C1(C(C(C(CCO)(O)O1)O)O)=O,8,5,7,12,2,0.00027
G3,C1(C2(C(C(CC2O)O1)O)O)O,32,5,6,11,43,0.00027
G3,C1C(C(C(O)O1)(C(CO)O)O)O,16,6,6,12,0,0.00033999999999999997
G3,C1C2(C(C(C(CO)O2)O1)O)O,16,1,2,3,2,4.7e-05
G3,C(C1C2CC(C(O)O2)(O)O1)O,16,2,3,5,41,9.499999999999999e-05
G3,C1C(C2C(CC(O)O2)(O)O1)O,16,2,4,6,9,9.499999999999999e-05
G3,CC1(C2C(C(C(O)O2)O1)O)O,32,2,3,5,35,9.499999999999999e-05
G3,C1(CC2C(C(C(O)O2)O)O1)O,32,2,5,7,2,9.499999999999999e-05
G3,C1C2C(C(CC(O)O2)(O)O1)O,16,2,4,6,9,9.499999999999999e-05
G3,C1C2CC(C(C(O)O2)O)(O)O1,16,2,5,7,2,9.499999999999999e-05
G3,C1C2(C(C(C(CO1)O2)O)O)O,16,3,4,7,36,0.000164
G3,C1C2C(CC(C(O)O1)(O)O2)O,16,3,4,7,41,0.000153
G3,C1C(C2(CC(C(O2)O1)O)O)O,16,2,3,5,38,0.000106
G3,C1CC2(C(C(C(O2)O1)O)O)O,16,3,4,7,17,0.000164
G3,C1C2(CC(C(C(O)O1)O2)O)O,16,3,3,6,40,0.000153
G3,C1C(C2CC(C(O)O2)(O)O1)O,16,2,3,5,30,9.499999999999999e-05
G3,C1(C2C(C(CC(O)O2)O1)O)O,32,2,3,5,37,9.499999999999999e-05
G3,C1(C(O)OC(CO)C(C1O)O)=O,16,7,8,15,29,0.000354
G3,C(C1(C(C(C(CO1)O)O)O)O)=O,16,8,12,20,15,0.000424
G3,C(C1(C(CC(CO1)O)O)O)=O,8,5,9,14,30,0.000259
G3,C1(COC(CO)(CC1O)O)=O,4,8,9,17,32,0.000391
G3,C(C1C(CC(C(O1)O)O)O)=O,16,9,12,21,37,0.000449
G3,C(C1CC(C(C(O1)O)O)O)=O,16,8,11,19,37,0.000413
G3,C1(COC(C)(C(C1O)O)O)=O,8,11,12,23,24,0.000544
G3,C1(C(C)OC(C(C1O)O)O)=O,16,11,11,22,24,0.000544
G3,CC1(C(C(C(CO1)O)O)O)O,16,5,7,12,14,0.00028199999999999997
G3,C1(C(C(CC(CO)(O)O1)O)O)=O,8,5,7,12,17,0.00027
G3,C1(C(C(C(C(C)(O)O1)O)O)O)=O,16,6,8,14,14,0.00032900000000000003
G3,C1C2(C(C(C(CO2)O)O1)O)O,16,1,2,3,2,4.7e-05
G3,C1C2(C(C(C(CO2)O1)O)O)O,16,3,4,7,54,0.000164
G3,C1C2C(CC(C(O)O2)(O)O1)O,16,3,4,7,30,0.000153
G3,C1(C(O)OCC(C(C1O)O)O)=O,16,9,10,19,2,0.000471
G3,C1(COC(CC(C1O)O)O)=O,8,12,12,24,38,0.000603
G3,C1C(C(C(CC(O)O1)O)O)O,16,6,7,13,29,0.00033999999999999997
G3,C1CC(C(C(C(O)O1)O)O)O,16,6,8,14,4,0.00033999999999999997
G3,C1(C(C(C(CC(O)O1)O)O)O)=O,16,7,8,15,43,0.00038700000000000003
G3,C1(CC(C(C(C(O)O1)O)O)O)=O,16,6,8,14,29,0.00033999999999999997
G3,C12C(C(C(CC(O)O1)O2)O)O,32,3,4,7,23,0.000164
G3,C12CC(C(C(C(O)O1)O)O2)O,32,2,4,6,43,0.000106
G3,C1(CC(C(C(C=O)O)O1)O)=O,8,11,9,20,8,0.000533
G3,C1(CC(C(C(C=O)O1)O)O)=O,8,14,13,27,8,0.000698
G3,C(CC(C(CO)O)CC(C=O)=O)=O,4,15,16,31,46,0.000759
G3,C(C(C(CC(CO)CC=O)=O)O)=O,4,16,16,32,55,0.000784
G3,C(CC(C=O)CC=O)(C(CO)O)=O,4,17,16,33,43,0.0008460000000000001
G3,C(CC(C(C(CO)O)=O)CC=O)=O,2,11,11,22,46,0.000549
G3,C(CCCC(C(C(C=O)O)O)=O)=O,4,19,19,38,7,0.0009279999999999999
G3,C(CC(C(C=O)O)CC(CO)=O)=O,4,16,17,33,32,0.000785
G3,C(CC(C(C(C=O)O)O)CC=O)=O,4,14,15,29,43,0.000701
G4,C1(C(C(CO)(C(C(C1)O)O)O)O)=O,16,9,13,22,5,0.00048300000000000003
G4,C1(C(C(CO)(CC(C1O)O)O)O)=O,16,6,14,20,5,0.000285
G4,C1(C(C(C(C(CO)(C1)O)O)O)O)=O,16,8,14,22,12,0.000424
G4,C1(C(C(C)(C(C(C1O)O)O)O)O)=O,32,4,14,18,5,0.00018999999999999998
G4,C1(C(C(C(C1O)O)O)O)=O,10,6,13,19,5,0.000285
G4,C1(C(C(C(CO)(C1CO)O)O)O)=O,16,10,15,25,2,0.000512
G4,C1(C(C(C(C1O)O)(CCO)O)O)=O,16,5,14,19,5,0.00023700000000000001
G4,C1(C(C(C(C(C1O)O)O)O)O)=O,10,4,8,12,5,0.00020099999999999998
G4,C(C1C(C(C(C1(CO)O)O)O)O)=O,32,8,18,26,51,0.000424
G4,C1(C(C(C(CC(C1O)O)O)O)O)=O,32,5,16,21,51,0.00023700000000000001
G4,C(CO)(C1C(CC(C1O)=O)O)=O,8,8,16,24,20,0.00037999999999999997
G4,C1(C(C(C(CC(C1)O)=O)O)O)=O,3,4,7,11,20,0.00018999999999999998
G4,C(C1(CC(CC(C1O)=O)O)O)=O,8,4,17,21,20,0.00018999999999999998
G4,C(C1C(CO)(CC(C1O)=O)O)=O,8,7,17,24,51,0.000332
G4,C(C1C(C(C(C)(C1O)O)O)=O)=O,16,6,17,23,49,0.000285
G4,C(C1C(C(C(C1(C)O)O)O)=O)=O,16,6,18,24,49,0.000285
G4,C(CC1(C(C(C(C1)=O)O)O)O)=O,8,4,19,23,51,0.00018999999999999998
G4,C1(CC(C(CC(C1O)O)=O)O)=O,8,5,13,18,20,0.00023700000000000001
G4,C(C1(CC(C(C(C1)=O)O)O)O)=O,8,3,17,20,51,0.00014199999999999998
G4,C1(C(CC(C(C=O)O)(C1)O)O)=O,8,5,17,22,26,0.000239
G4,C1(C(CC(C(CO)O)(C1)O)O)=O,8,3,13,16,45,0.000154
G4,C1(C(C(C(C(C1)O)=O)CO)O)=O,8,7,14,21,2,0.000336
G4,C1(C(CO)C(C=O)(CC1O)O)=O,8,6,15,21,2,0.00028900000000000003
G4,C(C1(C(CO)C(C(C1)=O)O)O)=O,8,2,14,16,45,9.499999999999999e-05
G4,C1(C(C(C(C)(C1CO)O)O)O)=O,16,7,14,21,3,0.00034700000000000003
G4,C1(C(C(C(CCO)(C1)O)O)O)=O,8,4,13,17,3,0.00020099999999999998
G4,C1(C(C(C)(C(C1CO)O)O)O)=O,16,7,13,20,45,0.00034700000000000003
G4,C1(C(C(CO)C(CO)(C1)O)O)=O,8,4,12,16,45,0.000212
G4,C1(C(C(C(C1)O)(C)O)O)=O,8,8,22,30,45,0.00037999999999999997
G4,C1(C(CC(CO)(C1)O)O)=O,4,6,19,25,3,0.000296
G4,C1(C(C(C(C)(C1)O)O)O)=O,8,8,23,31,16,0.00037999999999999997
G4,C(C1C(C(CC(C1O)=O)O)O)=O,16,6,20,26,20,0.000285
G4,C(C1C(C(CC1(C=O)O)O)O)=O,16,5,21,26,20,0.00023700000000000001
G4,C(C(C1C(C(CC1O)O)O)=O)=O,16,4,21,25,20,0.00018999999999999998
G4,C1(C(C(C(C1)O)C(C=O)O)O)=O,16,2,16,18,20,9.499999999999999e-05
G4,C(C(C1C(C(C(C1O)O)O)O)=O)=O,10,2,12,14,0,9.499999999999999e-05
G4,C1(C(CC(C1)O)O)=O,4,10,81,91,45,0.000475
G4,C1(C(C(C(C(CO)O)(C1)O)O)O)=O,16,7,15,22,51,0.000366
G4,C(C1C(C(C(C1O)O)O)=O)=O,16,7,21,28,2,0.000332
G4,C(C1C(C(C(C(C1O)O)O)O)=O)=O,32,4,19,23,1,0.00018999999999999998
G4,C1(C(C(CO)(CC(C1)O)O)O)=O,8,4,12,16,49,0.00020099999999999998
G4,C1(C(C(CC(CO)(C1)O)O)O)=O,8,4,13,17,49,0.00020099999999999998
G4,C1(C(C(C)(C(C(C1)O)O)O)O)=O,16,3,12,15,49,0.00014199999999999998
G4,C1(C(C(CC(C1)O)O)O)=O,8,3,23,26,2,0.00014199999999999998
G4,C1(C(C(C(C(C)(C1)O)O)O)O)=O,16,3,13,16,0,0.00014199999999999998
G4,C1(C(C(C(C1O)O)O)C(C=O)O)=O,32,6,22,28,0,0.000286
G4,C1(C(C(C(C1C(C)O)O)O)O)=O,32,6,15,21,11,0.00028700000000000004
G4,C(C1C(C(CC1(CO)O)O)O)=O,16,5,17,22,21,0.00024900000000000004
G4,C(CO)(C1C(C(CC1O)O)O)=O,16,5,14,19,21,0.00024900000000000004
G4,C1(C(C(CC(C(C1)O)O)O)O)=O,16,3,14,17,21,0.00014199999999999998
G4,C1(C(C(C(C1)O)(C(CO)O)O)O)=O,16,7,14,21,32,0.000377
G4,C1(C(C(CO)(C(C1CO)O)O)O)=O,16,11,14,25,2,0.000571
G4,C1(C(C(CO)(C(CO)C1O)O)O)=O,16,4,13,17,2,0.00018999999999999998
G4,C1(C(C(CC1O)(C(CO)O)O)O)=O,16,3,14,17,2,0.00014199999999999998
G4,C1(C(C(C(CO)C(C1O)O)O)O)=O,10,4,8,12,5,0.00020099999999999998
G4,C1(C(CO)C(C(C1CO)=O)O)=O,8,10,15,25,2,0.00048300000000000003
G4,C1(C(C(C(C(CO)C1)=O)O)O)=O,8,7,15,22,12,0.000334
G4,C(C1(C(CO)CC(C1O)=O)O)=O,8,4,16,20,12,0.00018999999999999998
G4,C(C1(CC(C(C1O)=O)CO)O)=O,8,6,15,21,12,0.00028700000000000004
G4,C(C1C(C(C(C1O)=O)CO)O)=O,16,11,19,30,2,0.000526
G4,C1(C(C(CO)C(C1CO)O)=O)=O,3,5,9,14,2,0.000241
G4,C1(C(CO)C(C(C(C1)=O)O)O)=O,8,9,16,25,2,0.00043099999999999996
G4,C1(CC(C(C(C1CO)=O)O)O)=O,8,8,14,22,2,0.000384
G4,C1(C(CO)C(CC(C1O)=O)O)=O,8,7,13,20,9,0.000336
G4,C(C1C(C(C(CO)C1O)O)=O)=O,16,5,17,22,23,0.00023700000000000001
G4,C1(C(CO)C(C=O)C(C1O)O)=O,16,5,18,23,2,0.000239
G4,C1(C(CC(C(C1CO)O)O)=O)=O,8,7,17,24,14,0.000336
G4,C(C1C(C(CO)C(C1O)O)=O)=O,16,9,20,29,2,0.00043099999999999996
G4,C1(C(C(C(C1)O)(CCO)O)O)=O,8,4,12,16,3,0.00020099999999999998
G4,C1(C(CC(CO)(C1CO)O)O)=O,8,6,13,19,3,0.0003
G4,C1(C(CC(C1CO)O)O)=O,8,7,17,24,4,0.000348
G4,C(C1C(C(C(C1(C)O)O)O)O)=O,32,4,19,23,16,0.00018999999999999998
G4,C1(C(C(C(CC(C1)O)O)O)O)=O,16,3,14,17,21,0.00014199999999999998
G4,C(CO)(C1C(C(C(C1O)O)O)O)=O,10,4,9,13,20,0.000212
G4,C1(C(C(C(C(C(C1)O)O)O)O)O)=O,32,5,15,20,20,0.000259
G4,C(C1C(C(CC1O)O)O)=O,16,5,19,24,43,0.00023700000000000001
G4,C(CCO)(C1C(C(CC1O)O)=O)=O,8,2,11,13,30,9.499999999999999e-05
G4,C1(C(CO)C(CC(C(C1)=O)O)O)=O,8,2,15,17,30,9.499999999999999e-05
G4,C(C1C(CCO)(CC(C1O)=O)O)=O,8,4,15,19,30,0.00018999999999999998
G4,C(C1(CC(C(C(C1)=O)CO)O)O)=O,8,2,15,17,23,9.499999999999999e-05
G4,C1(CC(C(C1CO)O)(CC=O)O)=O,8,3,15,18,23,0.000144
G4,C1(C(CO)C(C(C1C(C)O)=O)O)=O,16,5,13,18,30,0.00023999999999999998
G4,C1(C(C(CC1O)O)CC(CO)=O)=O,8,1,14,15,7,4.7e-05
G4,C(CO)(C1C(CC(C(C1)=O)O)O)=O,8,1,13,14,7,4.7e-05
G4,C1(CCC(C(CC(C1O)O)O)=O)=O,8,2,15,17,7,9.499999999999999e-05
G4,C(CC(C1(CCC(C1O)=O)O)O)=O,8,4,19,23,7,0.00019099999999999998
G4,C(C1C(CCC(C1O)=O)(CO)O)=O,8,5,15,20,7,0.00023700000000000001
G4,C(C1(CC(C(CO)=O)C(C1)O)O)=O,8,1,15,16,29,4.7e-05
G4,C(C1(CCC(C(C(C1)O)O)=O)O)=O,8,3,17,20,29,0.00014199999999999998
G4,C(CC1(CCC(C(C1O)O)=O)O)=O,8,4,19,23,29,0.00019099999999999998
G4,C(C1C(CO)(CCC1(C=O)O)O)=O,8,4,16,20,29,0.00018999999999999998
G4,C(C(C1CC(CO)(CC1O)O)=O)=O,8,1,16,17,29,4.7e-05
G4,C1(C(C(C(C(C(C)O)C1)=O)O)O)=O,16,5,14,19,12,0.000239
G4,C(C1(C(C(C)O)CC(C1O)=O)O)=O,16,3,15,18,12,0.00014199999999999998
G4,C(C1(CC(C(C1O)=O)C(C)O)O)=O,16,4,14,18,12,0.00019099999999999998
G4,C1(C(C(CC1O)O)C(C(C)=O)O)=O,16,4,15,19,45,0.00019099999999999998
G4,C1(CC(C(CC(CC1O)O)=O)O)=O,8,2,14,16,22,9.499999999999999e-05
G4,C(CC(C1(CC(C(C1)=O)O)O)O)=O,8,3,18,21,22,0.000144
G4,C(C1C(C(CC(C1O)=O)O)(C)O)=O,16,5,17,22,22,0.00023700000000000001
G4,C(C1(CC(C(CC(C1)O)=O)O)O)=O,8,1,14,15,22,4.7e-05
G4,C(CC1(C(CC(C(C1)O)=O)O)O)=O,8,2,17,19,22,9.6e-05
G4,C(C1C(C)(C(CC1(C=O)O)O)O)=O,16,4,18,22,22,0.00018999999999999998
G4,C(C(C1C(C(C)(CC1O)O)O)=O)=O,16,4,17,21,22,0.00018999999999999998
G4,C1(C(C(C(C(C1)O)=O)C(C)O)O)=O,16,5,13,18,22,0.00023999999999999998
G4,C(C1(C(C(C)O)C(C(C1)=O)O)O)=O,16,2,13,15,22,9.499999999999999e-05
G4,C1(C(C(C)O)C(C=O)(CC1O)O)=O,16,5,14,19,22,0.00023999999999999998
G4,C(CC(C1C(C(CC1O)O)=O)O)=O,16,6,15,21,13,0.00028700000000000004
G4,C(C1C(CC(C(CC1O)O)=O)O)=O,16,6,17,23,13,0.000285
G4,C(C1C(CC(CC(C1O)=O)O)O)=O,16,6,18,24,13,0.000285
G4,C(C1C(CC(C=O)(CC1O)O)O)=O,3,2,11,13,13,9.499999999999999e-05
G4,C(C1C(C(CC1O)(CC=O)O)O)=O,16,5,21,26,13,0.000239
G4,C(C1C(CC(CC1(C=O)O)O)O)=O,16,4,17,21,13,0.00018999999999999998
G4,C(C(C1C(CC(CC1O)O)O)=O)=O,3,2,9,11,13,9.499999999999999e-05
G4,C(C1C(C(C(C1O)=O)C(C)O)O)=O,32,9,17,26,4,0.00043
G4,C1(C(CC(CC(C1CO)O)O)=O)=O,8,2,15,17,53,9.499999999999999e-05
G4,C(C1C(CC(C1(CCO)O)=O)O)=O,8,4,13,17,53,0.00018999999999999998
G4,C1(C(CC(C1CO)O)(CC=O)O)=O,8,3,15,18,4,0.000144
G4,C(C1C(C(CCO)(CC1O)O)=O)=O,8,2,12,14,53,9.499999999999999e-05
G4,C1(C(C(C(C1CO)O)C(C)O)=O)=O,16,4,17,21,4,0.000192
G4,C1(CC(CC(C1C(CO)=O)O)O)=O,8,3,10,13,26,0.00014199999999999998
G4,C1(CC(CC(C(C(C1)=O)O)O)O)=O,8,3,13,16,26,0.00014199999999999998
G4,C(C1C(CC(CC1(CO)O)=O)O)=O,8,5,15,20,26,0.00023700000000000001
G4,C(CC1(CC(C(C(C1)=O)O)O)O)=O,8,4,16,20,32,0.00019099999999999998
G4,C(C1C(CC(CO)(CC1O)O)=O)=O,8,3,13,16,26,0.00014199999999999998
G4,C1(C(C(C(C(C1)=O)O)O)C(C)O)=O,16,6,14,20,4,0.00028700000000000004
G4,C1(CC(C(C(C1C(C)O)=O)O)O)=O,16,5,12,17,4,0.00023999999999999998
G4,C1(CC(CC(CC(C1O)=O)O)O)=O,3,1,5,6,9,4.7e-05
G4,C(C1C(CC(C(C1(C)O)O)=O)O)=O,16,6,16,22,6,0.000285
G4,C(CC1(CC(CC(C1O)=O)O)O)=O,8,4,15,19,49,0.00019099999999999998
G4,C(C1C(C(C(C)(CC1O)O)O)=O)=O,16,4,14,18,6,0.00018999999999999998
G4,C1(C(C(CC(C1O)=O)O)C(C)O)=O,16,5,12,17,9,0.00023999999999999998
G4,C(C1C(CC(C1(CC=O)O)O)O)=O,16,5,18,23,13,0.000239
G4,C(C1C(C(CC(CC1O)O)O)=O)=O,16,3,14,17,13,0.00014199999999999998
G4,C(C1C(C(C(C1O)C(C)O)O)=O)=O,32,3,15,18,4,0.00014199999999999998
G4,C1(C(C(CC(C1C(C)=O)O)O)O)=O,16,2,13,15,26,9.499999999999999e-05
G4,C(C1C(C(C(CC1(C)O)=O)O)O)=O,16,5,17,22,26,0.00023700000000000001
G4,C1(CC(CC(C(C=O)O)(C1)O)O)=O,8,2,16,18,27,9.499999999999999e-05
G4,C(CC1(C(C(CC(C1)=O)O)O)O)=O,8,3,15,18,27,0.000144
G4,C1(C(C(CC(C1O)O)O)CC=O)=O,16,4,16,20,18,0.00018999999999999998
G4,C(C1C(CC(C(C(C1)=O)O)O)O)=O,16,4,19,23,18,0.00018999999999999998
G4,C(C1C(C(C(CCC1O)=O)O)O)=O,16,4,18,22,44,0.00018999999999999998
G4,C(C1CC(CC1O)(C(C=O)O)O)=O,16,1,21,22,44,4.7e-05
G4,C(C1CC(C(C1O)O)(CC=O)O)=O,16,2,21,23,44,9.6e-05
G4,C(C1C(CCC1(C(C=O)O)O)O)=O,16,4,17,21,44,0.00018999999999999998
G4,C(C(C(C1C(CC(C1)O)O)=O)O)=O,16,1,13,14,44,4.7e-05
G4,C1(C(C(C)O)C(C=O)C(C1O)O)=O,32,2,16,18,4,9.6e-05
G4,C(C(C)=O)(C1C(C(CC1O)O)O)=O,16,4,16,20,21,0.00018999999999999998
G4,C1(C(CC(CC(C(C1)O)O)O)=O)=O,8,2,15,17,21,9.499999999999999e-05
G4,C(C1C(C(CC1(C(C)=O)O)O)O)=O,16,4,18,22,21,0.00018999999999999998
G4,C(C1C(C(CC(C1(C)O)=O)O)O)=O,16,5,17,22,21,0.00023700000000000001
G4,C1(CC(CC1(CC(C=O)O)O)O)=O,8,1,13,14,21,4.7e-05
G4,C1(C(CC(C(C1)O)O)(CC=O)O)=O,8,2,14,16,21,9.6e-05
G4,C1(C(C(CC1(C)O)O)C(C=O)O)=O,16,2,14,16,21,9.499999999999999e-05
G4,C1(C(CC(C(C1C(C)O)O)O)=O)=O,16,5,15,20,14,0.00023999999999999998
G4,C(CC(C1C(C(CC1O)O)O)=O)=O,16,4,16,20,6,0.00018999999999999998
G4,C(C1C(CC(C(CC1O)O)O)=O)=O,16,3,16,19,6,0.00014199999999999998
G4,C(C1C(C(CC1(CC=O)O)O)O)=O,16,5,20,25,4,0.000239
G4,C(C1C(CC(CC(C1O)O)=O)O)=O,16,5,18,23,6,0.00023700000000000001
G4,C1(C(C(CC(C1)O)O)C(C=O)O)=O,16,3,16,19,26,0.00014199999999999998
G4,C1(CC(C(C1C(CC=O)O)O)O)=O,16,3,17,20,26,0.000144
G4,C(C1C(C(C(C1O)O)C(C)O)=O)=O,32,4,17,21,4,0.000192
G4,C(C1C(C=CC1(C(CO)O)O)O)=O,16,4,12,16,21,0.00018999999999999998
G4,C(C1C(C(C(C1(C=C)O)O)O)O)=O,32,4,16,20,7,0.00018999999999999998
G4,C1C(C(CC(C(C(C=1)=O)O)O)O)O,16,2,12,14,32,9.499999999999999e-05
G4,C(C1C(C(C=CC1(CO)O)O)O)=O,16,4,12,16,32,0.00018999999999999998
G4,C(C1C(C(C(C=CC1O)O)O)O)=O,32,4,13,17,43,0.00018999999999999998
G4,C1(C(C(C(C1C(CO)O)O)O)O)=O,32,7,16,23,0,0.00034500000000000004
G4,C1(C(CO)C(C(C1O)=O)O)=O,8,2,16,18,2,9.499999999999999e-05
G4,C(C1(C(CC(C1O)=O)O)O)=O,8,10,20,30,15,0.000475
G4,C1(C(C(C(CC1O)=O)O)O)=O,8,6,19,25,5,0.000285
G4,C(C1(C(C(C(C1)=O)O)O)O)=O,8,5,19,24,1,0.00023700000000000001
G4,C(C1C(C(C(C1O)=O)O)O)=O,16,8,21,29,5,0.00037999999999999997
G4,C1(C(C(CC1O)O)O)=O,8,11,37,48,2,0.000544
G4,C1(CC(C(C1)=O)O)=O,2,12,157,169,26,0.00057
G4,C1(C(CC(C1)O)=O)=O,1,4,72,76,45,0.00018999999999999998
G4,C(CO)(C1C(C(CO1)O)O)=O,8,7,10,17,36,0.000365
G4,C(C1C(CO)(CC(O1)O)O)=O,8,7,11,18,38,0.000343
G4,C(CO)(C1C(O)OCC1O)=O,8,5,12,17,38,0.00023700000000000001
G4,C(C1C(C)(C(C(O1)O)O)O)=O,16,6,12,18,19,0.000285
G4,C(CO)(C1COC(C1O)O)=O,8,7,12,19,30,0.000343
G4,C1C(C(C(C=1)=O)O)O,4,11,102,113,28,0.000522
G4,C(C1C(CO)(O)OCC1O)=O,8,4,13,17,40,0.00018999999999999998
G4,C1(C(C(CC(C1)O)O)=O)=O,4,7,20,27,9,0.000343
G4,C1(C(C(C(C)(C1)O)O)=O)=O,4,5,23,28,26,0.00023700000000000001
G4,C1(CC(C(C(C1)O)=O)O)=O,3,4,15,19,17,0.00020099999999999998
G4,C1(C(C(C(CC1)O)O)=O)=O,4,6,22,28,17,0.000296
G4,C(C1CC(C(C1O)=O)O)=O,8,7,22,29,32,0.000354
G4,C1(C(CC(CO)(C1)O)=O)=O,1,3,13,16,2,0.000153
G4,C1(C(C)(C(C(C1)=O)O)O)=O,4,7,23,30,24,0.000343
G4,C1(C(C(C=CC1O)O)O)=O,8,7,18,25,32,0.000343
G4,C1C(CO)(C(C(C=1)=O)O)O,4,7,19,26,32,0.000354
G4,C1(C(C(CC1)(CO)O)O)=O,4,5,20,25,29,0.00024900000000000004
G4,C1(CC(C(C1CO)O)O)=O,8,5,22,27,29,0.00024900000000000004
G4,C(C1(CCC(C1O)=O)O)(O)=O,4,6,14,20,29,0.000296
G4,C(C1(CC(C(C1)=O)O)O)(O)=O,4,4,14,18,29,0.00020099999999999998
G4,C(C1C(C(CC1O)O)=O)(O)=O,8,7,13,20,45,0.00034500000000000004
G4,C(C1C(CC(C1O)O)=O)(O)=O,8,5,16,21,17,0.00024900000000000004
G4,C1(C(C(C(C(C1)O)(CO)O)O)O)=O,16,9,12,21,2,0.0004940000000000001
G4,C(C1C(C(CO)(C(C1O)O)O)O)=O,32,9,18,27,2,0.00048300000000000003
G4,C(C1(C(CC(C)(C1O)O)=O)O)=O,8,4,13,17,16,0.00018999999999999998
G4,C(C)(C1(C(CC(C1O)=O)O)O)=O,8,9,16,25,49,0.00042699999999999997
G4,C(C1(C(C)(CC(C1O)=O)O)O)=O,8,6,16,22,26,0.000285
G4,C(C1(C(CC(C1(C)O)O)=O)O)=O,8,4,12,16,29,0.00018999999999999998
G4,C1(CC(C)(C(C1(CO)O)O)O)=O,8,6,13,19,16,0.0003
G4,C1(C(C(CO)(C(C)(C1)O)O)O)=O,8,4,11,15,25,0.00020099999999999998
G4,C1(CC(C(C)(C1(CO)O)O)O)=O,8,6,12,18,45,0.0003
G4,C1(C(C(C(C1)O)(C(C=O)O)O)O)=O,16,1,18,19,0,4.7e-05
G4,C(C1(C(C(CC(C1O)=O)O)O)O)=O,16,7,21,28,0,0.000332
G4,C1(C(C(C)(C(C1(CO)O)O)O)O)=O,16,8,14,22,2,0.000395
G4,C1(C(C(CO)(C(CO)(C1)O)O)O)=O,8,5,12,17,32,0.000248
G4,C1(C(C(C(C)(C1(CO)O)O)O)O)=O,16,8,14,22,2,0.000395
G4,C(C1(C(CC(C(C1O)O)=O)O)O)=O,16,7,19,26,1,0.000332
G4,C(C1(C(CC(C1O)O)=O)O)=O,8,4,15,19,15,0.00018999999999999998
G4,C(C1(C(CC(C(C1O)O)O)=O)O)=O,16,3,15,18,1,0.00014199999999999998
G4,C1(C(C(C(C1)O)O)(C(C=O)O)O)=O,16,5,21,26,0,0.000239
G4,C1(C(C(C(C1(CO)O)O)O)O)=O,16,8,15,23,5,0.00040599999999999995
G4,C1(CC(CO)(C(C1(CO)O)O)O)=O,8,9,14,23,2,0.000475
G4,C1(C(C(CO)(C(C)(C1O)O)O)O)=O,16,5,12,17,5,0.00023700000000000001
G4,C1(C(C(CC(C1(CO)O)O)O)O)=O,16,8,15,23,2,0.00040599999999999995
G4,C1(CC(CC(C1(CO)O)=O)O)=O,1,4,7,11,9,0.000194
G4,C1(C(CO)(C(CC(C1)=O)O)O)=O,4,8,15,23,2,0.000384
G4,C(C1C(C(C(C1)=O)(CO)O)O)=O,8,8,19,27,2,0.000384
G4,C(C1(C(C(C(C1O)=O)CO)O)O)=O,16,10,20,30,15,0.000479
G4,C1(C(C(C(C1)O)(C(C)O)O)O)=O,16,3,12,15,49,0.00014199999999999998
G4,C1(CC(C(C1(C(C)O)O)O)O)=O,16,5,14,19,4,0.00023999999999999998
G4,C(C1C(C(C=O)(C(C1O)O)O)O)=O,32,8,24,32,43,0.00037999999999999997
G4,C1(CC(CC(C1(C(C)O)O)=O)O)=O,2,3,7,10,9,0.000145
G4,C1(C(C(CC(C1)=O)O)(C(C)O)O)=O,8,5,13,18,4,0.00023999999999999998
G4,C(C1C(C(C(C1)=O)(C(C)O)O)O)=O,16,4,17,21,4,0.000192
G4,C1(CC(C(C1(C(CO)O)O)O)O)=O,16,6,15,21,0,0.000298
G4,C(CC1(C(CC(C1O)=O)O)O)=O,8,4,17,21,20,0.00018999999999999998
G4,C(C1(C(C(C(C(C1)=O)O)O)O)O)=O,16,4,19,23,51,0.00018999999999999998
G4,C1(C(C(C(C(C=O)O)(C1)O)O)O)=O,16,3,20,23,51,0.00014199999999999998
G4,C1(C(C(C(C(C)O)(C1)O)O)O)=O,16,3,13,16,41,0.00014199999999999998
G4,C1(C(C(C(CO)(CC1O)O)O)O)=O,16,5,12,17,43,0.000248
G4,C1(C(C(C(CC1(CO)O)O)O)O)=O,16,5,13,18,32,0.00025
G4,C1(C(C(CO)(CC1(CO)O)O)O)=O,8,4,12,16,32,0.000192
G4,C1(CC(C(CC1(CO)O)=O)O)=O,4,5,12,17,2,0.000239
G4,C(C1(CC(C(C1)=O)(CO)O)O)=O,4,3,14,17,22,0.000144
G4,C(C1C(CC(C1(CO)O)=O)O)=O,8,8,16,24,2,0.00038199999999999996
G4,C(C1C(C(CO)(CC1O)O)=O)=O,8,5,16,21,2,0.000239
G4,C1(C(CC(CO)(C(C1)O)O)=O)=O,4,4,14,18,5,0.00018999999999999998
G4,C(C1C(CC(CO)(C1O)O)=O)=O,8,6,18,24,2,0.000285
G4,C1C(CO)(C(C(C(C=1)=O)O)O)O,8,4,11,15,43,0.00018999999999999998
G4,C(C1C(C(C(C1(C=O)O)O)O)O)=O,32,5,23,28,43,0.00023700000000000001
G4,C1(CC(C(CC1(C(C)O)O)=O)O)=O,8,2,11,13,4,9.6e-05
G4,C(C1(CC(C(C1)=O)(C(C)O)O)O)=O,8,2,13,15,4,9.6e-05
G4,C(C1C(CC(C1(C(C)O)O)=O)O)=O,16,5,14,19,4,0.000239
G4,C(C1C(C(C(C)O)(CC1O)O)=O)=O,16,3,14,17,4,0.000144
G4,C1(C(CC(C(C(C)O)(C1)O)O)=O)=O,8,2,12,14,14,9.499999999999999e-05
G4,C(C1C(CC(C1O)(C(C)O)O)=O)=O,16,3,15,18,25,0.00014199999999999998
G4,C1C(C(C(C(C=1)=O)O)O)(C(C)O)O,16,2,10,12,32,9.499999999999999e-05
G4,C1(C2C(C(CO2)(C1)O)O)=O,8,2,18,20,17,9.499999999999999e-05
G4,C1(C2C(CC(C1O)O2)O)=O,16,4,17,21,9,0.00018999999999999998
G4,C1(C2CC(C(O2)O)(C1)O)=O,8,4,15,19,22,0.00018999999999999998
G4,C1(C2CC(C1C(O2)O)O)=O,16,5,15,20,4,0.00023700000000000001
G4,C1(C=CC(C(C1)O)=O)=O,2,5,88,93,45,0.00023700000000000001
G4,C(C1(C=CC(C1)=O)O)=O,2,4,62,66,45,0.00018999999999999998
G4,C(C1C=CC(C1O)=O)=O,4,6,66,72,45,0.000285
G4,C1C(CC(C(C=1)=O)=O)O,2,4,65,69,27,0.00018999999999999998
G4,C(C1C(C=CC1O)=O)=O,4,6,55,61,45,0.000285
G4,C1(C2(CC(C1CO2)O)O)=O,8,5,10,15,2,0.00023700000000000001
G4,C1(C2C(CC(C1)(O2)O)O)=O,8,4,19,23,48,0.00018999999999999998
G4,C1(CC2(C(C1CO2)O)O)=O,8,6,18,24,30,0.000285
G4,C1(CC2C(C1C(O)O2)O)=O,16,6,18,24,37,0.000285
G4,C(C1C(C(CO)O)CC(C1O)=O)=O,16,4,17,21,46,0.00018999999999999998
G4,C(C1C(C(C(CC1CO)=O)O)O)=O,16,2,18,20,11,9.499999999999999e-05
G4,C(C1CCC(C(C(C1O)O)O)=O)=O,16,4,19,23,7,0.00018999999999999998
G4,C(CCC1C(C(C(C1O)O)O)=O)=O,16,3,17,20,4,0.000144
G4,C1(C(C(CC(C(C=O)O)C1)O)O)=O,16,3,17,20,32,0.00014199999999999998
G4,C(CC1C(C(C(C(C1)=O)O)O)O)=O,16,3,19,22,32,0.000144
G4,C(C1C(C(C(C1O)O)O)CC=O)=O,32,3,22,25,4,0.000144
G4,C(C1C(C(C(C1O)O)O)=O)(O)=O,16,8,17,25,0,0.000392
G4,C1(C(CO)C(C(C1C(O)=O)=O)O)=O,8,5,15,20,30,0.000239
G4,C(C1C(C(C(C(C1)=O)O)O)=O)(O)=O,8,5,15,20,12,0.00023799999999999998
G4,C(C1(CC(C(O)=O)C(C1O)=O)O)=O,8,4,17,21,12,0.00019099999999999998
G4,C(C1C(C(CC(C1O)=O)O)=O)(O)=O,8,5,13,18,17,0.000239
G4,C1(C(CC(C=O)(C1C(O)=O)O)O)=O,8,4,14,18,17,0.00019099999999999998
G4,C(C1C(C(C(O)=O)C(C1O)=O)O)=O,16,6,17,23,17,0.000286
G4,C(C1C(C(C(CO)C1O)=O)=O)(O)=O,8,4,17,21,17,0.00019099999999999998
G4,C(C1C(CC(C(C1O)O)=O)=O)(O)=O,8,6,14,20,17,0.000286
G4,C1(CC(C(C(C1C(O)=O)=O)O)O)=O,8,5,13,18,17,0.000239
G4,C(C1C(C(C(CC1O)=O)O)=O)(O)=O,8,5,12,17,17,0.000239
G4,C1(C(C(C(C=O)C1C(O)=O)O)O)=O,16,2,18,20,17,9.6e-05
G4,C(C1C(C(CC(C1O)O)=O)=O)(O)=O,8,5,15,20,17,0.000239
G4,C(C1C(C(C=O)C(C1O)O)=O)(O)=O,16,4,17,21,17,0.00019099999999999998
G4,C(C(C(C(C(C=O)O)O)=O)O)(O)=O,8,8,19,27,17,0.000396
G4,C(C(C(C(C(C)O)O)=O)O)(O)=O,8,8,12,20,17,0.000417
G4,C(C(C=O)C(CO)(CO)O)(O)=O,2,7,11,18,5,0.000357
G4,C(C(C=O)C(C(CO)O)O)(O)=O,8,8,16,24,17,0.00041600000000000003
G4,C(C(C(C=O)=O)C(C=O)(C)O)(O)=O,4,5,11,16,17,0.000251
G4,C(C(C(C=O)=O)C(C=O)O)(O)=O,4,7,16,23,0,0.000346
G4,C(C(C(C=O)=O)C(C)(CO)O)(O)=O,4,6,13,19,49,0.00031
G4,C(CC(C(CC(CO)=O)O)=O)(O)=O,2,4,13,17,29,0.00021400000000000002
G4,C(C(C(CO)=O)C(C(C)=O)O)(O)=O,4,7,13,20,45,0.000357
G4,C(C(C(CC(C(C)=O)O)=O)O)(O)=O,4,4,13,17,45,0.00020299999999999997
G4,C(C(C)(C(C(O)=O)C(CO)=O)O)=O,4,7,13,20,16,0.000357
G4,C(C(C)(CC(C(C(O)=O)O)=O)O)=O,4,4,13,17,16,0.00020299999999999997
G4,C(CC(C(C(C(C)=O)O)O)=O)(O)=O,4,6,16,22,17,0.000299
G4,C(C(C)(C(C(CC(O)=O)=O)O)O)=O,4,5,15,20,45,0.000251
G4,C(C(C(C(C)O)C(CCO)O)=O)=O,8,5,14,19,4,0.000252
G4,C(C(CO)C(C(CC(C)O)=O)O)=O,8,6,15,21,4,0.000302
G4,C(C(CO)C(C=O)(CC(C)O)O)=O,8,5,14,19,4,0.00025299999999999997
G4,C(C(C=O)C(C(CC(C)O)=O)O)=O,4,5,11,16,4,0.00023999999999999998
G4,C(C(C=O)C(C=O)(CC(C)O)O)=O,4,2,10,12,45,9.6e-05
G4,C(C(C(C=O)=O)C(C)O)(O)=O,4,8,14,22,4,0.000395
G4,C(C(C(C(C=O)=O)C(C)O)O)(O)=O,8,5,14,19,4,0.000252
G4,C(C(C(C(C)O)C(C(C)O)O)=O)=O,16,5,15,20,4,0.000252
G4,C(CC(C(CC(CCO)O)=O)O)=O,4,4,12,16,4,0.00020299999999999997
G4,C(C(C(CCO)O)C(C(C)=O)O)=O,8,5,14,19,45,0.000251
G4,C(C(CO)C(C)(C(CC=O)O)O)=O,8,6,18,24,45,0.000302
G4,C(C(CO)C(CC(C(C)=O)O)O)=O,8,5,16,21,45,0.00025299999999999997
G4,C(CC(C(C=O)C(C(C)=O)O)O)=O,8,7,18,25,45,0.000336
G4,C(C(C=O)C(C)(C(CC=O)O)O)=O,4,3,14,17,45,0.000145
G4,C(C(C=O)C(CC(C(C)=O)O)O)=O,4,3,12,15,45,0.000143
G4,C(C(C=O)C(C(C)=O)O)(O)=O,4,9,15,24,17,0.00044100000000000004
G4,C(C(CC(C(CC=O)O)=O)O)(O)=O,4,3,13,16,33,0.000155
G4,C(C(C(C=O)C(C(C)=O)O)O)(O)=O,8,7,14,21,45,0.000368
G4,C(CC(C(CC(C(C)O)O)=O)O)=O,8,2,13,15,11,9.7e-05
G4,C(C(C(C(C)O)O)C(C(C)=O)O)=O,16,4,15,19,45,0.000192
G4,C(C(C(CCO)O)C(C=O)(C)O)=O,8,5,14,19,45,0.000251
G4,C(C(CO)C(C(C)(CC=O)O)O)=O,8,6,18,24,45,0.000302
G4,C(C(CO)C(CC(C=O)(C)O)O)=O,8,5,15,20,18,0.00025299999999999997
G4,C(CC(C(C=O)C(C=O)(C)O)O)=O,8,5,16,21,45,0.000241
G4,C(C(C=O)C(C(C)(CC=O)O)O)=O,4,3,14,17,45,0.000145
G4,C(C(C=O)C(CC(C=O)(C)O)O)=O,4,2,11,13,45,9.6e-05
G4,C(C(C=O)C(C=O)(C)O)(O)=O,4,6,13,19,17,0.000299
G4,C(C(C(C=O)C(C=O)(C)O)O)(O)=O,8,7,14,21,45,0.000368
G4,C(C(C(C(C)O)O)C(C=O)(C)O)=O,16,4,15,19,11,0.000192
G4,C(C(C(C(C(O)=O)O)=O)CO)=O,4,7,14,21,17,0.000349
G4,C(C(C=O)C(C(CO)O)=O)(O)=O,4,9,15,24,17,0.000455
G4,C(C(C(C(C(O)=O)O)=O)C(C)O)=O,8,4,12,16,17,0.000194
G4,C(C(C=O)C(C(C(C)O)O)=O)(O)=O,8,4,13,17,17,0.000194
G4,C(CC(C(C(O)=O)C(CO)=O)O)=O,4,8,14,22,17,0.00040599999999999995
G4,C(C(C(CC(CC=O)O)=O)O)(O)=O,4,5,13,18,17,0.000252
G4,C(C(C=O)C(CC(CO)=O)O)(O)=O,4,8,14,22,49,0.000405
G4,C(C(C=O)C(CO)(CC=O)O)(O)=O,4,6,14,20,49,0.0003
G4,C(C(C(C(C=O)O)=O)CO)(O)=O,4,6,13,19,17,0.000302
G4,C(C(C(C(C=O)O)=O)C(C)O)(O)=O,8,4,12,16,4,0.000194
G4,C(CC(C(C(CC(O)=O)=O)O)O)=O,4,5,15,20,17,0.000252
G4,C(C(C=O)C(C(C(C)=O)O)O)(O)=O,8,7,15,22,17,0.00034700000000000003
G4,C(C(C=O)C(C)(C(C=O)O)O)(O)=O,8,7,15,22,17,0.000348
G4,C(C(C(C(CO)O)=O)CO)(O)=O,4,10,13,23,2,0.000518
G4,C(C(C(C(CO)O)=O)C(C)O)(O)=O,8,8,13,21,4,0.00041
G4,C(C(C=O)C(C)(C(CO)O)O)(O)=O,8,6,14,20,17,0.00031
G4,C(C(C(C(CO)CO)=O)O)(O)=O,2,7,9,16,17,0.00036
G4,C(C(CO)C(CCO)O)=O,4,7,16,23,18,0.00036
G4,C(C(CO)C(CO)(CC(C)O)O)=O,8,6,13,19,11,0.000312
G4,C(CO)(C(C(C)O)C(CCO)O)=O,8,6,11,17,11,0.00031099999999999997
G4,C(C(C(CCO)O)O)(CC(C)O)=O,8,4,11,15,11,0.00020299999999999997
G4,C(C(CO)C(C)(C(C(C)O)O)O)=O,16,5,14,19,4,0.00025299999999999997
G4,C(C(C(C)O)O)(CC(CCO)O)=O,8,4,11,15,18,0.000204
G4,C(C(CO)C(CC(C)(CO)O)O)=O,8,6,13,19,18,0.000312
G4,C(C(C(CCO)O)C(C)(CO)O)=O,8,6,13,19,49,0.000309
G4,C(C(CO)C(CC(C)O)O)=O,8,5,14,19,28,0.000254
G4,C(C(C(C)O)C(CCO)O)=O,8,5,14,19,18,0.000252
G4,C(C(CO)C(C(C(C)O)O)O)=O,16,6,16,22,28,0.000312
G4,C(C(CO)C(CC(CO)O)O)=O,8,7,15,22,6,0.000371
G4,C(C(C(CO)O)C(CCO)O)=O,8,7,15,22,18,0.00036899999999999997
G4,C(C(CO)C(C=O)(C(CO)O)O)=O,8,11,17,28,0,0.000595
G4,C(C(CO)C(C=O)(CO)O)=O,4,9,17,26,2,0.000468
G4,C(C(CO)C(C(CO)=O)O)=O,4,14,19,33,2,0.0007030000000000001
G4,C(C(CO)C(C(C)=O)(CO)O)=O,4,10,16,26,25,0.000515
G4,C(C(CO)C(C(CO)=O)(C)O)=O,4,7,15,22,25,0.000348
G4,C(C(C)=O)(C(C(CCO)O)O)=O,4,7,13,20,25,0.000356
G4,C(C(CO)=O)(CC(CCO)O)=O,2,4,11,15,18,0.000202
G4,C(C(CO)C(C(C(C)O)=O)O)=O,8,9,15,24,25,0.000454
G4,C(C(CO)C(C=O)(C(C)O)O)=O,8,8,17,25,4,0.000408
G4,C(C(CO)C(CO)(C(C)O)O)=O,8,7,14,21,25,0.000371
G4,C(C(C(CCO)O)O)(C(C)O)=O,8,5,10,15,25,0.000261
G4,C(C(CO)C(CC=O)O)=O,4,10,26,36,18,0.000492
G4,C(C(C=O)C(CCO)O)=O,2,4,13,17,18,0.000202
G4,C(C(CO)C(CO)(C(C=O)O)O)=O,8,10,17,27,2,0.000526
G4,C(C(C(C(C(CCO)O)O)=O)O)=O,8,6,13,19,5,0.000308
G4,C(C(CO)C(C(CCO)O)O)=O,8,7,15,22,29,0.00036
G4,C(C(CO)C(C(O)=O)(C)O)=O,4,8,14,22,28,0.00041799999999999997
G4,C(C(CC(CCO)O)=O)(O)=O,2,6,11,17,18,0.000308
G4,C(C(C=O)CO)(O)=O,2,11,45,56,18,0.000551
G4,C(C(CO)C(CO)(CC(O)=O)O)=O,4,6,13,19,29,0.000312
G4,C(C(C(CO)=O)C(CCO)O)(O)=O,4,8,11,19,0,0.00041600000000000003
G4,C(CC(C(C(CCO)O)O)=O)(O)=O,4,5,12,17,17,0.000262
G4,C(C(CO)C(C)(C(C(O)=O)O)O)=O,8,7,14,21,33,0.00036
G4,C(C(C(CC(CCO)O)=O)O)(O)=O,4,5,10,15,18,0.000262
G4,C(C(CO)C(C(O)=O)O)=O,4,12,19,31,33,0.00063
G4,C(C(CO)C(C(C(O)=O)O)O)=O,8,8,16,24,18,0.000408
G4,C(C(CO)C(C(CC(O)=O)O)O)=O,8,6,15,21,29,0.000312
G4,C(C(CO)C(C(CC(C)=O)=O)O)=O,4,5,15,20,26,0.000254
G4,C(CC(C=O)(C(C=O)CO)O)(C)=O,4,6,14,20,23,0.000301
G4,C(C(CO)C(C)(CC(C=O)=O)O)=O,4,6,15,21,6,0.000302
G4,C(C)(C(C(C=O)=O)C(CCO)O)=O,4,3,11,14,26,0.000155
G4,C(CC(CCO)O)(CC(C=O)=O)=O,2,2,10,12,18,0.00010700000000000001
G4,C(CC(C=O)(C(C=O)CO)O)=O,4,9,18,27,23,0.00045599999999999997
G4,C(C(C(C=O)=O)C(CCO)O)=O,4,6,17,23,23,0.000297
G4,C(C(CO)C(CC(C(C)=O)=O)O)=O,4,6,14,20,14,0.000301
G4,C(CC(C(C)=O)(C(C=O)CO)O)=O,4,7,14,21,4,0.00035
G4,C(C(CO)C(C(CC=O)=O)(C)O)=O,4,5,15,20,14,0.00025299999999999997
G4,C(C(C(C(C)=O)=O)C(CCO)O)=O,4,3,11,14,14,0.000155
G4,C(CC(C(CC(CCO)O)=O)=O)=O,2,2,11,13,18,0.00010700000000000001
G4,C(C(CO)C(C(C)=O)(C)O)=O,4,6,15,21,14,0.000301
G4,C(C(C)=O)(CC(CCO)O)=O,2,5,13,18,18,0.00024900000000000004
G4,C(C(CO)C(C)(CC=O)O)=O,4,8,19,27,6,0.000397
G4,C(C(CO)C(CC(C)=O)O)=O,4,8,19,27,18,0.000396
G4,C(CC(CC(CCO)O)=O)=O,2,3,15,18,18,0.000154
G4,C(C(C(C)=O)C(CCO)O)=O,4,6,14,20,18,0.000297
G4,C(C(CO)C1(COC(C1)O)O)=O,8,6,13,19,35,0.000301
G4,C1(COC(C1C(CCO)O)O)=O,8,4,11,15,35,0.000202
G4,C1(C(C(CCO)O)OC(C1)O)=O,8,4,9,13,35,0.000202
G4,C(C(CO)C(C=CC(CO)=O)O)=O,8,5,11,16,21,0.000254
G4,C(C(CO)C(C=CC=O)(CO)O)=O,8,5,11,16,11,0.000254
G4,C(C=CC(C(C(CCO)O)O)=O)=O,8,6,16,22,18,0.000308
G4,C(C(CO)C(C(C=C)=O)O)=O,4,8,18,26,7,0.000396
G4,C(C(C=C)(C(C=O)CO)O)=O,4,7,15,22,7,0.000349
G4,C(C(CO)C(C=C)(CO)O)=O,4,8,14,22,7,0.000407
G4,C=CC(C(C(CCO)O)O)=O,4,5,16,21,7,0.00025
G4,C(C(CO)C(C=CC=O)O)=O,8,8,16,24,43,0.000396
G4,C(C(CO)C(C(C)O)O)=O,8,6,17,23,11,0.000301
G4,C(C(CO)C(C(O)=O)(CCO)O)=O,4,7,14,21,7,0.000371
G4,C(C(C(CO)C(CCO)O)=O)(O)=O,4,6,13,19,18,0.000312
G4,C(C(CO)C(CC(C(O)=O)O)O)=O,8,8,15,23,33,0.000429
G4,C(C(C(CCO)O)C(C(O)=O)O)=O,8,8,14,22,33,0.000426
G4,C(C(CO)C(C(CO)(CO)O)O)=O,4,6,11,17,18,0.000312
G4,C(C(CO)C(C(C=O)(CO)O)O)=O,8,9,19,28,18,0.00044800000000000005
G4,C(C(CO)C1(COCC1O)O)=O,8,5,11,16,10,0.000254
G4,C1(C(C(CCO)O)OCC1O)=O,8,3,6,9,10,0.000155
G4,C(C(CO)C1(C(O)OCC1)O)=O,8,6,13,19,34,0.000301
G4,C1(C(O)OCC1C(CCO)O)=O,8,4,9,13,34,0.000202
G4,C(CC(C(C(C(O)=O)CO)=O)O)=O,4,8,13,21,45,0.00040899999999999997
G4,C(C(C=O)C(C(CCO)=O)O)(O)=O,4,8,14,22,17,0.00040599999999999995
G4,C(C(C=O)C(C=O)(CCO)O)(O)=O,4,5,13,18,3,0.000251
G4,C(C(C(C(C(C)O)O)=O)CO)(O)=O,8,8,13,21,2,0.00041
G4,C(C(C(C(CO)C(C)O)=O)O)(O)=O,8,8,13,21,17,0.00041
G4,C(C(C=O)C(CO)(CCO)O)(O)=O,4,7,13,20,3,0.000368
G4,C(C(C=O)C(C(C=O)O)O)(O)=O,8,9,18,27,0,0.000443
G4,C(C(C(CO)=O)C(CO)(C)O)(O)=O,4,8,11,19,49,0.00041600000000000003
G4,C(C(C(CC(CO)(C)O)=O)O)(O)=O,4,5,11,16,49,0.000262
G4,C(CC(C(C(CO)(C)O)O)=O)(O)=O,4,5,12,17,49,0.000262
G4,C(CC(C(C(CO)=O)C(C)O)O)=O,8,7,15,22,4,0.000348
G4,C(CC(C(C(CC(C)O)=O)O)O)=O,8,4,14,18,4,0.000193
G4,C(C(C=O)C(CO)(CC(C)O)O)=O,4,3,10,13,45,0.000155
G4,C(C(C(CO)=O)C(C)O)(O)=O,4,12,12,24,4,0.000596
G4,C(C(C(CC(C)O)=O)O)(O)=O,4,10,13,23,17,0.000489
G4,C(CO)(C(C(C)O)C(C(O)=O)O)=O,8,6,12,18,11,0.00031099999999999997
G4,C(C(C(C(O)=O)O)O)(CC(C)O)=O,8,5,12,17,33,0.000251
G4,C(CO)(C(C(C)O)C(C(C)O)O)=O,16,5,12,17,11,0.000252
G4,C(C(C(C(C)O)O)O)(CC(C)O)=O,16,3,12,15,11,0.000145
G4,C(CC(CC(C(C(C)O)O)=O)O)=O,8,4,14,18,4,0.000194
G4,C(C(C=O)C(C)(C(C(C)O)O)O)=O,8,2,11,13,45,9.6e-05
G4,C(CC(C(C(C)O)O)=O)(O)=O,4,10,15,25,4,0.000489
G4,C(CC(C(O)=O)O)(C(C(C)O)O)=O,8,4,12,16,4,0.000204
G4,C(C(C(C)O)O)(CC(C(C)O)O)=O,16,3,12,15,11,0.000145
G4,C(C(C(CC=O)O)C(C)(CO)O)=O,8,6,15,21,49,0.000299
G4,C(C(C=O)C(CC(C)(CO)O)O)=O,4,3,10,13,45,0.000155
G4,C(C(C=O)C(C)(CO)O)(O)=O,4,7,13,20,49,0.000357
G4,C(C(C(CO)(C)O)C(C(O)=O)O)=O,8,8,14,22,49,0.000426
G4,C(C(C(C(C)O)O)C(C)(CO)O)=O,16,5,14,19,49,0.000251
G4,C(C(C=O)C(C(CC=O)O)O)(O)=O,8,6,18,24,43,0.0003
G4,C(C(C=O)C(CC(C=O)O)O)(O)=O,8,6,16,22,43,0.000298
G4,C(C(C(C)O)C(CC(C)O)O)=O,16,4,14,18,28,0.000193
G4,C(C(C(C)O)C(C(C(C)O)O)O)=O,32,5,15,20,28,0.000252
G4,C(C(C(C)O)C(CC(CO)O)O)=O,16,6,14,20,6,0.00031
G4,C(C(C(CO)O)C(CC(C)O)O)=O,16,6,14,20,6,0.00031
G4,C(C(C(C)O)C(C=O)(CO)O)=O,8,6,17,23,43,0.00029
G4,C(C(C(C)O)C(C(CO)=O)O)=O,8,8,16,24,28,0.000394
G4,C(C(C(C(CC(C)O)O)O)=O)=O,8,4,16,20,5,0.000202
G4,C(C(C(C)O)C(C(C)=O)(CO)O)=O,8,5,14,19,25,0.00024300000000000002
G4,C(C(C(C)O)C(C(CO)=O)(C)O)=O,8,5,14,19,25,0.000241
G4,C(C(C)=O)(C(C(CC(C)O)O)O)=O,8,2,12,14,25,9.6e-05
G4,C(C(CO)=O)(CC(CC(C)O)O)=O,4,2,10,12,25,9.499999999999999e-05
G4,C(C(C(C)O)C(C(C(C)O)=O)O)=O,16,7,14,21,25,0.00034700000000000003
G4,C(C(C(C)O)C(C=O)(C(C)O)O)=O,16,6,15,21,4,0.000301
G4,C(C(C(C)O)C(CO)(C(C)O)O)=O,16,6,13,19,25,0.00031099999999999997
G4,C(C(C(CC(C)O)O)O)(C(C)O)=O,16,3,11,14,25,0.000154
G4,C(C(C(CC=O)O)C(C)O)=O,8,7,19,26,4,0.000337
G4,C(C(C=O)C(CC(C)O)O)=O,4,3,11,14,28,0.000143
G4,C(C(C(C(CCO)O)O)C(C)O)=O,16,5,14,19,29,0.000252
G4,C(C(C(C)O)C(C(O)=O)(C)O)=O,8,7,14,21,28,0.00035800000000000003
G4,C(C(CC(CC(C)O)O)=O)(O)=O,4,2,10,12,28,0.00010700000000000001
G4,C(C(C=O)C(C)O)(O)=O,4,8,23,31,4,0.000395
G4,C(C(C(C)O)C(C(O)=O)O)=O,8,8,15,23,33,0.000417
G4,C(C(C(C(C(O)=O)O)O)C(C)O)=O,16,6,15,21,17,0.0003
G4,C(CC(C=O)(C(C=O)C(C)O)O)=O,8,5,14,19,23,0.000242
G4,C(C(C(C=O)=O)C(CC(C)O)O)=O,8,2,12,14,23,9.6e-05
G4,C(C(C(C)O)C(C(C)=O)(C)O)=O,8,5,14,19,14,0.000241
G4,C(C(C)=O)(CC(CC(C)O)O)=O,4,2,11,13,14,9.499999999999999e-05
G4,C(C(C(C)O)C(C)(CC=O)O)=O,8,7,17,24,6,0.000337
G4,C(C(C(CC(C)=O)O)C(C)O)=O,8,7,16,23,6,0.000336
G4,C(CC(CC(CC(C)O)O)=O)=O,4,2,12,14,28,9.499999999999999e-05
G4,C(C(C(C)=O)C(CC(C)O)O)=O,8,5,13,18,6,0.00023799999999999998
G4,C(C(C(C)O)C1(COC(C1)O)O)=O,16,5,12,17,35,0.000241
G4,C1(COC(C1C(CC(C)O)O)O)=O,16,3,11,14,35,0.000143
G4,C1(C(C(CC(C)O)O)OC(C1)O)=O,16,3,9,12,35,0.000143
G4,C(C(C(C)O)C(C(C=C)=O)O)=O,8,7,17,24,7,0.000336
G4,C(C(C=C)(C(C=O)C(C)O)O)=O,8,6,15,21,7,0.000288
G4,C(C(C(C)O)C(C=C)(CO)O)=O,8,7,14,21,7,0.00034700000000000003
G4,C=CC(C(C(CC(C)O)O)O)=O,8,4,15,19,7,0.00019099999999999998
G4,C(C(C(C)O)C(C=CC=O)O)=O,16,7,16,23,43,0.000336
G4,C(C(C(C)O)C(C(C)O)O)=O,16,4,15,19,11,0.000193
G4,C(C(C(C)O)C1(COCC1O)O)=O,16,4,10,14,10,0.000193
G4,C1(C(C(CC(C)O)O)OCC1O)=O,16,2,7,9,10,9.6e-05
G4,C(C(C(C)O)C1(C(O)OCC1)O)=O,16,5,12,17,34,0.000241
G4,C1(C(O)OCC1C(CC(C)O)O)=O,16,3,9,12,34,0.000143
G4,C(C(C(C(C(CO)O)O)=O)O)(O)=O,8,11,15,26,2,0.0005809999999999999
G4,C(C(C(C=O)=O)C(CO)O)(O)=O,4,8,17,25,0,0.000417
G4,C(C(C(CO)=O)C(CO)O)(O)=O,4,9,12,21,0,0.00046399999999999995
G4,C(C(C(C(C(C(C)O)O)O)O)=O)=O,16,4,17,21,5,0.000202
G4,C(C(C=O)C(C(C(C)O)O)O)=O,8,4,13,17,28,0.000202
G4,C(C(CC(C(C(C)O)O)O)=O)(O)=O,8,3,13,16,28,0.000165
G4,C(C(C)=O)(CC(C(C(C)O)O)O)=O,8,2,12,14,14,0.000106
G4,C(CC(CC(C(C(C)O)O)O)=O)=O,8,2,12,14,6,0.000106
G4,C(C(C(C)=O)C(C(C(C)O)O)O)=O,16,3,13,16,6,0.000154
G4,C=CC(C(C(C(C(C)O)O)O)O)=O,16,3,16,19,7,0.000154
G4,C(C(C(CO)O)C(C=O)(CO)O)=O,8,9,17,26,43,0.00047599999999999997
G4,C(C(C(CO)O)C(C(CO)=O)O)=O,8,11,17,28,0,0.00058
G4,C(C(C(C(CC(CO)O)O)O)=O)=O,8,6,15,21,6,0.000319
G4,C(C(C(CC=O)O)C(CO)O)=O,8,10,19,29,6,0.000512
G4,C(C(C=O)C(CC(CO)O)O)=O,4,5,12,17,6,0.000261
G4,C(C(C(CO)O)C(C(O)=O)(C)O)=O,8,9,15,24,28,0.00048499999999999997
G4,C(C(CC(CC(CO)O)O)=O)(O)=O,4,4,11,15,29,0.00022400000000000002
G4,C(C(C=O)C(CO)O)(O)=O,4,8,16,24,0,0.000417
G4,C(C(C(CO)O)C(C(O)=O)O)=O,8,12,16,28,29,0.00065
G4,C(C(C(CO)O)C(C(C)=O)(C)O)=O,8,6,14,20,14,0.00031
G4,C(C(C)=O)(CC(CC(CO)O)O)=O,4,3,10,13,14,0.000165
G4,C(C(C(CO)O)C(C)(CC=O)O)=O,8,8,16,24,6,0.000417
G4,C(C(C(CC(C)=O)O)C(CO)O)=O,8,7,15,22,6,0.00035800000000000003
G4,C(CC(CC(CC(CO)O)O)=O)=O,4,3,10,13,6,0.000165
G4,C(C(C(C)=O)C(CC(CO)O)O)=O,8,4,12,16,6,0.000213
G4,C(C(C(CO)O)C(C(C=C)=O)O)=O,8,8,16,24,7,0.00041600000000000003
G4,C(C(C=C)(C(C=O)C(CO)O)O)=O,8,6,13,19,7,0.00031
G4,C(C(C(CO)O)C(C=C)(CO)O)=O,8,7,12,19,7,0.00036899999999999997
G4,C=CC(C(C(CC(CO)O)O)O)=O,8,4,15,19,7,0.000213
G4,C(C(C(CO)O)C(C=CC=O)O)=O,16,6,13,19,43,0.00031
G4,C(C(C(CO)O)C(C(C)O)O)=O,16,6,16,22,6,0.00031
G4,C(C(C=O)C(C=O)(C(CO)O)O)=O,4,4,13,17,0,0.00020299999999999997
G4,C(C(C=O)C(C(C(CO)O)=O)O)=O,4,6,14,20,5,0.000301
G4,C(C(CO)(C(C(C=O)=O)O)O)=O,4,7,21,28,1,0.000338
G4,C(CO)(C(C(C(C=O)=O)O)O)=O,4,6,21,27,5,0.00028700000000000004
G4,C(C)(C(CO)(C(C(C=O)=O)O)O)=O,4,6,18,24,1,0.00029
G4,C(CO)(C(C)(C(C(C=O)=O)O)O)=O,4,4,17,21,25,0.00019099999999999998
G4,C(C(CO)(C(C(C(C)=O)=O)O)O)=O,4,6,17,23,25,0.000291
G4,C(CO)(C(C(C(C(C)=O)=O)O)O)=O,4,5,18,23,5,0.000239
G4,C(C(CO)(CC(C(CO)=O)=O)O)=O,2,3,14,17,5,0.000145
G4,C(CO)(C(CC(C(CO)=O)=O)O)=O,2,3,16,19,1,0.000143
G4,C(C(C(C(C=O)=O)O)O)(C(C)O)=O,8,6,17,23,25,0.000297
G4,C(C(C(C)O)(C(C(C=O)=O)O)O)=O,8,7,18,25,1,0.00034700000000000003
G4,C(C(C(C(CO)(C(C)O)O)O)=O)=O,8,6,14,20,25,0.000319
G4,C(C(C(C(C(C)O)=O)O)O)(CO)=O,8,9,16,25,5,0.00045099999999999996
G4,C(C(C=O)C(C=O)(CO)O)=O,2,4,13,17,5,0.000193
G4,C(C(C=O)C(C(CO)=O)O)=O,2,9,15,24,5,0.00042800000000000005
G4,C(C(C(C(C(CCO)O)O)O)=O)=O,8,6,15,21,5,0.000319
G4,C(C(C)(C(C(C=O)=O)O)O)(O)=O,4,6,15,21,5,0.000297
G4,C(C(CO)(CC(C(O)=O)=O)O)=O,2,4,13,17,17,0.000204
G4,C(CO)(C(CC(C(O)=O)=O)O)=O,2,5,12,17,5,0.00024900000000000004
G4,C(C(C(C=O)=O)O)(O)=O,2,15,33,48,17,0.000725
G4,C(C(C(C(C=O)=O)O)O)(O)=O,4,9,19,28,33,0.00044
G4,C(C(C(C(C(C=O)=O)O)O)O)(O)=O,8,5,19,24,5,0.00025
G4,C(CC(C(C(C(C=O)=O)O)O)=O)=O,4,4,20,24,1,0.000192
G4,C(CC(C=O)(C(C(C=O)=O)O)O)=O,4,3,16,19,23,0.000144
G4,C(C=O)(CC(C(C(C=O)=O)O)O)=O,4,3,18,21,23,0.000144
G4,C(C(C(C=O)=O)C(C=O)(CO)O)=O,4,3,13,16,23,0.000145
G4,C(C(C(C=O)=O)C(C(CO)=O)O)=O,4,3,17,20,23,0.000143
G4,C(C)(C(C)(C(C(C=O)=O)O)O)=O,4,3,16,19,14,0.000143
G4,C(CO)(C(CC(C(C)=O)=O)O)=O,2,6,15,21,5,0.000285
G4,C(CC(C)(C(C(C=O)=O)O)O)=O,4,5,19,24,6,0.00023999999999999998
G4,C(C)(CC(C(C(C=O)=O)O)O)=O,4,6,20,26,5,0.000297
G4,C(CC(CC(C(CO)=O)O)=O)=O,2,6,18,24,51,0.000285
G4,C(C(CO)(C(C=O)C(C)=O)O)=O,4,6,16,22,6,0.000288
G4,C(C(C(C)=O)C(C(CO)=O)O)=O,4,8,17,25,5,0.000381
G4,C(C(C(C1(COC(C1)O)O)O)=O)=O,8,3,12,15,35,0.000143
G4,C(C(CO)(C1C(COC1O)=O)O)=O,8,4,15,19,5,0.000193
G4,C1(COC(C1C(C(CO)=O)O)O)=O,8,4,15,19,5,0.00019099999999999998
G4,C(C(CO)(C1C(CC(O1)O)=O)O)=O,8,5,14,19,5,0.000242
G4,C(C(C1C(CC(O1)O)=O)O)(CO)=O,8,4,13,17,5,0.00019099999999999998
G4,C=CC(C(C(C(C=O)=O)O)O)=O,4,7,17,24,5,0.000334
G4,C(C(C=C)(C(C(C=O)=O)O)O)=O,4,5,16,21,1,0.000239
G4,C(C(CO)(C(C(C=O)=O)O)O)=C,4,6,15,21,7,0.000297
G4,C(CO)(C(C(C(C=C)=O)O)O)=O,4,9,16,25,5,0.00044100000000000004
G4,C(C(C(C(C=O)=O)O)O)=CC=O,8,4,17,21,43,0.00019099999999999998
G4,C(C(C(C(C(C)O)O)O)=O)=O,8,10,18,28,11,0.000509
G4,C(C(C(C1(COCC1O)O)O)=O)=O,8,2,10,12,10,9.6e-05
G4,C(C(CO)(C1C(C(CO1)O)=O)O)=O,8,4,12,16,10,0.000195
G4,C(C(C1C(C(CO1)O)=O)O)(CO)=O,8,3,11,14,10,0.000143
G4,C(C(C(C1(C(O)OCC1)O)O)=O)=O,8,3,12,15,34,0.000143
G4,C(C(CO)(C1C(C(O)OC1)=O)O)=O,8,4,12,16,34,0.000193
G4,C(C(C1C(C(O)OC1)=O)O)(CO)=O,8,4,12,16,34,0.00019099999999999998
G4,C(C(C=O)C(C(CO)=O)O)(O)=O,4,8,15,23,28,0.000393
G4,C(C(C(C(CC=O)O)=O)O)(O)=O,4,8,15,23,2,0.000405
G4,C(CC(C(C(C(C)=O)=O)O)O)=O,4,8,18,26,25,0.000393
G4,C(CC(CC(C(CO)=O)=O)O)=O,2,9,16,25,25,0.000429
G4,C(C(C=O)C(C(C)=O)(CO)O)=O,2,6,12,18,45,0.000288
G4,C(C(C=O)C(C(CO)=O)(C)O)=O,2,4,11,15,25,0.00019099999999999998
G4,C(C(C)(C(C(C(C)=O)=O)O)O)(O)=O,4,4,11,15,25,0.000202
G4,C(C(C)(CC(C(CO)=O)=O)O)(O)=O,2,3,10,13,25,0.000154
G4,C(C)(C(CO)(CC(C(O)=O)=O)O)=O,2,3,11,14,29,0.000156
G4,C(CO)(C(C)(CC(C(O)=O)=O)O)=O,2,3,11,14,0,0.000154
G4,C(C(C(C(C)=O)=O)O)(O)=O,2,6,19,25,17,0.000298
G4,C(CC(C(CO)=O)=O)(O)=O,1,5,22,27,17,0.00024900000000000004
G4,C(C(C(C(C(C)=O)=O)O)O)(O)=O,4,7,13,20,33,0.00034500000000000004
G4,C(C(CC(C(CO)=O)=O)O)(O)=O,2,4,11,15,33,0.000202
G4,C(C)(C(C)(C(C(C(C)=O)=O)O)O)=O,4,2,12,14,14,9.6e-05
G4,C(C)(C(C)(CC(C(CO)=O)=O)O)=O,2,2,11,13,14,9.499999999999999e-05
G4,C(C)(C(CO)(CC(C(C)=O)=O)O)=O,2,3,11,14,14,0.000156
G4,C(CO)(C(C)(CC(C(C)=O)=O)O)=O,2,2,12,14,14,9.499999999999999e-05
G4,C(CC(C)(C(C(C(C)=O)=O)O)O)=O,4,3,14,17,25,0.000145
G4,C(CC(C)(CC(C(CO)=O)=O)O)=O,2,3,13,16,26,0.000144
G4,C(C)(CC(C(C(C(C)=O)=O)O)O)=O,4,3,15,18,25,0.000144
G4,C(C)(CC(CC(C(CO)=O)=O)O)=O,2,3,13,16,25,0.000143
G4,C(C)(C(CO)(CC(CC=O)=O)O)=O,2,4,13,17,25,0.00020299999999999997
G4,C(CO)(C(C)(CC(CC=O)=O)O)=O,2,2,13,15,25,9.499999999999999e-05
G4,C(C(C(C)=O)C(C(C)=O)(CO)O)=O,4,3,12,15,25,0.000145
G4,C(C)(C(C=O)C(C(CO)=O)(C)O)=O,4,3,13,16,25,0.000143
G4,C=CC(C(C(C(C(C)=O)=O)O)O)=O,4,4,13,17,25,0.000192
G4,C=CC(C(CC(C(CO)=O)=O)O)=O,2,2,11,13,25,9.499999999999999e-05
G4,C(C(C=C)(C(C(C(C)=O)=O)O)O)=O,4,3,10,13,25,0.000144
G4,C(C(C=C)(CC(C(CO)=O)=O)O)=O,2,2,9,11,25,9.499999999999999e-05
G4,C(C(CO)(C(C(C(C)=O)=O)O)O)=C,4,3,9,12,25,0.000155
G4,C(C(CO)(CC(C(CO)=O)=O)O)=C,2,3,8,11,25,0.000154
G4,C(C)(C(CO)(C(C(C=C)=O)O)O)=O,4,8,15,23,7,0.000408
G4,C(CO)(C(C)(C(C(C=C)=O)O)O)=O,4,5,13,18,25,0.00025
G4,C(C(C(C(C(C)=O)=O)O)O)=CC=O,8,2,12,14,25,9.6e-05
G4,C(C(CC(C(CO)=O)=O)O)=CC=O,4,2,11,13,25,9.499999999999999e-05
G4,C(C(C)=O)(C(C(C(C)O)O)O)=O,8,5,14,19,25,0.00023799999999999998
G4,C(C(CO)=O)(CC(C(C)O)O)=O,4,3,12,15,11,0.000143
G4,C(C(C(O)=O)O)(CC(CO)=O)=O,2,7,11,18,27,0.00034500000000000004
G4,C(C(C(CO)=O)C(CO)=O)(O)=O,1,5,6,11,27,0.00025
G4,C(C(C(C(C(C)=O)O)=O)O)(O)=O,4,6,10,16,0,0.000298
G4,C(CC(C(C(CO)=O)O)=O)(O)=O,2,4,10,14,17,0.000202
G4,C(C(C=O)C(C(C(C)O)=O)O)=O,4,5,11,16,25,0.00024900000000000004
G4,C(C(C=O)C(C=O)(C(C)O)O)=O,4,5,13,18,25,0.000251
G4,C(C(CC(C(O)=O)=O)O)(C(C)O)=O,4,4,11,15,49,0.000213
G4,C(C(C(C)O)(CC(C(O)=O)=O)O)=O,4,4,12,16,17,0.00021400000000000002
G4,C(C(CC(C(C)=O)=O)O)(C(C)O)=O,4,5,11,16,14,0.00024900000000000004
G4,C(CC(C(C(C)O)=O)O)(CC=O)=O,4,4,13,17,9,0.00020099999999999998
G4,C(C)(C(C=O)C(C(C(C)O)=O)O)=O,8,5,12,17,25,0.00024900000000000004
G4,C(C(C(C)O)(C(C=O)C(C)=O)O)=O,8,4,12,16,25,0.00020299999999999997
G4,C(C(C(C(C=C)=O)O)O)(C(C)O)=O,8,7,15,22,25,0.00034500000000000004
G4,C(CC(C(C(C(C)O)=O)O)O)=O,8,7,15,22,25,0.000346
G4,C(C(C=O)C(CO)(C(C)O)O)=O,4,5,11,16,25,0.000261
G4,C(C(C)(C(C(C(C)O)=O)O)O)(O)=O,8,6,11,17,25,0.000308
G4,C(C(CC(CO)(C(C)O)O)=O)(O)=O,4,4,11,15,29,0.00022400000000000002
G4,C(C(C(C(C)O)=O)O)(O)=O,4,5,17,22,17,0.000261
G4,C(C)(C(C)(C(C(C(C)O)=O)O)O)=O,8,3,12,15,25,0.000154
G4,C(C(C)=O)(CC(CO)(C(C)O)O)=O,4,4,10,14,29,0.00022400000000000002
G4,C(CC(C)(C(C(C(C)O)=O)O)O)=O,8,5,13,18,25,0.000251
G4,C(C(C(CC(C)=O)O)O)(C(C)O)=O,8,4,13,17,25,0.000202
G4,C(CC(CC(CO)(C(C)O)O)=O)=O,4,4,11,15,29,0.00022400000000000002
G4,C(C(C(C)=O)C(CO)(C(C)O)O)=O,8,4,11,15,25,0.000213
G4,C(C(C=C)(C(C(C(C)O)=O)O)O)=O,8,4,11,15,7,0.000202
G4,C(C(C(C=C)(CO)O)O)(C(C)O)=O,8,4,8,12,7,0.000213
G4,C=CC(C(C(CO)(C(C)O)O)O)=O,8,5,12,17,7,0.000272
G4,C(C(C(C=CC=O)O)O)(C(C)O)=O,16,4,13,17,25,0.000202
G4,C(C(C(C(C)O)O)O)(C(C)O)=O,16,5,11,16,25,0.00024900000000000004
G4,C(C(C=O)C(CC=O)O)=O,2,5,22,27,45,0.00023999999999999998
G4,C(C(C=O)C(CO)(C(C=O)O)O)=O,4,4,13,17,1,0.000193
G4,C(C(C=O)C(C(C(CO)=O)O)O)=O,4,7,14,21,5,0.00034500000000000004
G4,C(CC(C(C(C(C=O)O)=O)O)O)=O,8,5,19,24,5,0.00024900000000000004
G4,C(C(C=O)C(C(CCO)O)O)=O,4,4,12,16,29,0.000202
G4,C(C(C=O)C(C(O)=O)(C)O)=O,2,5,10,15,28,0.000261
G4,C(C(C=O)C(O)=O)=O,1,11,36,47,17,0.000535
G4,C(C(C=O)C(CO)(CC(O)=O)O)=O,2,3,9,12,45,0.000155
G4,C(C(C=O)C(C)(C(C(O)=O)O)O)=O,4,4,10,14,45,0.000202
G4,C(C(C=O)C(C(O)=O)O)=O,2,7,15,22,33,0.000367
G4,C(C(C=O)C(C(C(O)=O)O)O)=O,4,5,12,17,45,0.00025
G4,C(C(C=O)C(C(CC(O)=O)O)O)=O,4,3,11,14,29,0.000155
G4,C(C(C=O)C(C(CC(C)=O)=O)O)=O,2,2,10,12,26,9.6e-05
G4,C(C(C=O)C(C=O)(CC(C)=O)O)=O,2,3,9,12,26,0.000144
G4,C(C(C=O)C(C)(CC(C=O)=O)O)=O,2,3,10,13,26,0.000144
G4,C(CC(C(C(C)=O)C(C=O)=O)O)=O,4,3,12,15,26,0.000145
G4,C(CC(CC(CC(C=O)=O)=O)O)=O,2,2,16,18,26,9.7e-05
G4,C(C(C=O)C(C(CC=O)=O)O)=O,2,6,15,21,23,0.000286
G4,C(C(C=O)C(C=O)(CC=O)O)=O,2,5,13,18,23,0.00023999999999999998
G4,C(C(C=O)C(CC(C=O)=O)O)=O,2,6,15,21,23,0.000286
G4,C(C(C(C=O)=O)C(CC=O)O)=O,4,7,19,26,23,0.000335
G4,C(C(C=O)C(CC(C(C)=O)=O)O)=O,2,3,9,12,14,0.000144
G4,C(C(C=O)C(C(C)=O)(CC=O)O)=O,2,3,9,12,14,0.000145
G4,C(CC(C(C)(C(C=O)C=O)O)=O)=O,2,2,10,12,14,9.6e-05
G4,C(CC(C(C=O)C(C(C)=O)=O)O)=O,4,3,12,15,14,0.000145
G4,C(CC(C(CC(CC=O)O)=O)=O)=O,2,2,16,18,14,9.7e-05
G4,C(C(C=O)C(C(C)=O)(C)O)=O,2,4,11,15,14,0.00019099999999999998
G4,C(CC(CC(C(C)=O)=O)O)=O,2,8,19,27,14,0.00038199999999999996
G4,C(C(C=O)C(C)(CC=O)O)=O,2,5,15,20,6,0.00023999999999999998
G4,C(C(C=O)C(CC(C)=O)O)=O,2,6,15,21,45,0.000286
G4,C(CC(CC(CC=O)O)=O)=O,2,6,23,29,45,0.00028700000000000004
G4,C(CC(C(C=O)C(C)=O)O)=O,4,7,18,25,6,0.000335
G4,C(C(C=O)C1(COC(C1)O)O)=O,4,4,10,14,35,0.00019099999999999998
G4,C(CC(C1C(COC1O)=O)O)=O,8,4,16,20,35,0.00019099999999999998
G4,C(CC(C1C(CC(O1)O)=O)O)=O,8,4,13,17,35,0.00019099999999999998
G4,C(C(C=O)C(C=CC(CO)=O)O)=O,4,2,8,10,11,9.6e-05
G4,C(C(C=O)C(C=CC=O)(CO)O)=O,4,2,8,10,11,9.6e-05
G4,C(CC(C(C(C=CC=O)=O)O)O)=O,8,3,17,20,45,0.000145
G4,C(C(C=O)C(C(C=C)=O)O)=O,2,5,13,18,7,0.00023799999999999998
G4,C(C(C=O)C(C=O)(C=C)O)=O,2,5,11,16,7,0.00023799999999999998
G4,C(C(C=O)C(C=C)(CO)O)=O,2,6,11,17,7,0.000297
G4,C(CC(C(C(C=C)=O)O)O)=O,4,7,20,27,45,0.000335
G4,C(C(C=O)C(C=CC=O)O)=O,4,5,13,18,43,0.00023799999999999998
G4,C(C(C=O)C(C(C)O)O)=O,4,3,14,17,11,0.000144
G4,C(C(C=O)C(C(O)=O)(CCO)O)=O,2,4,10,14,7,0.000213
G4,C(CC(C(C(C(O)=O)=O)CO)O)=O,4,5,14,19,45,0.000254
G4,C(C(C=O)C(CC(C(O)=O)O)O)=O,4,5,11,16,33,0.000272
G4,C(CC(C(C=O)C(C(O)=O)O)O)=O,8,8,16,24,33,0.00041600000000000003
G4,C(C(C=O)C(C(CO)(CO)O)O)=O,2,3,8,11,45,0.000155
G4,C(C(C=O)C(C(C=O)(CO)O)O)=O,4,6,15,21,1,0.00029
G4,C(C(C=O)C(C(C=CC(C)=O)=O)O)=O,4,2,9,11,45,9.6e-05
G4,C(C(C=O)C(C=O)(C=CC(C)=O)O)=O,4,2,6,8,45,9.6e-05
G4,C(C(C=O)C(C=CC(C=O)=O)(C)O)=O,4,2,6,8,45,9.6e-05
G4,C(CC(CC(C=CC(C=O)=O)=O)O)=O,4,1,15,16,45,4.8e-05
G4,C(C(C=O)C(C(C=CCC=O)=O)O)=O,4,2,8,10,45,9.6e-05
G4,C(C(C=O)C(C=O)(C=CCC=O)O)=O,4,2,6,8,45,9.6e-05
G4,C(C(C=O)C(CC=CC(C=O)=O)O)=O,4,2,6,8,45,9.6e-05
G4,C(C(C=CC(C=O)=O)C(CC=O)O)=O,8,1,9,10,45,4.8e-05
G4,C(C(C=O)C(C=CC(C(C)=O)=O)O)=O,4,2,7,9,45,9.6e-05
G4,C(C(C=O)C(C(C)=O)(C=CC=O)O)=O,4,2,6,8,45,9.6e-05
G4,C(C(C=O)C(C(C=CC=O)=O)(C)O)=O,4,2,7,9,45,9.6e-05
G4,C(CC(CC(C(C=CC=O)=O)=O)O)=O,4,1,16,17,45,4.8e-05
G4,C(C(C=O)C(C=CC(CC=O)=O)O)=O,4,2,7,9,45,9.6e-05
G4,C(C(C=O)C(C=CC=O)(CC=O)O)=O,4,2,8,10,45,9.6e-05
G4,C(C(C=O)C(CC(C=CC=O)=O)O)=O,4,3,11,14,45,0.000144
G4,C(C(C(C=CC=O)=O)C(CC=O)O)=O,8,2,11,13,45,9.6e-05
G4,C(C(C=O)C(C(CC(C=C)=O)=O)O)=O,2,2,10,12,45,9.6e-05
G4,C(C(C=O)C(C=O)(CC(C=C)=O)O)=O,2,2,6,8,45,9.6e-05
G4,C(C(C=O)C(C=C)(CC(C=O)=O)O)=O,2,2,7,9,45,9.6e-05
G4,C(CC(C(C(C=O)=O)C(C=C)=O)O)=O,4,2,10,12,45,9.6e-05
G4,C(C(C=O)C(CC(C(C=C)=O)=O)O)=O,2,2,10,12,45,9.6e-05
G4,C(C(C=O)C(C(C=C)=O)(CC=O)O)=O,2,2,7,9,45,9.6e-05
G4,C(C(C=O)C(C(CC=O)=O)(C=C)O)=O,2,2,7,9,45,9.6e-05
G4,C(C(C(C(C=C)=O)=O)C(CC=O)O)=O,4,2,11,13,45,9.6e-05
G4,C(C(C=O)C(C(CC=CC=O)=O)O)=O,4,2,8,10,45,9.6e-05
G4,C(C(C=O)C(C=O)(CC=CC=O)O)=O,4,2,5,7,27,9.6e-05
G4,C(C(C=O)C(C=CCC(C=O)=O)O)=O,4,2,6,8,27,9.6e-05
G4,C(CC(C(C=CC=O)C(C=O)=O)O)=O,8,1,9,10,27,4.8e-05
G4,C(C(C=O)C1(COCC1O)O)=O,4,3,8,11,10,0.000143
G4,C(CC(C1C(C(CO1)O)=O)O)=O,8,3,11,14,10,0.000143
G4,C(C(C=O)C1(C(O)OCC1)O)=O,4,4,10,14,34,0.00019099999999999998
G4,C(CC(C1C(C(O)OC1)=O)O)=O,8,4,13,17,34,0.00019099999999999998
G4,C(C(C(C(C=O)O)=O)O)(O)=O,4,3,15,18,17,0.000144
G4,C(C(C(C(C(C(O)=O)O)O)=O)O)=O,8,6,17,23,5,0.000297
G4,C(C(C(C(C(C(C)O)O)O)=O)O)=O,16,5,15,20,5,0.00024900000000000004
G4,C(C(CC(C(CCO)O)O)=O)(O)=O,4,3,11,14,29,0.000165
G4,C(C(C)=O)(CC(C(CCO)O)O)=O,4,2,10,12,29,0.00010700000000000001
G4,C(CC(CC(C(CCO)O)O)=O)=O,4,2,11,13,29,0.00010700000000000001
G4,C(C(C(C)=O)C(C(CCO)O)O)=O,8,3,12,15,29,0.000155
G4,C=CC(C(C(C(CCO)O)O)O)=O,8,3,15,18,7,0.000155
G4,C(C(C)(CC(C(O)=O)=O)O)(O)=O,2,4,9,13,29,0.000213
G4,C(CC(C(O)=O)=O)(O)=O,1,6,24,30,17,0.000308
G4,C(C(CC(C(O)=O)=O)O)(O)=O,2,6,11,17,33,0.000308
G4,C(C(C(CC(C(O)=O)=O)O)O)(O)=O,4,4,12,16,29,0.000213
G4,C(CC(C(CC(C(O)=O)=O)O)=O)=O,2,2,12,14,23,0.00010700000000000001
G4,C(CC(C=O)(CC(C(O)=O)=O)O)=O,2,2,10,12,29,0.00010700000000000001
G4,C(C(CC(CC(C=O)=O)O)=O)(O)=O,2,3,11,14,23,0.000155
G4,C(C(C(C=O)=O)C(C(O)=O)(C)O)=O,4,3,11,14,23,0.000154
G4,C(C)(C(C)(CC(C(O)=O)=O)O)=O,2,3,9,12,14,0.000154
G4,C(C(C)(CC(C(C)=O)=O)O)(O)=O,2,4,10,14,28,0.00020099999999999998
G4,C(CC(C)(CC(C(O)=O)=O)O)=O,2,5,12,17,28,0.00025
G4,C(C)(CC(CC(C(O)=O)=O)O)=O,2,5,11,16,28,0.00024900000000000004
G4,C(C(C)(CC(CC=O)=O)O)(O)=O,2,5,12,17,29,0.00026000000000000003
G4,C(C(C)(C(C=O)C(C)=O)O)(O)=O,4,7,12,19,28,0.000356
G4,C(C(CC1(COC(C1)O)O)=O)(O)=O,4,3,9,12,28,0.000154
G4,C(C(C)(C1C(COC1O)=O)O)(O)=O,8,4,11,15,28,0.000202
G4,C(C(C)(C1C(CC(O1)O)=O)O)(O)=O,8,4,9,13,28,0.000202
G4,C=CC(C(CC(C(O)=O)=O)O)=O,2,5,10,15,7,0.00024900000000000004
G4,C(C(C=C)(CC(C(O)=O)=O)O)=O,2,4,10,14,29,0.000202
G4,C(C(CO)(CC(C(O)=O)=O)O)=C,2,5,10,15,29,0.00026000000000000003
G4,C(C(C)(C(C(C=C)=O)O)O)(O)=O,4,6,11,17,7,0.000297
G4,C(C(CC(C(O)=O)=O)O)=CC=O,4,4,11,15,29,0.000202
G4,C(C(CC(C(C)O)O)=O)(O)=O,4,5,12,17,11,0.00024900000000000004
G4,C(C(CC1(COCC1O)O)=O)(O)=O,4,2,7,9,10,0.00010700000000000001
G4,C(C(C)(C1C(C(CO1)O)=O)O)(O)=O,8,3,7,10,10,0.000154
G4,C(C(CC1(C(O)OCC1)O)=O)(O)=O,4,3,9,12,29,0.000154
G4,C(C(C)(C1C(C(O)OC1)=O)O)(O)=O,8,4,9,13,34,0.000202
G4,C(C(C(O)=O)C(CO)=O)(O)=O,1,5,8,13,17,0.00025
G4,C(CC(C(C(O)=O)O)=O)(O)=O,2,6,13,19,17,0.00031
G4,C(C(C(CO)=O)C(C(O)=O)O)(O)=O,4,7,11,18,33,0.000357
G4,C(C(C(CC(C(O)=O)O)=O)O)(O)=O,4,5,11,16,33,0.000262
G4,C(CC(C(C(C(O)=O)O)O)=O)(O)=O,4,6,13,19,33,0.000309
G4,C(C(C(C)=O)C(C=O)=O)(O)=O,2,7,13,20,17,0.00034500000000000004
G4,C(CC(CC(C=O)=O)=O)(O)=O,1,9,17,26,30,0.000439
G4,C(C(C(O)=O)C(C=O)=O)=O,2,9,17,26,17,0.00044
G4,C(C(C(O)=O)C(C(C)=O)=O)=O,2,6,12,18,17,0.000298
G4,C(CC(C(CC(O)=O)=O)=O)=O,1,6,16,22,17,0.000297
G4,C(CC(C(C)=O)=O)(O)=O,1,11,37,48,17,0.000534
G4,C(CC(CC(O)=O)=O)=O,1,10,46,56,17,0.000487
G4,C(C(C(O)=O)C(C)=O)=O,2,11,30,41,17,0.000535
G4,C(C1C(COC1O)=O)(O)=O,4,3,17,20,17,0.000144
G4,C(C1C(CC(O1)O)=O)(O)=O,4,4,20,24,17,0.00019099999999999998
G4,C(C1C(COC(C1O)O)=O)(O)=O,8,5,10,15,17,0.00025
G4,C(C1C(CC(C(O1)O)O)=O)(O)=O,8,5,10,15,27,0.00025
G4,C(C(C(C=CC=O)=O)O)(O)=O,4,10,14,24,17,0.000487
G4,C(C(C(C=C)=O)O)(O)=O,2,12,33,45,17,0.000583
G4,C(C(C(C=O)=O)CC(C=O)O)(O)=O,4,5,13,18,12,0.00024900000000000004
G4,C(C(C(C(C)O)=O)C(C=O)=O)(O)=O,4,4,10,14,24,0.000202
G4,C(C(C=O)C(C(C(C)=O)=O)O)(O)=O,4,5,11,16,25,0.000239
G4,C(CC(C(C(CC=O)O)=O)=O)(O)=O,2,3,11,14,17,0.000154
G4,C(C(C=O)C(C(C(C)O)=O)=O)(O)=O,4,4,10,14,17,0.000202
G4,C(C(C(C(CC(C)=O)=O)=O)O)(O)=O,2,2,11,13,26,9.6e-05
G4,C(C(C(C)=O)C(C(CO)=O)=O)(O)=O,2,4,10,14,26,0.00019099999999999998
G4,C(CC(O)=O)(CC(C(CO)=O)=O)=O,1,4,11,15,17,0.00019099999999999998
G4,C(C(C(C)=O)C(C(C=O)=O)O)(O)=O,4,6,12,18,17,0.00028700000000000004
G4,C(CC(CC(C(C=O)=O)O)=O)(O)=O,2,6,13,19,17,0.000297
G4,C(C(C(C(CCC=O)=O)=O)O)(O)=O,2,2,10,12,17,9.6e-05
G4,C(C(C(C(CO)=O)=O)CC=O)(O)=O,2,2,11,13,17,9.6e-05
G4,C(C(C=O)CC(C(CO)=O)=O)(O)=O,2,2,11,13,17,9.6e-05
G4,C(C(C=O)CC(C(C=O)=O)O)(O)=O,4,3,13,16,17,0.000154
G4,C(C(C(O)=O)O)(CC(C(C)=O)=O)=O,2,2,11,13,24,9.6e-05
G4,C(C(C(CO)=O)C(C(C)=O)=O)(O)=O,2,3,10,13,24,0.000144
G4,C(CC(C(CC(CO)=O)=O)=O)(O)=O,1,2,11,13,17,9.6e-05
G4,C(C(C(C(C=CCO)=O)=O)O)(O)=O,4,2,7,9,55,9.6e-05
G4,C(C(C(C(C=CC=O)O)=O)O)(O)=O,8,3,9,12,32,0.000144
G4,C(C(C(C(C(C=C)=O)O)=O)O)(O)=O,4,2,10,12,17,9.6e-05
G4,C(C(C(C=CC(CO)=O)=O)O)(O)=O,4,3,9,12,32,0.000144
G4,C(C(C(O)=O)O)(CC(CCO)=O)=O,2,5,9,14,30,0.000263
G4,C(CCO)(C(C(O)=O)C(CO)=O)=O,2,6,9,15,30,0.00032
G4,C(C(C(CC(CO)=O)=O)CO)(O)=O,2,8,10,18,17,0.00041900000000000005
G4,C(C(C(CCC(CO)=O)=O)O)(O)=O,2,4,12,16,29,0.00021400000000000002
G4,C(C(C(CO)=O)CC(CO)=O)(O)=O,2,4,13,17,29,0.00022400000000000002
G4,C(C(C(C=O)=O)C(CCO)O)(O)=O,4,6,13,19,17,0.00031
G4,C(C(C(C(CCO)=O)=O)CO)(O)=O,2,7,11,18,2,0.00037200000000000004
G4,C(C(C(C(C(C)=O)O)=O)CO)(O)=O,4,6,10,16,17,0.00031299999999999996
G4,C(CC(C(C(CCO)=O)O)=O)(O)=O,2,4,9,13,29,0.000215
G4,C(C(C=O)C(C(CCO)O)=O)(O)=O,4,5,11,16,17,0.000261
G4,C(C(CO)O)(C(C(O)=O)C(C)=O)=O,4,4,11,15,26,0.00021400000000000002
G4,C(CC(CC(C(CO)O)=O)=O)(O)=O,2,5,11,16,17,0.000265
G4,C(C(CO)O)(C(C(O)=O)CC=O)=O,4,3,15,18,17,0.000166
G4,C(C(C=O)CC(C(CO)O)=O)(O)=O,4,3,15,18,29,0.000166
G4,C(C(C(C(C=O)O)=O)CCO)(O)=O,4,3,12,15,17,0.000166
G4,C(C(C(C(C)=O)=O)C(CO)O)(O)=O,4,6,12,18,17,0.00031099999999999997
G4,C(CC(C(CC(CO)O)=O)=O)(O)=O,2,4,11,15,17,0.00021400000000000002
G4,C(C(C(CC=O)=O)C(CO)O)(O)=O,4,6,13,19,17,0.00031099999999999997
G4,C(C(C=O)C(CC(CO)O)=O)(O)=O,4,5,12,17,44,0.000262
G4,C(CCO)(C(C(O)=O)C(C=O)O)=O,4,5,14,19,17,0.000261
G4,C(CC(C=O)O)(C(C(O)=O)CO)=O,4,7,13,20,17,0.00036
G4,C(C(C(C=CC(CO)O)=O)O)(O)=O,8,4,6,10,29,0.00021400000000000002
G4,C(C(C(C(O)=O)=O)CO)(O)=O,2,6,10,16,17,0.000302
G4,C(C(C=O)C(C(O)=O)O)(O)=O,4,9,13,22,17,0.00047400000000000003
G4,C(C1C(C(C=O)(C(C1)O)O)=O)(O)=O,8,3,15,18,17,0.000143
G4,C(C(C(CC(O)=O)=O)(CO)O)=O,2,5,12,17,17,0.00025299999999999997
G4,C(C(C(CC(O)=O)=O)(C(C)O)O)=O,4,3,11,14,4,0.000146
G4,C(CC(C(CO)(CO)O)=O)(O)=O,1,6,9,15,2,0.000312
G4,C(CC(C(CO)(C(C)O)O)=O)(O)=O,4,7,14,21,4,0.000362
G4,C(C(C(C(CO)(CO)O)=O)O)(O)=O,2,5,10,15,2,0.000254
G4,C1(CC(C(C=O)(C1C(O)=O)O)O)=O,8,5,14,19,17,0.000239
G4,C(C1(C(C(C(O)=O)C(C1)=O)O)O)=O,8,4,15,19,17,0.00019099999999999998
G4,C(C(C=O)C(C=O)(CO)O)(O)=O,4,7,16,23,5,0.000348
G4,C(C(C=O)C(C=O)(C(C)O)O)(O)=O,8,6,14,20,4,0.000299
G4,C1(C(C(O)=O)C(C(C1CO)=O)O)=O,8,3,13,16,2,0.000144
G4,C1(C(C(O)=O)C(C(C1O)=O)CO)=O,8,1,14,15,17,4.8e-05
G4,C1(C(C(O)=O)CC(C1(CO)O)=O)=O,4,1,12,13,17,4.8e-05
G4,C1(C(C(O)=O)C(C(C1)=O)(CO)O)=O,4,4,13,17,17,0.00019099999999999998
G4,C1(C(CO)(CC(C1C(O)=O)=O)O)=O,4,3,13,16,17,0.000144
G4,C1(CC(C(C(CC(O)=O)=O)O1)O)=O,4,1,6,7,17,4.8e-05
G4,C(C(C=O)C1C(CC(O1)=O)O)(O)=O,8,2,7,9,48,9.6e-05
G4,C(C1C(C(C(C(C)=O)O1)O)=O)(O)=O,8,2,8,10,17,9.6e-05
G4,C(CC(C1C(C(CO1)=O)O)=O)(O)=O,4,1,9,10,17,4.8e-05
G4,C(CC1C(C(C(C(O)=O)O1)=O)O)=O,8,2,8,10,9,9.6e-05
G4,C(C(C=O)C1C(C(CO1)=O)O)(O)=O,8,3,9,12,9,0.000144
G4,C(C1C(C(O)OC1C(C)=O)=O)(O)=O,8,3,7,10,22,0.000144
G4,C(CC(C1CC(C(O)O1)=O)=O)(O)=O,4,2,7,9,17,9.6e-05
G4,C(CC1C(C(O)=O)C(C(O)O1)=O)=O,8,3,9,12,23,0.000144
G4,C(C(C=O)C1CC(C(O)O1)=O)(O)=O,8,3,9,12,23,0.000144
G4,C(C1C(C(C(C)=O)OC1O)=O)(O)=O,8,3,7,10,17,0.000144
G4,C(CC(C1C(CC(O1)O)=O)=O)(O)=O,4,2,6,8,17,9.6e-05
G4,C(CC1C(C(C(O)=O)C(O1)O)=O)=O,8,3,10,13,17,0.000144
G4,C(C(C=O)C1C(CC(O1)O)=O)(O)=O,8,3,11,14,17,0.000144
G4,C1(C(C(O)=O)C(CC(CO)O1)=O)=O,4,3,4,7,17,0.000144
G4,C(C1C(CC(OC1CO)=O)=O)(O)=O,4,3,5,8,19,0.000144
G4,C(C1C(C(CO)OC(C1)=O)=O)(O)=O,4,2,6,8,17,9.6e-05
G4,C(C1C(C(CC(CO)O1)=O)=O)(O)=O,4,2,5,7,54,9.6e-05
G4,C(C1C(C(COC1CO)=O)=O)(O)=O,4,2,6,8,54,9.6e-05
G4,C1(C(C(O)=O)OC(C(C1)=O)CO)=O,4,2,6,8,54,9.6e-05
G4,C1(C(CO)OCC(C1C(O)=O)=O)=O,4,2,6,8,17,9.6e-05
G4,C1(C(C(O)=O)C(CC(CO1)O)=O)=O,4,2,6,8,19,9.6e-05
G4,C(C1C(CC(OCC1O)=O)=O)(O)=O,4,2,7,9,17,9.6e-05
G4,C1(C(COC(CC1C(O)=O)=O)O)=O,4,1,6,7,17,4.8e-05
G4,C1(CC(C(C(C(O)=O)CO1)=O)O)=O,4,2,6,8,19,9.6e-05
G4,C1(CC(C(C(O)=O)C(CO1)=O)O)=O,4,2,7,9,17,9.6e-05
G4,C(C1C(CC(CC(O1)=O)O)=O)(O)=O,4,2,6,8,48,9.6e-05
G4,C(C1C(C(CC(CO1)O)=O)=O)(O)=O,4,2,7,9,36,9.6e-05
G4,C(C1C(C(COCC1O)=O)=O)(O)=O,4,2,7,9,17,9.6e-05
G4,C1(C(C(O)=O)OCC(C(C1)=O)O)=O,4,3,6,9,36,0.000144
G4,C1(C(COCC(C1C(O)=O)=O)O)=O,4,3,5,8,36,0.000144
G4,C1(C(C(O)=O)OCCC(C1O)=O)=O,4,2,6,8,36,9.6e-05
G4,C(C1C(C(C(COC1)=O)O)=O)(O)=O,4,2,6,8,36,9.6e-05
G4,C(C1C(C(CC(CO1)=O)O)=O)(O)=O,4,2,7,9,17,9.6e-05
G4,C(C1C(COCC(C1O)=O)=O)(O)=O,4,3,7,10,17,0.000144
G4,C(C1C(CC(C(CO1)=O)O)=O)(O)=O,4,3,7,10,17,0.000144
G4,C1(CCOC(C(C1C(O)=O)=O)O)=O,4,3,6,9,30,0.000144
G4,C(C1C(CC(C(O)OC1)=O)=O)(O)=O,4,3,7,10,30,0.000144
G4,C(C1C(C(O)OCC(C1)=O)=O)(O)=O,4,2,6,8,12,9.6e-05
G4,C(C1C(COC(C(C1)=O)O)=O)(O)=O,4,2,6,8,17,9.6e-05
G4,C(C1C(CCC(C(O1)O)=O)=O)(O)=O,4,3,5,8,12,0.000144
G4,C(C1C(C(CCOC1O)=O)=O)(O)=O,4,3,8,11,17,0.000144
G4,C(C1C(C(CC(O)OC1)=O)=O)(O)=O,4,3,8,11,17,0.000144
G4,C(C1C(CC(COC1O)=O)=O)(O)=O,4,3,7,10,17,0.000144
G4,C1(CC(OCC(C1C(O)=O)=O)O)=O,4,3,6,9,38,0.000144
G4,C1(C(C(O)=O)OC(CC(C1)=O)O)=O,4,3,6,9,38,0.000144
G4,C(CC(C=CC(C=O)=O)=O)(O)=O,2,3,13,16,17,0.000143
G4,C(C(C(O)=O)C=CC(C=O)=O)=O,4,3,13,16,17,0.000143
G4,C(CC(C(C=CC=O)=O)=O)(O)=O,2,4,12,16,17,0.00019099999999999998
G4,C(C(C(O)=O)C(C=CC=O)=O)=O,4,6,11,17,45,0.000286
G4,C(C(C(C=O)=O)C(C=C)=O)(O)=O,2,5,11,16,17,0.000239
G4,C(C(C(O)=O)C(C(C=C)=O)=O)=O,2,5,10,15,17,0.000239
G4,C(C(C=CC=O)C(C=O)=O)(O)=O,4,3,13,16,17,0.000143
G4,C(C1C(C(CO1)O)=O)(O)=O,4,2,17,19,17,9.7e-05
G4,C(C1C(C(O)OC1)=O)(O)=O,4,3,13,16,17,0.000144
G4,C(C(C=O)C1C(C(CO1)O)=O)(O)=O,8,3,9,12,9,0.000144
G4,C(C(C=O)C1(C(CCO1)=O)O)(O)=O,4,3,10,13,17,0.000144
G4,C(CC1(C(C(C(O)=O)CO1)=O)O)=O,4,3,9,12,17,0.000144
G4,C(C(C=O)C1(CC(CO1)=O)O)(O)=O,4,3,12,15,48,0.000144
G4,C(CC1(C(C(O)=O)C(CO1)=O)O)=O,4,3,12,15,48,0.000144
G4,C(C1C(CC(CC=O)(O1)O)=O)(O)=O,4,3,11,14,48,0.000144
G4,C(C1C(C(C=O)OC1(C)O)=O)(O)=O,8,3,9,12,17,0.000144
G4,C1(C(C)(OC(C=O)C1C(O)=O)O)=O,8,3,7,10,14,0.000144
G4,C1(CCOC(C=O)(C1C(O)=O)O)=O,4,3,10,13,30,0.000144
G4,C1(CC(C=O)(O)OCC1C(O)=O)=O,4,3,9,12,30,0.000144
G4,C(C1(CC(C(O)=O)C(CO1)=O)O)=O,4,2,8,10,17,9.6e-05
G4,C1(CCC(C=O)(OC1C(O)=O)O)=O,4,3,7,10,12,0.000144
G4,C(C1C(C(C=O)OC(C1)O)=O)(O)=O,8,2,8,10,17,9.6e-05
G4,C1(CC(OC(C=O)C1C(O)=O)O)=O,8,3,10,13,37,0.000144
G4,C1(CC(C=O)OC(C1C(O)=O)O)=O,8,3,9,12,17,0.000144
G4,C(C1C(C=CC(C(O1)O)O)=O)(O)=O,8,2,4,6,2,9.6e-05
G4,C(C(C(CO)=O)C(C(C)O)O)(O)=O,8,6,12,18,0,0.000298
G4,C(CC(C(C(C(C)O)O)O)=O)(O)=O,8,4,14,18,0,0.00020299999999999997
G4,C(C(C(CC(C(C)O)O)=O)O)(O)=O,8,4,12,16,11,0.00020299999999999997
G4,C(C(C(C(C)=O)C(C=O)=O)O)(O)=O,4,3,10,13,26,0.000154
G4,C(C(CC(CC(C=O)=O)=O)O)(O)=O,2,2,12,14,33,0.00010700000000000001
G4,C(C(C(C=O)=O)C(C(O)=O)O)=O,4,6,16,22,33,0.000297
G4,C(C(C(C(C)=O)=O)C(C(O)=O)O)=O,4,3,10,13,14,0.000154
G4,C(CC(C(CC(C(O)=O)O)=O)=O)=O,2,2,11,13,33,0.00010700000000000001
G4,C(C(C(C)=O)C(C(O)=O)O)=O,4,8,14,22,33,0.000414
G4,C1(COC(C1C(C(O)=O)O)O)=O,8,4,11,15,33,0.000202
G4,C(C(C1C(CC(O1)O)=O)O)(O)=O,8,5,9,14,33,0.00024900000000000004
G4,C(C(C(C(C=CC=O)=O)O)O)(O)=O,8,6,14,20,33,0.000308
G4,C(C(C(C(C(O)=O)=O)CO)O)(O)=O,4,6,13,19,33,0.000312
G4,C(C(C(C=O)C(C(O)=O)O)O)(O)=O,3,5,8,13,33,0.000271
G4,C(C(C1C(C(CO1)O)=O)O)(O)=O,8,3,6,9,10,0.000154
G4,C1(C(O)OCC1C(C(O)=O)O)=O,8,4,9,13,34,0.000202
G4,C(C(C(CC(C(C)=O)=O)O)O)(O)=O,4,3,13,16,14,0.000154
G4,C(CC(C(C(O)=O)O)O)(CC=O)=O,4,3,13,16,9,0.000154
G4,C(C(C(C(C=O)C(C)=O)O)O)(O)=O,8,4,12,16,6,0.000202
G4,C(C(C(C(C(C=C)=O)O)O)O)(O)=O,8,7,14,21,7,0.00037799999999999997
G4,C(C)(C(C(C=O)=O)C(C(C=C)=O)O)=O,4,2,9,11,7,9.6e-05
G4,C(CC(C(C=C)=O)O)(CC(C=O)=O)=O,2,1,13,14,7,4.8e-05
G4,C(C(C=C)(C(C(C)=O)C(C=O)=O)O)=O,4,2,6,8,7,9.6e-05
G4,C(C(C=C)(CC(CC(C=O)=O)=O)O)=O,2,1,8,9,7,4.8e-05
G4,C(C)(C(C(C=O)=O)C(C=CC=O)O)=O,8,2,8,10,43,9.6e-05
G4,C(CC(C=CC=O)O)(CC(C=O)=O)=O,4,1,11,12,43,4.8e-05
G4,C(C)(C(C(C=O)=O)C(C(C)O)O)=O,8,2,12,14,26,9.6e-05
G4,C(CC(C(C)O)O)(CC(C=O)=O)=O,4,1,12,13,11,4.8e-05
G4,C(C(C(C=O)=O)C(C(C)=O)(C)O)=O,4,2,10,12,14,9.6e-05
G4,C(CC(C(CC(C(C)=O)=O)O)=O)=O,2,1,14,15,14,4.8e-05
G4,C(CC(C=O)(CC(C(C)=O)=O)O)=O,2,2,11,13,14,9.7e-05
G4,C(C=O)(CC(CC(C(C)=O)=O)O)=O,2,2,13,15,14,9.6e-05
G4,C(C(C(C=O)=O)C(C)(CC=O)O)=O,4,3,12,15,23,0.000145
G4,C(C(C(C=O)=O)C(CC(C)=O)O)=O,4,3,13,16,23,0.000144
G4,C(CC(CC(C(CC=O)=O)O)=O)=O,2,1,18,19,23,4.8e-05
G4,C(CC(CC(C=O)(CC=O)O)=O)=O,2,2,14,16,26,9.7e-05
G4,C(CC(CC(CC(C=O)=O)O)=O)=O,2,2,16,18,23,9.6e-05
G4,C(C(C(C)=O)C(C(CC=O)=O)O)=O,4,2,14,16,23,9.6e-05
G4,C(C(C(C)=O)C(C=O)(CC=O)O)=O,4,3,10,13,23,0.000145
G4,C(C(C(C)=O)C(CC(C=O)=O)O)=O,4,3,11,14,23,0.000144
G4,C(C(C(C=O)=O)C(C(C=C)=O)O)=O,4,2,8,10,23,9.6e-05
G4,C(C(C(C=O)=O)C(C=O)(C=C)O)=O,4,2,7,9,23,9.6e-05
G4,C(C(C(C=O)=O)C(C=C)(CO)O)=O,4,3,10,13,23,0.000155
G4,C(CC(C(C(C(C=C)=O)O)O)=O)=O,4,5,17,22,23,0.000239
G4,C(CC(C=O)(C(C(C=C)=O)O)O)=O,4,4,12,16,23,0.000193
G4,C=CC(C(C(CC(C=O)=O)O)O)=O,4,3,15,18,23,0.000144
G4,C(C(C(C=O)=O)C(C=CC=O)O)=O,8,2,8,10,23,9.6e-05
G4,C(C(C(C=O)=O)C(C(C)O)O)=O,8,5,18,23,23,0.00023799999999999998
G4,C(C(C(C(C)=O)=O)C(C(C=C)=O)O)=O,4,2,9,11,14,9.6e-05
G4,C(CC(C(CC(C(C=C)=O)O)=O)=O)=O,2,1,12,13,14,4.8e-05
G4,C(C(C(C(C)=O)=O)C(C=O)(C=C)O)=O,4,2,6,8,14,9.6e-05
G4,C(C(C=C)(CC(C(CC=O)=O)=O)O)=O,2,1,8,9,14,4.8e-05
G4,C(C(C(C(C)=O)=O)C(C=CC=O)O)=O,8,2,8,10,14,9.6e-05
G4,C(CC(C(CC(C=CC=O)O)=O)=O)=O,4,1,11,12,14,4.8e-05
G4,C(C(C(C(C)=O)=O)C(C(C)O)O)=O,8,2,12,14,14,9.6e-05
G4,C(CC(C(CC(C(C)O)O)=O)=O)=O,4,1,12,13,11,4.8e-05
G4,C(C)(C(C)(CC(C(C)=O)=O)O)=O,2,3,11,14,14,0.000143
G4,C(CC(C)(CC(C(C)=O)=O)O)=O,2,5,15,20,14,0.000239
G4,C(C)(CC(CC(C(C)=O)=O)O)=O,2,5,15,20,14,0.00023799999999999998
G4,C(C)(C(C)(CC(CC=O)=O)O)=O,2,3,14,17,14,0.000143
G4,C(C(C(C)=O)C(C(C)=O)(C)O)=O,4,6,13,19,14,0.000286
G4,C(C(C)=O)(CC1(COC(C1)O)O)=O,4,2,8,10,14,9.499999999999999e-05
G4,C(C)(C(C)(C1C(COC1O)=O)O)=O,8,3,12,15,14,0.000143
G4,C(C)(C(C)(C1C(CC(O1)O)=O)O)=O,8,3,10,13,14,0.000143
G4,C=CC(C(CC(C(C)=O)=O)O)=O,2,5,12,17,14,0.00023799999999999998
G4,C(C(C=C)(CC(C(C)=O)=O)O)=O,2,4,11,15,14,0.00018999999999999998
G4,C(C(CO)(CC(C(C)=O)=O)O)=C,2,5,11,16,14,0.00024900000000000004
G4,C(C)(C(C)(C(C(C=C)=O)O)O)=O,4,5,13,18,14,0.00023799999999999998
G4,C(C(CC(C(C)=O)=O)O)=CC=O,4,4,14,18,21,0.00018999999999999998
G4,C(C(C)=O)(CC(C(C)O)O)=O,4,3,14,17,11,0.000143
G4,C(C(C)=O)(CC1(COCC1O)O)=O,4,1,6,7,10,4.8e-05
G4,C(C)(C(C)(C1C(C(CO1)O)=O)O)=O,8,2,8,10,10,9.6e-05
G4,C(C(C)=O)(CC1(C(O)OCC1)O)=O,4,2,8,10,14,9.499999999999999e-05
G4,C(C)(C(C)(C1C(C(O)OC1)=O)O)=O,8,3,9,12,34,0.000143
G4,C(CC(CC(C)(CC=O)O)=O)=O,2,5,18,23,6,0.000239
G4,C(CC(C)(C(C=O)C(C)=O)O)=O,4,7,15,22,6,0.000335
G4,C(CC(CC(C)=O)O)(CC=O)=O,2,5,18,23,6,0.00023799999999999998
G4,C(C(C(C)=O)C(CC(C)=O)O)=O,4,8,15,23,6,0.000381
G4,C(CC(CC1(COC(C1)O)O)=O)=O,4,2,8,10,35,9.499999999999999e-05
G4,C(C(C(C)=O)C1(COC(C1)O)O)=O,8,3,9,12,35,0.000143
G4,C(CC(C)(C1C(COC1O)=O)O)=O,8,3,14,17,35,0.000143
G4,C(C)(CC(C1C(COC1O)=O)O)=O,8,3,13,16,6,0.000143
G4,C(CC(C)(C1C(CC(O1)O)=O)O)=O,8,4,11,15,6,0.000192
G4,C1(C(C(CC(C)=O)O)OC(C1)O)=O,8,3,10,13,35,0.000143
G4,C(CC(CC(C(C=C)=O)O)=O)=O,2,6,16,22,7,0.000285
G4,C(C(C(C)=O)C(C(C=C)=O)O)=O,4,7,14,21,7,0.000333
G4,C(C(C=C)(CC(CC=O)=O)O)=O,2,4,14,18,29,0.00018999999999999998
G4,C(C(C(C)=O)C(C=O)(C=C)O)=O,4,7,13,20,7,0.000333
G4,C(CC(CC(C=C)(CO)O)=O)=O,2,5,13,18,29,0.00024900000000000004
G4,C(C(C(C)=O)C(C=C)(CO)O)=O,4,8,13,21,7,0.000392
G4,C(CC(C)(C(C(C=C)=O)O)O)=O,4,6,15,21,7,0.00028700000000000004
G4,C(C)(CC(C(C(C=C)=O)O)O)=O,4,7,16,23,7,0.000334
G4,C(CC(CC(C=CC=O)O)=O)=O,4,5,17,22,29,0.00023799999999999998
G4,C(C(C(C)=O)C(C=CC=O)O)=O,8,7,15,22,43,0.000333
G4,C(CC(CC(C(C)O)O)=O)=O,4,2,17,19,11,9.6e-05
G4,C(C(C(C)=O)C(C(C)O)O)=O,8,5,15,20,11,0.00023799999999999998
G4,C(CC(CC1(COCC1O)O)=O)=O,4,1,7,8,10,4.8e-05
G4,C(C(C(C)=O)C1(COCC1O)O)=O,8,2,7,9,10,9.6e-05
G4,C(CC(C)(C1C(C(CO1)O)=O)O)=O,8,4,10,14,10,0.000192
G4,C1(C(C(CC(C)=O)O)OCC1O)=O,8,2,9,11,10,9.6e-05
G4,C(CC(CC1(C(O)OCC1)O)=O)=O,4,2,9,11,34,9.499999999999999e-05
G4,C(C(C(C)=O)C1(C(O)OCC1)O)=O,8,3,9,12,34,0.000143
G4,C(CC(C)(C1C(C(O)OC1)=O)O)=O,8,3,11,14,34,0.000143
G4,C(C)(CC(C1C(C(O)OC1)=O)O)=O,8,3,10,13,34,0.000143
G4,C1(COC(C1C(C(C=C)=O)O)O)=O,8,3,14,17,7,0.000143
G4,C1(C(C(C(C=C)=O)O)OC(C1)O)=O,8,3,12,15,7,0.000143
G4,C(C(C=C)(C1C(COC1O)=O)O)=O,8,3,11,14,7,0.000143
G4,C(C(C=C)(C1C(CC(O1)O)=O)O)=O,8,3,9,12,7,0.000143
G4,C1(COC(C1C(C=C)(CO)O)O)=O,8,4,9,13,7,0.000202
G4,C1(C(C(C=C)(CO)O)OC(C1)O)=O,8,4,7,11,35,0.000202
G4,C=CC(C(C1(COC(C1)O)O)O)=O,8,3,11,14,7,0.000143
G4,C1(COC(C1C(C=CC=O)O)O)=O,16,3,12,15,43,0.000143
G4,C1(C(C(C=CC=O)O)OC(C1)O)=O,16,3,12,15,35,0.000143
G4,C1(COC(C1C(C(C)O)O)O)=O,16,3,12,15,35,0.000143
G4,C1(C(C(C(C)O)O)OC(C1)O)=O,16,3,10,13,35,0.000143
G4,C=CC(C(C(C(C=CC=O)=O)O)O)=O,8,4,14,18,7,0.00019099999999999998
G4,C(C(C=C)(C(C(C=CC=O)=O)O)O)=O,8,3,8,11,7,0.000144
G4,C(C(C(C(C=CC=O)=O)O)O)=CC=O,16,2,10,12,43,9.6e-05
G4,C(C=CC(C(C(C(C)O)O)O)=O)=O,16,4,17,21,11,0.000202
G4,C=CC(C(C(C(C=C)=O)O)O)=O,3,4,7,11,7,0.00019099999999999998
G4,C(C(C=C)(C(C(C=C)=O)O)O)=O,4,7,12,19,7,0.000334
G4,C1(C(C(C(C=C)=O)O)OCC1O)=O,8,2,10,12,10,9.6e-05
G4,C(C(C=C)(C1C(C(CO1)O)=O)O)=O,8,2,7,9,10,9.6e-05
G4,C1(C(O)OCC1C(C(C=C)=O)O)=O,8,3,11,14,7,0.000143
G4,C(C(C=C)(C1C(C(O)OC1)=O)O)=O,8,3,8,11,34,0.000143
G4,C(C(CO)(C(C(C=C)=O)O)O)=C,4,7,11,18,7,0.00034500000000000004
G4,C=CC(C(C(C=CC=O)O)O)=O,8,6,14,20,43,0.000286
G4,C=CC(C(C(C(C)O)O)O)=O,8,4,17,21,11,0.00019099999999999998
G4,C=CC(C(C1(COCC1O)O)O)=O,8,2,9,11,10,9.6e-05
G4,C1(C(C(C=C)(CO)O)OCC1O)=O,8,3,5,8,10,0.000155
G4,C=CC(C(C1(C(O)OCC1)O)O)=O,8,3,11,14,7,0.000143
G4,C1(C(O)OCC1C(C=C)(CO)O)=O,8,4,7,11,34,0.000202
G4,C1(C(C(C=CC=O)O)OCC1O)=O,16,2,10,12,10,9.6e-05
G4,C1(C(O)OCC1C(C=CC=O)O)=O,16,3,9,12,34,0.000143
G4,C(C(C(CO)C(C(C)O)O)=O)(O)=O,8,5,14,19,11,0.00025299999999999997
G4,C(C(C(C(C)O)O)C(C(O)=O)O)=O,16,7,15,22,33,0.000367
G4,C1(C(C(C(C)O)O)OCC1O)=O,16,2,7,9,10,9.6e-05
G4,C1(C(O)OCC1C(C(C)O)O)=O,16,3,10,13,34,0.000143
G4,C(C(C1(C(C(C(C1)O)O)O)O)O)=O,32,3,17,20,0,0.000155
G4,C(C(C(CO)(C(C(C)O)O)O)O)=O,16,6,13,19,0,0.00032
G4,C(C(C(CO)O)O)(C(C(C)O)O)=O,16,11,14,25,2,0.000582
G4,C(C(C(CC(CO)(CO)O)O)O)=O,4,6,11,17,5,0.00032
G4,C(C(C(CO)O)C(CO)(CO)O)=O,4,8,12,20,5,0.00042699999999999997
G4,C(C(C(CC(C(CO)O)O)O)O)=O,16,9,14,23,41,0.000496
G4,C(C(C(CO)O)C(C(CO)O)O)=O,16,12,16,28,41,0.000661
G4,C(C(CC(C=O)(C(C=O)O)O)O)=O,8,8,19,27,0,0.000393
G4,C(C(C(C(C=O)=O)C(CO)O)O)=O,8,6,17,23,0,0.00031
G4,C(C(CC(C)O)(C(C=O)O)O)=O,8,3,15,18,0,0.000145
G4,C(C(C(C(CO)O)C(C)O)=O)=O,8,7,18,25,0,0.000359
G4,C(CC(C(C)(C(C=O)O)O)O)=O,8,5,20,25,0,0.000241
G4,C(C(C(CC(C(C)=O)O)O)O)=O,8,7,18,25,0,0.000367
G4,C(CC(C(CC(CO)O)=O)O)=O,4,6,15,21,0,0.000309
G4,C(C(C(CO)O)C(C(C)=O)O)=O,8,10,17,27,45,0.000522
G4,C(C(C)(CC(C(C=O)O)O)O)=O,8,8,17,25,16,0.000404
G4,C(C(C(CO)O)C(C=O)(C)O)=O,8,8,17,25,29,0.00041600000000000003
G4,C(CC(C(CO)O)(C(C=O)O)O)=O,8,6,16,22,0,0.00031
G4,C(C(C(C(CO)O)=O)C(CO)O)=O,8,10,15,25,0,0.000536
G4,C(C(C(CCO)(C(C=O)O)O)O)=O,3,2,9,11,27,9.7e-05
G4,C(C(C(C(CO)O)(CCO)O)O)=O,8,5,13,18,0,0.000273
G4,C(C(C(CO)CO)(C(C=O)O)O)=O,4,6,12,18,2,0.000321
G4,C(C(C(CO)(C(CO)CO)O)O)=O,4,4,10,14,2,0.00021400000000000002
G4,C(C(C(C(CO)C(C=O)O)O)O)=O,16,12,19,31,43,0.000627
G4,C(C(C(CCO)O)O)=O,4,23,32,55,0,0.0011380000000000001
G4,C(C(CO)C(CO)O)=O,4,13,27,40,6,0.000668
G4,C(CC(C(C(C(C=O)O)O)O)O)=O,16,10,22,32,0,0.000544
G4,C(C(C(CC(C(C=O)O)O)O)O)=O,10,5,11,16,0,0.000261
G4,C(C(C(C(C=O)O)O)C(CO)O)=O,16,12,19,31,0,0.00063
G4,C(C(C(CO)(CC(C)O)O)O)=O,8,3,12,15,0,0.000156
G4,C(CO)(C(C(CO)O)C(C)O)=O,8,7,12,19,0,0.00037
G4,C(C(C(CO)O)O)(CC(C)O)=O,8,5,12,17,0,0.000263
G4,C(C(C(C)(C(C(C)O)O)O)O)=O,16,3,13,16,0,0.000144
G4,C(C(C(C)O)O)(CC(CO)O)=O,8,4,12,16,0,0.000205
G4,C(C(C(CC(CO)(C)O)O)O)=O,8,5,13,18,49,0.000262
G4,C(C(C(CO)O)C(C)(CO)O)=O,8,8,15,23,49,0.00041600000000000003
G4,C(C(C(CC(C)O)O)O)=O,8,12,18,30,28,0.000594
G4,C(C(C(CO)O)C(C)O)=O,8,8,17,25,6,0.00041799999999999997
G4,C(C(C)(C(C(C(C=O)O)O)O)O)=O,16,12,19,31,16,0.000627
G4,C(C(CC(CO)O)(C(C=O)O)O)=O,8,7,16,23,0,0.000379
G4,C(C(C(C(CO)O)C(CO)O)=O)=O,3,4,9,13,0,0.00021400000000000002
G4,C(C(C(C(C(CO)(C)O)O)O)O)=O,16,6,14,20,49,0.00032
G4,C(C(C(CO)(CC(CO)O)O)O)=O,8,5,13,18,0,0.000262
G4,C(CO)(C(C(CO)O)C(CO)O)=O,3,5,7,12,0,0.000273
G4,C(C(C(CO)O)O)(CC(CO)O)=O,8,11,13,24,0,0.000603
G4,C(C(C(C)(C(C(CO)O)O)O)O)=O,16,7,14,21,0,0.000379
G4,C(C(C(C(C(C)O)O)O)O)=O,16,11,16,27,28,0.000579
G4,C(C(C(CO)O)C(CO)O)=O,3,6,10,16,6,0.00032
G4,C(C(C(C(CO)O)O)=O)=O,4,13,23,36,0,0.000653
G4,C(C(C(CC(C(CO)=O)O)O)O)=O,8,10,18,28,0,0.000532
G4,C(CC(C(CO)(C(C=O)O)O)O)=O,8,11,19,30,2,0.0005809999999999999
G4,C(CC(C(C(C(CO)O)O)=O)O)=O,8,10,16,26,0,0.000533
G4,C(CO)(C(C)(C(C=O)O)O)=O,4,13,17,30,0,0.000642
G4,C(C(C(CO)(CC(CO)=O)O)O)=O,4,11,15,26,12,0.0005690000000000001
G4,C(C(C(CO)O)O)(CC(CO)=O)=O,4,9,13,22,0,0.00048499999999999997
G4,C(CO)(C(C(CO)=O)C(CO)O)=O,2,4,8,12,0,0.00020299999999999997
G4,C(C(C(CO)(C(C(C)=O)O)O)O)=O,8,11,15,26,0,0.00057
G4,C(C(C(CO)O)O)(C(C(C)=O)O)=O,8,7,13,20,0,0.000368
G4,C(CC(CO)O)(C(C(CO)=O)O)=O,4,6,11,17,0,0.000319
G4,C(C(C(CO)(C(C)O)O)O)=O,8,10,13,23,25,0.000521
G4,C(C(C=O)C(CO)O)=O,2,10,23,33,0,0.0005099999999999999
G4,C(C(C(CO)(C(C=O)O)O)O)=O,3,6,9,15,5,0.00032
G4,C(C(C)(C(C=O)O)O)(O)=O,4,14,17,31,28,0.0006889999999999999
G4,C(C(CC(CO)O)=O)(O)=O,2,7,16,23,0,0.000367
G4,C(CC(CO)(C(C=O)O)O)(O)=O,4,4,12,16,0,0.00021400000000000002
G4,C(C(C(C(CC(C)=O)=O)O)O)=O,4,13,20,33,26,0.000642
G4,C(C(C(C=O)(CC(C)=O)O)O)=O,4,7,17,24,0,0.000346
G4,C(C)(C(C(C=O)=O)C(CO)O)=O,4,5,17,22,0,0.000251
G4,C(CC(CO)O)(CC(C=O)=O)=O,2,7,17,24,0,0.000367
G4,C(C(C(C=O)=O)C(CO)O)=O,4,8,18,26,0,0.00041500000000000006
G4,C(C(C(CC(C(C)=O)=O)O)O)=O,4,9,18,27,14,0.000463
G4,C(CC(C(C)=O)(C(C=O)O)O)=O,4,6,17,23,0,0.00028900000000000003
G4,C(C(C)(C(C=O)O)O)(CC=O)=O,4,6,19,25,0,0.000298
G4,C(C(C(C(C)=O)=O)C(CO)O)=O,4,9,16,25,14,0.000462
G4,C(CC(C(CC(CO)O)=O)=O)=O,2,6,16,22,0,0.000308
G4,C(C)(C(C)(C(C=O)O)O)=O,4,10,22,32,14,0.00047699999999999994
G4,C(C(C(CC(C)=O)O)O)=O,4,14,30,44,0,0.000678
G4,C(C(C(C)=O)C(CO)O)=O,4,10,20,30,0,0.0005099999999999999
G4,C(C(C1(COC(C1)O)O)O)=O,8,6,12,18,35,0.00028700000000000004
G4,C1(COC(C1C(CO)O)O)=O,8,5,14,19,0,0.000251
G4,C(C(C1(COC(C(C1)O)O)O)O)=O,16,4,12,16,27,0.000192
G4,C1(COC(C(C1C(CO)O)O)O)=O,16,4,12,16,0,0.00020299999999999997
G4,C1(C(C(CO)O)OC(C(C1)O)O)=O,16,4,10,14,0,0.00020299999999999997
G4,C(C(C(C=CC(CO)=O)O)O)=O,8,7,14,21,11,0.000357
G4,C(C(C(C=CC=O)(CO)O)O)=O,8,6,14,20,11,0.000298
G4,C(C=CC(C(C(CO)O)O)=O)=O,8,7,17,24,0,0.000357
G4,C(C(C=C)(C(C=O)O)O)=O,4,12,20,32,7,0.000572
G4,C(C(C(C=C)(CO)O)O)=O,4,15,17,32,7,0.0007469999999999999
G4,C(C(C(C(CC(C=O)O)O)O)O)=O,16,6,20,26,0,0.000309
G4,C(C(C(C(C(C(C)O)=O)O)O)O)=O,16,11,17,28,0,0.0005690000000000001
G4,C(C(C(C(C)O)(C(C=O)O)O)O)=O,6,4,9,13,0,0.00020299999999999997
G4,C(C(C(C(C)O)O)O)=O,8,23,33,56,11,0.0011380000000000001
G4,C(C(CCO)(C(C=O)O)O)(O)=O,4,6,13,19,7,0.000321
G4,C(C(C(CO)C(CO)O)=O)(O)=O,4,8,14,22,29,0.00041900000000000005
G4,C(C(C(C(CO)(CO)O)O)O)=O,4,8,11,19,41,0.000437
G4,C(C(C(C(CO)(C(C)O)O)O)O)=O,16,8,13,21,0,0.000437
G4,C(C(C(C)(C(CO)(CO)O)O)O)=O,4,5,9,14,0,0.000261
G4,C(C(C(C(C=O)O)O)(C(C)O)O)=O,16,9,19,28,1,0.000455
G4,C(CC(CO)(C(C(C=O)O)O)O)=O,8,14,20,34,43,0.000723
G4,C(C(C(C(C=CC(C)=O)=O)O)O)=O,8,4,16,20,45,0.000193
G4,C(C(C=CC(C)=O)(C(C=O)O)O)=O,8,2,12,14,45,9.7e-05
G4,C(C(C(C=CC(C=O)=O)(C)O)O)=O,8,2,11,13,45,9.7e-05
G4,C(C(C=CC(CC(CO)O)=O)=O)=O,4,2,13,15,0,0.00010700000000000001
G4,C(CC=CC(C(C(C=O)O)O)=O)=O,8,4,16,20,29,0.000193
G4,C(C(C=CCC=O)(C(C=O)O)O)=O,8,3,13,16,45,0.000145
G4,C(C(C(CC=CC(C=O)=O)O)O)=O,8,2,12,14,45,9.7e-05
G4,C(C(C=CC(C=O)=O)C(CO)O)=O,8,2,8,10,45,0.00010700000000000001
G4,C(C(C(C=CC(C(C)=O)=O)O)O)=O,8,2,12,14,45,9.7e-05
G4,C(C(C(C(C)=O)(C=CC=O)O)O)=O,8,3,12,15,45,0.000145
G4,C(C(C(C(C=CC=O)=O)(C)O)O)=O,8,2,13,15,45,9.7e-05
G4,C(C(C=CC=O)=O)(CC(CO)O)=O,4,2,15,17,0,0.00010700000000000001
G4,C(CC(C=CC(C(C=O)O)O)=O)=O,8,2,13,15,45,9.7e-05
G4,C(CC(C=CC=O)(C(C=O)O)O)=O,8,3,14,17,45,0.000146
G4,C(C(C(CC(C=CC=O)=O)O)O)=O,8,3,17,20,45,0.000145
G4,C(C(C(C=CC=O)=O)C(CO)O)=O,8,3,13,16,0,0.000156
G4,C(C(C(C(CC(C=C)=O)=O)O)O)=O,4,4,17,21,27,0.000193
G4,C(C(C(C=O)(CC(C=C)=O)O)O)=O,4,3,12,15,0,0.000145
G4,C(C(C(C=C)(CC(C=O)=O)O)O)=O,4,3,13,16,45,0.000145
G4,C=CC(C(C(C=O)=O)C(CO)O)=O,4,3,12,15,0,0.000156
G4,C(C(C(CC(C(C=C)=O)=O)O)O)=O,4,2,16,18,0,9.7e-05
G4,C(CC(C(C=C)=O)(C(C=O)O)O)=O,4,3,13,16,0,0.000145
G4,C(CC=O)(C(C=C)(C(C=O)O)O)=O,4,3,14,17,0,0.000145
G4,C(C(C(C(C=C)=O)=O)C(CO)O)=O,4,3,13,16,0,0.000156
G4,C(C(C(C(CC=CC=O)=O)O)O)=O,8,4,16,20,27,0.000193
G4,C(C(C(C=O)(CC=CC=O)O)O)=O,8,3,12,15,27,0.000145
G4,C(C(C(C=CCC(C=O)=O)O)O)=O,8,2,12,14,27,9.7e-05
G4,C(C(C(C=O)=O)C(CO)O)=CC=O,8,2,9,11,27,0.00010700000000000001
G4,C(C(C1(COCC1O)O)O)=O,8,5,10,15,10,0.000239
G4,C(C(C1(C(O)OCC1)O)O)=O,8,6,12,18,34,0.00028700000000000004
G4,C1(C(O)OCC1C(CO)O)=O,8,7,11,18,0,0.00034500000000000004
G4,C(C(C=O)C(C(C(CO)O)O)O)=O,8,9,13,22,0,0.0005059999999999999
G4,C(C(CO)C(CO)(CO)O)=O,2,7,12,19,5,0.00036
G4,C(CO)(C(C(CC(C)O)O)O)=O,8,3,10,13,5,0.000155
G4,C(C(C(C)O)C(CO)(CO)O)=O,4,5,12,17,5,0.000252
G4,C(CO)(C(C(C(C(C)O)O)O)O)=O,16,9,13,22,11,0.00048300000000000003
G4,C(CO)(C(C(CC(CO)O)O)O)=O,8,7,12,19,6,0.00037799999999999997
G4,C(C(CO)(C(C(CO)=O)O)O)=O,4,10,18,28,5,0.0005139999999999999
G4,C(CO)(C(C(C(CO)=O)O)O)=O,3,5,8,13,5,0.00025
G4,C(C(C(C(CO)(CO)O)O)=O)=O,2,4,13,17,5,0.000202
G4,C(CO)(C(C)(C(C(CO)=O)O)O)=O,4,12,15,27,5,0.000604
G4,C(C(C)=O)(C(C(CO)(CO)O)O)=O,2,5,9,14,25,0.000261
G4,C(C(CO)=O)(CC(CO)(CO)O)=O,1,4,8,12,5,0.000213
G4,C(C(C(C)O)(C(C(CO)=O)O)O)=O,8,10,18,28,5,0.000512
G4,C(CO)(C(C(CO)(C(C)O)O)O)=O,8,8,10,18,25,0.000425
G4,C(C(C(CO)(CO)O)O)(C(C)O)=O,4,7,8,15,25,0.000366
G4,C(C(C=O)C(CO)(CO)O)=O,1,4,9,13,5,0.000202
G4,C(CO)(C(C(C(CCO)O)O)O)=O,8,8,12,20,29,0.000436
G4,C(C(C)(C(C(CO)=O)O)O)(O)=O,4,6,10,16,5,0.000309
G4,C(C(CC(CO)(CO)O)=O)(O)=O,1,4,8,12,29,0.000213
G4,C(C(C(CO)=O)O)(O)=O,2,30,40,70,17,0.001448
G4,C(C(C(C(CO)=O)O)O)(O)=O,4,15,16,31,33,0.0007469999999999999
G4,C(C(C(C(C(CO)=O)O)O)O)(O)=O,8,13,14,27,5,0.0007070000000000001
G4,C(CC(C(C(C(CO)=O)O)O)=O)=O,4,7,21,28,5,0.00034500000000000004
G4,C(CC(C=O)(C(C(CO)=O)O)O)=O,4,5,18,23,5,0.00025
G4,C(CO)(C(C(CC(C=O)=O)O)O)=O,4,6,19,25,5,0.000298
G4,C(C(C(C=O)=O)C(CO)(CO)O)=O,2,3,10,13,23,0.000155
G4,C(C)(C(C)(C(C(CO)=O)O)O)=O,4,4,13,17,5,0.000202
G4,C(C(C)=O)(CC(CO)(CO)O)=O,1,5,9,14,29,0.00026000000000000003
G4,C(CC(C)(C(C(CO)=O)O)O)=O,4,6,15,21,5,0.000298
G4,C(C)(CC(C(C(CO)=O)O)O)=O,4,7,15,22,5,0.000356
G4,C(CC(CC(CO)(CO)O)=O)=O,1,6,11,17,29,0.000308
G4,C(C(C(C)=O)C(CO)(CO)O)=O,2,6,11,17,5,0.000297
G4,C(CO)(C(C1(COC(C1)O)O)O)=O,8,5,9,14,35,0.00024900000000000004
G4,C1(COC(C1C(CO)(CO)O)O)=O,4,4,9,13,5,0.000202
G4,C1(C(C(CO)(CO)O)OC(C1)O)=O,4,5,7,12,35,0.00026000000000000003
G4,C(C(C=C)(C(C(CO)=O)O)O)=O,4,6,14,20,7,0.000297
G4,C(C(C(C=C)(CO)O)O)(CO)=O,4,6,9,15,7,0.000308
G4,C=CC(C(C(CO)(CO)O)O)=O,2,6,9,15,7,0.000308
G4,C(CO)(C(C(C=CC=O)O)O)=O,8,6,15,21,51,0.000297
G4,C(CO)(C(C(C(C)O)O)O)=O,8,14,14,28,11,0.000721
G4,C(CO)(C(C1(COCC1O)O)O)=O,8,3,7,10,10,0.000155
G4,C1(C(C(CO)(CO)O)OCC1O)=O,4,4,5,9,10,0.000213
G4,C(CO)(C(C1(C(O)OCC1)O)O)=O,8,4,9,13,5,0.000202
G4,C1(C(O)OCC1C(CO)(CO)O)=O,4,4,7,11,5,0.000202
G4,C(C(CO)C(C(CO)O)O)=O,8,10,16,26,41,0.000536
G4,C(C(C(C)O)C(C(CO)O)O)=O,16,8,16,24,41,0.00042800000000000005
G4,C(C(C)=O)(C(C(C(CO)O)O)O)=O,8,10,15,25,25,0.000553
G4,C(C(CO)=O)(CC(C(CO)O)O)=O,4,10,13,23,12,0.000531
G4,C(C(C(C(CO)O)O)O)(C(C)O)=O,16,11,13,24,25,0.000601
G4,C(C(C=O)C(C(CO)O)O)=O,4,7,13,20,45,0.00037799999999999997
G4,C(C(C(C=O)=O)C(C(CO)O)O)=O,8,6,16,22,23,0.00033
G4,C(C(C)=O)(CC(C(CO)O)O)=O,4,8,14,22,29,0.000436
G4,C(CC(CC(C(CO)O)O)=O)=O,4,8,15,23,41,0.000425
G4,C(C(C(C)=O)C(C(CO)O)O)=O,8,9,16,25,41,0.00047300000000000006
G4,C1(COC(C1C(C(CO)O)O)O)=O,16,6,13,19,35,0.000319
G4,C1(C(C(C(CO)O)O)OC(C1)O)=O,16,7,11,18,35,0.00037799999999999997
G4,C=CC(C(C(C(CO)O)O)O)=O,8,8,16,24,41,0.000425
G4,C1(C(C(C(CO)O)O)OCC1O)=O,16,5,9,14,10,0.000272
G4,C1(C(O)OCC1C(C(CO)O)O)=O,16,8,11,19,34,0.000436
G4,C(C(CC(C)O)(CC(C=O)=O)O)=O,4,1,11,12,45,4.8e-05
G4,C(C(C)(C(C(C=O)=O)C(C)O)O)=O,8,4,13,17,4,0.000194
G4,C(CC(C(C)(CC(C=O)=O)O)O)=O,4,2,18,20,4,9.7e-05
G4,C(C)(C(CC(CC(C=O)=O)O)O)=O,4,2,16,18,22,9.6e-05
G4,C(CC(C(CC(C=O)(C)O)=O)O)=O,4,2,15,17,4,9.7e-05
G4,C(C(C(C(C)=O)O)C(C(C)=O)O)=O,3,2,8,10,45,9.6e-05
G4,C(C(C(C=O)C(C=O)(C)O)O)(C)=O,8,5,14,19,45,0.00023999999999999998
G4,C(C(C)(CC(CC(C=O)=O)O)O)=O,4,3,13,16,22,0.000143
G4,C(C(C)(C(C=O)C(C=O)(C)O)O)=O,3,2,7,9,45,9.6e-05
G4,C(C(CO)C(C(C)=O)O)=O,4,17,24,41,2,0.0008349999999999999
G4,C(C(CO)C(C=O)(C)O)=O,4,8,18,26,45,0.000397
G4,C(C(CC(CO)(CC(C)O)O)=O)=O,4,2,12,14,45,0.00010700000000000001
G4,C(CO)(C(C(C)O)C(C(C)=O)O)=O,8,5,14,19,45,0.000252
G4,C(C(C)(C(C(CO)=O)C(C)O)O)=O,8,5,14,19,45,0.000252
G4,C(C(C(C(CC(C)O)=O)O)O)(C)=O,8,5,15,20,4,0.000241
G4,C(C(C)(C(C(CC(C)O)=O)O)O)=O,8,4,14,18,45,0.000193
G4,C(C(CC(C)(C(C(C)O)O)O)=O)=O,8,1,13,14,45,4.8e-05
G4,C(CC(C(C)=O)O)(C(C(C)O)O)=O,8,3,14,17,45,0.000146
G4,C(C(C)(CC(C(C(C)O)O)=O)O)=O,8,3,14,17,4,0.000146
G4,C(C(CC(CC(C)(CO)O)O)=O)=O,4,2,11,13,45,0.00010700000000000001
G4,C(C(C(CO)(C)O)C(C(C)=O)O)=O,8,5,14,19,49,0.000251
G4,C(C(C(CO)(C)O)C(C=O)(C)O)=O,8,5,14,19,49,0.000251
G4,C(C(CC(CC(C)O)O)=O)=O,4,4,15,19,3,0.00019099999999999998
G4,C(C(C(C)O)C(C(C)=O)O)=O,8,9,17,26,45,0.00043099999999999996
G4,C(C(C(C)O)C(C=O)(C)O)=O,8,5,15,20,45,0.000241
G4,C(C(CC(C(C(C)O)O)O)=O)=O,8,4,17,21,45,0.000213
G4,C(C(CC(CC(CO)O)O)=O)=O,4,3,15,18,29,0.000165
G4,C(C(C(CO)O)(CC(C=O)=O)O)=O,4,6,15,21,0,0.000331
G4,C(C(CC(C=O)=O)O)(C(CO)O)=O,4,5,17,22,5,0.00025299999999999997
G4,C(C(CO)(CC(C=O)=O)O)=O,2,7,17,24,2,0.000346
G4,C(CO)(C(CC(C=O)=O)O)=O,2,13,21,34,5,0.000629
G4,C(C(C)(C(C(C=O)=O)O)O)=O,4,7,17,24,45,0.000334
G4,C(CO)(C(C)(CC(C=O)=O)O)=O,2,4,16,20,26,0.000202
G4,C(C)(C(C(C(C(C)=O)=O)O)O)=O,4,8,16,24,25,0.00038199999999999996
G4,C(C(C)(C(C(C(C)=O)=O)O)O)=O,4,4,14,18,25,0.000192
G4,C(C)(C(CC(C(CO)=O)=O)O)=O,2,7,14,21,5,0.000333
G4,C(C(C)(CC(C(CO)=O)=O)O)=O,2,3,13,16,25,0.000143
G4,C(C(CC(C=O)=O)O)(C(C)O)=O,4,4,15,19,29,0.000202
G4,C(C(C(C)O)(CC(C=O)=O)O)=O,4,5,16,21,4,0.000261
G4,C(C(CC(CO)(C(C)O)O)=O)=O,4,5,15,20,29,0.000271
G4,C(C(C(C(C(C)O)=O)O)O)(C)=O,8,9,14,23,25,0.00044100000000000004
G4,C(C(C)(C(C(C(C)O)=O)O)O)=O,8,5,13,18,25,0.00025
G4,C(C(C=O)C(C(C)=O)O)=O,2,11,20,31,45,0.000524
G4,C(C(C=O)C(C=O)(C)O)=O,2,5,14,19,45,0.000239
G4,C(C(C(CO)(CC(C=O)=O)O)O)=O,4,6,17,23,51,0.000321
G4,C(C(C(C(C(C(C)=O)O)O)=O)O)=O,8,7,20,27,5,0.000335
G4,C(C(C)(C(C(C(C=O)O)=O)O)O)=O,8,3,16,19,5,0.000144
G4,C(C(CC(C(CCO)O)O)=O)=O,4,3,15,18,29,0.000165
G4,C(C(C)(CC(C=O)=O)O)(O)=O,2,8,14,22,29,0.00040300000000000004
G4,C(C(C)(CC(C(O)=O)=O)O)=O,2,5,11,16,7,0.00024900000000000004
G4,C(CC(C=O)=O)(O)=O,1,44,73,117,17,0.002101
G4,C(CC(CO)(CC(C=O)=O)O)(O)=O,2,2,12,14,29,0.00010700000000000001
G4,C(C(C(C)(CC(C=O)=O)O)O)(O)=O,4,3,14,17,26,0.000155
G4,C(C(CC(C=O)=O)O)(O)=O,2,9,22,31,33,0.000439
G4,C(C(C(CC(C=O)=O)O)O)(O)=O,4,6,18,24,29,0.000308
G4,C(CC(C(CC(C=O)=O)O)O)(O)=O,4,2,13,15,29,0.00010700000000000001
G4,C(C(CC(C=O)=O)O)(CC(C)=O)=O,2,1,14,15,26,4.8e-05
G4,C(C(CC(C=O)=O)(CC(C)=O)O)=O,2,1,12,13,45,4.8e-05
G4,C(C(CC(C)(CC(C=O)=O)O)=O)=O,1,1,7,8,26,4.8e-05
G4,C(C)(C(C(C=O)=O)C(C(C)=O)O)=O,4,2,11,13,45,9.6e-05
G4,C(C(C)(C(C(C)=O)C(C=O)=O)O)=O,4,2,9,11,26,9.6e-05
G4,C(CC(C(C)=O)O)(CC(C=O)=O)=O,2,1,15,16,45,4.8e-05
G4,C(C(C)(CC(CC(C=O)=O)=O)O)=O,2,1,11,12,45,4.8e-05
G4,C(CC(C(CC(C=O)=O)O)=O)=O,2,4,20,24,29,0.00019099999999999998
G4,C(CC(C=O)(CC(C=O)=O)O)=O,2,3,17,20,29,0.000143
G4,C(C(CC(CC(C=O)=O)O)=O)=O,1,3,10,13,29,0.000143
G4,C(C(C(C=O)=O)C(C(C)=O)O)=O,4,6,17,23,23,0.000286
G4,C(C(C(C=O)=O)C(C=O)(C)O)=O,4,5,15,20,45,0.000239
G4,C(CC(C(C)=O)(CC(C=O)=O)O)=O,2,2,12,14,45,9.7e-05
G4,C(C(C)(CC(C=O)=O)O)(CC=O)=O,2,1,13,14,45,4.8e-05
G4,C(C(C(C(C)=O)=O)C(C(C)=O)O)=O,4,2,11,13,45,9.6e-05
G4,C(C(C)(C(C=O)C(C(C)=O)=O)O)=O,4,2,9,11,14,9.6e-05
G4,C(CC(C(CC(C(C)=O)O)=O)=O)=O,2,1,14,15,45,4.8e-05
G4,C(C(C)(CC(C(CC=O)=O)=O)O)=O,2,1,11,12,45,4.8e-05
G4,C(C)(C(C)(CC(C=O)=O)O)=O,2,5,15,20,29,0.00023799999999999998
G4,C(C)(C(CC(C(C)=O)=O)O)=O,2,7,16,23,14,0.000333
G4,C(C(C)(CC(C(C)=O)=O)O)=O,2,3,13,16,45,0.000143
G4,C(CC(C)(CC(C=O)=O)O)=O,2,9,20,29,6,0.000429
G4,C(C)(CC(CC(C=O)=O)O)=O,2,7,21,28,23,0.000333
G4,C(CC(CC(C(C)=O)O)=O)=O,2,8,21,29,45,0.00037999999999999997
G4,C(C(C)(CC(CC=O)=O)O)=O,2,4,17,21,45,0.00019099999999999998
G4,C(C(C(C)=O)C(C(C)=O)O)=O,4,9,17,26,45,0.000429
G4,C(C(C)(C(C=O)C(C)=O)O)=O,4,5,14,19,45,0.000239
G4,C(C(CC1(COC(C1)O)O)=O)=O,4,2,13,15,45,9.6e-05
G4,C1(COC(C1C(C(C)=O)O)O)=O,8,5,14,19,35,0.000239
G4,C(C(C)(C1C(COC1O)=O)O)=O,8,4,14,18,45,0.00019099999999999998
G4,C(C(C1C(CC(O1)O)=O)O)(C)=O,8,5,12,17,35,0.000239
G4,C(C(C)(C1C(CC(O1)O)=O)O)=O,8,3,12,15,35,0.000144
G4,C(C(CC(C=O)=O)O)=CC(CO)=O,4,1,11,12,45,4.8e-05
G4,C(C(CO)(CC(C=O)=O)O)=CC=O,4,1,10,11,45,4.8e-05
G4,C(C)(C(C(C(C=CC=O)=O)O)O)=O,8,4,18,22,45,0.000192
G4,C(C(C)(C(C(C=CC=O)=O)O)O)=O,8,3,13,16,45,0.000144
G4,C=CC(C(CC(C=O)=O)O)=O,2,7,16,23,7,0.000333
G4,C(C(C=C)(CC(C=O)=O)O)=O,2,6,14,20,7,0.000285
G4,C(C(CO)(CC(C=O)=O)O)=C,2,7,15,22,7,0.000344
G4,C(C)(C(C(C(C=C)=O)O)O)=O,4,11,20,31,7,0.000525
G4,C(C(C)(C(C(C=C)=O)O)O)=O,4,5,15,20,45,0.000239
G4,C(C(CC(C=O)=O)O)=CC=O,4,6,17,23,20,0.000285
G4,C(C(CC(C(C)O)O)=O)=O,4,9,21,30,11,0.000439
G4,C(C(CCO)(CC(C=O)=O)O)(O)=O,2,2,12,14,29,0.00010700000000000001
G4,C(C(C(C(C(O)=O)=O)CO)O)(C)=O,4,5,13,18,45,0.000254
G4,C(C(C)(C(C(C(O)=O)=O)CO)O)=O,4,5,13,18,7,0.000254
G4,C(C(CC(CC(C=O)=O)O)O)(O)=O,4,4,13,17,29,0.00022400000000000002
G4,C(C(CC(C(CO)(CO)O)O)=O)=O,2,4,10,14,29,0.00022400000000000002
G4,C(C(CO)(C(CC(C=O)=O)O)O)=O,4,7,17,24,23,0.00036
G4,C(C(CC(C(C=CC(C)=O)=O)O)=O)=O,4,1,11,12,45,4.8e-05
G4,C(C(C=CC(C)=O)(CC(C=O)=O)O)=O,4,1,8,9,45,4.8e-05
G4,C(C(C)(CC(C=O)=O)O)=CC(C=O)=O,4,1,8,9,45,4.8e-05
G4,C(C)(C(CC(C=CC(C=O)=O)=O)O)=O,4,1,15,16,45,4.8e-05
G4,C(C(C)(CC(C=CC(C=O)=O)=O)O)=O,4,1,9,10,45,4.8e-05
G4,C(CC=CC(C(CC(C=O)=O)O)=O)=O,4,1,10,11,45,4.8e-05
G4,C(C(C=CCC=O)(CC(C=O)=O)O)=O,4,1,8,9,45,4.8e-05
G4,C(CC(CC(C=O)=O)O)=CC(C=O)=O,4,1,8,9,45,4.8e-05
G4,C(C(C=CC(C=O)=O)C(C(C)=O)O)=O,8,1,10,11,45,4.8e-05
G4,C(C(C=CC(C=O)=O)C(C=O)(C)O)=O,8,1,4,5,45,4.8e-05
G4,C(C(CC(C=O)=O)O)=CC(C(C)=O)=O,4,1,10,11,45,4.8e-05
G4,C(C)(C(C=CC=O)(CC(C=O)=O)O)=O,4,1,8,9,45,4.8e-05
G4,C(C(CC(C(C=CC=O)=O)(C)O)=O)=O,4,1,8,9,45,4.8e-05
G4,C(C)(C(CC(C(C=CC=O)=O)=O)O)=O,4,1,15,16,45,4.8e-05
G4,C(C(C)(CC(C(C=CC=O)=O)=O)O)=O,4,1,9,10,45,4.8e-05
G4,C(CC(C=CC(CC(C=O)=O)O)=O)=O,4,1,11,12,45,4.8e-05
G4,C(CC(C=CC=O)(CC(C=O)=O)O)=O,4,1,11,12,45,4.8e-05
G4,C(C(CC(CC(C=CC=O)=O)O)=O)=O,4,2,14,16,45,9.6e-05
G4,C(C(C(C=CC=O)=O)C(C(C)=O)O)=O,8,2,12,14,45,9.6e-05
G4,C(C(C(C=CC=O)=O)C(C=O)(C)O)=O,8,2,7,9,45,9.6e-05
G4,C(C(CC(C=O)=O)O)(CC(C=C)=O)=O,2,1,13,14,45,4.8e-05
G4,C(C(CC(C=O)=O)(CC(C=C)=O)O)=O,2,1,8,9,45,4.8e-05
G4,C=CC(CC(C=O)=O)(CC(C=O)=O)O,1,1,5,6,45,4.8e-05
G4,C(C)(C(C(C(C=O)=O)C(C=C)=O)O)=O,4,2,10,12,45,9.6e-05
G4,C(C(C)(C(C(C=O)=O)C(C=C)=O)O)=O,4,2,6,8,45,9.6e-05
G4,C=CC(C(CC(CC(C=O)=O)O)=O)=O,2,1,13,14,45,4.8e-05
G4,C(CC(C(C=C)=O)(CC(C=O)=O)O)=O,2,1,9,10,45,4.8e-05
G4,C(CC=O)(C(C=C)(CC(C=O)=O)O)=O,2,1,10,11,45,4.8e-05
G4,C(C(C(C(C=C)=O)=O)C(C(C)=O)O)=O,4,2,11,13,45,9.6e-05
G4,C(C(C(C(C=C)=O)=O)C(C=O)(C)O)=O,4,2,7,9,45,9.6e-05
G4,C(C(CC(C=O)=O)O)(CC=CC=O)=O,4,1,10,11,45,4.8e-05
G4,C(C(CC(C=O)=O)(CC=CC=O)O)=O,4,1,6,7,45,4.8e-05
G4,C(CC(C=O)=O)=CC(CC(C=O)=O)O,4,1,9,10,45,4.8e-05
G4,C(C)(C(C(C=CC=O)C(C=O)=O)O)=O,8,1,9,10,45,4.8e-05
G4,C(C(C)(C(C=CC=O)C(C=O)=O)O)=O,8,1,4,5,27,4.8e-05
G4,C(C(CC1(COCC1O)O)=O)=O,4,1,11,12,10,4.8e-05
G4,C(C(C1C(C(CO1)O)=O)O)(C)=O,8,3,9,12,10,0.000144
G4,C(C(C)(C1C(C(CO1)O)=O)O)=O,8,2,9,11,10,9.6e-05
G4,C(C(CC1(C(O)OCC1)O)=O)=O,4,2,13,15,29,9.6e-05
G4,C(C(C1C(C(O)OC1)=O)O)(C)=O,8,4,11,15,45,0.00019099999999999998
G4,C(C(C)(C1C(C(O)OC1)=O)O)=O,8,3,11,14,34,0.000144
G4,C(C(C(CO)=O)C(CCO)O)=O,4,8,13,21,49,0.00040300000000000004
G4,C(CC(C(C(CCO)O)O)=O)=O,4,6,14,20,49,0.000308
G4,C(C(CO)C(CC(CO)=O)O)=O,4,10,17,27,2,0.000503
G4,C(C(CO)C(CO)(CC=O)O)=O,4,11,18,29,49,0.000562
G4,C(C(C(CO)=O)C(CC(C)O)O)=O,8,5,11,16,49,0.00024900000000000004
G4,C(CC(C(C(CC(C)O)O)O)=O)=O,8,4,12,16,49,0.000202
G4,C(C(C(CC(CO)=O)O)C(C)O)=O,8,7,15,22,49,0.000348
G4,C(C(C(C)O)C(CO)(CC=O)O)=O,8,8,15,23,4,0.000407
G4,C(C(CO)(C(C=O)C(CO)=O)O)=O,4,6,15,21,5,0.000299
G4,C(C(CO)(C(C(CC=O)=O)O)O)=O,4,9,19,28,23,0.000455
G4,C(C(C(CO)=O)C(C(CO)=O)O)=O,4,6,17,23,49,0.000297
G4,C(CO)(CC(C(C(C=O)=O)O)O)=O,4,7,19,26,49,0.00034500000000000004
G4,C(CC(CO)(C(C(C=O)=O)O)O)=O,4,5,17,22,49,0.000261
G4,C(CC(C(C=O)C(CO)=O)O)=O,4,9,17,26,49,0.00044100000000000004
G4,C(CC(C(C(CC=O)=O)O)O)=O,4,8,21,29,49,0.000393
G4,C(C(C=O)C(CC(CO)=O)O)=O,2,8,13,21,49,0.000404
G4,C(C(C=O)C(CO)(CC=O)O)=O,2,8,14,22,49,0.000404
G4,C(C(C)(C(C=O)C(CO)=O)O)(O)=O,4,6,11,17,28,0.000308
G4,C(C(C)(C(C(CC=O)=O)O)O)(O)=O,4,5,12,17,28,0.00025
G4,C(CO)(CC(CC(C(O)=O)=O)O)=O,2,5,11,16,49,0.000261
G4,C(CC(CO)(CC(C(O)=O)=O)O)=O,2,5,12,17,29,0.000271
G4,C(C(C=O)C(CO)=O)(O)=O,2,18,20,38,17,0.000878
G4,C(C(C(CC=O)=O)O)(O)=O,2,17,24,41,17,0.00082
G4,C(C(C(CO)=O)C(C(O)=O)O)=O,4,8,13,21,33,0.00040300000000000004
G4,C(CC(C(C(C(O)=O)O)O)=O)=O,4,9,17,26,33,0.00045099999999999996
G4,C(C)(C(C)(C(C=O)C(CO)=O)O)=O,4,5,12,17,14,0.00024900000000000004
G4,C(C)(C(C)(C(C(CC=O)=O)O)O)=O,4,3,14,17,14,0.000143
G4,C(CO)(CC(CC(C(C)=O)=O)O)=O,2,4,14,18,14,0.000202
G4,C(CC(CO)(CC(C(C)=O)=O)O)=O,2,5,13,18,14,0.000261
G4,C(CC(C)(C(C=O)C(CO)=O)O)=O,4,6,13,19,49,0.000298
G4,C(C)(CC(C(C=O)C(CO)=O)O)=O,4,9,13,22,6,0.00044
G4,C(C(C(CC(C)=O)O)O)(CC=O)=O,4,7,17,24,49,0.00034500000000000004
G4,C(CC(CC(CO)=O)O)(CC=O)=O,2,7,16,23,49,0.000356
G4,C(C)(C(C=O)C(CC(CO)=O)O)=O,4,9,14,23,6,0.00045099999999999996
G4,C(CC(CO)(C(C=O)C(C)=O)O)=O,4,6,12,18,49,0.000309
G4,C(C(C(CO)=O)C(C(C=C)=O)O)=O,4,5,12,17,7,0.00025
G4,C(C(C(CO)=O)C(C=O)(C=C)O)=O,4,5,10,15,7,0.00025
G4,C(C(C=C)(C(C(CC=O)=O)O)O)=O,4,4,12,16,7,0.00019099999999999998
G4,C(C(C(CO)=O)C(C=C)(CO)O)=O,4,6,9,15,7,0.000308
G4,C(CC(C(C(C=C)(CO)O)O)=O)=O,4,6,10,16,7,0.000319
G4,C(CO)(CC(C(C(C=C)=O)O)O)=O,4,5,15,20,49,0.00025
G4,C(CC(CO)(C(C(C=C)=O)O)O)=O,4,6,13,19,7,0.000309
G4,C(C(C(CO)=O)C(C=CC=O)O)=O,8,5,11,16,43,0.00024900000000000004
G4,C(CC(C(C(C=CC=O)O)O)=O)=O,8,3,14,17,43,0.000143
G4,C(C(C(CO)=O)C(C(C)O)O)=O,8,7,14,21,49,0.00034500000000000004
G4,C(CC(C(C(C(C)O)O)O)=O)=O,8,7,16,23,11,0.000344
G4,C(C(C(CC(CCO)O)=O)O)=O,4,3,11,14,18,0.000154
G4,C(C(CO)C(C(C(C)=O)O)O)=O,8,11,18,29,18,0.000551
G4,C(C(CO)C(C)(C(C=O)O)O)=O,8,9,18,27,6,0.00044500000000000003
G4,C(C(C(CC(CC(C)O)O)=O)O)=O,8,2,10,12,1,9.499999999999999e-05
G4,C(C(C(C(C(C)=O)O)O)C(C)O)=O,16,8,16,24,1,0.000395
G4,C(C(C(C)O)C(C)(C(C=O)O)O)=O,16,7,16,23,1,0.000338
G4,C(C(CO)(CC(C(C=O)O)=O)O)=O,4,3,15,18,2,0.000145
G4,C(C(C(CC(C(CO)=O)O)=O)O)=O,4,3,17,20,1,0.000143
G4,C(C)(C(C(C(C(C=O)=O)O)O)O)=O,8,7,20,27,5,0.000334
G4,C(C(C(C)(C(C(C=O)=O)O)O)O)=O,8,6,18,24,0,0.000288
G4,C(C(C(CC(CC=O)O)=O)O)=O,4,7,18,25,55,0.000356
G4,C(C(C=O)C(C(C(C)=O)O)O)=O,4,9,14,23,1,0.00045099999999999996
G4,C(C(C=O)C(C)(C(C=O)O)O)=O,4,6,14,20,1,0.000288
G4,C(C(C)(CC(C(C=O)O)=O)O)(O)=O,4,3,11,14,25,0.000154
G4,C(C)(C(C(CC(C(O)=O)=O)O)O)=O,4,5,13,18,49,0.00025
G4,C(C(C(C)(CC(C(O)=O)=O)O)O)=O,4,5,13,18,0,0.000251
G4,C(CC(C(C=O)O)=O)(O)=O,2,15,23,38,17,0.000724
G4,C(C(C(CC(C(O)=O)O)=O)O)=O,4,4,13,17,33,0.000202
G4,C(C)(C(C)(CC(C(C=O)O)=O)O)=O,4,2,12,14,14,9.499999999999999e-05
G4,C(C)(C(C(CC(C(C)=O)=O)O)O)=O,4,4,15,19,14,0.00019099999999999998
G4,C(C(C(C)(CC(C(C)=O)=O)O)O)=O,4,4,14,18,14,0.000192
G4,C(CC(CC(C)=O)O)(C(C=O)O)=O,4,4,15,19,6,0.00019099999999999998
G4,C(CC(C(C(C)=O)O)O)(CC=O)=O,4,7,17,24,9,0.000356
G4,C(CC(C)(C(C=O)O)O)(CC=O)=O,4,4,16,20,27,0.000192
G4,C(C(C(C)=O)C(C(C(C)=O)O)O)=O,8,8,14,22,6,0.000404
G4,C(C(C(C)(C(C=O)C(C)=O)O)O)=O,8,5,13,18,6,0.00023999999999999998
G4,C(C(C(CC(C(C=C)=O)O)=O)O)=O,4,2,13,15,1,9.499999999999999e-05
G4,C(C(C=C)(CC(C(C=O)O)=O)O)=O,4,2,10,12,25,9.499999999999999e-05
G4,C(C(C(CC(C=C)(CO)O)=O)O)=O,4,4,9,13,25,0.000213
G4,C(C)(C(C(C(C(C=C)=O)O)O)O)=O,8,6,16,22,1,0.000298
G4,C(C(C(C)(C(C(C=C)=O)O)O)O)=O,8,5,14,19,1,0.00023999999999999998
G4,C(C(C(CC(C=CC=O)O)=O)O)=O,8,2,12,14,1,9.499999999999999e-05
G4,C(C(C(CC(C(C)O)O)=O)O)=O,8,3,13,16,11,0.000143
G4,C(C(C(C=O)O)O)(C(C(C)O)O)=O,16,9,19,28,5,0.00044400000000000006
G4,C(C(C(C(C=O)=O)C(C=O)O)O)=O,3,2,8,10,0,9.6e-05
G4,C(C(C(C(C=O)=O)C(C)O)O)=O,8,5,18,23,0,0.000241
G4,C(CC(C(CC(C=O)O)=O)O)=O,4,8,20,28,20,0.00038199999999999996
G4,C(C(C(C(C(C=O)O)O)=O)CO)=O,8,9,19,28,2,0.000434
G4,C(C(CO)O)(C(C=O)C(C=O)O)=O,8,7,17,24,2,0.00036
G4,C(C(CO)C(C=O)O)(C(C=O)O)=O,8,4,18,22,15,0.000195
G4,C(C(C(C(C=O)=O)O)O)=O,4,17,31,48,1,0.00081
G4,C(C(C(C=O)C(C(CO)=O)O)O)=O,8,8,19,27,43,0.000393
G4,C(C(C(C(C(CC=O)O)=O)O)O)=O,8,6,23,29,0,0.000298
G4,C(C(C(C(C(C)=O)=O)O)O)=O,4,11,20,31,25,0.000536
G4,C(C(CC(C(CO)=O)=O)O)=O,2,5,18,23,5,0.00023799999999999998
G4,C(C(C(C(CC(CO)=O)=O)O)O)=O,4,5,19,24,0,0.00023999999999999998
G4,C(C(C(C(CO)=O)C(CO)=O)O)=O,2,3,10,13,0,0.000144
G4,C(C(C(C(C(C(C)=O)O)=O)O)O)=O,8,6,19,25,0,0.000288
G4,C(C(CC(C(C(CO)=O)O)=O)O)=O,4,2,15,17,0,9.6e-05
G4,C(C(C=O)C(C=O)O)=O,2,17,33,50,0,0.000808
G4,C(C(C(C(C(C=O)O)O)=O)O)=O,8,6,21,27,5,0.000288
G4,C(C(CC(C(O)=O)=O)O)=O,2,10,20,30,17,0.000487
G4,C(C(C(CO)=O)C(C=O)O)(O)=O,4,12,15,27,0,0.000595
G4,C(CC(C(C(C=O)O)O)=O)(O)=O,4,12,18,30,0,0.000607
G4,C(C(C(CC(C=O)O)=O)O)(O)=O,4,11,15,26,17,0.000547
G4,C(C(C(C(C)=O)C(C=O)=O)O)=O,4,4,16,20,0,0.00019099999999999998
G4,C(C(CC(CC(C=O)=O)=O)O)=O,2,4,20,24,0,0.00019099999999999998
G4,C(C(C(C=O)=O)C(C=O)O)=O,4,7,17,24,0,0.000334
G4,C(C(C(C(C)=O)=O)C(C=O)O)=O,4,5,15,20,14,0.000239
G4,C(CC(C(CC(C=O)O)=O)=O)=O,2,3,18,21,0,0.000143
G4,C(C(C(C)=O)C(C=O)O)=O,4,14,24,38,6,0.000666
G4,C1(COC(C1C(C=O)O)O)=O,8,6,18,24,0,0.000286
G4,C(C(C1C(CC(O1)O)=O)O)=O,8,7,18,25,0,0.000334
G4,C1(COC(C(C1C(C=O)O)O)O)=O,16,3,15,18,0,0.000144
G4,C(C(C1C(CC(C(O1)O)O)=O)O)=O,16,3,12,15,0,0.000144
G4,C(C(C(C(C=CC=O)=O)O)O)=O,8,6,19,25,0,0.000288
G4,C(C(C(C(C(O)=O)=O)CO)O)=O,4,6,15,21,29,0.000301
G4,C(C(C(C=O)C(C=O)O)O)(O)=O,8,9,17,26,33,0.000463
G4,C(CC(C=O)O)(C(C=O)(CO)O)=O,4,4,13,17,15,0.000206
G4,C(C(C(C=O)C(C=O)(CO)O)O)=O,8,6,17,23,43,0.00028900000000000003
G4,C(C(CC(C=CC(C=O)=O)=O)O)=O,4,1,12,13,0,4.8e-05
G4,C(C(C=CC(C=O)=O)C(C=O)O)=O,8,1,9,10,45,4.8e-05
G4,C(C(CC(C(C=CC=O)=O)=O)O)=O,4,1,12,13,0,4.8e-05
G4,C(C(C(C=CC=O)=O)C(C=O)O)=O,8,2,10,12,45,9.6e-05
G4,C(C(C(C(C=O)=O)C(C=C)=O)O)=O,4,2,8,10,45,9.6e-05
G4,C(C(C(C(C=C)=O)=O)C(C=O)O)=O,4,2,9,11,0,9.6e-05
G4,C(C(C(C=CC=O)C(C=O)=O)O)=O,8,1,8,9,0,4.8e-05
G4,C(C(C1C(C(CO1)O)=O)O)=O,8,6,15,21,10,0.000286
G4,C1(C(O)OCC1C(C=O)O)=O,8,5,14,19,34,0.000239
G4,C(C(CO)O)(CC(CCO)O)=O,4,7,11,18,18,0.000381
G4,C(C(CO)C(C)(C(CO)O)O)=O,8,9,15,24,18,0.00047699999999999994
G4,C(C(CO)O)(CC(CC(C)O)O)=O,8,6,11,17,28,0.000323
G4,C(C(C(C)O)C(C)(C(CO)O)O)=O,16,7,14,21,28,0.00036899999999999997
G4,C(C(C(C(C)(C(CO)O)O)O)=O)=O,8,6,15,21,5,0.000319
G4,C(CC(CC(C(CO)O)=O)O)=O,4,10,16,26,2,0.0005139999999999999
G4,C(C(C=O)C(C)(C(CO)O)O)=O,4,6,12,18,28,0.000319
G4,C(C(C)(CC(C(CO)O)=O)O)(O)=O,4,8,12,20,28,0.00044
G4,C(C(CC(C)(C(CO)O)O)=O)(O)=O,4,5,12,17,28,0.00028199999999999997
G4,C(CC(C(CO)O)=O)(O)=O,2,19,23,42,2,0.000951
G4,C(C)(C(C)(CC(C(CO)O)=O)O)=O,4,6,13,19,14,0.000323
G4,C(C(C)=O)(CC(C)(C(CO)O)O)=O,4,4,11,15,14,0.00022400000000000002
G4,C(CC(C)(CC(C(CO)O)=O)O)=O,4,7,14,21,6,0.000371
G4,C(C(CO)O)(CC(CC(C)=O)O)=O,4,7,13,20,6,0.00037
G4,C(CC(CC(C)(C(CO)O)O)=O)=O,4,4,11,15,6,0.00022400000000000002
G4,C(C(C(C)=O)C(C)(C(CO)O)O)=O,8,5,12,17,6,0.000272
G4,C(CC(C(C=C)=O)O)(C(CO)O)=O,4,6,15,21,7,0.000323
G4,C(C(C=C)(CC(C(CO)O)=O)O)=O,4,6,12,18,7,0.000323
G4,C(CC(C=C)(CO)O)(C(CO)O)=O,4,7,9,16,7,0.000381
G4,C=CC(C(C(C)(C(CO)O)O)O)=O,8,5,13,18,7,0.000272
G4,C(CC(C=CC=O)O)(C(CO)O)=O,8,7,14,21,43,0.000381
G4,C(C(CO)O)(CC(C(C)O)O)=O,8,6,12,18,11,0.000323
G4,C(C(C(C(CO)O)=O)CO)=O,4,10,17,27,2,0.000516
G4,C(C(C(C(CO)O)=O)C(C)O)=O,8,8,15,23,4,0.000397
G4,C(C(C(C(C(C)O)O)=O)CO)=O,8,7,15,22,4,0.000339
G4,C(CC(C(C(CO)=O)CO)O)=O,4,10,17,27,2,0.000504
G4,C(C(C(C(CO)CO)=O)O)=O,2,5,12,17,2,0.00025299999999999997
G4,C(C(C(C(CO)C(C)O)=O)O)=O,8,5,14,19,4,0.000244
G4,C(CC(C(C(CCO)=O)O)O)=O,4,8,16,24,3,0.00040599999999999995
G4,C(C(CO)O)(C(CO)CO)=O,2,8,12,20,2,0.000421
G4,C(C(CO)O)(C(CO)C(C)O)=O,8,8,13,21,2,0.000413
G4,C(C(CO)CO)=O,1,13,109,122,18,0.000633
G4,C(CC(C(C(CO)CO)=O)O)=O,2,7,12,19,4,0.000349
G4,C(C(CO)C(C(CCO)=O)O)=O,4,12,17,29,2,0.000621
G4,C(C(CO)C(C=O)(CCO)O)=O,4,9,16,25,3,0.000466
G4,C(C(C(C)O)O)(C(CO)CO)=O,4,5,10,15,4,0.00025499999999999996
G4,C(C(CO)C(CO)(CCO)O)=O,4,9,14,23,3,0.00047699999999999994
G4,C(C(CO)C(C(C=O)O)O)=O,8,13,21,34,18,0.000646
G4,C(C(CO)C(C)(CO)O)=O,4,8,16,24,49,0.000408
G4,C(C(CO)C(C(CC=O)O)O)=O,8,10,22,32,43,0.0005139999999999999
G4,C(C(CO)C(CC(C=O)O)O)=O,8,8,19,27,43,0.000407
G4,C(C(CO)C(C)O)=O,4,10,53,63,18,0.000493
G4,C(C(CO)C(CO)(C(CO)O)O)=O,8,10,14,24,2,0.000547
G4,C(C(CO)C(C(O)=O)O)(CCO)=O,4,6,12,18,2,0.000333
G4,C(CC(C(O)=O)O)(C(CO)CO)=O,2,6,8,14,30,0.000333
G4,C(C(CC(C(CO)=O)CO)O)(O)=O,4,4,10,14,12,0.00021400000000000002
G4,C(C(CO)O)(CCC(C(O)=O)O)=O,4,5,11,16,12,0.000264
G4,C(C(CC(C(O)=O)O)O)(CCO)=O,4,4,9,13,2,0.000225
G4,C(C(C(C(CO)C(CO)O)=O)=O)=O,4,2,16,18,0,9.9e-05
G4,C(C(CO)O)(C(C(C=O)=O)CO)=O,4,6,16,22,2,0.000304
G4,C(C(CO)CO)(C(C(C=O)=O)O)=O,2,2,10,12,2,9.9e-05
G4,C(CO)(C(CO)C(C(C=O)=O)O)=O,4,6,18,24,15,0.00028900000000000003
G4,C(CC(C(C=O)=O)O)(C(CO)O)=O,4,3,17,20,1,0.000147
G4,C(C(C(C(C=O)=O)O)O)(CCO)=O,4,7,18,25,3,0.00035800000000000003
G4,C(C(CO)C(C(C(C=O)=O)O)O)=O,8,6,19,25,5,0.00029
G4,C(C(C)=O)(C(CO)O)=O,2,17,41,58,0,0.000833
G4,C(C(CO)=O)(CCO)=O,1,19,46,65,2,0.000926
G4,C(CO)(C(C(CO)=O)CO)=O,1,8,9,17,2,0.00040599999999999995
G4,C(C(CO)O)(C(C)O)=O,4,25,36,61,2,0.001235
G4,C(C(C=O)CO)=O,1,23,109,132,18,0.0011070000000000001
G4,C(C(C(C(CO)O)=O)O)=O,4,12,25,37,2,0.000596
G4,C(C(C(CO)=O)CO)(O)=O,2,17,18,35,2,0.0008460000000000001
G4,C(C(C(CCO)=O)O)(O)=O,2,17,21,38,17,0.0008439999999999999
G4,C(CO)(C(CO)C(C(O)=O)O)=O,4,11,12,23,33,0.000583
G4,C(C)(C(C(C=O)=O)CO)=O,2,10,21,31,2,0.00049
G4,C(C(C(C=O)=O)CO)=O,2,18,33,51,2,0.0008699999999999999
G4,C(C(C(C(C)=O)=O)CO)=O,2,9,20,29,2,0.000443
G4,C(C(C)=O)(CCO)=O,1,20,93,113,14,0.0009630000000000001
G4,C(CC(CCO)=O)=O,1,23,111,134,2,0.001105
G4,C(C(C(C)=O)CO)=O,2,15,79,94,6,0.000728
G4,C(OC(C(CCO)=O)C(CO)O)=O,4,3,7,10,0,0.000144
G4,C1(COC(C1CO)O)=O,4,6,37,43,27,0.00028900000000000003
G4,C1(C(CO)OC(C1)O)=O,4,7,42,49,27,0.000336
G4,C(C(C(OC(C(C)=O)CO)O)O)=O,8,9,13,22,35,0.00043099999999999996
G4,C(C(C(OCC(CCO)=O)O)O)=O,4,8,14,22,2,0.00038199999999999996
G4,C(C(CO)OC(C(CO)=O)CO)=O,4,6,8,14,2,0.000293
G4,C(C(CO)OCC(C(CO)O)=O)=O,4,5,10,15,2,0.000241
G4,C(C(CO)OC(C(CCO)=O)O)=O,4,3,8,11,2,0.000144
G4,C(OC(CO)C(C(CCO)=O)O)=O,4,3,4,7,9,0.000144
G4,C(OC(CO)CC(C(CO)O)=O)=O,4,5,6,11,2,0.000241
G4,C(OC(CO)C(C(CO)=O)CO)=O,4,4,5,9,2,0.000194
G4,C(C(CO)OC(C=O)O)(CCO)=O,4,3,8,11,2,0.000144
G4,C1(COC(C(C1CO)O)O)=O,8,7,13,20,2,0.000348
G4,C(C(COC(C(CO)=O)CO)O)=O,4,4,11,15,36,0.000194
G4,C(C(COCC(C(CO)O)=O)O)=O,4,5,13,18,36,0.000241
G4,C(C(COC(C(CCO)=O)O)O)=O,4,6,10,16,41,0.00028700000000000004
G4,C(OCC(C(C(CCO)=O)O)O)=O,4,5,7,12,28,0.00023999999999999998
G4,C(CO)(C(C(OCC=O)O)CO)=O,4,4,13,17,38,0.000194
G4,C(C(CO)O)(CC(OCC=O)O)=O,4,5,14,19,38,0.000241
G4,C(C(CO)OC(CC(CO)=O)O)=O,4,10,12,22,38,0.000479
G4,C(OCC(CC(C(CO)O)=O)O)=O,4,6,7,13,19,0.00028900000000000003
G4,C(OCC(C(C(CO)=O)CO)O)=O,4,6,7,13,19,0.00028900000000000003
G4,C(C(C(OCC=O)O)O)(CCO)=O,4,3,14,17,19,0.000144
G4,C(C(CO)OC(C(C(C)=O)O)O)=O,8,9,13,22,19,0.00043099999999999996
G4,C(C(COC(C=O)O)O)(CCO)=O,4,6,10,16,2,0.00028700000000000004
G4,C(C(CO)O)(CCOC(C=O)O)=O,4,7,12,19,30,0.000336
G4,C(CO)(C(CO)COC(C=O)O)=O,4,4,10,14,30,0.000194
G4,C=CC(C(CO)O)=O,2,23,85,108,7,0.0011070000000000001
G4,C(CC(CO)(OC(C=O)CO)O)=O,4,7,12,19,40,0.000336
G4,C(C(CO)C(CO)(OCC=O)O)=O,4,4,13,17,40,0.000194
G4,C(C(C(C)(OC(C=O)CO)O)O)=O,8,8,13,21,1,0.000384
G4,C(C(CC(OC(C=O)CO)O)O)=O,8,8,11,19,37,0.000384
G4,C(C(C(CO)O)=O)(C(CO)CO)=O,2,6,11,17,2,0.000304
G4,C(C(C(CO)O)=O)(C(CCO)O)=O,4,6,13,19,2,0.00031099999999999997
G4,C(C(CO)O)(C(C(C(C)O)=O)O)=O,8,6,12,18,2,0.00031099999999999997
G4,C(C(CC(CO)O)O)(C(CO)O)=O,8,7,12,19,29,0.00037
G4,C(C(C(CCO)O)O)(C(CO)O)=O,8,11,13,24,2,0.000583
G4,C(C(CC(C(C=O)=O)CO)O)=O,4,7,17,24,12,0.000346
G4,C(C(C)O)(C(C(C=O)=O)CO)=O,4,6,15,21,24,0.0003
G4,C(C(CO)C(C(C(C)=O)=O)O)=O,4,8,16,24,25,0.000396
G4,C(CC(C(C(CCO)=O)=O)O)=O,2,7,14,21,9,0.00034500000000000004
G4,C(C(C(C(C(C)O)=O)=O)CO)=O,4,5,14,19,4,0.000252
G4,C(C)(CC(C(C(CO)O)=O)=O)=O,2,6,16,22,26,0.0003
G4,C(C)(C(C(C(CO)=O)=O)CO)=O,2,6,14,20,26,0.00028900000000000003
G4,C(CCO)(CC(C(CO)=O)=O)=O,1,8,15,23,2,0.00038199999999999996
G4,C(C)(C(CO)C(C(C=O)=O)O)=O,4,9,18,27,17,0.000443
G4,C(CC(C(C=O)=O)O)(CCO)=O,2,8,17,25,2,0.000393
G4,C(CCC(C(C(CO)O)=O)=O)=O,2,5,15,20,17,0.000241
G4,C(CC(C(C(CO)=O)=O)CO)=O,2,4,15,19,5,0.000192
G4,C(C(CO)CC(C(CO)=O)=O)=O,2,4,15,19,5,0.000192
G4,C(C(CO)CC(C(C=O)=O)O)=O,4,4,17,21,5,0.00020299999999999997
G4,C(C(CO)O)(CC(C(C)=O)=O)=O,2,8,16,24,2,0.000395
G4,C(CO)(C(C(C(C)=O)=O)CO)=O,2,7,14,21,24,0.000336
G4,C(CO)(CC(C(CCO)=O)=O)=O,1,6,15,21,24,0.00028700000000000004
G4,C1(C(CO)OC(C(CC1O)O)O)=O,16,5,9,14,2,0.000252
G4,C(CO)=CC(C(C(CO)O)=O)=O,4,4,12,16,55,0.000194
G4,C(C(CO)O)(C(C=CC=O)O)=O,8,6,13,19,32,0.00028900000000000003
G4,C(C(CO)O)(C(C(C=C)=O)O)=O,4,6,13,19,32,0.0003
G4,C(C=CC(CO)=O)(C(CO)O)=O,4,6,13,19,32,0.00028900000000000003
G4,C(C1(CC(CO1)O)O)(C(CO)O)=O,8,3,9,12,2,0.000146
G4,C(C1C(CC(O1)O)O)(C(CO)O)=O,16,4,10,14,38,0.000194
G4,C(CCO)(CC(C(CO)O)=O)=O,2,9,13,22,2,0.00046699999999999997
G4,C(CCO)(C(C(CO)=O)CO)=O,2,10,11,21,29,0.0005139999999999999
G4,C(C(CO)CO)(CC(CO)=O)=O,1,8,9,17,30,0.00040599999999999995
G4,C(CCC(C(CO)O)=O)(CO)=O,2,9,15,24,29,0.00047599999999999997
G4,C(CO)(C(CO)CC(CO)=O)=O,2,8,14,22,29,0.00041600000000000003
G4,C(C(C(CO)C(CCO)O)=O)=O,4,7,17,24,18,0.00036
G4,C(C(CCO)=O)(C(CO)CO)=O,1,7,10,17,2,0.000361
G4,C(C(CO)CO)(C(C(C)=O)O)=O,2,5,8,13,9,0.00025299999999999997
G4,C(CCO)(C(C(CCO)=O)O)=O,1,3,5,8,29,0.000156
G4,C(C(C(C(CCO)O)=O)CO)=O,4,7,13,20,2,0.000359
G4,C(C(CO)O)(C(C(C)=O)CO)=O,4,10,13,23,2,0.000516
G4,C(C(CO)CC=O)(C(CO)O)=O,4,11,17,28,2,0.000573
G4,C(C(CO)CC(C(CO)O)=O)=O,4,16,17,33,55,0.0008210000000000001
G4,C(C(C(C(CO)CCO)=O)O)=O,4,5,12,17,29,0.000262
G4,C(C(C)=O)(C(CO)C(CO)O)=O,4,10,15,25,14,0.000525
G4,C(C(CCO)=O)(CC(CO)O)=O,2,7,13,20,29,0.00036899999999999997
G4,C(CC(C(CO)C(CO)O)=O)=O,4,9,17,26,44,0.00046699999999999997
G4,C(C(C(CC(CO)O)=O)CO)=O,4,8,15,23,44,0.000407
G4,C(C(CO)C(C=O)O)(CCO)=O,4,6,17,23,29,0.00031099999999999997
G4,C(CC(C=O)O)(C(CO)CO)=O,2,6,12,18,29,0.0003
G4,C(C(CO)O)=CC(C(CO)O)=O,8,7,10,17,29,0.00037
G4,C(C(C(CO)CO)=O)(O)=O,1,5,10,15,7,0.00025299999999999997
G4,C(CCO)(C(C(C(O)=O)=O)CO)=O,2,3,10,13,2,0.00015800000000000002
G4,C(C(CO)CO)(CC(C(O)=O)=O)=O,1,3,7,10,2,0.00015800000000000002
G4,C(CC(C(C(O)=O)=O)CO)(CO)=O,2,2,12,14,29,0.00010800000000000001
G4,C(CO)(C(CO)CC(C(O)=O)=O)=O,2,2,12,14,29,0.00010800000000000001
G4,C(CCC(C(O)=O)=O)(C(CO)O)=O,2,3,12,15,29,0.00015800000000000002
G4,C(C(CC(C(O)=O)=O)O)(CCO)=O,2,5,11,16,29,0.000273
G4,C(C(CO)C(CC(C(O)=O)=O)O)=O,4,6,14,20,18,0.000301
G4,C(CC(C(C(C=O)=O)CO)O)(O)=O,4,5,14,19,28,0.00025299999999999997
G4,C(CC(C(C(CO)CO)=O)=O)(O)=O,1,4,8,12,2,0.000206
G4,C(CC(O)=O)(C(C(CO)=O)CO)=O,2,5,10,15,17,0.00025299999999999997
G4,C(C(CO)C(C(CC(O)=O)=O)O)=O,4,7,16,23,17,0.000349
G4,C(CC(C(C(C=O)CO)=O)O)(O)=O,4,4,11,15,29,0.000205
G4,C(C(C(O)=O)O)(C(C(C)=O)CO)=O,4,5,10,15,2,0.000254
G4,C(C(CO)CC=O)(C(C(O)=O)O)=O,4,5,14,19,17,0.000252
G4,C(C(CO)CC(C(C(O)=O)O)=O)=O,4,5,14,19,17,0.000252
G4,C(C(CO)CC(O)=O)(C(C=O)O)=O,4,2,11,13,29,0.00010800000000000001
G4,C(C(C(C(C(C)=O)=O)CO)O)(O)=O,4,6,12,18,14,0.000312
G4,C(C(CC(C(CCO)=O)=O)O)(O)=O,2,4,9,13,14,0.000215
G4,C(C(CO)C(C(O)=O)O)(CC=O)=O,4,7,14,21,2,0.00037
G4,C(CC(C(O)=O)O)(C(C=O)CO)=O,4,4,12,16,2,0.000205
G4,C(C(CO)C(C=O)O)(CC(O)=O)=O,4,4,16,20,17,0.000205
G4,C(C(C=CC(C(CO)O)=O)O)(O)=O,8,3,8,11,29,0.00015800000000000002
G4,C(C1(C(C(CO)CC1O)=O)O)=O,8,4,13,17,43,0.000192
G4,C(CCO)(C(C=O)(C(C=O)O)O)=O,4,3,15,18,27,0.000146
G4,C(C(C(CCO)=O)(CO)O)=O,2,7,12,19,2,0.00037200000000000004
G4,C(C(C(CCO)=O)(C(C)O)O)=O,4,4,11,15,4,0.000194
G4,C(CCO)(C(CO)(CO)O)=O,1,6,9,15,2,0.00031299999999999996
G4,C(CCO)(C(CO)(C(C)O)O)=O,4,7,12,19,2,0.000363
G4,C(C(CO)O)(C(CO)(CO)O)=O,2,7,9,16,2,0.000362
G4,C(C(CO)O)(C(CO)(C(C)O)O)=O,8,11,14,25,2,0.0005769999999999999
G4,C(C(C(CCO)=O)(C(CO)O)O)=O,4,7,12,19,27,0.000381
G4,C1(C(CO)C(C=O)(C(C1)O)O)=O,8,5,16,21,2,0.000241
G4,C(C1(C(C(C(C1)=O)CO)O)O)=O,8,6,17,23,17,0.00028900000000000003
G4,C(C(C(C=O)(C(C=O)CO)O)O)=O,8,8,18,26,0,0.000398
G4,C(C(CO)(C(C(CO)=O)CO)O)=O,4,9,16,25,2,0.00045700000000000005
G4,C1(C(CO)C(C(C1O)=O)CO)=O,3,2,7,9,2,9.7e-05
G4,C(C(C(C(CO)O)O)=O)(CCO)=O,4,7,14,21,2,0.00035800000000000003
G4,C1(C(CO)CC(C1(CO)O)=O)=O,4,5,11,16,2,0.00024300000000000002
G4,C1(C(CO)C(C(C1)=O)(CO)O)=O,4,8,16,24,2,0.000386
G4,C1(C(CO)(CC(C1CO)=O)O)=O,4,7,13,20,2,0.000338
G4,C1(CC(C(C(CCO)=O)O1)O)=O,4,2,6,8,2,9.7e-05
G4,C(C(CO)C1C(CC(O1)=O)O)=O,8,4,9,13,48,0.000194
G4,C(C1C(C(C(CO)O1)=O)O)(C)=O,8,4,8,12,2,0.000194
G4,C(C1C(C(CO1)=O)O)(CCO)=O,4,2,9,11,2,9.7e-05
G4,C(CC1C(C(C(CO)O1)=O)O)=O,8,4,9,13,2,0.000194
G4,C(C(CO)C1C(C(CO1)=O)O)=O,8,4,11,15,9,0.000194
G4,C(C1C(C(C(O1)O)=O)CO)(C)=O,8,4,9,13,2,0.000194
G4,C1(C(OC(C(CCO)=O)C1)O)=O,4,4,9,13,2,0.000192
G4,C(CC1C(C(C(O)O1)=O)CO)=O,8,4,12,16,2,0.000194
G4,C(C(CO)C1CC(C(O)O1)=O)=O,8,4,12,16,23,0.000194
G4,C1(C(CO)C(OC1C(C)=O)O)=O,8,5,10,15,9,0.000241
G4,C(CCO)(C1C(CC(O1)O)=O)=O,4,4,8,12,2,0.000192
G4,C(CC1C(C(CO)C(O1)O)=O)=O,8,5,14,19,2,0.000241
G4,C(C(CO)C1C(CC(O1)O)=O)=O,8,5,14,19,23,0.000241
G4,C1(C(C(CC(CO)O1)=O)CO)=O,4,5,6,11,19,0.000241
G4,C1(CC(C(CO)C(CO)O1)=O)=O,4,4,7,11,19,0.000194
G4,C1(C(CO)OC(CC1CO)=O)=O,4,5,7,12,2,0.00023999999999999998
G4,C1(C(C(CO)OC(CO)C1)=O)=O,4,3,7,10,2,0.000146
G4,C1(C(COC(CO)C1CO)=O)=O,4,3,8,11,54,0.000146
G4,C1(C(CO)OC(C(C1)=O)CO)=O,3,4,4,8,54,0.000194
G4,C1(C(CO)OCC(C1CO)=O)=O,4,6,8,14,2,0.00028900000000000003
G4,C1(C(C(CC(CO1)O)=O)CO)=O,4,4,8,12,19,0.000194
G4,C1(CC(C(CO)C(CO1)O)=O)=O,4,3,10,13,19,0.000146
G4,C1(C(CO)CC(OCC1O)=O)=O,4,4,7,11,2,0.000192
G4,C1(CC(C(C(CO)CO1)=O)O)=O,4,4,7,11,19,0.000194
G4,C1(CC(C(C(CO1)=O)CO)O)=O,4,3,9,12,2,0.000146
G4,C1(CC(CC(C(CO)O1)=O)O)=O,4,3,6,9,48,0.000146
G4,C1(C(C(CO)OCC(C1)O)=O)=O,4,3,8,11,36,0.000146
G4,C1(C(COCC(C1CO)O)=O)=O,4,3,10,13,36,0.000146
G4,C1(C(COC(C(C1)=O)CO)O)=O,4,5,7,12,36,0.000241
G4,C1(C(COCC(C1CO)=O)O)=O,4,6,7,13,36,0.00028900000000000003
G4,C1(CCOC(C(C1O)=O)CO)=O,4,4,6,10,36,0.000194
G4,C1(C(CO)COCC(C1O)=O)=O,4,3,7,10,36,0.000146
G4,C1(CC(C(C(CO)OC1)=O)O)=O,4,5,7,12,2,0.000241
G4,C1(COCC(C(C1CO)O)=O)=O,4,5,9,14,2,0.000241
G4,C1(CC(C(COC1CO)=O)O)=O,4,4,7,11,2,0.000194
G4,C1(CCOC(C(C1CO)=O)O)=O,4,5,9,14,30,0.000241
G4,C1(C(CO)COC(C(C1)=O)O)=O,4,4,10,14,30,0.000194
G4,C1(CC(C(C(OC1)O)=O)CO)=O,4,3,8,11,12,0.000144
G4,C1(COC(C(CC1CO)=O)O)=O,4,4,8,12,2,0.000192
G4,C1(CCC(C(OC1CO)O)=O)=O,4,5,7,12,12,0.000241
G4,C1(C(CCOC(C1CO)O)=O)=O,4,5,12,17,2,0.000241
G4,C1(C(CC(O)OCC1CO)=O)=O,4,5,11,16,2,0.000241
G4,C1(C(CO)C(OCC(C1)=O)O)=O,4,6,11,17,2,0.00028900000000000003
G4,C1(CC(OCC(C1CO)=O)O)=O,4,6,9,15,38,0.00028900000000000003
G4,C1(CC(OC(C(C1)=O)CO)O)=O,4,6,9,15,2,0.00028900000000000003
G4,C(C(C=CC(CCO)=O)=O)=O,2,4,18,22,2,0.000192
G4,C(C(C=CC(C=O)=O)CO)=O,4,3,14,17,29,0.000144
G4,C(C(C=CC=O)=O)(CCO)=O,2,4,18,22,14,0.000192
G4,C(C(C(C=CC=O)=O)CO)=O,4,6,16,22,2,0.00028900000000000003
G4,C=CC(C(C(C=O)=O)CO)=O,2,5,15,20,2,0.000241
G4,C(C(C(C(C=C)=O)=O)CO)=O,2,5,15,20,2,0.000241
G4,C(C(C(C=O)=O)CO)=CC=O,4,4,14,18,29,0.000192
G4,C1(C(CO)OCC1O)=O,4,7,39,46,27,0.000336
G4,C1(C(O)OCC1CO)=O,4,4,28,32,34,0.000194
G4,C1(C(CO)(O)OC(CO)C1CO)=O,8,4,8,12,0,0.000196
G4,C1(C(CO)OC(CO)(C1CO)O)=O,8,3,11,14,2,0.000146
G4,C(C(CO)C1C(C(CO1)O)=O)=O,8,5,11,16,9,0.000241
G4,C(C(CO)C1(C(CCO1)=O)O)=O,4,5,14,19,2,0.000241
G4,C(CC1(C(C(CO)CO1)=O)O)=O,4,4,12,16,2,0.000194
G4,C(C(CO)C1(CC(CO1)=O)O)=O,4,5,16,21,48,0.000241
G4,C(CC1(C(C(CO1)=O)CO)O)=O,4,5,16,21,2,0.000241
G4,C(CC1(CC(C(CO)O1)=O)O)=O,4,5,13,18,2,0.000241
G4,C(C1C(C(CO)C(C)(O1)O)=O)=O,8,4,12,16,26,0.000194
G4,C1(C(C)(OC(C=O)C1CO)O)=O,8,3,9,12,14,0.000146
G4,C1(C(CO)(O)OCC(C1CO)O)=O,8,4,10,14,2,0.000196
G4,C1(C(COC(CO)(C1CO)O)O)=O,8,4,10,14,2,0.000194
G4,C1(C(C(CO)(O)OCC1CO)O)=O,8,3,10,13,2,0.000146
G4,C1(COC(CO)(C(C1CO)O)O)=O,8,3,10,13,2,0.000146
G4,C1(C(CO)OC(C(C1)O)(CO)O)=O,8,4,8,12,2,0.000194
G4,C1(C(CO)C(C=O)(O)OCC1)=O,4,4,14,18,2,0.000194
G4,C1(CC(C=O)(O)OCC1CO)=O,4,3,12,15,30,0.000146
G4,C(C1(CC(C(CO1)=O)CO)O)=O,4,3,9,12,12,0.000144
G4,C1(C(CO)OC(C=O)(CC1)O)=O,4,4,8,12,12,0.000194
G4,C(C1C(C(CO)CC(O1)O)=O)=O,8,2,9,11,2,9.7e-05
G4,C1(C(CO)C(C=O)OC(C1)O)=O,8,3,13,16,2,0.000146
G4,C1(CC(C=O)OC(C1CO)O)=O,8,5,13,18,2,0.000241
G4,C1(C(C(CO)C(C(CO)O)O1)=O)=O,8,4,8,12,27,0.000194
G4,C1(C(C(C(C(CO)O)O1)=O)CO)=O,8,4,8,12,2,0.000194
G4,C1(C(C(C(C(CCO)=O)O1)O)O)=O,8,1,8,9,2,4.9e-05
G4,C(C(CO)C1C(C(C(O1)=O)O)O)=O,16,2,11,13,27,9.9e-05
G4,C1(C(C(CO)C(C(CO)O1)O)=O)=O,8,3,9,12,50,0.000146
G4,C1(C(C(C(C(CO)O1)O)=O)CO)=O,8,3,6,9,2,0.000146
G4,C1(C(C(C(CO)C(CO)O1)=O)O)=O,8,3,6,9,50,0.000146
G4,C1(C(CO)OC(C(C1CO)O)=O)=O,8,3,9,12,2,0.000146
G4,C1(C(C(CO)C(C(CO1)O)O)=O)=O,8,2,12,14,27,9.9e-05
G4,C1(C(C(C(C(CO1)O)O)=O)CO)=O,8,2,10,12,2,9.9e-05
G4,C1(C(C(C(CO)C(CO1)O)=O)O)=O,8,2,9,11,2,9.9e-05
G4,C1(C(CO)C(C(OCC1O)=O)O)=O,8,2,9,11,2,9.9e-05
G4,C1(C(C(C(OCC1CO)=O)O)O)=O,8,3,10,13,2,0.000146
G4,C1(C(C(C(C(CO1)=O)CO)O)O)=O,8,2,11,13,2,9.9e-05
G4,C1(C(C(CC(C(CO)O1)=O)O)O)=O,8,2,8,10,2,9.9e-05
G4,C1C(C(OC(C(C=1)=O)CO)O)O,8,4,7,11,2,0.000194
G4,C1(C(CO)OC(C(CO)O)(C1)O)=O,8,4,10,14,2,0.000205
G4,C1(COC(C(CO)O)(C1CO)O)=O,8,4,12,16,2,0.000205
G4,C(C1CC(C(O1)O)O)(C(CO)O)=O,16,4,10,14,32,0.000194
G4,C1(C(CO)OC(CCO)(C1O)O)=O,8,3,10,13,2,0.000146
G4,C1(C(CO)OC(CC1O)(CO)O)=O,8,3,8,11,32,0.000146
G4,C1(C(CO)OC(C(C1O)O)(C)O)=O,16,3,10,13,24,0.000146
G4,C1(C(CO)OC(CC(C1O)O)O)=O,16,4,10,14,38,0.000205
G4,C(C(C(CO)C(CC(C)O)O)=O)=O,8,6,14,20,3,0.000301
G4,C(C(C(C)O)C(C(CCO)=O)O)=O,8,8,15,23,4,0.000407
G4,C(C(C(C)O)C(C=O)(CCO)O)=O,8,7,14,21,3,0.00035800000000000003
G4,C(C(CO)(C(C(C=O)=O)CO)O)=O,4,7,16,23,2,0.00035
G4,C(C(C(C(C=O)=O)CO)O)(CO)=O,4,8,18,26,5,0.000396
G4,C(C(CCO)(C(C(C=O)=O)O)O)=O,4,6,15,21,1,0.000308
G4,C(C(C=O)C(C(CCO)=O)O)=O,2,10,13,23,2,0.0005
G4,C(C(C=O)C(C=O)(CCO)O)=O,2,6,12,18,3,0.000308
G4,C(C(C)(C(C(C=O)=O)CO)O)(O)=O,4,7,14,21,29,0.00036
G4,C(C(CCO)(CC(C(O)=O)=O)O)=O,2,5,11,16,29,0.000271
G4,C(C(C(C=O)=O)CO)(O)=O,2,13,17,30,17,0.0006450000000000001
G4,C(C(C(C(C=O)=O)CO)O)(O)=O,4,8,17,25,33,0.000407
G4,C(C)(C(C)(C(C(C=O)=O)CO)O)=O,4,6,13,19,14,0.000301
G4,C(C(CC(C(C)=O)=O)O)(CCO)=O,2,4,12,16,14,0.000215
G4,C(C(CCO)(CC(C(C)=O)=O)O)=O,2,4,10,14,14,0.000213
G4,C(CC(C)(C(C(C=O)=O)CO)O)=O,4,7,16,23,6,0.00035
G4,C(C)(CC(C(C(C=O)=O)CO)O)=O,4,7,16,23,23,0.000349
G4,C(CC(C(CCO)=O)O)(CC=O)=O,2,6,15,21,30,0.00031
G4,C(C(CCO)(CC(CC=O)=O)O)=O,2,4,11,15,34,0.000213
G4,C(C)(C(C=O)C(C(CCO)=O)O)=O,4,5,14,19,3,0.000263
G4,C(C(CCO)(C(C=O)C(C)=O)O)=O,4,5,11,16,3,0.000261
G4,C=CC(C(C(C(C=O)=O)CO)O)=O,4,6,13,19,7,0.000301
G4,C(C(C=C)(C(C(C=O)=O)CO)O)=O,4,6,11,17,7,0.000301
G4,C=CC(CO)(C(C(C=O)=O)CO)O,4,7,12,19,7,0.00036
G4,C(C(C(C(C=C)=O)O)O)(CCO)=O,4,7,16,23,3,0.00035800000000000003
G4,C(C(CCO)(C(C(C=C)=O)O)O)=O,4,6,13,19,7,0.000308
G4,C(C(C(C(C=O)=O)CO)O)=CC=O,8,6,11,17,20,0.000301
G4,C(C(C(CO)C(C(C)O)O)=O)=O,8,8,18,26,11,0.000407
G4,C(C(C(CCO)O)O)(CCO)=O,4,6,11,17,3,0.000321
G4,C(CO)(C(CO)C(CCO)O)=O,4,7,11,18,18,0.000371
G4,C(C(C(CC(C)O)O)O)(CCO)=O,8,5,11,16,3,0.000262
G4,C(CO)(C(CO)C(CC(C)O)O)=O,8,6,11,17,3,0.000312
G4,C(C(C(C)O)C(CO)(CCO)O)=O,8,7,13,20,3,0.00036899999999999997
G4,C(C(C(C(CO)(CCO)O)O)=O)=O,4,6,14,20,3,0.000319
G4,C(C(C=O)C(CO)(CCO)O)=O,2,6,11,17,3,0.000319
G4,C(C(C)(C(C(CCO)=O)O)O)(O)=O,4,8,11,19,3,0.00042699999999999997
G4,C(C(C)(C(C(CO)=O)CO)O)(O)=O,4,9,12,21,3,0.00047699999999999994
G4,C(C(CC(CO)(CCO)O)=O)(O)=O,2,5,11,16,29,0.000283
G4,C(C)(C(C)(C(C(CCO)=O)O)O)=O,4,5,13,18,14,0.000262
G4,C(C)(C(C)(C(C(CO)=O)CO)O)=O,4,6,13,19,14,0.000312
G4,C(C(C)=O)(CC(CO)(CCO)O)=O,2,5,10,15,14,0.00028199999999999997
G4,C(CC(C)(C(C(CCO)=O)O)O)=O,4,6,13,19,3,0.00031099999999999997
G4,C(CC(C)(C(C(CO)=O)CO)O)=O,4,7,15,22,3,0.000361
G4,C(C(C(CC(C)=O)O)O)(CCO)=O,4,6,13,19,3,0.00031
G4,C(C)(CC(C(C(CO)=O)CO)O)=O,4,7,14,21,3,0.00036
G4,C(CC(CC(CO)(CCO)O)=O)=O,2,5,10,15,29,0.00028199999999999997
G4,C(C(C(C)=O)C(CO)(CCO)O)=O,4,5,11,16,3,0.000272
G4,C(CO)(C(CO)C(C(C=C)=O)O)=O,4,6,15,21,7,0.000312
G4,C(C(C=C)(C(C(CCO)=O)O)O)=O,4,7,12,19,7,0.00036899999999999997
G4,C(C(C=C)(C(C(CO)=O)CO)O)=O,4,6,12,18,7,0.000312
G4,C(C(C(C=C)(CO)O)O)(CCO)=O,4,6,8,14,7,0.000321
G4,C(CO)(C(CO)C(C=C)(CO)O)=O,4,7,9,16,7,0.000371
G4,C=CC(C(C(CO)(CCO)O)O)=O,4,5,12,17,7,0.000272
G4,C(C(C(C=CC=O)O)O)(CCO)=O,8,8,14,22,43,0.00042699999999999997
G4,C(CO)(C(CO)C(C=CC=O)O)=O,8,6,12,18,43,0.000312
G4,C(C(C(C(C)O)O)O)(CCO)=O,8,5,12,17,11,0.000263
G4,C(CO)(C(CO)C(C(C)O)O)=O,8,6,12,18,11,0.000312
G4,C(C(C(C(C=O)O)O)C(C)O)=O,16,8,19,27,0,0.00038500000000000003
G4,C(C(C(C(C(C=O)=O)O)O)O)=O,8,7,23,30,5,0.000335
G4,C(C(C(C(C(C(C)=O)=O)O)O)O)=O,8,6,19,25,25,0.00028700000000000004
G4,C(C(C(CC(C(CO)=O)=O)O)O)=O,4,5,17,22,1,0.00023999999999999998
G4,C(C(C=O)C(C(C=O)O)O)=O,4,9,17,26,1,0.00043
G4,C(C(C(CC(C(O)=O)=O)O)O)=O,4,6,15,21,5,0.000298
G4,C(C(C(C=O)=O)C(C(C=O)O)O)=O,8,5,17,22,23,0.00023999999999999998
G4,C(CC(C(C=O)O)O)(CC=O)=O,4,12,21,33,0,0.000605
G4,C(C(C(C(C=O)C(C)=O)O)O)=O,8,11,18,29,1,0.000547
G4,C(C(C(C1C(COC1O)=O)O)O)=O,16,4,17,21,35,0.00019099999999999998
G4,C(C(C(C1C(CC(O1)O)=O)O)O)=O,16,4,14,18,35,0.00019099999999999998
G4,C(C(C(C(C(C=C)=O)O)O)O)=O,8,13,18,31,0,0.000664
G4,C(C(C(C1C(C(CO1)O)=O)O)O)=O,16,3,13,16,10,0.000143
G4,C(C(C(C1C(C(O)OC1)=O)O)O)=O,16,4,14,18,34,0.00019099999999999998
G4,C(CC(C(CC(C)O)=O)O)(CO)=O,4,3,13,16,4,0.000156
G4,C(C(CC(C)O)(CC(CO)=O)O)=O,4,2,12,14,49,0.00010700000000000001
G4,C(C(CC(C)O)(C(C(C)=O)O)O)=O,8,3,13,16,4,0.000144
G4,C(C(C(C(C)O)C(C)(CO)O)=O)=O,8,5,14,19,49,0.000252
G4,C(CC(C(C)(CC(CO)=O)O)O)=O,4,3,16,19,4,0.000156
G4,C(CC(C(C)(C(C(C)=O)O)O)O)=O,8,3,17,20,45,0.000145
G4,C(C)(C(CC(CC(CO)=O)O)O)=O,4,2,14,16,49,0.00010700000000000001
G4,C(C)(C(C(CC(C(C)=O)O)O)O)=O,8,2,16,18,45,9.6e-05
G4,C(CC(C(CC(CO)(C)O)=O)O)=O,4,3,12,15,49,0.000156
G4,C(CC(C)(C(CC(CO)=O)O)O)=O,4,3,16,19,29,0.000156
G4,C(CC(C)(C(C(C(C)=O)O)O)O)=O,8,5,18,23,45,0.000251
G4,C(C(C)(CC(CC(CO)=O)O)O)=O,4,2,13,15,49,0.00010700000000000001
G4,C(C(C)(CC(C(C(C)=O)O)O)O)=O,8,2,15,17,45,9.6e-05
G4,C(CO)(CC(CCO)O)=O,2,17,20,37,18,0.0008300000000000001
G4,C(C)(C(C(CCO)O)O)=O,4,17,19,36,18,0.000831
G4,C(CO)(CC(CO)(CC(C)O)O)=O,4,3,9,12,49,0.000166
G4,C(C)(C(C(CO)(CC(C)O)O)O)=O,8,3,10,13,11,0.000155
G4,C(CO)(C(C(C)O)C(CO)(C)O)=O,8,6,11,17,49,0.00031099999999999997
G4,C(C(C(CO)(C)O)O)(CC(C)O)=O,8,4,10,14,11,0.000204
G4,C(CO)(CC(C)(C(C(C)O)O)O)=O,8,2,10,12,49,0.00010700000000000001
G4,C(C)(C(C(C)(C(C(C)O)O)O)O)=O,16,2,11,13,49,9.6e-05
G4,C(C(C(C)O)O)(CC(CO)(C)O)=O,8,4,11,15,49,0.000204
G4,C(CO)(CC(CC(CO)(C)O)O)=O,4,3,9,12,49,0.000165
G4,C(C)(C(C(CC(CO)(C)O)O)O)=O,8,3,11,14,49,0.000155
G4,C(C(C(C)(CO)O)C(C)(CO)O)=O,3,3,7,10,49,0.000155
G4,C(CO)(CC(CC(C)O)O)=O,4,6,12,18,28,0.000297
G4,C(C)(C(C(CC(C)O)O)O)=O,8,6,13,19,28,0.000286
G4,C(C(C(C)O)C(C)(CO)O)=O,8,5,14,19,49,0.000252
G4,C(CO)(CC(C(C(C)O)O)O)=O,8,3,11,14,49,0.000165
G4,C(C)(C(C(C(C(C)O)O)O)O)=O,16,5,13,18,28,0.000261
G4,C(CO)(CC(CC(CO)O)O)=O,4,4,10,14,29,0.00022400000000000002
G4,C(C)(C(C(CC(CO)O)O)O)=O,8,4,12,16,49,0.000213
G4,C(C(C(C(CO)(C)O)O)=O)=O,4,7,16,23,49,0.00034500000000000004
G4,C(C)(C(CO)(CC(CO)=O)O)=O,2,7,13,20,45,0.000368
G4,C(CO)(C(C)(CC(CO)=O)O)=O,2,6,12,18,25,0.000297
G4,C(CO)(C(C)(C(C(C)=O)O)O)=O,4,7,13,20,25,0.000356
G4,C(C(C)=O)(C(C(CO)(C)O)O)=O,4,4,12,16,49,0.000202
G4,C(C(CO)=O)(CC(CO)(C)O)=O,2,4,11,15,25,0.000202
G4,C(CC(C(C(C)O)=O)O)(CO)=O,4,9,12,21,49,0.00045
G4,C(CO)(CC(CO)(C(C)O)O)=O,4,5,9,14,29,0.000283
G4,C(C)(C(C(CO)(C(C)O)O)O)=O,8,5,10,15,25,0.000272
G4,C(C(C(CO)(C)O)O)(C(C)O)=O,8,4,9,13,25,0.000213
G4,C(C(C=O)C(C)(CO)O)=O,2,5,13,18,49,0.00025
G4,C(C(C(C(C(CO)(C)O)O)=O)O)=O,8,4,13,17,49,0.000202
G4,C(CO)(CC(C(CCO)O)O)=O,4,3,10,13,29,0.000166
G4,C(C)(C(C(C(CCO)O)O)O)=O,8,5,12,17,29,0.000261
G4,C(C(C)(CC(CO)=O)O)(O)=O,2,10,12,22,28,0.000509
G4,C(C(C)(C(C(C)=O)O)O)(O)=O,4,10,12,22,28,0.000499
G4,C(C(CC(C)(CO)O)=O)(O)=O,2,5,11,16,29,0.00026000000000000003
G4,C(CC(CO)(CC(CO)=O)O)(O)=O,2,5,9,14,29,0.000271
G4,C(CC(CO)(C(C(C)=O)O)O)(O)=O,4,4,10,14,29,0.00021400000000000002
G4,C(C(C(C)(CC(CO)=O)O)O)(O)=O,4,4,10,14,33,0.000213
G4,C(C(C(C)(C(C(C)=O)O)O)O)(O)=O,8,6,11,17,49,0.00032
G4,C(CC(C(CC(CO)=O)O)O)(O)=O,4,3,10,13,29,0.000166
G4,C(CC(C(C(C(C)=O)O)O)O)(O)=O,8,3,13,16,29,0.000155
G4,C(C)(CC(C(CC(CO)=O)O)=O)=O,2,2,15,17,26,0.00010700000000000001
G4,C(C)(CC(C(C(C(C)=O)O)O)=O)=O,4,4,17,21,26,0.000192
G4,C(C(CC(C)=O)(CC(CO)=O)O)=O,2,3,14,17,27,0.000155
G4,C(C(CC(C)=O)(C(C(C)=O)O)O)=O,4,4,14,18,26,0.000192
G4,C(CO)(CC(C)(CC(C=O)=O)O)=O,2,3,15,18,26,0.000155
G4,C(C)(C(C(C)(CC(C=O)=O)O)O)=O,4,3,15,18,49,0.000144
G4,C(C)(C(C(C=O)=O)C(C)(CO)O)=O,4,3,11,14,26,0.000155
G4,C(CC(C)(CO)O)(CC(C=O)=O)=O,2,2,11,13,49,0.00010700000000000001
G4,C(CC(C(CC(CO)=O)O)=O)=O,2,13,19,32,20,0.000629
G4,C(CC(C=O)(CC(CO)=O)O)=O,2,10,17,27,51,0.000488
G4,C(C(C(C=O)=O)C(C)(CO)O)=O,4,6,17,23,49,0.000297
G4,C(CC(C(C)=O)(CC(CO)=O)O)=O,2,4,14,18,24,0.00020299999999999997
G4,C(CC(C(C)=O)(C(C(C)=O)O)O)=O,4,4,14,18,14,0.000193
G4,C(C(C)(CC(CO)=O)O)(CC=O)=O,2,2,15,17,14,0.00010700000000000001
G4,C(C(C)(C(C(C)=O)O)O)(CC=O)=O,4,3,16,19,14,0.000144
G4,C(C(C(C(C)=O)=O)C(C)(CO)O)=O,4,3,11,14,14,0.000155
G4,C(CC(C(CC(C)(CO)O)=O)=O)=O,2,2,11,13,49,0.00010700000000000001
G4,C(C)(C(C)(CC(CO)=O)O)=O,2,7,15,22,14,0.000344
G4,C(C)(C(C)(C(C(C)=O)O)O)=O,4,7,15,22,14,0.000333
G4,C(C(C)=O)(CC(C)(CO)O)=O,2,3,13,16,49,0.000154
G4,C(CC(C)(CC(CO)=O)O)=O,2,9,19,28,6,0.00044
G4,C(CC(C)(C(C(C)=O)O)O)=O,4,9,18,27,6,0.00043
G4,C(C)(CC(CC(CO)=O)O)=O,2,9,19,28,6,0.000439
G4,C(C)(CC(C(C(C)=O)O)O)=O,4,9,19,28,49,0.000429
G4,C(CC(CC(C)(CO)O)=O)=O,2,5,16,21,49,0.00024900000000000004
G4,C(C(C(C)=O)C(C)(CO)O)=O,4,6,14,20,49,0.000297
G4,C(CO)(CC1(COC(C1)O)O)=O,4,4,8,12,49,0.000202
G4,C(C)(C(C1(COC(C1)O)O)O)=O,8,3,9,12,49,0.000144
G4,C1(COC(C1C(CO)(C)O)O)=O,8,5,11,16,49,0.00025
G4,C1(C(C(CO)(C)O)OC(C1)O)=O,8,4,9,13,49,0.000202
G4,C(CO)(CC(C=CC(CO)=O)O)=O,4,2,11,13,49,0.00010700000000000001
G4,C(C)(C(C(C=CC(CO)=O)O)O)=O,8,2,12,14,49,9.6e-05
G4,C(CC(C=CC=O)(CO)O)(CO)=O,4,2,11,13,49,0.00010700000000000001
G4,C(C(C(C=CC=O)(CO)O)O)(C)=O,8,2,11,13,49,9.6e-05
G4,C(C=CC(C(C(CO)(C)O)O)=O)=O,8,3,14,17,49,0.000155
G4,C(CO)(CC(C(C=C)=O)O)=O,2,9,18,27,7,0.000439
G4,C(C(C=C)(CC(CO)=O)O)=O,2,8,15,23,7,0.000392
G4,C(C(C=C)(C(C(C)=O)O)O)=O,4,9,15,24,7,0.000429
G4,C(CC(C=C)(CO)O)(CO)=O,2,9,12,21,7,0.00045
G4,C(C(C(C=C)(CO)O)O)(C)=O,4,9,12,21,7,0.00044
G4,C=CC(C(C(CO)(C)O)O)=O,4,5,14,19,7,0.00025
G4,C(CO)(CC(C=CC=O)O)=O,4,8,18,26,43,0.000392
G4,C(C)(C(C(C=CC=O)O)O)=O,8,8,18,26,43,0.000381
G4,C(CO)(CC(C(C)O)O)=O,4,15,21,36,11,0.000724
G4,C(C)(C(C(C(C)O)O)O)=O,8,16,20,36,11,0.000772
G4,C(C(CCO)(CC(CO)=O)O)(O)=O,2,5,10,15,29,0.000271
G4,C(C(CCO)(C(C(C)=O)O)O)(O)=O,4,5,11,16,7,0.000262
G4,C(C(C(CO)C(C)(CO)O)=O)(O)=O,4,6,13,19,29,0.000312
G4,C(C(CC(CC(CO)=O)O)O)(O)=O,4,6,10,16,29,0.00033
G4,C(C(CC(C(C(C)=O)O)O)O)(O)=O,8,5,13,18,49,0.000272
G4,C(CO)(CC(C(CO)(CO)O)O)=O,2,8,7,15,29,0.000436
G4,C(C)(C(C(C(CO)(CO)O)O)O)=O,4,9,9,18,41,0.000484
G4,C(CO)(CC1(COCC1O)O)=O,4,2,6,8,10,0.00010700000000000001
G4,C(C)(C(C1(COCC1O)O)O)=O,8,2,7,9,10,9.6e-05
G4,C1(C(C(CO)(C)O)OCC1O)=O,8,3,6,9,10,0.000155
G4,C(CO)(CC1(C(O)OCC1)O)=O,4,3,8,11,34,0.000154
G4,C(C)(C(C1(C(O)OCC1)O)O)=O,8,3,9,12,34,0.000144
G4,C1(C(O)OCC1C(CO)(C)O)=O,8,4,9,13,49,0.000202
G4,C(C(C(CCO)O)C(C=O)O)=O,8,6,17,23,43,0.000298
G4,C(C(C(CC(C)O)O)C(C=O)O)=O,16,5,15,20,43,0.000239
G4,C(C(C(C(CC=O)O)O)C(C)O)=O,16,7,19,26,43,0.000359
G4,C(C(C(C)O)C(CC(C=O)O)O)=O,16,6,17,23,43,0.000299
G4,C(CC(C(C(C(C=O)=O)O)O)O)=O,8,7,23,30,43,0.000346
G4,C(C(CC(C(C(C=O)=O)O)O)O)=O,8,8,20,28,5,0.00040300000000000004
G4,C(CC(C(C=O)C(C=O)O)O)=O,8,8,22,30,43,0.000383
G4,C(C(C=O)C(C(CC=O)O)O)=O,4,9,18,27,43,0.000463
G4,C(C(C=O)C(CC(C=O)O)O)=O,4,5,15,20,43,0.00024900000000000004
G4,C(C(C)(C(C=O)C(C=O)O)O)(O)=O,8,7,15,22,28,0.000357
G4,C(CC(C(CC(C(O)=O)=O)O)O)=O,4,4,16,20,29,0.00021400000000000002
G4,C(C(CC(CC(C(O)=O)=O)O)O)=O,4,4,14,18,29,0.000213
G4,C(C(C=O)C(C=O)O)(O)=O,4,17,20,37,43,0.0008210000000000001
G4,C(C)(C(C)(C(C=O)C(C=O)O)O)=O,8,6,14,20,14,0.00028700000000000004
G4,C(C(CC(CC(C(C)=O)=O)O)O)=O,4,6,15,21,21,0.000296
G4,C(CC(C)(C(C=O)C(C=O)O)O)=O,8,6,18,24,6,0.000288
G4,C(C)(CC(C(C=O)C(C=O)O)O)=O,8,7,18,25,6,0.000335
G4,C(CC(CC(C=O)O)O)(CC=O)=O,4,5,16,21,6,0.00024900000000000004
G4,C(CC(C(C(C=O)C(C)=O)O)O)=O,8,6,18,24,6,0.00032
G4,C(C(CC(C(C=O)C(C)=O)O)O)=O,8,5,15,20,6,0.00024900000000000004
G4,C(C(C(C=O)C(C(C=C)=O)O)O)=O,8,5,14,19,7,0.000239
G4,C(C(C=C)(C(C=O)C(C=O)O)O)=O,8,5,12,17,7,0.000239
G4,C(C(C(C=O)C(C=C)(CO)O)O)=O,8,6,13,19,7,0.000298
G4,C(C(CC(C(C(C=C)=O)O)O)O)=O,8,8,18,26,7,0.000392
G4,C(C(C(C=O)C(C=CC=O)O)O)=O,16,5,13,18,43,0.000239
G4,C(C(C(C(C)O)O)C(C=O)O)=O,16,6,18,24,43,0.00028700000000000004
G4,C(C(C=O)C(C(C(C=O)O)O)O)=O,8,11,18,29,0,0.000558
G4,C(CC1(CC(C(C1O)O)O)O)=O,16,1,17,18,4,4.9e-05
G4,C(CC1(C(CO)C(C(C1)=O)O)O)=O,8,2,15,17,30,9.6e-05
G4,C(C1(C(C(CC1)(CC=O)O)O)O)=O,8,2,17,19,29,9.6e-05
G4,C(C1(CC(C(C1)O)(CC=O)O)O)=O,8,1,18,19,22,4.9e-05
G4,C(CC(C1C(CC(C1O)=O)O)O)=O,16,3,18,21,4,0.000144
G4,C1(C(C(C(C1)O)CO)(CC=O)O)=O,8,2,15,17,4,9.6e-05
G4,C(CC(C1C(C(C(C1)=O)O)O)O)=O,16,5,21,26,18,0.000239
G4,C(CC1(C=CC(C(C1O)O)O)O)=O,16,1,11,12,32,4.9e-05
G4,C(CC(CO)(C(C(C)O)O)O)=O,8,2,13,15,4,0.00010800000000000001
G4,C(C(C(C)O)O)(C(C(C)O)O)=O,10,3,6,9,2,0.000145
G4,C(CC(CC(CO)(CO)O)O)=O,2,2,10,12,4,0.00010800000000000001
G4,C(CC(CC(C(CO)O)O)O)=O,8,4,13,17,29,0.000225
G4,C(C(C)(CC(C=O)(CC=O)O)O)=O,4,1,13,14,4,4.9e-05
G4,C(C(CC(C=O)(CC=O)O)O)=O,4,5,18,23,20,0.000239
G4,C(C(CC(CO)(C)O)(CC=O)O)=O,4,2,12,14,4,0.00010800000000000001
G4,C(CC(CO)(CC(C(C)=O)O)O)=O,4,2,15,17,29,0.00010800000000000001
G4,C(C(C)(CC(CO)(CC=O)O)O)=O,4,2,14,16,4,0.00010800000000000001
G4,C(C(C)(C(C(C)(CC=O)O)O)O)=O,8,2,15,17,11,9.7e-05
G4,C(CC(C(CC(C)O)=O)O)=O,4,7,18,25,4,0.000335
G4,C(C(CC(C)O)(CC=O)O)=O,4,3,14,17,4,0.000144
G4,C(C(C(C(C)O)C(C)O)=O)=O,3,4,11,15,4,0.000192
G4,C(CC(C(C)(CC=O)O)O)=O,4,7,22,29,45,0.000335
G4,C(CC(CC(C(C)=O)O)O)=O,4,5,19,24,45,0.000239
G4,C(C(C)(CC(CC=O)O)O)=O,4,3,16,19,18,0.000144
G4,C(CC(C(CO)O)(CC=O)O)=O,2,4,10,14,4,0.000213
G4,C(C(C(C(C(C)O)O)=O)C(C)O)=O,16,5,13,18,4,0.00024300000000000002
G4,C(CC(C(C(C)O)O)(CC=O)O)=O,4,1,9,10,4,4.9e-05
G4,C(CC(CC(CO)(CC=O)O)O)=O,4,4,17,21,4,0.000215
G4,C(CC(CC(CC(CO)=O)O)O)=O,4,4,16,20,29,0.00020299999999999997
G4,C(CC(CCO)(C(C=O)O)O)=O,4,4,16,20,0,0.000193
G4,C(CC(CC(C)O)(C(C=O)O)O)=O,8,3,14,17,4,0.000146
G4,C(C(C(C(C(C)O)C(C)O)=O)O)=O,6,2,8,10,4,9.8e-05
G4,C(CC(C)(C(C(CC=O)O)O)O)=O,8,3,18,21,4,0.000156
G4,C(CC(CC(C(C(C)=O)O)O)O)=O,8,3,18,21,4,0.000145
G4,C(CC(CC(C)(C(C=O)O)O)O)=O,8,3,18,21,4,0.000146
G4,C(CC(CCO)(C(CO)O)O)=O,4,4,13,17,29,0.000225
G4,C(CC(CC(C)O)(C(CO)O)O)=O,8,2,12,14,4,0.00010800000000000001
G4,C(C(CO)O)(C(C(C)O)C(C)O)=O,6,5,9,14,4,0.00025499999999999996
G4,C(CC(CC(C)(C(CO)O)O)O)=O,8,2,11,13,4,0.00010800000000000001
G4,C(C(C(CO)CO)(CC=O)O)=O,2,3,11,14,29,0.000166
G4,C(CC(CO)(C(CO)CO)O)=O,2,3,10,13,29,0.000166
G4,C(CC(C(CO)C(C=O)O)O)=O,8,4,18,22,43,0.000202
G4,C(CC(CCO)O)=O,2,21,67,88,18,0.001009
G4,C(CC(C(CO)O)(C(CO)O)O)=O,3,5,8,13,4,0.000283
G4,C(CC(C(C(CO)C(C)O)=O)O)=O,8,7,14,21,4,0.00035099999999999997
G4,C(C(C(CO)C(C)O)(CC=O)O)=O,8,2,12,14,4,0.00010800000000000001
G4,C(CC(C(CCO)(CC=O)O)O)=O,4,4,17,21,4,0.000215
G4,C(CC(CC(C(CCO)=O)O)O)=O,4,4,15,19,4,0.000204
G4,C(C(CCO)(CC(CC=O)O)O)=O,4,2,13,15,4,0.00010800000000000001
G4,C(CC(CCO)(C(C(C)O)O)O)=O,8,2,12,14,4,0.00010800000000000001
G4,C(C(C(C)O)O)(C(CO)C(C)O)=O,16,7,13,20,4,0.00035299999999999996
G4,C(CC(CO)(C(CO)C(C)O)O)=O,8,3,11,14,4,0.000166
G4,C(CC(CC(CO)(CCO)O)O)=O,4,3,10,13,4,0.000166
G4,C(CC(C(C(CC=O)O)O)O)=O,3,3,11,14,4,0.000155
G4,C(CC(CC(C(C=O)O)O)O)=O,8,7,21,28,45,0.00035800000000000003
G4,C(CC(CO)(CC(C)(CO)O)O)=O,4,3,11,14,4,0.000166
G4,C(CC(C)(C(C(C)(CO)O)O)O)=O,8,2,11,13,4,0.00010800000000000001
G4,C(CC(CO)(CC(C)O)O)=O,4,4,13,17,11,0.000202
G4,C(CO)(C(C(C)O)C(C)O)=O,3,7,9,16,4,0.000346
G4,C(C(C(C)O)O)(CC(C)O)=O,8,8,14,22,4,0.000384
G4,C(CC(C)(C(C(C)O)O)O)=O,8,3,14,17,4,0.000144
G4,C(CC(CC(C)(CO)O)O)=O,4,4,13,17,18,0.000202
G4,C(CC(C(C(C)O)C(C=O)O)O)=O,16,2,16,18,4,9.6e-05
G4,C(CC(C(CC(CC=O)O)O)O)=O,8,2,18,20,4,9.8e-05
G4,C(CC(CC(CC(C=O)O)O)O)=O,8,2,15,17,4,9.6e-05
G4,C(CC(CC(C)O)O)=O,4,10,32,42,28,0.00047599999999999997
G4,C(C(C(C)O)C(C)O)=O,3,4,21,25,4,0.000193
G4,C(CC(C(C(CO)(CO)O)O)O)=O,4,9,10,19,29,0.000495
G4,C(CC(CO)(C(C(CO)O)O)O)=O,8,9,13,22,29,0.000517
G4,C(CC(C(C(C(CO)O)O)O)O)=O,16,9,14,23,4,0.000517
G4,C(C(C)(C(C(CC=O)O)O)O)=O,8,5,18,23,45,0.000261
G4,C(C(CC(CO)O)(CC=O)O)=O,4,3,15,18,4,0.000166
G4,C(CC(C(C(C)(CO)O)O)O)=O,8,4,13,17,4,0.000213
G4,C(CC(CO)(CC(CO)O)O)=O,4,3,13,16,4,0.000166
G4,C(CC(C)(C(C(CO)O)O)O)=O,8,6,14,20,29,0.000331
G4,C(CC(C(C(C)O)O)O)=O,8,9,19,28,28,0.00045099999999999996
G4,C(CC(CC(CO)O)O)=O,4,9,18,27,6,0.00045099999999999996
G4,C(C(C(C(C)O)O)=O)=O,4,16,37,53,0,0.000773
G4,C(CC(CC(C(CO)=O)O)O)=O,4,5,16,21,41,0.00025
G4,C(CC(C(CO)(CC=O)O)O)=O,4,8,20,28,29,0.00042699999999999997
G4,C(CC(C(C(C(C)O)O)=O)O)=O,8,8,16,24,4,0.00040599999999999995
G4,C(C)(C(CO)(CC=O)O)=O,2,14,22,36,25,0.0006900000000000001
G4,C(CO)(C(C)(CC=O)O)=O,2,8,24,32,25,0.000381
G4,C(C(C)=O)(C(C(C)O)O)=O,4,7,21,28,4,0.000346
G4,C(C(CO)=O)(CC(C)O)=O,2,3,22,25,4,0.000144
G4,C(C(C(C)O)O)(CC(CO)=O)=O,4,7,12,19,4,0.000346
G4,C(CO)(C(C(CO)=O)C(C)O)=O,2,4,7,11,27,0.000192
G4,C(C(C(C)O)O)(C(C(C)=O)O)=O,8,6,11,17,0,0.000298
G4,C(CC(C)O)(C(C(CO)=O)O)=O,4,3,9,12,11,0.000144
G4,C(CC(C(C(C)O)=O)O)=O,4,15,24,39,25,0.000724
G4,C(CC(CO)(C(C)O)O)=O,4,10,17,27,25,0.000509
G4,C(C(C(C)O)O)(C(C)O)=O,8,5,18,23,4,0.000251
G4,C(CC(CC=O)O)=O,1,27,58,85,45,0.001294
G4,C(C(C=O)C(C)O)=O,2,13,47,60,4,0.00062
G4,C(CC(C(CCO)O)O)=O,4,8,18,26,29,0.000392
G4,C(C(C)(CC=O)O)(O)=O,2,13,28,41,28,0.000641
G4,C(C(CC(C)O)=O)(O)=O,2,5,27,32,4,0.00025
G4,C(CC(O)=O)=O,1,76,371,447,28,0.0036200000000000004
G4,C(CC(CO)(CC=O)O)(O)=O,2,6,13,19,29,0.000308
G4,C(CC(C)(C(C(O)=O)O)O)=O,4,8,15,23,33,0.000393
G4,C(CC(CO)(CC(C(O)=O)O)O)=O,4,5,13,18,29,0.000283
G4,C(CC(C)(C(C(C(O)=O)O)O)O)=O,8,6,15,21,29,0.000331
G4,C(CC(C(C(O)=O)O)O)=O,4,14,24,38,17,0.0006889999999999999
G4,C(CC(C(CC=O)O)O)(O)=O,4,6,15,21,29,0.000308
G4,C(CC(C(CC(C)=O)=O)O)=O,2,10,21,31,26,0.00047599999999999997
G4,C(CC(C=O)(CC(C)=O)O)=O,2,7,18,25,23,0.000334
G4,C(C)(C(C(C=O)=O)C(C)O)=O,4,6,15,21,4,0.00028700000000000004
G4,C(CC(C)O)(CC(C=O)=O)=O,2,7,18,25,4,0.000334
G4,C(CC(C=O)(CC=O)O)=O,1,9,15,24,23,0.000429
G4,C(C(C(C=O)=O)C(C)O)=O,4,9,19,28,4,0.00043
G4,C(CC(C(C)=O)(CC=O)O)=O,1,6,10,16,4,0.000286
G4,C(C(C)(CC=O)O)(CC=O)=O,2,4,19,23,14,0.00019099999999999998
G4,C(C(C(C(C)=O)=O)C(C)O)=O,4,6,14,20,4,0.00028700000000000004
G4,C(CC(C(CC(C)O)=O)=O)=O,2,5,17,22,4,0.000239
G4,C(C)(C(C)(CC=O)O)=O,2,14,40,54,14,0.000666
G4,C(C(C)=O)(CC(C)O)=O,2,9,40,49,4,0.000429
G4,C(CC(C)(CC=O)O)=O,1,12,26,38,6,0.000571
G4,C(CC(CC(C)=O)O)=O,2,17,57,74,6,0.0008089999999999999
G4,C(CC(CC(C)O)=O)=O,2,11,49,60,4,0.000524
G4,C(C(C(C)=O)C(C)O)=O,4,11,35,46,4,0.000525
G4,C(CC1(COC(C1)O)O)=O,4,8,16,24,35,0.000381
G4,C1(COC(C1C(C)O)O)=O,8,4,19,23,4,0.000193
G4,C1(C(C(C)O)OC(C1)O)=O,8,3,20,23,4,0.000145
G4,C(CC1(COC(C(C1)O)O)O)=O,8,2,12,14,27,9.6e-05
G4,C1(COC(C(C1C(C)O)O)O)=O,16,3,11,14,27,0.000145
G4,C1(C(C(C)O)OC(C(C1)O)O)=O,16,3,9,12,4,0.000145
G4,C(CC(C=CC(CO)=O)O)=O,4,9,17,26,21,0.00044
G4,C(CC(C=CC=O)(CO)O)=O,4,5,16,21,11,0.000239
G4,C(C=CC(C(C(C)O)O)=O)=O,8,7,19,26,4,0.000335
G4,C(CC(C(C=C)=O)O)=O,2,17,60,77,7,0.000808
G4,C(C(C=C)(CC=O)O)=O,2,15,39,54,7,0.000713
G4,C(CC(C=C)(CO)O)=O,2,13,29,42,7,0.00063
G4,C=CC(C(C(C)O)O)=O,4,10,39,49,4,0.00047699999999999994
G4,C(CC(C=CC=O)O)=O,4,15,53,68,43,0.000713
G4,C(CC(C(CC(C=O)O)O)O)=O,8,3,19,22,4,0.000144
G4,C(CC(C(C)O)(C(C=O)O)O)=O,8,5,16,21,45,0.00023999999999999998
G4,C(CC(C(C)O)O)=O,4,19,68,87,11,0.0009029999999999999
G4,C(CC(C(CCC(C=O)O)=O)O)=O,4,4,15,19,7,0.00020299999999999997
G4,C(C(CCC(C=O)(CC=O)O)O)=O,4,5,15,20,29,0.00025
G4,C(CC(C(CCC(C=O)=O)O)O)=O,4,4,18,22,7,0.00021400000000000002
G4,C(C(CC(C(C=O)=O)C(C)O)O)=O,8,6,13,19,12,0.000298
G4,C(CC(C(CC(C(C)O)=O)=O)O)=O,4,3,13,16,45,0.000155
G4,C(CC(C=O)(CC=O)O)(C(C)O)=O,4,3,12,15,4,0.000155
G4,C(CC(C(C)O)(CC(C=O)=O)O)=O,4,4,14,18,45,0.00021400000000000002
G4,C(C(C)O)(C(C(C=O)=O)C(C)O)=O,8,4,11,15,24,0.00020299999999999997
G4,C(CC(CC(C(C(C)=O)=O)O)O)=O,4,3,16,19,9,0.000155
G4,C(C)(C(C(CC=O)O)(CC=O)O)=O,4,6,17,23,45,0.00031
G4,C(CC(C(C(C)(CC=O)O)=O)O)=O,4,3,15,18,6,0.000155
G4,C(C(C(C)O)C(C(C(C)=O)=O)O)=O,8,6,13,19,25,0.000299
G4,C(CC(C(C(CC(C)O)=O)=O)O)=O,4,3,11,14,4,0.000155
G4,C(CC(CC(C(C(C)O)=O)=O)O)=O,4,7,12,19,4,0.00034500000000000004
G4,C(CC(C(C(C)O)=O)(CC=O)O)=O,2,3,7,10,4,0.000155
G4,C(C(C(C(C(C)O)=O)=O)C(C)O)=O,8,4,11,15,4,0.00020299999999999997
G4,C(C)(CC(C(CO)(CC=O)O)=O)=O,2,2,14,16,26,9.8e-05
G4,C(CC(C(CO)=O)(CC(C)=O)O)=O,2,4,14,18,26,0.00019099999999999998
G4,C(C)(CC(C(C(C(C)O)O)=O)=O)=O,4,2,13,15,26,9.8e-05
G4,C(C)(C(C(C(CO)=O)=O)C(C)O)=O,4,4,11,15,26,0.000192
G4,C(CC(C)O)(CC(C(CO)=O)=O)=O,2,4,12,16,4,0.00019099999999999998
G4,C(CC(C(C(CC(C)=O)O)=O)O)=O,4,5,17,22,26,0.00025
G4,C(C)(CC(C(C=O)(CC=O)O)O)=O,4,4,17,21,6,0.00020299999999999997
G4,C(CC(C)(CC(C(C=O)=O)O)O)=O,4,3,17,20,6,0.000155
G4,C(C)(C(C(C)O)C(C(C=O)=O)O)=O,8,5,14,19,17,0.000251
G4,C(CC(C(C=O)=O)O)(CC(C)O)=O,4,5,13,18,4,0.00025
G4,C(CCC=O)(C(CO)(CC=O)O)=O,2,1,14,15,4,4.9e-05
G4,C(CO)(C(CCC=O)(CC=O)O)=O,2,3,17,20,27,0.000144
G4,C(CC(CCC(C(CO)=O)=O)O)=O,2,3,16,19,44,0.000144
G4,C(CCC(C(C(C(C)O)O)=O)=O)=O,4,3,12,15,17,0.000156
G4,C(CC(C(C(CO)=O)=O)C(C)O)=O,4,2,12,14,4,9.6e-05
G4,C(C(C(C)O)CC(C(CO)=O)=O)=O,4,2,12,14,46,9.6e-05
G4,C(CCC(C(C(CC=O)O)=O)O)=O,4,4,16,20,27,0.000202
G4,C(CCC(C(C=O)(CC=O)O)O)=O,4,4,17,21,27,0.00020299999999999997
G4,C(CC(CCC(C(C=O)=O)O)O)=O,4,3,16,19,27,0.000155
G4,C(C(CC(C(C=O)=O)O)C(C)O)=O,8,3,13,16,46,0.000155
G4,C(CO)(CC(C(C)(CC=O)O)=O)=O,2,2,13,15,21,9.6e-05
G4,C(C(C(C)O)O)(CC(C(C)=O)=O)=O,4,3,13,16,24,0.000145
G4,C(CO)(C(C(C(C)=O)=O)C(C)O)=O,4,3,11,14,24,0.000145
G4,C(CO)(CC(C(CC(C)O)=O)=O)=O,2,2,12,14,4,9.6e-05
G4,C(CC(C(C=CCO)=O)(CO)O)=O,4,1,9,10,4,4.9e-05
G4,C(CC(C(CO)=O)(C=CCO)O)=O,4,2,7,9,0,9.6e-05
G4,C(CO)=CC(C(C(C(C)O)O)=O)=O,8,2,11,13,55,9.8e-05
G4,C(CC(C(C(C=CCO)O)=O)O)=O,8,2,7,9,29,9.6e-05
G4,C(CC(C=O)(C(C=CCO)O)O)=O,8,3,8,11,28,0.000155
G4,C(CC(C=CC(C(CO)=O)O)O)=O,8,3,10,13,32,0.000144
G4,C(CC(CO)(C(C=CC=O)O)O)=O,8,2,10,12,32,0.00010800000000000001
G4,C(C(C(C)O)O)(C(C=CC=O)O)=O,16,5,12,17,32,0.000251
G4,C(CC(C=C)(C(C(CO)=O)O)O)=O,4,2,12,14,7,9.6e-05
G4,C(C(C(C)O)O)(C(C(C=C)=O)O)=O,8,3,13,16,32,0.000145
G4,C(CC(C(C(C(C=C)O)=O)O)O)=O,8,5,12,17,31,0.000251
G4,C(CC(C(C=O)O)(C(C=C)O)O)=O,8,3,12,15,27,0.000146
G4,C(CC(C=CC(CO)=O)(CO)O)=O,4,2,10,12,32,9.6e-05
G4,C(C=CC(CO)=O)(C(C(C)O)O)=O,8,3,14,17,32,0.000145
G4,C(CC(C(C=CC(C=O)O)O)O)=O,16,2,11,13,32,9.6e-05
G4,C(CC(CO)(CC(CCO)=O)O)=O,2,4,12,16,29,0.00021400000000000002
G4,C(CC(CCO)(CC(CO)=O)O)=O,2,5,13,18,29,0.000262
G4,C(CCO)(CC(C(C(C)O)O)=O)=O,4,3,11,14,30,0.000156
G4,C(CCO)(C(C(CO)=O)C(C)O)=O,4,5,9,14,30,0.000262
G4,C(C(CO)C(C)O)(CC(CO)=O)=O,4,5,11,16,4,0.000262
G4,C(CC(CO)(CCC(CO)=O)O)=O,2,4,15,19,29,0.00021400000000000002
G4,C(CCC(C(C(C)O)O)=O)(CO)=O,4,4,14,18,29,0.000204
G4,C(CO)(C(C(C)O)CC(CO)=O)=O,4,5,13,18,29,0.000261
G4,C(C(CC(CCO)O)(CC=O)O)=O,4,2,11,13,4,0.00010800000000000001
G4,C(C(CCO)(CC=O)O)(CCO)=O,2,3,12,15,29,0.000166
G4,C(C(CCO)=O)(C(CO)C(C)O)=O,4,4,12,16,2,0.000215
G4,C(CC(CCO)(C(C(C)=O)O)O)=O,4,5,13,18,49,0.000262
G4,C(C(CO)C(C)O)(C(C(C)=O)O)=O,8,3,11,14,9,0.000156
G4,C(CC(C)O)(C(C(CCO)=O)O)=O,4,2,9,11,9,0.00010800000000000001
G4,C(CC(CC(C(CCO)O)=O)O)=O,4,4,11,15,4,0.00020299999999999997
G4,C(CC(C(CCO)O)(CC=O)O)=O,2,2,8,10,4,0.00010800000000000001
G4,C(C(C(C(CCO)O)=O)C(C)O)=O,8,4,11,15,4,0.000204
G4,C(CC(C(CO)O)(CC(C)=O)O)=O,4,3,13,16,27,0.000155
G4,C(C(CO)O)(C(C(C)=O)C(C)O)=O,8,3,11,14,4,0.000156
G4,C(CC(C)O)(CC(C(CO)O)=O)=O,4,2,11,13,4,0.00010800000000000001
G4,C(CCC(C(CO)O)(CC=O)O)=O,4,3,17,20,29,0.000155
G4,C(CC(CCC(C(CO)O)=O)O)=O,4,5,16,21,7,0.000254
G4,C(C(C(C)O)CC=O)(C(CO)O)=O,8,8,15,23,46,0.00041900000000000005
G4,C(C(C(C)O)CC(C(CO)O)=O)=O,8,12,15,27,46,0.000608
G4,C(CC(C(C(CCCO)=O)O)O)=O,4,5,13,18,55,0.000251
G4,C(CC(CCCO)(C(C=O)O)O)=O,4,2,13,15,29,0.00010800000000000001
G4,C(C(C(C(C(C)O)CCO)=O)O)=O,8,2,11,13,4,0.00010800000000000001
G4,C(C)(C(CC(CO)O)(CC=O)O)=O,4,2,12,14,29,0.00010800000000000001
G4,C(C(C)(CC=O)O)(CC(CO)O)=O,4,3,12,15,29,0.000156
G4,C(C(C)=O)(C(C(CO)O)C(C)O)=O,8,6,13,19,14,0.000312
G4,C(C(CC(C)O)=O)(CC(CO)O)=O,4,3,11,14,4,0.000156
G4,C(CC(CC(CO)O)(CC=O)O)=O,2,2,9,11,29,0.00010800000000000001
G4,C(CC(CC(CC(CO)O)=O)O)=O,4,3,12,15,29,0.000156
G4,C(CC(C(C(CO)O)C(C)O)=O)=O,8,6,14,20,44,0.000312
G4,C(C(C(CC(CO)O)=O)C(C)O)=O,8,4,12,16,44,0.000205
G4,C(CC(C(CC(CCO)=O)O)O)=O,4,3,17,20,29,0.000155
G4,C(CC(CC(C=O)O)(CCO)O)=O,4,3,16,19,29,0.000155
G4,C(C(C(C)O)C(C=O)O)(CCO)=O,8,4,15,19,4,0.000204
G4,C(CC(C=O)O)(C(CO)C(C)O)=O,8,4,14,18,4,0.000204
G4,C(CC(C=CC(CO)O)(CO)O)=O,8,3,7,10,29,0.000166
G4,C(C(CO)O)=CC(C(C(C)O)O)=O,16,3,10,13,29,0.000156
G4,C(CC(C=CCO)(C(CO)O)O)=O,8,3,8,11,29,0.000166
G4,C(CC(C=C)(C(C(CO)O)O)O)=O,8,2,11,13,29,0.00010800000000000001
G4,C(CC(C=CC(C(CO)O)O)O)=O,16,2,7,9,29,0.00010800000000000001
G4,C(CC(C(C(C=CCO)O)O)O)=O,16,2,9,11,29,0.00010800000000000001
G4,C(C(C(CO)C(C)O)=O)(O)=O,4,6,12,18,4,0.000303
G4,C1(CCC(C1(C(CC=O)O)O)O)=O,8,3,16,19,45,0.000144
G4,C(C1(C(CCC1(CC=O)O)O)O)=O,8,3,16,19,44,0.000144
G4,C(C1(C(C(C(C)O)CC1O)=O)O)=O,16,3,12,15,4,0.000144
G4,C(CC1(C=CC(C1(CO)O)O)O)=O,8,1,8,9,4,4.9e-05
G4,C(CC(C1(C(C=CC1O)O)O)O)=O,6,1,7,8,43,4.9e-05
G4,C(CC(C(CO)(CO)O)O)=O,2,6,11,17,18,0.000308
G4,C(CC(C(CO)(C(C)O)O)O)=O,8,3,12,15,4,0.000166
G4,C(CC(C(C(C)=O)(CO)O)O)=O,4,9,17,26,45,0.00045599999999999997
G4,C(C(CO)(C(C)(CC=O)O)O)=O,4,8,17,25,6,0.000408
G4,C(C(C(CC(C)O)=O)(CO)O)=O,4,4,11,15,4,0.000195
G4,C(CC(C(C(C)=O)(C(C)O)O)O)=O,8,5,15,20,4,0.000242
G4,C(C(C(C)O)(C(C)(CC=O)O)O)=O,8,6,15,21,4,0.000301
G4,C(C(C(CC(C)O)=O)(C(C)O)O)=O,8,3,10,13,4,0.000146
G4,C(CC(C(C=O)(C(C=O)O)O)O)=O,8,10,23,33,0,0.0005
G4,C(CC(C)(C(CO)(CO)O)O)=O,2,4,9,13,29,0.000213
G4,C(CC(C)O)(C(CO)(CO)O)=O,2,4,8,12,2,0.000206
G4,C(CC(C)(C(CO)(C(C)O)O)O)=O,8,3,10,13,4,0.000166
G4,C(CC(C)O)(C(CO)(C(C)O)O)=O,8,6,12,18,4,0.000304
G4,C(C(CO)(C(CC=O)O)O)=O,4,10,19,29,45,0.000503
G4,C(CC(CO)(C(CO)(CO)O)O)=O,2,5,8,13,29,0.000283
G4,C(C(C(C)O)O)(C(CO)(CO)O)=O,4,8,10,18,2,0.00042
G4,C(C(C(CC=O)O)(C(C)O)O)=O,8,7,18,25,4,0.000348
G4,C(CC(C(CO)(C(CO)O)O)O)=O,8,8,12,20,29,0.000459
G4,C(C(C(CC=O)O)(C(CO)O)O)=O,8,10,18,28,0,0.000534
G4,C(CC(C1(C(CC(C1)=O)O)O)O)=O,8,2,19,21,26,9.6e-05
G4,C(C1(CC(CC1O)(CC=O)O)O)=O,8,2,19,21,4,9.6e-05
G4,C1(C(C(C)O)C(C=O)(C(C1)O)O)=O,16,5,14,19,17,0.00023999999999999998
G4,C(C1(C(C(C(C1)=O)C(C)O)O)O)=O,16,4,15,19,17,0.000192
G4,C(CC(C(C)(C(C(O)=O)O)O)O)=O,8,5,14,19,25,0.000272
G4,C(C(CO)(CC(CC=O)O)O)=O,4,3,17,20,43,0.000146
G4,C(CC(C(CC=O)O)(C(C)O)O)=O,8,3,17,20,4,0.000156
G4,C(C(C(C)O)(CC(CC=O)O)O)=O,8,2,15,17,4,9.8e-05
G4,C(CC1(CC(C(C1CO)=O)O)O)=O,8,4,16,20,30,0.00019099999999999998
G4,C1(CC(C(CC=O)(C1CO)O)O)=O,8,3,16,19,30,0.000144
G4,C1(C(C(C)O)C(C(C1CO)=O)O)=O,16,3,13,16,2,0.000145
G4,C(CC1(CC(C(C1O)=O)CO)O)=O,8,1,14,15,47,4.9e-05
G4,C(CC1(C(CO)CC(C1O)=O)O)=O,8,2,16,18,47,9.6e-05
G4,C1(C(C(C)O)C(C(C1O)=O)CO)=O,16,1,13,14,4,4.9e-05
G4,C1(CCC(CC=O)(C1(CO)O)O)=O,4,1,15,16,21,4.9e-05
G4,C1(C(C(C)O)CC(C1(CO)O)=O)=O,8,1,10,11,2,4.9e-05
G4,C1(CC(CC1(CO)O)(CC=O)O)=O,4,2,13,15,2,9.6e-05
G4,C(CC1(C(CO)(CC(C1)=O)O)O)=O,4,2,14,16,4,9.6e-05
G4,C1(C(C(C)O)C(C(C1)=O)(CO)O)=O,8,4,14,18,4,0.000192
G4,C1(C(CO)(CC(C1C(C)O)=O)O)=O,8,3,11,14,4,0.000145
G4,C1(CC(C(C(C)(CC=O)O)O1)O)=O,8,1,7,8,48,4.9e-05
G4,C1(CC(C(C(CC(C)O)=O)O1)O)=O,8,1,6,7,4,4.9e-05
G4,C1(CC(C(CC(CC=O)O)O1)O)=O,8,1,7,8,48,4.9e-05
G4,C(C(C1C(CC(O1)=O)O)C(C)O)=O,16,2,8,10,48,9.8e-05
G4,C(CC1(C(C(C(C)=O)OC1)O)O)=O,8,1,13,14,17,4.9e-05
G4,C(CC(C)(C1C(C(CO1)=O)O)O)=O,8,2,13,15,17,9.6e-05
G4,C(C1C(C(C(C(C)O)O1)=O)O)(C)=O,16,2,8,10,4,9.8e-05
G4,C(C1C(C(CO1)=O)O)(CC(C)O)=O,8,1,9,10,4,4.9e-05
G4,C(CC1(COC(C1O)CC=O)O)=O,8,1,12,13,4,4.9e-05
G4,C(CC(CC1C(C(CO1)=O)O)O)=O,8,2,13,15,9,9.6e-05
G4,C(CC1C(C(C(C(C)O)O1)=O)O)=O,16,2,8,10,9,9.8e-05
G4,C(C(C1C(C(CO1)=O)O)C(C)O)=O,16,3,10,13,9,0.000145
G4,C(CC1(CC(C(C)=O)OC1O)O)=O,8,2,12,14,22,9.6e-05
G4,C(CC(C)(C1CC(C(O)O1)=O)O)=O,8,2,12,14,22,9.6e-05
G4,C(C1C(C(C(O1)O)=O)C(C)O)(C)=O,16,3,8,11,22,0.000145
G4,C1(C(OC(C(CC(C)O)=O)C1)O)=O,8,2,8,10,22,9.6e-05
G4,C(CC1CC(C(O)O1)(CC=O)O)=O,8,2,14,16,13,9.6e-05
G4,C(CC(CC1CC(C(O)O1)=O)O)=O,8,2,12,14,13,9.6e-05
G4,C(CC1C(C(C(O)O1)=O)C(C)O)=O,16,3,10,13,4,0.000145
G4,C(C(C1CC(C(O)O1)=O)C(C)O)=O,16,3,10,13,23,0.000145
G4,C(CC1(CC(OC1C(C)=O)O)O)=O,8,2,10,12,9,9.6e-05
G4,C1(C(C(OC1C(C)=O)O)C(C)O)=O,16,3,9,12,9,0.000145
G4,C(CC(C)O)(C1C(CC(O1)O)=O)=O,8,2,7,9,9,9.6e-05
G4,C(CC1C(CC(O)O1)(CC=O)O)=O,8,2,14,16,13,9.6e-05
G4,C(CC(CC1C(CC(O1)O)=O)O)=O,8,2,13,15,13,9.6e-05
G4,C(CC1C(C(C(O1)O)C(C)O)=O)=O,16,3,12,15,4,0.000145
G4,C(C(C(C)O)C1C(CC(O1)O)=O)=O,16,3,12,15,4,0.000145
G4,C1(CC(CC(CO)O1)(CC=O)O)=O,4,2,6,8,19,9.6e-05
G4,C1(C(C(CC(CO)O1)=O)C(C)O)=O,8,3,5,8,19,0.000145
G4,C1(CC(C(C(CO)O1)C(C)O)=O)=O,8,3,6,9,19,0.000145
G4,C1(CCC(C(CO)O1)(CC=O)O)=O,4,2,7,9,4,9.6e-05
G4,C1(C(CO)OC(CC1C(C)O)=O)=O,8,3,7,10,46,0.000144
G4,C1(C(COC(CO)C1)(CC=O)O)=O,4,1,6,7,54,4.9e-05
G4,C1(COC(CO)CC1(CC=O)O)=O,4,1,8,9,54,4.9e-05
G4,C1(C(C(C(C)O)OC(CO)C1)=O)=O,8,2,6,8,54,9.8e-05
G4,C1(C(COC(CO)C1C(C)O)=O)=O,8,2,7,9,54,9.8e-05
G4,C(CC1(COC(C(C1)=O)CO)O)=O,4,1,9,10,54,4.9e-05
G4,C(CC1(C(CO)OCC(C1)=O)O)=O,4,1,9,10,54,4.9e-05
G4,C1(C(C(C)O)OC(C(C1)=O)CO)=O,8,2,7,9,54,9.8e-05
G4,C1(C(CO)OCC(C1C(C)O)=O)=O,8,2,7,9,4,9.8e-05
G4,C1(CC(CC(CO1)O)(CC=O)O)=O,4,1,8,9,19,4.9e-05
G4,C1(C(C(CC(CO1)O)=O)C(C)O)=O,8,2,7,9,19,9.8e-05
G4,C1(CC(C(C(C)O)C(CO1)O)=O)=O,8,2,9,11,19,9.8e-05
G4,C1(CCC(C(CO1)O)(CC=O)O)=O,4,1,9,10,4,4.9e-05
G4,C1(C(C(C)O)CC(OCC1O)=O)=O,8,2,7,9,46,9.6e-05
G4,C1(CC(C(CCO1)(CC=O)O)O)=O,4,1,9,10,19,4.9e-05
G4,C1(CC(C(C(CO1)C(C)O)=O)O)=O,8,2,7,9,19,9.8e-05
G4,C1(CC(CC(CO1)(CC=O)O)O)=O,4,1,9,10,48,4.9e-05
G4,C1(CC(C(C(CO1)=O)C(C)O)O)=O,8,2,9,11,4,9.8e-05
G4,C1(CC(CC(C(C(C)O)O1)=O)O)=O,8,2,6,8,48,9.8e-05
G4,C1(C(COCC(C1)O)(CC=O)O)=O,4,1,8,9,4,4.9e-05
G4,C1(COCC(CC1(CC=O)O)O)=O,4,1,9,10,36,4.9e-05
G4,C1(C(C(C(C)O)OCC(C1)O)=O)=O,8,2,7,9,36,9.8e-05
G4,C1(C(COCC(C1C(C)O)O)=O)=O,8,2,9,11,36,9.8e-05
G4,C(CC1(COCC(C(C1)=O)O)O)=O,4,2,9,11,36,9.6e-05
G4,C(CC1(C(COCC(C1)=O)O)O)=O,4,1,10,11,36,4.9e-05
G4,C1(C(COC(C(C1)=O)C(C)O)O)=O,8,3,6,9,36,0.000145
G4,C1(C(COCC(C1C(C)O)=O)O)=O,8,3,6,9,36,0.000145
G4,C(CC1(COCCC(C1O)=O)O)=O,4,1,10,11,36,4.9e-05
G4,C(CC1(CCOCC(C1O)=O)O)=O,4,1,11,12,36,4.9e-05
G4,C1(CCOC(C(C1O)=O)C(C)O)=O,8,2,6,8,36,9.8e-05
G4,C1(C(COCC(C1O)=O)C(C)O)=O,8,2,7,9,36,9.8e-05
G4,C(CC1(C(CC(COC1)=O)O)O)=O,4,1,14,15,36,4.9e-05
G4,C(CC1(COCC(C(C1)O)=O)O)=O,4,2,13,15,36,9.6e-05
G4,C1(CC(C(C(C(C)O)OC1)=O)O)=O,8,2,7,9,4,9.8e-05
G4,C1(COCC(C(C1C(C)O)O)=O)=O,8,3,9,12,4,0.000145
G4,C1(CC(C(COC1C(C)O)=O)O)=O,8,3,7,10,17,0.000145
G4,C(CC1(C(O)OCCC(C1)=O)O)=O,4,2,11,13,23,9.6e-05
G4,C(CC1(CCOC(C(C1)=O)O)O)=O,4,2,10,12,30,9.6e-05
G4,C1(CCOC(C(C1C(C)O)=O)O)=O,8,3,7,10,30,0.000145
G4,C1(C(COC(C(C1)=O)O)C(C)O)=O,8,3,8,11,4,0.000145
G4,C(CC1(CCC(COC1O)=O)O)=O,4,2,14,16,29,9.6e-05
G4,C(CC1(COC(C(CC1)=O)O)O)=O,4,2,12,14,29,9.6e-05
G4,C1(CC(C(C(OC1)O)=O)C(C)O)=O,8,2,7,9,12,9.6e-05
G4,C1(COC(C(CC1C(C)O)=O)O)=O,8,2,7,9,12,9.6e-05
G4,C1(CCC(C(OC1C(C)O)O)=O)=O,8,3,6,9,12,0.000145
G4,C1(C(CC(O)OCC1)(CC=O)O)=O,4,2,10,12,4,9.6e-05
G4,C1(C(CCOC(C1)O)(CC=O)O)=O,4,2,10,12,53,9.6e-05
G4,C1(C(CCOC(C1C(C)O)O)=O)=O,8,3,10,13,4,0.000145
G4,C1(C(CC(O)OCC1C(C)O)=O)=O,8,3,9,12,4,0.000145
G4,C(CC1(CC(OCC(C1)=O)O)O)=O,4,2,11,13,32,9.6e-05
G4,C(CC1(COC(CC(C1)=O)O)O)=O,4,2,10,12,26,9.6e-05
G4,C1(C(C(OCC(C1)=O)O)C(C)O)=O,8,3,9,12,4,0.000145
G4,C1(CC(OCC(C1C(C)O)=O)O)=O,8,3,7,10,38,0.000145
G4,C1(CC(OC(C(C1)=O)C(C)O)O)=O,8,3,7,10,38,0.000145
G4,C(CC(C(C=CC(C)=O)=O)O)=O,4,4,15,19,29,0.00019099999999999998
G4,C(C(C=CC(C)=O)(CC=O)O)=O,4,4,14,18,29,0.00019099999999999998
G4,C(CC(C=CC(C=O)=O)(C)O)=O,4,3,16,19,29,0.000144
G4,C(C(C=CC(CC(C)O)=O)=O)=O,4,3,17,20,4,0.000144
G4,C(CC=CC(C(CC=O)O)=O)=O,4,5,16,21,13,0.000239
G4,C(C(C=CCC=O)(CC=O)O)=O,4,4,16,20,29,0.00019099999999999998
G4,C(CC(CC=CC(C=O)=O)O)=O,4,3,16,19,29,0.000144
G4,C(C(C=CC(C=O)=O)C(C)O)=O,8,3,13,16,46,0.000144
G4,C(CC(C=CC(C(C)=O)=O)O)=O,4,4,15,19,21,0.00019099999999999998
G4,C(CC(C(C)=O)(C=CC=O)O)=O,4,4,14,18,21,0.00019099999999999998
G4,C(CC(C(C=CC=O)=O)(C)O)=O,4,3,14,17,29,0.000144
G4,C(C(C=CC=O)=O)(CC(C)O)=O,4,4,17,21,4,0.00019099999999999998
G4,C(CC(C=CC(CC=O)O)=O)=O,4,5,17,22,29,0.000239
G4,C(CC(C=CC=O)(CC=O)O)=O,2,4,11,15,4,0.00019099999999999998
G4,C(CC(CC(C=CC=O)=O)O)=O,4,5,19,24,29,0.000239
G4,C(C(C(C=CC=O)=O)C(C)O)=O,8,6,16,22,45,0.00028700000000000004
G4,C(CC(C(CC(C=C)=O)=O)O)=O,2,4,17,21,7,0.00019099999999999998
G4,C(CC(C=O)(CC(C=C)=O)O)=O,2,3,13,16,29,0.000144
G4,C(CC(C=C)(CC(C=O)=O)O)=O,2,4,17,21,29,0.00019099999999999998
G4,C=CC(C(C(C=O)=O)C(C)O)=O,4,5,15,20,4,0.00023999999999999998
G4,C(CC(CC(C(C=C)=O)=O)O)=O,2,4,17,21,29,0.00019099999999999998
G4,C(CC(C(C=C)=O)(CC=O)O)=O,1,3,8,11,4,0.000144
G4,C(CC=O)(C(C=C)(CC=O)O)=O,2,4,16,20,29,0.00019099999999999998
G4,C(C(C(C(C=C)=O)=O)C(C)O)=O,4,5,15,20,45,0.00023999999999999998
G4,C(CC(C(CC=CC=O)=O)O)=O,4,5,16,21,29,0.000239
G4,C(CC(C=O)(CC=CC=O)O)=O,4,3,14,17,29,0.000144
G4,C(CC(C=CCC(C=O)=O)O)=O,4,4,17,21,29,0.00019099999999999998
G4,C(C(C(C=O)=O)C(C)O)=CC=O,8,3,13,16,29,0.000144
G4,C(CC1(COCC1O)O)=O,4,6,14,20,10,0.000286
G4,C1(C(C(C)O)OCC1O)=O,8,3,17,20,4,0.000145
G4,C(CC1(C(O)OCC1)O)=O,4,7,16,23,34,0.000334
G4,C1(C(O)OCC1C(C)O)=O,8,3,14,17,4,0.000145
G4,C(CC(CC1C(C(CO1)O)=O)O)=O,8,2,11,13,9,9.6e-05
G4,C(CC1(C(CC=O)OCC1O)O)=O,8,1,12,13,9,4.9e-05
G4,C(C(C(C)O)C1C(C(CO1)O)=O)=O,16,3,10,13,9,0.000145
G4,C(CC(CC1(C(CCO1)=O)O)O)=O,4,2,12,14,53,9.6e-05
G4,C(CC1(C(CC=O)(O)OCC1)O)=O,4,2,14,16,53,9.6e-05
G4,C(C(C(C)O)C1(C(CCO1)=O)O)=O,8,3,12,15,4,0.000145
G4,C(CC1(C(C(CO1)C(C)O)=O)O)=O,8,3,10,13,4,0.000145
G4,C(CC(CC1(CC(CO1)=O)O)O)=O,4,2,16,18,26,9.6e-05
G4,C(CC1(COC(C1)(CC=O)O)O)=O,4,2,15,17,26,9.6e-05
G4,C(C(C1(CC(CO1)=O)O)C(C)O)=O,8,3,14,17,4,0.000145
G4,C(CC1(C(C(CO1)=O)C(C)O)O)=O,8,3,14,17,4,0.000145
G4,C(CC1(CC(C(C(C)O)O1)=O)O)=O,8,3,11,14,48,0.000145
G4,C(CC(C(C1CC(CO1)O)=O)O)=O,8,1,7,8,39,4.9e-05
G4,C(C(C1CC(CO1)O)(CC=O)O)=O,8,1,7,8,4,4.9e-05
G4,C(CC(C1C(CC(C=O)O1)O)O)=O,16,1,11,12,40,4.9e-05
G4,C(CC(C1CC(C(C=O)O1)O)O)=O,16,1,13,14,40,4.9e-05
G4,C(CC(C1C(CC(C)(O1)O)=O)O)=O,8,2,11,13,26,9.6e-05
G4,C(CC1(CC(C)(OC1C=O)O)O)=O,8,2,11,13,4,9.6e-05
G4,C(C1C(C(C(C)O)C(C)(O1)O)=O)=O,16,3,11,14,26,0.000145
G4,C(CC(C1CC(C(C)(O)O1)=O)O)=O,8,2,10,12,21,9.6e-05
G4,C(CC1(CC(C=O)OC1(C)O)O)=O,8,2,12,14,21,9.6e-05
G4,C1(C(C)(OC(C=O)C1C(C)O)O)=O,16,3,8,11,14,0.000145
G4,C(CC(C1C(C(C(C)O1)=O)O)O)=O,16,1,11,12,29,4.9e-05
G4,C(CC1(C(C(C=O)OC1C)O)O)=O,16,1,13,14,29,4.9e-05
G4,C(CC(C1(CC(CCO1)=O)O)O)=O,4,2,15,17,30,9.6e-05
G4,C(CC1(CC(C=O)(O)OCC1)O)=O,4,2,12,14,30,9.6e-05
G4,C1(C(C(C)O)C(C=O)(O)OCC1)=O,8,3,12,15,30,0.000145
G4,C1(CC(C=O)(O)OCC1C(C)O)=O,8,3,10,13,4,0.000145
G4,C(CC(C1(CCC(CO1)=O)O)O)=O,4,2,14,16,7,9.6e-05
G4,C(CC1(COC(C=O)(CC1)O)O)=O,4,2,11,13,29,9.6e-05
G4,C(C1(CC(C(CO1)=O)C(C)O)O)=O,8,2,8,10,12,9.6e-05
G4,C1(C(C(C)O)OC(C=O)(CC1)O)=O,8,3,7,10,12,0.000145
G4,C(CC(C1C(CCC(O1)O)=O)O)=O,8,2,9,11,37,9.6e-05
G4,C(CC1(CCC(OC1C=O)O)O)=O,8,2,10,12,29,9.6e-05
G4,C(C1C(C(C(C)O)CC(O1)O)=O)=O,16,2,8,10,4,9.6e-05
G4,C(CC(C1CC(CC(O)O1)=O)O)=O,8,2,13,15,6,9.6e-05
G4,C(CC1(CC(C=O)OC(C1)O)O)=O,8,2,13,15,4,9.6e-05
G4,C1(C(C(C)O)C(C=O)OC(C1)O)=O,16,3,11,14,37,0.000145
G4,C1(CC(C=O)OC(C1C(C)O)O)=O,16,3,11,14,37,0.000145
G4,C(CC1(C(CO)=CC(C1O)O)O)=O,8,1,9,10,2,4.9e-05
G4,C(CC1(C(C(C(C1O)O)O)=C)O)=O,16,1,13,14,47,4.9e-05
G4,C(CC(C1C(C(C(C=1)O)O)O)O)=O,16,1,9,10,29,4.9e-05
G4,C(CC(C(C(C(C=C)O)O)O)O)=O,16,1,12,13,4,4.9e-05
G4,C(CC(C1(C=CC(C1O)O)O)O)=O,16,1,10,11,29,4.9e-05
G4,C(CC1(C=COC1C(CO)O)O)=O,8,1,7,8,9,4.9e-05
G4,C(CC1(C=CC(CO)OC1O)O)=O,8,1,5,6,46,4.9e-05
G4,C(CC1(C=COC(CO)C1O)O)=O,8,1,6,7,9,4.9e-05
G4,C(CC1(C=CC(O)OC1CO)O)=O,8,1,4,5,2,4.9e-05
G4,C(CC1(C=CC(COC1O)O)O)=O,8,1,5,6,41,4.9e-05
G4,C(CC1(C=COCC(C1O)O)O)=O,8,1,8,9,38,4.9e-05
G4,C(CC1(C=CCOC(C1O)O)O)=O,8,1,8,9,19,4.9e-05
G4,C(CC1(C=CC(O)OCC1O)O)=O,8,1,5,6,38,4.9e-05
G4,C(CC1(C=CC(C(O)OC1)O)O)=O,8,1,5,6,29,4.9e-05
G4,C1C(C(OC(C(C=1)=O)C(C)O)O)O,16,2,7,9,4,9.8e-05
G4,C(CC(C1OC(CO)C(C=1)O)O)=O,8,1,3,4,29,4.9e-05
G4,C(CC(C1(C=CC(CO)O1)O)O)=O,8,1,5,6,41,4.9e-05
G4,C(CC(C=C1C(C(CO1)O)O)O)=O,16,1,5,6,29,4.9e-05
G4,C(CC(C(C1OCC(C=1)O)O)O)=O,8,1,6,7,36,4.9e-05
G4,C(CC(C(C1(C=CCO1)O)O)O)=O,8,1,8,9,39,4.9e-05
G4,C(CC(C1C=CC(CO)(O1)O)O)=O,8,1,4,5,40,4.9e-05
G4,C(CC(C1C(C=C(CO)O1)O)O)=O,8,1,4,5,40,4.9e-05
G4,C(CC(C1C(C(C(O1)=C)O)O)O)=O,16,1,7,8,26,4.9e-05
G4,C(CC(C(C1C=CC(O1)O)O)O)=O,16,1,6,7,43,4.9e-05
G4,C(CC(C(C1C(C=CO1)O)O)O)=O,16,1,7,8,36,4.9e-05
G4,C(CC(C1OCC(C(C=1)O)O)O)=O,8,1,5,6,30,4.9e-05
G4,C(CC(C1(C=CC(CO1)O)O)O)=O,8,1,5,6,30,4.9e-05
G4,C(CC(C1C(C=CC(O)O1)O)O)=O,16,1,4,5,37,4.9e-05
G4,C(CC(C1C(C(C=CO1)O)O)O)=O,16,1,7,8,37,4.9e-05
G4,C(C(C=O)C(CO)(C(CO)O)O)=O,4,6,11,17,45,0.00033
G4,C(C(C(C(CO)O)=O)O)(O)=O,4,15,15,30,2,0.000762
G4,C(C(C(C(O)=O)O)O)(C(CO)O)=O,8,12,15,27,33,0.00063
G4,C(C(C(C(C)O)O)O)(C(CO)O)=O,16,10,14,24,2,0.000524
G4,C(C(C(CCO)=O)C(C=O)=O)(O)=O,2,8,11,19,30,0.000394
G4,C(C(C(CC(C=O)=O)=O)CO)(O)=O,2,8,11,19,30,0.00038500000000000003
G4,C(C(C(C=O)=O)CC(CO)=O)(O)=O,2,6,13,19,12,0.000297
G4,C(C(C(CO)=O)CC(C=O)=O)(O)=O,2,8,13,21,12,0.000392
G4,C(C(C(CCC(C=O)=O)=O)O)(O)=O,2,11,12,23,12,0.000535
G4,C(C(C(C=O)=O)C(C(C)=O)O)(O)=O,4,8,12,20,45,0.000394
G4,C(CC(C(CC(C=O)=O)O)=O)(O)=O,2,9,13,22,17,0.00045099999999999996
G4,C(C(C(C=O)=O)C(CC=O)O)(O)=O,4,10,14,24,17,0.0005009999999999999
G4,C(C(C=O)C(CC(C=O)=O)O)(O)=O,4,10,13,23,23,0.0005
G4,C(C(C=O)C(C(CCO)=O)=O)(O)=O,2,9,11,20,17,0.000453
G4,C(C(C(C(CC=O)=O)=O)CO)(O)=O,2,8,11,19,17,0.00038500000000000003
G4,C(C(C=O)C(CC(CO)=O)=O)(O)=O,2,8,10,18,17,0.000392
G4,C(C(C(CC=O)=O)C(CO)=O)(O)=O,2,8,10,18,17,0.000392
G4,C(C(C(CC(CC=O)=O)=O)O)(O)=O,2,8,10,18,17,0.000392
G4,C(C(C=O)C(C(C(C)=O)O)=O)(O)=O,4,7,9,16,17,0.00034500000000000004
G4,C(CC(C(C(CC=O)=O)O)=O)(O)=O,2,6,10,16,17,0.000297
G4,C(C(C=O)C(C(CC=O)O)=O)(O)=O,4,11,13,24,17,0.000547
G4,C(C(C=O)C(C(CC=O)=O)O)(O)=O,4,9,14,23,17,0.00044100000000000004
G4,C(C(C(C(C=O)O)=O)C(C)=O)(O)=O,4,7,9,16,17,0.00034500000000000004
G4,C(CC(CC(C(C=O)O)=O)=O)(O)=O,2,6,10,16,17,0.000297
G4,C(C(C(C(C=O)O)=O)CC=O)(O)=O,4,8,13,21,17,0.000392
G4,C(C(C=O)CC(C(C=O)O)=O)(O)=O,4,5,13,18,17,0.00023799999999999998
G4,C(C(C(C(C)=O)=O)C(C=O)O)(O)=O,4,8,11,19,17,0.000394
G4,C(CC(C(CC(C=O)O)=O)=O)(O)=O,2,7,11,18,17,0.000356
G4,C(C(C(CC=O)=O)C(C=O)O)(O)=O,4,11,14,25,17,0.000536
G4,C(C(C=O)C(CC(C=O)O)=O)(O)=O,4,11,12,23,17,0.000546
G4,C(C(C(C=CC(C=O)O)=O)O)(O)=O,8,7,8,15,32,0.00034500000000000004
G4,C(C1(CC(C(C1)O)O)O)(O)=O,3,1,6,7,29,5.9e-05
G4,C(C(CC(CO)(CO)O)O)(O)=O,2,3,6,9,29,0.000176
G4,C(C(C)(CC(C(O)=O)O)O)=O,4,3,10,13,29,0.000176
G4,C(C(CC(C)(C(C=O)O)O)O)(O)=O,8,5,14,19,26,0.000273
G4,C(C(CC(C=O)O)O)(O)=O,4,5,16,21,29,0.000271
G4,C(C(CC(C)(C(CO)O)O)O)(O)=O,8,4,10,14,29,0.00023500000000000002
G4,C(C(CC(C(O)=O)O)(CCO)O)=O,4,3,11,14,29,0.000176
G4,C(C(C(CO)C(C(C)=O)O)O)(O)=O,8,4,10,14,29,0.00023500000000000002
G4,C(C(C)(C(CO)C(C(O)=O)O)O)=O,8,4,11,15,29,0.00023500000000000002
G4,C(C(CC(CO)(CCO)O)O)(O)=O,4,5,9,14,29,0.000293
G4,C(C(CC(CO)(C)O)O)(O)=O,4,4,8,12,29,0.00023500000000000002
G4,C(CC(C(CC(C(O)=O)O)O)O)=O,8,4,13,17,29,0.000225
G4,C(C(CC(CC(C=O)O)O)O)(O)=O,8,4,12,16,20,0.000223
G4,C(C(CC(C)O)O)(O)=O,4,3,16,19,27,0.000176
G4,C(C(C(CO)C(C=O)O)O)(O)=O,8,7,12,19,29,0.000399
G4,C(C(C(CO)CO)O)(O)=O,2,5,7,12,29,0.000293
G4,C(C(C(CO)CC(CO)=O)O)(O)=O,4,6,11,17,29,0.00033
G4,C(CC(C(CO)C(C(O)=O)O)O)=O,8,5,13,18,33,0.000283
G4,C(C(C(CO)CO)(CC=O)O)(O)=O,2,3,9,12,29,0.000166
G4,C(C(C)(C(CO)C(C=O)O)O)(O)=O,8,4,12,16,29,0.000223
G4,C(C(CC(C=O)O)(CCO)O)(O)=O,4,3,12,15,29,0.000165
G4,C(C(C(CO)C(CO)(C)O)O)(O)=O,8,5,9,14,29,0.000293
G4,C(C(C(CO)C(C)O)O)(O)=O,8,4,8,12,29,0.00023500000000000002
G4,C(C(CC(CO)O)O)(O)=O,4,6,10,16,29,0.000341
G4,C(C(C(CO)C(CO)O)O)(O)=O,8,7,9,16,29,0.00041
G4,C(C(C=O)(CC(CO)O)O)(O)=O,4,3,12,15,29,0.000165
G4,C(C(CO)(C)O)(O)=O,2,4,10,14,25,0.000226
G4,C(C(CC(C)=O)O)(O)=O,2,12,41,53,26,0.000603
G4,C(C(C)(C)O)(O)=O,1,1,10,11,14,5.9e-05
G4,C(C(C=C)O)(O)=O,2,6,53,59,7,0.000319
G4,C(C(C(CO)O)(CCO)O)(O)=O,4,7,9,16,29,0.0004
G4,C(C(CO)(C(CCO)O)O)(O)=O,4,9,10,19,33,0.000488
G4,C(C(CCC(C=O)O)O)(O)=O,4,4,12,16,12,0.000223
G4,C(CC(C(O)=O)O)(C(C)O)=O,4,5,12,17,24,0.00027
G4,C(C(C)(C(CC=O)O)O)(O)=O,4,6,13,19,25,0.00032
G4,C(C(C(C)O)(CC=O)O)(O)=O,4,6,13,19,4,0.000321
G4,C(C(CO)(CC(C)=O)O)(O)=O,2,6,12,18,33,0.000298
G4,C(C(C(CC(C)=O)O)O)(O)=O,4,10,15,25,17,0.0005200000000000001
G4,C(C(CO)(CCC=O)O)(O)=O,2,3,12,15,29,0.000154
G4,C(CCC(C(C(O)=O)O)O)=O,4,7,17,24,33,0.000377
G4,C(C(C=CCO)(CO)O)(O)=O,4,3,6,9,29,0.000153
G4,C(C(C(C=CCO)O)O)(O)=O,8,7,8,15,29,0.000377
G4,C(C(CC(CCO)O)O)(O)=O,4,4,8,12,29,0.00023500000000000002
G4,C(C(CCO)(CCO)O)(O)=O,1,3,4,7,29,0.000176
G4,C(C(C)(CC(CO)O)O)(O)=O,4,2,8,10,29,0.000117
G4,C(CC(CC(C(O)=O)O)O)(O)=O,4,4,7,11,29,0.00023500000000000002
G4,C(C(CCO)(CC(O)=O)O)(O)=O,2,3,7,10,29,0.000176
G4,C(C(C)(CC(C(O)=O)O)O)(O)=O,4,5,8,13,29,0.000293
G4,C(C(CC(C(C)=O)(CO)O)O)(O)=O,4,3,10,13,45,0.000166
G4,C(C(C)(CC(C=O)(CO)O)O)(O)=O,4,2,12,14,14,0.00010800000000000001
G4,C(C(C)(C(C(CO)O)O)O)(O)=O,8,7,10,17,29,0.000399
G4,C(C1(COC(CO)C1)O)(O)=O,4,1,3,4,54,5.9e-05
G4,C(C1(COCC(C1)O)O)(O)=O,4,1,4,5,29,5.9e-05
G4,C(C1(CC(O)OCC1)O)(O)=O,4,3,6,9,7,0.000165
G4,C(C(C=CC(C)=O)O)(O)=O,4,5,16,21,29,0.000259
G4,C(C(C=CCC=O)O)(O)=O,4,6,15,21,29,0.00031800000000000003
G4,C(C(C=CC=O)(C)O)(O)=O,4,3,12,15,29,0.000153
G4,C(C(CC(C=C)=O)O)(O)=O,2,6,22,28,29,0.00031800000000000003
G4,C(C(C=C)(CC=O)O)(O)=O,2,6,17,23,7,0.000308
G4,C(C(CC=CC=O)O)(O)=O,4,5,15,20,29,0.000271
G4,C(C(C1CC(CO1)O)O)(O)=O,8,2,5,7,39,0.000117
G4,C(C(C(C)=O)=O)=O,1,79,224,303,25,0.003749
G4,C(CO)(CC(C=O)=O)=O,1,18,53,71,51,0.0008539999999999999
G4,C(C)(C(C(C=O)=O)O)=O,2,14,44,58,0,0.000664
G4,C(C(C=O)=O)=O,1,109,282,391,1,0.005173
G4,C(C(C(C=O)=O)O)=O,2,38,89,127,5,0.0018030000000000001
G4,C(C(C(C(CCO)O)=O)=O)=O,2,4,14,18,31,0.00020099999999999998
G4,C(C(CC(C(C=O)=O)O)O)=O,4,6,17,23,43,0.000307
G4,C(C(C)O)(C(C(C=O)=O)O)=O,4,3,15,18,1,0.000153
G4,C(CC(C(C(C=O)=O)O)O)(O)=O,4,5,16,21,29,0.000261
G4,C1(C(C(CC(C1O)O)O)=O)=O,8,1,15,16,43,4.7e-05
G4,C(C(C(CO)O)=O)(C(CO)O)=O,3,6,8,14,0,0.00031099999999999997
G4,C(C)(CC(C(C=O)=O)=O)=O,1,3,28,31,27,0.00014199999999999998
G4,C(CCC(C(C=O)=O)=O)=O,1,3,24,27,27,0.00014199999999999998
G4,C(C(CC(C(C)=O)=O)=O)=O,1,7,28,35,27,0.000332
G4,C(CC(CC(C=O)=O)=O)=O,1,9,34,43,27,0.00042699999999999997
G4,C(CO)=CC(C(C=O)=O)=O,2,3,15,18,17,0.00014199999999999998
G4,C=CC(C(C(C=O)=O)O)=O,2,4,25,29,33,0.00018999999999999998
G4,C(C(C=CC(CO)=O)=O)=O,2,11,31,42,12,0.000522
G4,C(C(C(C=O)=O)O)=CC=O,4,7,22,29,43,0.000332
G4,C(C(C1(CC(CO1)O)O)=O)=O,4,2,10,12,29,9.499999999999999e-05
G4,C(C(C1C(CC(O1)O)O)=O)=O,8,2,13,15,5,9.499999999999999e-05
G4,C(C(C(C(C(CO)O)=O)=O)O)=O,4,1,17,18,0,4.7e-05
G4,C(C(CO)=O)(C(CO)O)=O,2,10,24,34,0,0.00049
G4,C(C(C(C)O)=O)(C(CO)O)=O,4,7,14,21,0,0.00035800000000000003
G4,C(C(C(CO)(CO)O)=O)=O,1,6,12,18,0,0.0003
G4,C(C(C(C=O)=O)(C)O)=O,2,10,21,31,0,0.000475
G4,C(CC(C(C=O)=O)(CO)O)=O,2,4,17,21,29,0.000212
G4,C(C(C(C(C=O)=O)(C)O)O)=O,4,8,17,25,0,0.000393
G4,C(C(C(C)(C(CO)O)O)=O)=O,4,5,14,19,0,0.000261
G4,C(C(C(C=O)=O)(CCO)O)=O,2,1,12,13,29,4.7e-05
G4,C(C(C(CO)(CCO)O)=O)=O,2,8,13,21,29,0.000426
G4,C(C(C(CO)(C)O)=O)=O,2,11,20,31,0,0.000558
G4,C(C(C(CO)(C(CO)O)O)=O)=O,4,9,19,28,0,0.000478
G4,C(C(C=O)CC(CO)=O)=O,1,7,22,29,2,0.000332
G4,C(CO)(C(C(CO)=O)O)=O,1,8,16,24,5,0.00037999999999999997
G4,C(C(C=O)C(CO)=O)=O,1,13,36,49,1,0.000628
G4,C(CC(C(C=O)O)=O)=O,2,18,51,69,1,0.0008539999999999999
G4,C(C)(CC(CO)=O)=O,1,40,124,164,26,0.0019100000000000002
G4,C(C)(C(C(C)=O)O)=O,1,21,71,92,49,0.000997
G4,C(C)(CCO)=O,1,24,516,540,28,0.001152
G4,C(CC(CC=O)=O)=O,1,18,84,102,9,0.0008539999999999999
G4,C(CC(CC(C)=O)=O)=O,1,10,74,84,27,0.000475
G4,C(C)(C)=O,1,82,1787,1869,27,0.0038909999999999995
G4,C(CCC(CO)=O)=O,1,41,111,152,7,0.001957
G4,C(CC(CCC=O)=O)=O,1,14,68,82,44,0.000664
G4,C(C(CC(C)=O)O)=O,2,23,111,134,27,0.001103
G4,C(CO)=CC(CO)=O,2,21,80,101,11,0.001019
G4,C(CC(C=CCO)=O)=O,2,7,48,55,0,0.000344
G4,C(OCC(C)=O)=O,1,9,186,195,35,0.00042699999999999997
G4,C(COCC(CO)=O)=O,1,6,58,64,27,0.000285
G4,C(COC(C(C)=O)O)=O,2,5,44,49,27,0.00023700000000000001
G4,C(C(O)OCC(C)=O)=O,2,5,44,49,27,0.00023700000000000001
G4,C(OCC=O)=O,1,22,368,390,28,0.001044
G4,C(CO)(OCC=O)=O,1,9,72,81,40,0.00042699999999999997
G4,C(COC(C)=O)=O,1,6,146,152,28,0.000285
G4,C(C(C(CCO)O)=O)=O,2,12,28,40,27,0.0005809999999999999
G4,C(CO)(C(CCO)O)=O,2,17,34,51,31,0.000852
G4,C(CC(C(CO)=O)O)(O)=O,2,6,18,24,2,0.000307
G4,C(CCC(C=O)=O)=O,1,23,111,134,20,0.001092
G4,C(CCC=O)=O,1,52,274,326,27,0.002468
G4,C1(COC(CC1O)O)=O,4,5,33,38,27,0.000248
G4,C(CO)(C(COCC=O)O)=O,2,4,16,20,36,0.00020099999999999998
G4,C(OCCC(C(CO)=O)O)=O,2,3,6,9,19,0.000153
G4,C(CO)=CC(C=O)=O,2,13,72,85,55,0.000628
G4,C(CO)=CC=O,2,34,342,376,28,0.001625
G4,C(CC(OCC(CO)=O)O)=O,2,4,18,22,38,0.00018999999999999998
G4,C(C(CO)=O)(O)=O,1,40,138,178,33,0.0019100000000000002
G4,C(C)(CC(C(O)=O)=O)=O,1,8,36,44,0,0.000391
G4,C(CC(C(O)=O)=O)=O,1,22,71,93,45,0.0010550000000000002
G4,C(CC(C)=O)(O)=O,1,15,189,204,6,0.000724
G4,C(C=CC(CO)=O)(O)=O,2,6,39,45,18,0.000296
G4,C(C=CC(O)=O)=O,2,14,185,199,18,0.000676
G4,C(CO)(C(CO)(CO)C(C=O)O)=O,2,6,11,17,2,0.00031
G4,C(C(C(CO)=O)(CO)O)=O,2,9,16,25,2,0.000454
G4,C(C(CO)=O)(CO)=O,1,19,53,72,5,0.0009019999999999999
G4,C(C(C=O)(C=O)O)=O,1,9,17,26,1,0.00042699999999999997
G4,C(C(C=O)(C(CO)=O)O)=O,1,3,12,15,4,0.00014199999999999998
G4,C(C(C=O)(C(C)=O)O)=O,1,9,19,28,1,0.00042699999999999997
G4,C(C(C(C(C)=O)=O)O)=O,2,13,43,56,25,0.000617
G4,C(C(C(CO)O)=O)(O)=O,2,8,27,35,0,0.00040599999999999995
G4,C(C)(C(C(CO)=O)(CO)O)=O,2,9,10,19,2,0.000453
G4,C(C(CO)=O)(C(C)O)=O,2,12,38,50,0,0.0005809999999999999
G4,C(OC(C(C)=O)(CO)C(CO)O)=O,4,3,9,12,35,0.000146
G4,C(OC(CO)C(C(C)=O)(CO)O)=O,4,3,5,8,9,0.000146
G4,C(C)(C(CO)(CO)OC(C=O)O)=O,2,3,6,9,2,0.000146
G4,C(OCC(C(C(C)=O)(CO)O)O)=O,4,5,8,13,28,0.000242
G4,C(C)(C(C(OCC=O)O)(CO)O)=O,4,5,12,17,19,0.000241
G4,C(C)(C(CO)(COC(C=O)O)O)=O,4,3,8,11,2,0.000146
G4,C=CC(C(CO)=O)=O,1,14,112,126,7,0.000664
G4,C(C(C)=O)(C(C)O)=O,2,19,76,95,49,0.0009019999999999999
G4,C=CC(C(C(C)O)=O)=O,2,4,41,45,7,0.00018999999999999998
G4,C(C(C=O)(CC(C)=O)O)=O,1,3,18,21,17,0.000143
G4,C(CO)(C(CO)(CC=O)O)=O,2,12,17,29,2,0.000618
G4,C(CO)(C(CO)(C)O)=O,2,15,26,41,49,0.0007480000000000001
G4,C(CC(C(CO)=O)=O)=O,1,16,52,68,0,0.000759
G4,C(C(CO)OC(C(C)=O)(CO)O)=O,4,4,7,11,2,0.000196
G4,C(C(COC(C(C)=O)(CO)O)O)=O,4,2,8,10,41,9.7e-05
G4,C(C(C=O)(CC=O)O)=O,1,9,30,39,1,0.00042800000000000005
G4,C1(CCC(C1O)=O)=O,1,5,91,96,47,0.00023700000000000001
G4,C(CC(OCC(C)=O)=O)=O,1,6,26,32,48,0.000285
G4,C(COCC(C=O)=O)(C)=O,1,4,27,31,17,0.00018999999999999998
G4,C(OC(C(C)=O)C(C)=O)=O,1,2,11,13,9,9.499999999999999e-05
G4,C(OC(C(C)=O)CC=O)=O,2,2,19,21,17,9.499999999999999e-05
G4,C1(CCC(CO1)=O)=O,1,3,96,99,7,0.00014199999999999998
G4,C1(COCC(C1)=O)=O,1,4,110,114,54,0.00018999999999999998
G4,C(CC(C)=O)(OCC=O)=O,1,2,26,28,19,9.499999999999999e-05
G4,C(COCC(C(C)=O)=O)=O,1,2,25,27,36,9.499999999999999e-05
G4,C(OCCC(C(C)=O)=O)=O,1,2,14,16,17,9.499999999999999e-05
G4,C(OCC(CC(C)=O)=O)=O,1,2,20,22,38,9.499999999999999e-05
G4,C(C(C(CO)OCC=O)O)=O,4,5,14,19,26,0.000259
G4,C1(COC(CO)C1O)=O,4,6,38,44,27,0.000285
G4,C1(C(O)OC(CO)C1)=O,4,9,33,42,27,0.00043799999999999997
G4,C(C)(C(CO)OC(CO)=O)=O,2,6,8,14,2,0.000307
G4,C1(COC(CO)(C1)O)=O,2,5,41,46,27,0.00023700000000000001
G4,C1(C(OCC1)=O)=O,1,30,187,217,28,0.001424
G4,C1(CC(CO1)=O)=O,1,16,293,309,28,0.000759
G4,C(C(CC=O)OCC=O)=O,2,3,29,32,40,0.00014199999999999998
G4,C(C(C(C)=O)OC(C)=O)=O,2,1,14,15,26,4.7e-05
G4,C(COC(C(C=O)=O)C)=O,2,3,20,23,29,0.00014199999999999998
G4,C(C(C(COCC=O)O)O)=O,4,4,17,21,37,0.00020099999999999998
G4,C1(COCC(C1O)O)=O,4,6,41,47,27,0.000296
G4,C(COC(C(CO)=O)CO)=O,2,8,13,21,2,0.000384
G4,C1(C(O)OCC(C1)O)=O,4,9,34,43,27,0.00042699999999999997
G4,C(C)(C(CO)(OCC=O)O)=O,2,5,10,15,2,0.000239
G4,C(C)(C(COC(CO)=O)O)=O,2,5,7,12,2,0.00024900000000000004
G4,C(CO)(CCOC(CO)=O)=O,1,7,8,15,2,0.00035499999999999996
G4,C(C(CO)(OCC(C)=O)O)=O,2,4,10,14,2,0.000192
G4,C(C)(CCOC(C=O)=O)=O,1,2,18,20,30,9.499999999999999e-05
G4,C(OC(C=O)CC(C)=O)=O,2,1,19,20,37,4.7e-05
G4,C(C(C=O)O)(OCC(C)=O)=O,2,3,14,17,2,0.00014199999999999998
G4,C(C(CO)OC(C(C)=O)=O)=O,2,1,9,10,50,4.7e-05
G4,C(C)(C(CO)OC(C=O)=O)=O,2,3,9,12,2,0.00014199999999999998
G4,C1(C(CC(CO1)=O)O)=O,2,4,45,49,27,0.00018999999999999998
G4,C(C(COC(C(C)=O)=O)O)=O,2,1,10,11,27,4.7e-05
G4,C(CC(CO)=O)(OCC=O)=O,1,3,17,20,2,0.00014199999999999998
G4,C(C(C(C)=O)O)(OCC=O)=O,2,3,14,17,2,0.00014199999999999998
G4,C(C)(C(COC(C=O)=O)O)=O,2,3,10,13,2,0.00014199999999999998
G4,C(CO)(CCOC(C=O)=O)=O,1,5,12,17,2,0.00023700000000000001
G4,C(C=C(C(CO)=O)CO)=O,2,12,24,36,2,0.000592
G4,C(C(C(C(CO)=O)=C)O)=O,2,8,25,33,47,0.000391
G4,C(C(C=C)O)=O,2,74,276,350,28,0.003512
G4,C1OCC(C=1)=O,1,3,529,532,28,0.00014199999999999998
G4,C1C(O)OCC(C=1)=O,2,4,97,101,27,0.00018999999999999998
G4,C(COC=CC(CO)=O)=O,2,4,22,26,38,0.00018999999999999998
G4,C(OCC=CC(CO)=O)=O,2,4,14,18,19,0.00018999999999999998
G4,C1COC(C=1)=O,1,14,251,265,28,0.000664
G4,C(COC(CO)=CC=O)=O,2,3,15,18,40,0.00014199999999999998
G4,C(C(C(OCC=O)=C)O)=O,2,3,24,27,26,0.00014199999999999998
G4,C(COC(C=CC=O)O)=O,4,4,20,24,37,0.00018999999999999998
G4,C(C(C=COCC=O)O)=O,4,4,20,24,37,0.00018999999999999998
G4,C(C(C(CO)OC(C=O)O)O)=O,8,5,10,15,0,0.00023700000000000001
G4,C(CC(CO)OC(C=O)O)=O,4,5,13,18,41,0.00023700000000000001
G4,C(C(CO)O)(OCC(C)=O)=O,2,4,11,15,2,0.000212
G4,C(CCO)(OCC(CO)=O)=O,1,2,8,10,2,9.499999999999999e-05
G4,C(OC(C(CO)=O)CCO)=O,2,2,6,8,2,9.499999999999999e-05
G4,C1(C(CCO1)O)=O,2,10,66,76,28,0.00048600000000000005
G4,C(C(CO)OC(C(CO)=O)O)=O,4,2,8,10,29,9.499999999999999e-05
G4,C(C(C(COC(C=O)O)O)O)=O,8,5,13,18,15,0.00023700000000000001
G4,C(CC(COC(C=O)O)O)=O,4,5,14,19,30,0.00023700000000000001
G4,C(CC(C(OCC=O)O)O)=O,4,6,18,24,37,0.000296
G4,C(C(C)(OCC(CO)=O)O)=O,2,2,10,12,24,9.499999999999999e-05
G4,C(CO)(C(C)OC(C=O)O)=O,4,2,10,12,24,9.499999999999999e-05
G4,C(C(COC(C(CO)=O)O)O)=O,4,2,10,12,2,9.499999999999999e-05
G4,C(CC(C=O)O)(OCC=O)=O,2,4,14,18,8,0.00018999999999999998
G4,C(CC(C=O)CC(CO)=O)=O,2,11,20,31,43,0.000535
G4,C(CC(C(CO)=O)CC=O)=O,1,6,12,18,46,0.000286
G4,C(CCCC(C=O)=O)=O,1,15,50,65,7,0.000714
G4,C(CCCC(CO)=O)=O,1,17,50,67,27,0.00082
G4,C(CC(C=O)CC=O)=O,1,14,30,44,43,0.000666
G4,C1(C(C(CC1(CO)O)O)O)=O,8,11,12,23,2,0.0005679999999999999
G4,C1(CCC(C(C1O)=O)O)=O,4,5,21,26,32,0.000248
G4,C(C1(C(C(CC1)O)=O)O)=O,4,2,12,14,12,0.000106
G4,C1(C(CC(C(C1)=O)O)O)=O,3,3,14,17,32,0.000153
G4,C1(C(C(CO)C(C(C1O)O)O)O)=O,32,4,14,18,5,0.00018999999999999998
G4,C(C(C(C(CO)O)=O)(C)O)=O,4,3,12,15,2,0.000146
G4,C(C(C)(C(C(C=O)O)O)O)=O,8,6,17,23,11,0.000296
G4,C(C(C)(C(C=O)O)O)(C(CO)O)=O,8,12,17,29,0,0.000609
G4,C(C(C(CC(CO)(CO)O)O)=O)=O,2,2,10,12,5,0.000106
G4,C(C(CO)O)(C(C)(C(CO)O)O)=O,8,7,12,19,0,0.000371
G4,C(C(C(C(C)(C(CO)O)O)O)O)=O,16,6,14,20,0,0.00032
G4,C(CO)(C(CC(CO)(CO)O)O)=O,2,5,7,12,29,0.000271
G4,C(C(CCO)O)(C(C(CO)=O)O)=O,4,3,10,13,5,0.00014199999999999998
G4,C(C(C(C(CO)O)=O)(CCO)O)=O,4,3,12,15,55,0.000146
G4,C(C(C(C(C=O)O)O)(CCO)O)=O,8,5,16,21,29,0.000271
G4,C(C(CO)O)(C(CO)(CCO)O)=O,4,9,11,20,2,0.000489
G4,C(C(C(C(CO)(CCO)O)O)O)=O,8,8,13,21,29,0.000437
G4,C(C(CCO)O)(C(CO)(CO)O)=O,2,7,8,15,2,0.000381
G4,C(C(C(CO)C(CO)(CO)O)O)=O,4,2,9,11,29,0.000106
G4,C(C(CO)O)(C(CO)(C)O)=O,4,6,11,17,2,0.00031299999999999996
G4,C(C(C(C(CO)(C)O)O)O)=O,8,5,14,19,11,0.000261
G4,C(C(CC(CO)(CO)O)O)=O,2,2,9,11,29,0.000106
G4,C(C(C)O)(C(CO)(CO)O)=O,2,4,7,11,2,0.000205
G4,C(C(C(CC(C(CO)O)O)O)=O)=O,8,6,14,20,20,0.00033999999999999997
G4,C(CO)(C(CC(C(CO)O)O)O)=O,8,8,11,19,41,0.000446
G4,C(C(CCO)O)(C(C(CO)O)O)=O,8,8,12,20,31,0.000426
G4,C(C(C(CO)C(C(CO)O)O)O)=O,16,7,13,20,29,0.000399
G4,C(C(C)O)(C(C=O)C(CO)=O)=O,4,5,12,17,11,0.00023700000000000001
G4,C(CC(C(C(C(C)O)=O)O)=O)=O,4,4,12,16,9,0.00020099999999999998
G4,C(CC(C(C(C(C)=O)O)=O)O)=O,4,5,16,21,0,0.000239
G4,C(CC(C(C(C=O)(C)O)=O)O)=O,4,4,13,17,9,0.000202
G4,C(C(C=O)O)(CC(C(C)O)=O)=O,4,4,12,16,5,0.00020099999999999998
G4,C(C)(C(CC(C(C=O)=O)O)O)=O,4,4,16,20,45,0.00020099999999999998
G4,C(C(C)(CC(C(C=O)=O)O)O)=O,4,2,14,16,16,9.499999999999999e-05
G4,C(C(CO)O)(CC(C(C)O)=O)=O,4,6,12,18,24,0.0003
G4,C(C)(C(CC(C(CO)=O)O)O)=O,4,5,12,17,49,0.00026000000000000003
G4,C(C(C)(CC(C(CO)=O)O)O)=O,4,3,12,15,16,0.000154
G4,C(C(CCO)O)(CC(C=O)=O)=O,2,3,14,17,29,0.00014199999999999998
G4,C(CCO)(C(C(C(C)O)=O)O)=O,4,4,9,13,25,0.00020299999999999997
G4,C(C(CCO)O)(C(C(C)=O)O)=O,4,4,9,13,31,0.00020099999999999998
G4,C(C(C(C(CCO)O)=O)(C)O)=O,4,2,9,11,45,0.000106
G4,C(C(C)O)(C(C(CO)=O)CO)=O,4,7,10,17,24,0.000359
G4,C(C(C(CO)C(C(C)=O)O)O)=O,8,5,13,18,29,0.000271
G4,C(C(C)(C(CO)C(C=O)O)O)=O,8,2,13,15,29,0.000106
G4,C(C(C)O)(CC(CO)=O)=O,2,9,24,33,24,0.000449
G4,C(C(CC(C(C)=O)O)O)=O,4,4,21,25,29,0.00020099999999999998
G4,C(C(C)(CC(C=O)O)O)=O,4,1,15,16,16,4.7e-05
G4,C(C(C)O)(C(C(C)=O)O)=O,4,9,20,29,25,0.00043799999999999997
G4,C(C(C(C(C)O)=O)(C)O)=O,4,1,11,12,49,4.7e-05
G4,C(C(C)O)(C(C=O)C(C=O)O)=O,8,7,15,22,45,0.000344
G4,C(CC(C(C)O)=O)=O,2,18,94,112,45,0.0008539999999999999
G4,C(C(C(C(C(CO)O)O)=O)(C)O)=O,8,5,13,18,0,0.000261
G4,C(C(C)(C(C(C(CO)=O)O)O)O)=O,8,5,16,21,5,0.00026000000000000003
G4,C(C(C(CO)=O)C(CO)=O)=O,1,3,10,13,2,0.00014199999999999998
G4,C(C(C(C(CC=O)O)=O)O)=O,4,7,21,28,5,0.00034500000000000004
G4,C(CC(C(C(CO)=O)O)=O)=O,2,4,18,22,2,0.00018999999999999998
G4,C(CC(C(C(CO)(C)O)=O)O)=O,4,5,12,17,49,0.000252
G4,C(C(CO)(CC=O)O)(C(C)O)=O,4,5,13,18,25,0.000252
G4,C(C(C=O)O)(CC(CO)=O)=O,2,4,18,22,15,0.00018999999999999998
G4,C(C(C(CC(C(C=O)=O)O)O)O)=O,8,3,21,24,0,0.000164
G4,C(C(C(CC(CO)(C)O)O)=O)=O,4,3,14,17,49,0.000154
G4,C(C(CC(C)(C(C=O)O)O)O)=O,8,3,18,21,0,0.000144
G4,C(C(C)(C(C=O)O)O)(C(C)O)=O,8,4,13,17,49,0.000192
G4,C(C(C(CC(C)O)O)=O)=O,4,3,16,19,33,0.00014199999999999998
G4,C(C(C(C(C=O)O)C(C=O)O)O)=O,4,1,4,5,0,4.7e-05
G4,C(C(C(C(CC(C=O)O)O)=O)O)=O,8,3,16,19,0,0.000153
G4,C(CO)(C(C(C=O)=O)CO)=O,2,8,18,26,51,0.000384
G4,C(C(C(CO)C(C=O)O)O)=O,3,4,8,12,29,0.000223
G4,C(C(CO)O)(C(C(CO)=O)O)=O,4,7,11,18,5,0.00034700000000000003
G4,C(CO)(C(CC(CO)(C)O)O)=O,4,4,8,12,49,0.000212
G4,C(C(CC(C)(C(CO)O)O)O)=O,8,2,12,14,52,0.000106
G4,C(C(C)O)(C(C)(C(CO)O)O)=O,8,3,9,12,49,0.000155
G4,C(CO)(C(CC(C)O)O)=O,4,3,16,19,11,0.000154
G4,C(C(C(C(C)O)C(C=O)O)O)=O,6,1,8,9,11,4.7e-05
G4,C(C(CC(C(C(C)O)=O)O)O)=O,8,3,12,15,49,0.00014199999999999998
G4,C(C(C(CO)CO)O)=O,2,9,20,29,2,0.00046100000000000004
G4,C(C(CO)=O)(C(C(CO)CO)O)=O,2,2,8,10,30,9.499999999999999e-05
G4,C(C(C(CO)C(C(CO)=O)O)O)=O,8,9,14,23,5,0.00046100000000000004
G4,C(CO)(C(CC(C(CO)=O)O)O)=O,3,3,7,10,2,0.000153
G4,C(C(C(CO)CO)O)(C(CO)O)=O,4,7,9,16,49,0.000388
G4,C(CO)(C(C(CO)C(CO)O)O)=O,8,8,10,18,5,0.000458
G4,C(C(C(CO)CC(C=O)=O)O)=O,4,9,18,27,12,0.000462
G4,C(CO)(C(CCC(C=O)=O)O)=O,2,6,17,23,20,0.000308
G4,C(CC(C(C(CCO)O)=O)=O)=O,2,4,13,17,31,0.00018999999999999998
G4,C(CC(CO)C(C(C=O)=O)O)=O,4,7,18,25,43,0.00035499999999999996
G4,C1(C(C(CO)O)OC(CO)C1O)=O,16,3,7,10,27,0.000144
G4,C1(C(C(CO)C(C(CO)O)O1)O)=O,16,3,5,8,41,0.00014199999999999998
G4,C1(C(C(CO)OC(CO)C1O)O)=O,10,1,2,3,2,4.7e-05
G4,C1(C(C(CO)C(C(CO)O1)O)O)=O,16,2,5,7,41,9.499999999999999e-05
G4,C1(C(CO)OC(C(CO)C1O)O)=O,16,2,8,10,2,9.499999999999999e-05
G4,C1(C(O)OC(CO)C(CO)C1O)=O,16,2,7,9,19,9.499999999999999e-05
G4,C1(C(C(COC(CO)C1O)O)O)=O,16,1,7,8,36,4.7e-05
G4,C1(C(C(CO)C(C(CO1)O)O)O)=O,16,1,8,9,41,4.7e-05
G4,C1(C(C(C(O)OCC1O)CO)O)=O,16,3,8,11,5,0.00014199999999999998
G4,C1(C(O)OCC(C(CO)C1O)O)=O,16,2,8,10,19,9.499999999999999e-05
G4,C1(COC(C(C(CO)C1O)O)O)=O,16,2,9,11,2,9.499999999999999e-05
G4,C1(C(C(COC(C1O)O)CO)O)=O,16,2,10,12,30,9.499999999999999e-05
G4,C(C(C=CC(C(CO)=O)O)O)=O,8,4,11,15,51,0.00018999999999999998
G4,C(C(CCO)O)(CC(CO)=O)=O,2,5,10,15,29,0.00026000000000000003
G4,C(C(CC(C=O)O)O)(CCO)=O,4,4,13,17,3,0.00020299999999999997
G4,C(C(CC(C=O)O)(CCO)O)=O,4,2,13,15,29,0.000106
G4,C(C(C(C(C)O)=O)(CCO)O)=O,4,2,9,11,29,0.000106
G4,C(C(C(C=O)O)O)(C(CCO)O)=O,8,11,15,26,31,0.00057
G4,C(C(CCO)O)(C(CO)(C)O)=O,4,4,8,12,3,0.00021400000000000002
G4,C(C(C(CO)C(CO)(C)O)O)=O,8,3,11,14,29,0.000165
G4,C(C(CC(CO)(CCO)O)O)=O,4,3,11,14,29,0.000165
G4,C(C(C)O)(C(CO)(CCO)O)=O,4,4,8,12,3,0.00021400000000000002
G4,C(C(CCO)O)(C(C)O)=O,4,7,13,20,3,0.000344
G4,C(C(C(CO)C(C)O)O)=O,8,2,13,15,29,0.000106
G4,C(C(C(C(CC(C)O)O)=O)O)=O,8,2,11,13,11,9.499999999999999e-05
G4,C(C(CC(CO)(C)O)O)=O,4,2,13,15,49,0.000106
G4,C(C(C)O)(C(CO)(C)O)=O,4,3,10,13,49,0.000156
G4,C(C(CC(CC(C=O)O)O)O)=O,3,1,8,9,21,4.7e-05
G4,C(C(CC(C)O)O)=O,4,11,50,61,11,0.000522
G4,C(C(C)O)(C(C)O)=O,3,7,39,46,49,0.000332
G4,C(C(CC(CO)(C(CO)O)O)O)=O,8,4,12,16,29,0.000223
G4,C(C(C)O)(C(CO)(C(CO)O)O)=O,8,11,13,24,2,0.000595
G4,C(C(C(CO)O)O)(C(CO)(C)O)=O,8,8,12,20,49,0.00042800000000000005
G4,C(CO)(C(C(C(CO)(C)O)O)O)=O,8,6,11,17,5,0.000308
G4,C(CC(C(CC=O)=O)O)(CCO)=O,2,5,16,21,30,0.00024900000000000004
G4,C(C(CCC(CO)=O)O)(CC=O)=O,2,4,15,19,7,0.000202
G4,C(C(C(C(C)O)CC(C=O)=O)O)=O,8,4,14,18,12,0.00018999999999999998
G4,C(C(CCC(C=O)=O)O)(C(C)O)=O,4,4,12,16,12,0.00020099999999999998
G4,C(C(CC(C(C)=O)O)O)(CC=O)=O,4,1,14,15,45,4.7e-05
G4,C(C(CC(C)O)O)(CC(C=O)=O)=O,4,1,10,11,22,4.7e-05
G4,C(CC(C(C(CC(C)O)O)=O)=O)=O,4,1,10,11,9,4.7e-05
G4,C(CC(C(C)O)C(C(C=O)=O)O)=O,8,2,14,16,46,9.499999999999999e-05
G4,C(CC(C(C=CC(CO)O)O)=O)=O,8,2,5,7,29,0.000106
G4,C(C(C=CC(C(C(C)O)=O)O)O)=O,16,1,8,9,32,4.7e-05
G4,C(C(C(CO)=O)(C)O)=O,2,16,29,45,0,0.000782
G4,C(CO)(C(C)(C(CO)O)O)=O,4,8,10,18,0,0.000425
G4,C(C(C(C(CO)O)C(C=O)O)O)=O,6,2,9,11,0,0.000106
G4,C(C(C(CO)=O)(CCO)O)=O,2,6,10,16,55,0.00031800000000000003
G4,C(CO)(C(CO)(CCO)O)=O,2,9,9,18,2,0.00048499999999999997
G4,C(C(C(CO)C(CO)O)O)=O,8,6,12,18,29,0.000341
G4,C(C(C(C(C(CO)=O)(C)O)O)O)=O,8,8,16,24,26,0.00041500000000000006
G4,C(C(C(C(CC(CO)O)O)=O)O)=O,8,4,12,16,29,0.000212
G4,C(C(CC(CO)O)O)=O,4,9,24,33,0,0.00046100000000000004
G4,C(C(CC(C(C(CO)O)O)O)O)=O,16,6,13,19,49,0.00033999999999999997
G4,C(C(C(C(CO)C(CO)O)O)=O)=O,8,6,14,20,19,0.00031800000000000003
G4,C(C(C(C(C(CO)CO)O)=O)O)=O,4,5,9,14,30,0.000248
G4,C(C(C(C(CCO)=O)=O)O)=O,2,5,17,22,2,0.000239
G4,C(C(C(C(C(C)=O)O)=O)O)=O,4,3,15,18,1,0.00014199999999999998
G4,C(C(C(C)O)=O)(O)=O,2,12,40,52,4,0.000592
G4,C(COC(C(CO)=O)O)(C)=O,2,2,12,14,2,9.499999999999999e-05
G4,C(C(COC(C=O)CO)O)=O,4,1,15,16,2,4.7e-05
G4,C(C(C)O)(OC(C=O)CO)=O,4,1,9,10,2,4.7e-05
G4,C(OC(C(C(C)O)=O)CO)=O,4,1,7,8,2,4.7e-05
G4,C(OC(CO)CC(C=O)O)=O,4,1,6,7,2,4.7e-05
G4,C(C(COCC(C=O)O)O)=O,3,1,7,8,36,4.7e-05
G4,C(COCC(CO)=O)(CO)=O,1,1,7,8,36,4.7e-05
G4,C(C(C)O)(OCC(C=O)O)=O,4,1,8,9,41,4.7e-05
G4,C(COC(C(C)=O)O)(CO)=O,2,4,12,16,2,0.00018999999999999998
G4,C(OCC(C(C(C)O)=O)O)=O,4,1,6,7,2,4.7e-05
G4,C(OCC(CC(C=O)O)O)=O,4,1,7,8,19,4.7e-05
G4,C(COC(C(C(C)O)=O)O)=O,4,1,10,11,19,4.7e-05
G4,C(COC(C=O)O)(C(C)O)=O,4,2,10,12,2,0.000106
G4,C(C(CCOC(C=O)O)O)=O,4,5,11,16,30,0.00023700000000000001
G4,C(C(C=CC=O)O)=O,4,9,93,102,20,0.00042699999999999997
G4,C(COC(C(CO)=O)(C)O)=O,2,3,10,13,2,0.00014199999999999998
G4,C(C(CO)=O)(C(C(CO)O)O)=O,4,5,14,19,5,0.000239
G4,C(C(CO)=O)(C(C(C)O)O)=O,4,7,15,22,4,0.000357
G4,C(C(C(C(CCO)O)O)=O)(O)=O,4,7,11,18,33,0.00037799999999999997
G4,C1(C(C(CC(CO)O1)O)O)=O,8,6,6,12,19,0.00031800000000000003
G4,C1(C(C(CC(CO1)O)O)O)=O,8,4,8,12,19,0.000212
G4,C1(C(O)OCCC(C1O)O)=O,8,4,11,15,18,0.000212
G4,C=CC(C(C(CO)O)=O)=O,2,8,24,32,2,0.000395
G4,C=CC(C(C(CO)=O)=O)O,2,4,18,22,32,0.00018999999999999998
G4,C=CC(C(C(C=O)=O)O)O,4,7,21,28,27,0.000344
G4,C(C(CCC(CO)=O)O)=O,2,13,25,38,7,0.00064
G4,C(C(C)=O)(C(CCO)O)=O,2,6,16,22,9,0.000307
G4,C(C(C(C)O)=O)(CCO)=O,2,9,19,28,9,0.000463
G4,C(CO)(C(CC(C)=O)O)=O,2,8,30,38,5,0.00040199999999999996
G4,C(CCC(C(CO)=O)O)=O,2,6,25,31,27,0.000307
G4,C(C(CO)=O)(CCCO)=O,1,6,19,25,55,0.000308
G4,C(C(C(CCCO)O)=O)=O,2,3,15,18,29,0.000165
G4,C(C(C=CC(CO)O)O)=O,8,5,11,16,29,0.00026000000000000003
G4,C(CO)(C(C=CCO)O)=O,4,6,14,20,29,0.000307
G4,C(C(CO)O)(C(C=C)O)=O,4,8,18,26,2,0.00040599999999999995
G4,C(C(CCC(C(O)=O)=O)O)=O,2,5,12,17,29,0.000261
G4,C(C(C)O)(CC(C(O)=O)=O)=O,2,4,11,15,29,0.000212
G4,C(CC(C(C(C)=O)=O)O)(O)=O,2,4,10,14,29,0.000212
G4,C(CC(C(C(C)O)=O)=O)(O)=O,2,5,12,17,17,0.00026000000000000003
G4,C(C)(CC(C(C(O)=O)=O)O)=O,2,5,12,17,29,0.00026000000000000003
G4,C(CCC(C(C(O)=O)=O)O)=O,2,5,11,16,29,0.00026000000000000003
G4,C(CCC(C(CO)=O)=O)(O)=O,1,3,10,13,29,0.000154
G4,C(CCC(C(C=O)=O)O)(O)=O,2,4,12,16,29,0.000213
G4,C(C(C(C(O)=O)=O)O)=CCO,4,4,5,9,29,0.00020099999999999998
G4,C(CO)(C(C=CC(O)=O)O)=O,4,5,9,14,29,0.00024900000000000004
G4,C(C(C(C(C=C)O)=O)O)(O)=O,4,6,11,17,17,0.000298
G4,C(C(C=CC(C=O)O)O)(O)=O,8,7,10,17,29,0.000366
G4,C1(C(C(C(CO)(CO)C1O)O)O)=O,8,3,8,11,30,0.000153
G4,C(C(C(C(C)O)=O)(CO)O)=O,4,5,10,15,2,0.000264
G4,C(C(CO)(C(C(CO)=O)(C)O)O)=O,4,9,16,25,25,0.000466
G4,C(C(C)O)(C(C=O)(C(C)=O)O)=O,4,2,7,9,0,9.499999999999999e-05
G4,C(C(C)O)(C(C(C)=O)(CO)O)=O,4,5,8,13,2,0.00025299999999999997
G4,C(C(C=O)(C(C(C)O)=O)O)=O,2,1,6,7,1,4.7e-05
G4,C(C(C)O)(C(C=O)(C(C=O)O)O)=O,8,3,14,17,0,0.000144
G4,C(C(C(CO)=O)(C(C(C)=O)O)O)=O,4,3,15,18,5,0.000144
G4,C(C(C)(C(C=O)(C(CO)=O)O)O)=O,4,3,13,16,45,0.000144
G4,C(C(C)O)(C(C(CO)=O)(CO)O)=O,4,6,9,15,2,0.00031099999999999997
G4,C(C(C)(C(CO)(C(C=O)O)O)O)=O,8,7,14,21,0,0.000368
G4,C(C(C(CO)=O)(C(C)=O)O)=O,2,2,9,11,0,9.499999999999999e-05
G4,C(C(C=O)(C(C(C(C)O)=O)O)O)=O,4,6,12,18,1,0.000297
G4,C(C(C=O)(C(C(CO)=O)(C)O)O)=O,2,4,11,15,25,0.00019099999999999998
G4,C(C(C(C)=O)(C(C(CO)=O)O)O)=O,4,5,16,21,5,0.000239
G4,C(C(C(C(CO)=O)(C(C)=O)O)O)=O,4,3,14,17,0,0.000144
G4,C(C(C(CO)=O)(C(C=O)O)O)=O,4,3,16,19,0,0.000144
G4,C(CO)(C(C(CO)=O)(CO)O)=O,1,4,6,10,5,0.000205
G4,C(C(C(CO)=O)(C(CO)O)O)(O)=O,4,10,12,22,17,0.000534
G4,C(C(CO)O)(C(C(C)=O)(CO)O)=O,4,7,11,18,2,0.000362
G4,C(C(C(C(C(C)O)O)=O)(CO)O)=O,8,7,13,20,2,0.000361
G4,C(C(C(C(C=C)O)=O)(CO)O)=O,4,5,10,15,2,0.000241
G4,C(CO)(C(C(C=C)=O)(CO)O)=O,2,5,10,15,32,0.000241
G4,C(C(C=O)(C(C(CCO)O)=O)O)=O,2,1,7,8,3,4.7e-05
G4,C(C(C(C(C)O)=O)(C(C)O)O)=O,8,3,10,13,0,0.000145
G4,C(C)(C(C(CO)=O)(C(C)O)O)=O,4,4,8,12,4,0.000192
G4,C(C(C=O)(C(C(CO)=O)O)O)=O,2,5,13,18,5,0.000239
G4,C(C(C(CO)=O)(C(CO)(C)O)O)=O,4,4,10,14,49,0.000202
G4,C(C(C(CO)(C(CO)(C)O)O)O)=O,8,7,11,18,49,0.000379
G4,C(C(C(CO)=O)(C(C)O)O)=O,4,4,11,15,5,0.000204
G4,C(C(C(C(C=C)O)=O)(C(C)O)O)=O,8,3,8,11,2,0.000145
G4,C(CO)(C(C(C=C)=O)(C(C)O)O)=O,4,3,10,13,32,0.000145
G4,C(C(C(C(C)O)=O)(C(CO)O)O)=O,8,7,12,19,0,0.000379
G4,C(C)(C(C(CO)=O)(C(CO)O)O)=O,4,4,10,14,0,0.00020299999999999997
G4,C(C(C(CO)=O)(C(CO)O)O)=O,4,7,12,19,0,0.000379
G4,C(C(C)O)(C(C=O)(CC=O)O)=O,4,2,12,14,29,9.499999999999999e-05
G4,C(CO)(C(C)(C(C(O)=O)O)O)=O,4,5,9,14,0,0.000261
G4,C(C(C(CO)=O)(CC(CO)=O)O)=O,2,1,15,16,51,4.7e-05
G4,C(C(C(CO)=O)(CC=O)O)=O,2,3,16,19,0,0.000153
G4,C(C(CO)(CC(C=O)O)O)=O,4,2,14,16,2,9.7e-05
G4,C(C(CC(C=O)O)(C(C)O)O)=O,8,2,14,16,4,9.6e-05
G4,C(C(CO)=O)(C(CO)(CCO)O)=O,2,4,11,15,2,0.00021400000000000002
G4,C(C(CO)(C)O)(C(C(CO)=O)O)=O,4,3,10,13,2,0.000155
G4,C(C(C=CC(C=O)O)(CO)O)=O,8,5,11,16,29,0.000251
G4,C(C(C=CC(C=O)O)(C(C)O)O)=O,16,2,8,10,32,9.6e-05
G4,C(C(CC(C=O)O)(C(CO)O)O)=O,8,5,15,20,0,0.000272
G4,C(CO)(C(CO)OC(CO)=O)=O,2,2,4,6,50,9.499999999999999e-05
G4,C(CO)(C(COC(CO)=O)O)=O,2,2,3,5,40,9.499999999999999e-05
G4,C1(C(C(CC1CO)O)=O)=O,4,3,17,20,47,0.000153
G4,C1(C(C(C(CO)C1)O)=O)=O,4,3,19,22,55,0.00014199999999999998
G4,C1(C(COC1C(C)=O)O)=O,4,5,20,25,4,0.000248
G4,C1(C(CC(C(C)=O)O1)O)=O,4,4,13,17,48,0.00020099999999999998
G4,C(CC1CC(C(O1)=O)O)=O,4,5,16,21,23,0.000248
G4,C1(CCC(C(CO1)=O)O)=O,2,3,14,17,4,0.000153
G4,C1(CC(C(CCO1)O)=O)=O,2,5,14,19,19,0.000248
G4,C1(C(C(COCC1)O)=O)=O,2,3,18,21,36,0.000153
G4,C1(C(COCCC1O)=O)=O,2,3,15,18,36,0.000153
G4,C1(CC(C(OCC1)=O)O)=O,2,6,20,26,30,0.000296
G4,C1(C(CCC(CO1)=O)O)=O,2,4,17,21,12,0.00020099999999999998
G4,C(C1C(C(C(C)O1)O)=O)=O,8,2,18,20,17,0.000106
G4,C1(C(CO)(O)OCCC1O)=O,4,3,7,10,2,0.000153
G4,C1(CC(C(C(CO)O1)=O)O)=O,4,6,8,14,2,0.000296
G4,C1(C(C(CC(CO)O1)O)=O)=O,4,5,4,9,50,0.000248
G4,C1(CC(C(C(CO1)O)=O)O)=O,4,5,8,13,2,0.000248
G4,C1(C(C(CC(CO1)O)O)=O)=O,4,4,6,10,27,0.00020099999999999998
G4,C1(C(CC(C(CO1)=O)O)O)=O,4,4,9,13,2,0.00020099999999999998
G4,C1(C(C(C(CCO1)O)=O)O)=O,4,3,7,10,2,0.000153
G4,C1(C(C=C(CO)C1O)O)=O,4,4,11,15,46,0.00018999999999999998
G4,C1(C(C(C(C1O)=C)O)O)=O,8,7,18,25,2,0.000343
G4,C(CO)(C(C(C=C)O)O)=O,4,8,21,29,27,0.00040300000000000004
G4,C1(C(C=CC(CO)O1)O)=O,4,3,5,8,48,0.00014199999999999998
G4,C1(C(CO)OC=CC1O)=O,4,2,14,16,2,9.499999999999999e-05
G4,C1(C(C=CC(CO1)O)O)=O,4,3,5,8,48,0.00014199999999999998
G4,C1(C(COC=CC1O)O)=O,4,3,13,16,38,0.00014199999999999998
G4,C1(C(O)OCC=CC1O)=O,4,3,11,14,41,0.00014199999999999998
G4,C1(COC(C=CC1O)O)=O,4,3,13,16,38,0.00014199999999999998
G4,C1C(COC=1C(CO)=O)O,2,2,9,11,36,9.499999999999999e-05
G4,C(CO)(C1(C=CCO1)O)=O,2,3,10,13,2,0.00014199999999999998
G4,C(CO)(C1C=CC(O1)O)=O,4,3,13,16,38,0.00014199999999999998
G4,C(CO)(C1C(C=CO1)O)=O,4,2,17,19,38,9.499999999999999e-05
G4,C1(C(C(CO)O)OC(C1O)O)=O,16,4,11,15,5,0.000192
G4,C1(C(CCO)(O)OCC1O)=O,4,2,7,9,2,9.499999999999999e-05
G4,C1(C(O)OC(CCO)C1O)=O,8,3,8,11,18,0.000154
G4,C(CO)(C1(C(CCO1)O)O)=O,4,3,8,11,2,0.000153
G4,C1(C(C(CO)OC(C1O)O)O)=O,16,3,8,11,5,0.00014199999999999998
G4,C1(C(C(C)(O)OCC1O)O)=O,8,3,11,14,2,0.00014199999999999998
G4,C1(C(C(C)OC(C1O)O)O)=O,16,2,11,13,2,9.499999999999999e-05
G4,C1(C(C(COC(C1O)O)O)O)=O,16,3,11,14,5,0.00014199999999999998
G4,C1(CC(C(C(CO)=O)O1)O)=O,4,5,9,14,2,0.00023700000000000001
G4,C(CC(CO)CC(C(CO)=O)=O)=O,2,4,14,18,55,0.00020299999999999997
G4,C(CC(CO)CC(C(C=O)=O)O)=O,4,3,15,18,55,0.000154
G4,C(CO)(C(CC(C=O)CC=O)O)=O,4,5,16,21,25,0.00024900000000000004
G4,C(CC(C(C(CO)=O)O)CC=O)=O,2,5,10,15,46,0.00025
G4,C(CCCC(C(C(CO)=O)O)=O)=O,2,3,13,16,32,0.000144
G4,C(CCCC(C(C(C=O)O)=O)O)=O,4,2,14,16,27,9.499999999999999e-05
G4,C(CC(C(CO)=O)CC(CO)=O)=O,2,5,17,22,32,0.00025
G4,C(CC(CC(C=O)O)C(C=O)O)=O,8,5,17,22,27,0.00025
G4,C1(C(C(C(C1)O)CO)O)=O,8,4,19,23,4,0.00020099999999999998
G4,C1(C(C(C(CO)C1)O)O)=O,8,10,22,32,55,0.00048600000000000005
G4,C(C(CO)(CCO)O)O,1,2,6,8,29,0.000118
G4,C(C(C(CCO)O)O)O,4,7,11,18,27,0.00041
G4,C(C)(C(CCO)O)=O,2,9,64,73,45,0.00045
G4,C(C(C)(CCO)O)=O,2,4,30,34,29,0.00020099999999999998
G4,C(C(C(C)(CCO)O)O)=O,4,3,17,20,28,0.000156
G4,CC(CCO)(C(CO)O)O,4,2,6,8,29,0.000117
G4,C(CCO)O,1,2,85,87,18,0.000106
G4,C(CO)(C(C(C(CO)CO)O)O)=O,4,8,9,17,18,0.000425
G4,C(C(CO)C(C(C(CO)O)O)O)O,8,3,8,11,29,0.000176
G4,C(C(CC(C(CO)CO)O)=O)=O,2,3,12,15,29,0.000154
G4,C(CC(C(C(CO)CO)O)=O)=O,2,5,10,15,29,0.00026000000000000003
G4,C(C(C(CC(CO)CO)=O)O)=O,2,6,9,15,55,0.000307
G4,C1(C(C(C(C(CO)CO)O1)O)O)O,16,2,6,8,29,0.000106
G4,C1C(C(C(C(CO)CO)(O)O1)O)O,8,2,6,8,29,0.000106
G4,C(C(CCO)O)(CCO)=O,2,6,17,23,29,0.00032
G4,C(C(CCO)(CCO)O)=O,1,1,6,7,29,5.9e-05
G4,C(C(CCO)(CCO)O)O,1,2,3,5,29,0.000117
G4,C(C(C(C(C)(CCO)O)O)O)=O,8,3,13,16,29,0.000156
G4,CC(CO)(CCO)O,2,2,16,18,18,0.000118
G4,C(C(CC(CCO)O)O)=O,4,2,13,15,29,0.000106
G4,CC(CCO)O,2,1,87,88,28,5.9e-05
G4,C(C(C(CO)(CCO)O)O)O,4,4,6,10,29,0.00023500000000000002
G4,C(CCO)(CC(C(CCO)O)=O)=O,2,1,9,10,29,5.9e-05
G4,C(C(CCO)(CC(CCO)=O)O)=O,2,3,12,15,29,0.000165
G4,C(C(CC(CCO)(CCO)O)=O)=O,1,1,8,9,29,5.9e-05
G4,C(CCC(C(CCO)O)=O)(CO)=O,2,2,10,12,7,0.000106
G4,C(C(CCC(CO)=O)(CCO)O)=O,2,3,12,15,29,0.000165
G4,C(C(CCC(CO)(CCO)O)=O)=O,2,3,11,14,29,0.000165
G4,C(CC(C(C)=O)O)(C(CCO)O)=O,4,2,10,12,45,0.00010700000000000001
G4,C(C(CC(C(C)=O)O)(CCO)O)=O,4,1,11,12,29,5.9e-05
G4,C(C(CC(C(C)(CCO)O)O)=O)=O,4,2,11,13,29,0.00010700000000000001
G4,C(C(CC(CC(CCO)O)O)=O)=O,4,2,10,12,29,0.00010700000000000001
G4,C(C(CC(C(CO)C(C)O)O)=O)=O,8,2,12,14,29,0.00010700000000000001
G4,C(C(CCO)=O)(CC(CCO)O)=O,2,4,10,14,18,0.000215
G4,C(CC(C(CCO)(CCO)O)=O)=O,1,1,6,7,29,5.9e-05
G4,C(CC(CCO)O)(CC(CO)=O)=O,2,4,8,12,26,0.000213
G4,C(CC(CCO)O)(C(C(C)=O)O)=O,4,2,8,10,49,0.00010700000000000001
G4,C(CC(C(C(C)(CCO)O)O)=O)=O,4,3,11,14,28,0.000154
G4,C(CC(C(CC(CCO)O)O)=O)=O,4,2,10,12,29,0.000106
G4,C(CC(C(C(CO)C(C)O)O)=O)=O,8,2,11,13,29,0.000106
G4,C(C(C(CCO)O)O)(CC(C)=O)=O,4,3,10,13,26,0.000155
G4,C(C(C(CCO)(CC(C)=O)O)O)=O,4,5,13,18,27,0.000262
G4,C(C(C(CC(C)(CCO)O)=O)O)=O,4,2,10,12,29,0.00010700000000000001
G4,C(CCC=O)(C(C(CCO)O)O)=O,4,3,13,16,7,0.000155
G4,C(CCC(CCO)(C(C=O)O)O)=O,4,2,17,19,29,0.000106
G4,C(C(C(CCC(CCO)O)=O)O)=O,4,2,10,12,29,0.000106
G4,C(C(C(CC(CO)C(C)O)=O)O)=O,8,4,12,16,46,0.00020099999999999998
G4,C(C(CC(C(C)=O)(CCO)O)O)=O,4,1,11,12,29,5.9e-05
G4,C(CC(C=O)O)(C(C)(CCO)O)=O,4,1,9,10,29,5.9e-05
G4,C(CC(C=O)O)(CC(CCO)O)=O,4,3,12,15,27,0.000154
G4,C(C(CO)O)=CC(C(CCO)O)=O,8,1,8,9,29,5.9e-05
G4,C(C(C=CC(CO)O)(CCO)O)=O,8,1,6,7,29,5.9e-05
G4,C(CO)=CC(C(C(CCO)O)O)=O,8,4,11,15,11,0.000213
G4,C(C(C(C=CCO)(CCO)O)O)=O,8,1,8,9,0,5.9e-05
G4,C(C(CCO)O)=CC(C(CO)O)=O,8,1,8,9,2,5.9e-05
G4,C(C(C(CO)O)(CCO)O)=CC=O,8,1,6,7,29,5.9e-05
G4,C(C(C(C(C=C)(CCO)O)O)O)=O,8,1,11,12,0,5.9e-05
G4,C(C(C(CCO)O)O)=CC(CO)=O,8,1,6,7,29,5.9e-05
G4,C(C(C=CC(CO)(CCO)O)O)=O,8,1,5,6,29,5.9e-05
G4,C(C(C(C(CCO)O)O)O)=CC=O,16,1,9,10,29,5.9e-05
G4,C(C(C(C=CC(CCO)O)O)O)=O,16,1,8,9,29,5.9e-05
G4,C(C(CO)(C(CO)O)O)O,2,6,4,10,29,0.000352
G4,C(C(C(C(CO)O)O)O)O,3,5,4,9,29,0.000293
G4,C(C(C)(C(CO)O)O)=O,4,6,16,22,0,0.000308
G4,CC(C(CO)O)(C(CO)O)O,3,2,4,6,29,0.000117
G4,C(C(C(CO)O)(CCO)O)=O,4,5,11,16,29,0.000283
G4,CC(CO)(C(CO)O)O,4,3,9,12,27,0.000176
G4,CC(C(CO)O)O,4,3,37,40,28,0.000176
G4,C(C(CCO)O)O,2,4,36,40,29,0.00022400000000000002
G4,C(C(C(C(C(CO)CO)O)O)O)=O,8,9,12,21,29,0.000484
G4,C(CC(CO)O)(O)=O,2,5,29,34,45,0.00028199999999999997
G4,C(COC(C(CO)O)O)(C)=O,4,1,8,9,29,5.9e-05
G4,C(COC(CO)CO)(CO)=O,1,1,5,6,2,5.9e-05
G4,C(C(O)OC(CO)CO)(C)=O,2,1,4,5,29,5.9e-05
G4,C(C)(C(CO)OC(CO)O)=O,4,1,8,9,2,5.9e-05
G4,C(COCC(CO)O)(CO)=O,2,1,7,8,36,5.9e-05
G4,C(C(O)OCC(CO)O)(C)=O,4,1,6,7,41,5.9e-05
G4,C(CO)(CC(O)OCCO)=O,2,2,8,10,38,0.000106
G4,C(C)(C(C(O)OCCO)O)=O,4,1,9,10,29,5.9e-05
G4,C(C)(C(COC(CO)O)O)=O,4,1,7,8,29,5.9e-05
G4,C(CO)(CCOC(CO)O)=O,2,1,8,9,2,5.9e-05
G4,C(CC(CO)(O)OCCO)=O,2,1,9,10,29,5.9e-05
G4,C(COC(CO)(CCO)O)=O,2,1,7,8,29,5.9e-05
G4,C(C(C(C)(O)OCCO)O)=O,4,1,9,10,29,5.9e-05
G4,C(COC(C)(C(CO)O)O)=O,4,1,8,9,29,5.9e-05
G4,C(C(CC(O)OCCO)O)=O,4,2,7,9,29,0.000106
G4,C(COC(CC(CO)O)O)=O,4,1,8,9,29,5.9e-05
G4,CC(CO)O,2,2,129,131,11,0.000118
G4,C(C(C(CC(CO)O)O)O)O,8,6,8,14,29,0.000352
G4,C(C(CCC(CO)O)=O)=O,2,5,18,23,7,0.000271
G4,C(C(CO)O)(CCCO)=O,2,7,19,26,29,0.00037
G4,C(CC(CO)O)(CCO)=O,2,6,22,28,29,0.000319
G4,C(C(C(CO)O)O)=CCO,8,4,6,10,29,0.000212
G4,C(CC(CC(CO)=O)O)(O)=O,2,6,12,18,28,0.000319
G4,C(CC(C(CCO)O)=O)(O)=O,2,5,12,17,29,0.000261
G4,C(CC(C(CCO)=O)O)(O)=O,2,6,11,17,29,0.00032
G4,C(C(C(CCCO)=O)O)(O)=O,2,8,12,20,55,0.000426
G4,C(CCC(O)=O)(C(CO)O)=O,2,4,12,16,29,0.000212
G4,C(CC(CC(CO)O)=O)(O)=O,2,5,15,20,29,0.000261
G4,C1(CCC(C1(CO)O)O)=O,4,4,15,19,7,0.00020099999999999998
G4,C1C(C(CO)(C(C=1)O)O)O,3,2,3,5,29,0.000106
G4,C(C1(CO)C(C(C(C1O)O)O)O)O,10,1,3,4,29,5.9e-05
G4,C(C(CO)(C(CO)(CO)O)O)O,1,2,1,3,5,0.000117
G4,C(C(CO)(C(C(CO)O)O)O)O,4,8,6,14,29,0.000469
G4,C(C(C)(C(CO)(CO)O)O)=O,2,3,7,10,11,0.000165
G4,CC(C(CO)O)(C(CO)(CO)O)O,4,4,5,9,29,0.00023500000000000002
G4,C(C(CO)(CO)O)O,1,2,4,6,18,0.000117
G4,C(C(CCO)(C(CO)(CO)O)O)=O,2,4,8,12,29,0.00022400000000000002
G4,C(C(CCO)(C(CO)(CO)O)O)O,2,4,4,8,29,0.00023500000000000002
G4,CC(CO)(C(CO)(CO)O)O,2,3,3,6,29,0.000176
G4,C(C(CC(C(CO)(CO)O)O)O)=O,4,5,9,14,29,0.00028199999999999997
G4,C(C(CO)(C(CC(CO)O)O)O)=O,8,10,15,25,6,0.000546
G4,CC(C(CO)(CO)O)O,2,2,6,8,27,0.000117
G4,C(CO)(C(CO)(C(CCO)O)O)=O,4,9,12,21,2,0.000488
G4,C(C(CO)(C(C(CCO)O)O)O)O,4,3,6,9,29,0.000176
G4,C(CCO)(C(C(C)=O)(CO)O)=O,2,7,9,16,9,0.000361
G4,C(C(CO)(CO)O)(CC(C)=O)=O,1,6,9,15,26,0.0003
G4,C(CCC=O)(C(CO)(CO)O)=O,1,5,10,15,7,0.00025299999999999997
G4,C(C(C(CCCO)=O)(CO)O)=O,2,5,11,16,29,0.00025299999999999997
G4,C(CO)=CC(C(CO)(CO)O)=O,2,7,7,14,2,0.000359
G4,C=CC(C(CO)(C(CO)O)O)=O,4,7,16,23,7,0.000349
G4,C(C(C(CO)(CO)O)O)=CC=O,4,4,6,10,29,0.000212
G4,C(C(CO)(C(C=CCO)O)O)=O,8,7,12,19,28,0.000348
G4,C1C(CC(C(CO)(CO)O)(O)O1)O,4,2,4,6,29,0.000106
G4,C(C1(CC(C(CO)(CO)O1)O)O)O,4,2,4,6,29,0.000106
G4,CC1(C(C(C(CO)(CO)O1)O)O)O,8,2,5,7,29,0.000106
G4,C(C(CO)(C1C(CC(O)O1)O)O)O,8,2,4,6,29,0.000106
G4,C(C1(CO)C(C(CC(O)O1)O)O)O,8,2,5,7,29,0.000106
G4,C(C)(C(C(CO)O)(C(C)O)O)=O,8,6,13,19,4,0.000312
G4,C(C(C=O)(C(C(CCO)O)O)O)=O,4,4,11,15,29,0.000213
G4,C(C(C=O)(C(CC(CO)O)O)O)=O,4,5,11,16,6,0.000272
G4,C(CCO)(C(C(C)=O)(C(C)O)O)=O,4,3,8,11,9,0.000156
G4,C(C(CO)(C(C)O)O)(CC(C)=O)=O,4,3,12,15,26,0.000156
G4,C(CCC=O)(C(CO)(C(C)O)O)=O,4,3,13,16,4,0.000156
G4,C(C(C(CCCO)=O)(C(C)O)O)=O,4,3,10,13,29,0.000156
G4,C(CO)=CC(C(CO)(C(C)O)O)=O,8,4,12,16,4,0.000215
G4,C=CC(C(C(CO)O)(C(C)O)O)=O,8,5,16,21,7,0.00025299999999999997
G4,C(C(C(CO)(C(C)O)O)O)=CC=O,16,2,6,8,43,0.000117
G4,C(C(C(C)O)(C(C=CCO)O)O)=O,16,5,10,15,28,0.000252
G4,C(C)(C(C(CO)O)(C(CO)O)O)=O,3,4,7,11,0,0.00021400000000000002
G4,C(C(C)(C(CO)(C(CO)O)O)O)=O,8,7,11,18,29,0.000399
G4,CC(CO)(C(CO)(C(CO)O)O)O,8,7,6,13,29,0.00041
G4,CC(C(CO)(C(CO)O)O)O,8,6,6,12,29,0.000352
G4,C(C1(CC(C(C1O)O)O)O)O,16,6,8,14,29,0.00035099999999999997
G4,C1(CC(C(CO)(C1)O)O)=O,4,4,23,27,17,0.00020099999999999998
G4,C(C(CCO)(C(C(CO)O)O)O)=O,8,6,13,19,29,0.000341
G4,C(C(C)(C(CO)(CC=O)O)O)=O,4,6,14,20,29,0.000309
G4,C(C(CCO)(C(C=O)(C)O)O)=O,4,5,13,18,29,0.000261
G4,C(C(CO)(CCO)O)=O,2,6,15,21,29,0.000309
G4,C(CO)(C(CO)(CC(CO)O)O)=O,4,5,10,15,29,0.000273
G4,C(C(CO)(CC(C(CO)O)O)O)=O,8,6,13,19,29,0.000342
G4,C(C(CO)(CC=O)O)(CCO)=O,2,7,15,22,2,0.00036
G4,C(CC(C(CO)(CCO)O)=O)=O,2,4,13,17,2,0.00020299999999999997
G4,C(C(CO)(CC(CCO)=O)O)=O,2,5,15,20,2,0.000251
G4,C(C(CO)(CO)O)=CC(CO)=O,2,3,4,7,29,0.000154
G4,C(CC(CO)(C(C)(CO)O)O)=O,4,4,11,15,29,0.00021400000000000002
G4,C(C(CCO)(C(CO)(C)O)O)=O,4,3,10,13,29,0.000166
G4,C(C(C(C)O)(CCO)O)=O,4,2,10,12,4,0.00010800000000000001
G4,C(C)(C(C(C)O)(CC(CO)=O)O)=O,4,3,12,15,45,0.000156
G4,C(C(C(C)O)(CC=O)O)(CCO)=O,4,4,13,17,4,0.000206
G4,C(CC(C(C(C)O)(CCO)O)=O)=O,4,2,11,13,4,0.00010800000000000001
G4,C(C(C(C)O)(CC(CCO)=O)O)=O,4,3,13,16,25,0.000155
G4,C(C(CO)(C(C)O)O)=CC(CO)=O,8,1,4,5,29,5.9e-05
G4,C(CO)(OC(CO)C(CO)O)=O,4,4,2,6,29,0.000223
G4,C(CO)(OCC(C(CO)O)O)=O,4,4,4,8,29,0.000223
G4,C1(CC(C(CCO)O1)O)=O,4,3,5,8,29,0.000154
G4,C1(COC(CCO)C1O)=O,4,3,16,19,29,0.000154
G4,C1(C(O)OC(CCO)C1)=O,4,3,15,18,4,0.000154
G4,C1(C(CCO)OC(C1)O)=O,4,3,16,19,4,0.000154
G4,C(C=CC(CO)=O)(C)=O,2,10,68,78,45,0.00048600000000000005
G4,C(CC=CC(CO)=O)=O,2,9,59,68,29,0.00043799999999999997
G4,C(CCO)=CC(C=O)=O,2,5,31,36,29,0.00024900000000000004
G4,C(CO)=CC(C(C)=O)=O,2,4,38,42,27,0.00020099999999999998
G4,C(C=CC(CCO)=O)=O,2,5,62,67,27,0.000251
G4,C(CO)(CC(C=C)=O)=O,1,8,67,75,27,0.000391
G4,C=CC(C(CCO)=O)=O,1,4,51,55,45,0.00020099999999999998
G4,C(CO)(CC=CC=O)=O,2,9,59,68,27,0.00043799999999999997
G4,C(CC(C=O)=O)=CCO,2,4,30,34,27,0.00020099999999999998
G4,C(C1C(C(C(CO)O1)O)O)O,10,3,1,4,29,0.000176
G4,C1(C(CCO)OCC1O)=O,4,3,13,16,29,0.000154
G4,C1(C(CCO)(O)OCC1)=O,2,3,12,15,2,0.000154
G4,C1(COC(CCO)(C1)O)=O,2,3,20,23,30,0.000154
G4,C(CO)(C1CC(CO1)O)=O,4,2,13,15,4,0.000106
G4,C(C1CC(C(CO)O1)O)=O,8,2,9,11,29,0.000106
G4,C(C1C(CC(CO)O1)O)=O,8,2,13,15,29,0.000106
G4,C1(C(CO)OC(C)(C1)O)=O,4,3,20,23,26,0.000154
G4,C1(C(C)(O)OC(CO)C1)=O,4,3,11,14,14,0.000154
G4,C1(C(C)OC(CO)C1O)=O,8,2,12,14,29,0.000106
G4,C1C(C(C(C(CO)O1)O)O)O,16,4,4,8,29,0.000234
G4,C1(CC(CO)(O)OCC1)=O,2,4,20,24,30,0.00020099999999999998
G4,C1(COC(CO)(CC1)O)=O,2,3,16,19,29,0.000154
G4,C1(C(CO)OC(CC1)O)=O,4,3,16,19,37,0.000154
G4,C1(CC(CO)OC(C1)O)=O,4,4,19,23,44,0.00020099999999999998
G4,C1(C(C(C(CCO)O1)O)O)=O,8,5,6,11,29,0.00026000000000000003
G4,C1C(C(C(C=1CO)O)O)O,8,3,6,9,29,0.000154
G4,C=CC(C(C(CO)O)O)O,8,5,8,13,29,0.000271
G4,C1C(CO)(C(C(C=1)O)O)O,8,3,6,9,29,0.000154
G4,C1C(C(CO)OC=1CO)O,4,3,1,4,29,0.000165
G4,C1C(CO)OC(C=1)(CO)O,4,4,3,7,29,0.000212
G4,C1(C(C(CO1)O)O)=CCO,8,2,3,5,29,0.000106
G4,C1(C(CO)O)OCC(C=1)O,4,2,3,5,29,0.000106
G4,C1C(C(CO)O)(OCC=1)O,4,3,5,8,29,0.000154
G4,C=C1C(C(C(CO)O1)O)O,8,2,3,5,29,0.000106
G4,C1C(C(CO)O)OC(C=1)O,8,3,4,7,29,0.000154
G4,C1OC(C(CO)O)C(C=1)O,8,2,3,5,29,0.000106
G4,C1C(C(COC=1CO)O)O,4,2,3,5,29,0.000106
G4,C1C(COC(C=1)(CO)O)O,4,3,3,6,29,0.000154
G4,C1C(C(CO)OC(C=1)O)O,8,3,2,5,29,0.000154
G4,C1OC(CO)C(C(C=1)O)O,8,2,3,5,29,0.000106
G4,C(C1(C(CC(CO)O1)O)O)O,8,4,4,8,29,0.000223
G4,C1CC(C(C(CO)O)(O)O1)O,8,4,6,10,29,0.000223
G4,C(C(C1CC(C(O)O1)O)O)O,16,4,6,10,29,0.000223
G4,C1C(CC(C(CO)(O)O1)O)O,8,3,5,8,29,0.000165
G4,C(C1C(CC(C(O)O1)O)O)O,16,3,5,8,29,0.000165
G4,C(C1CC(C(C(O)O1)O)O)O,16,3,6,9,29,0.000165
G4,C(C(CC(CCO)C(CO)O)=O)=O,4,7,13,20,46,0.000366
G4,C(CC(C(CO)O)CC(CO)=O)=O,4,6,16,22,46,0.00031
G4,C(C(C(CC(CO)CCO)=O)O)=O,4,4,10,14,46,0.00020099999999999998
G4,C(CC(CO)CC(C(CO)O)=O)=O,4,4,16,20,29,0.00021400000000000002
G4,C(C(CCO)CC(C(CO)O)=O)=O,4,12,15,27,46,0.000607
G4,C(C(CCO)CC=O)(C(CO)O)=O,4,7,15,22,46,0.00037
G4,C(C(C(C=O)O)O)(CCCCO)=O,4,10,13,23,46,0.0005110000000000001
G4,C(CCCC(C(C(CO)O)O)=O)=O,4,5,14,19,27,0.000252
G4,C(C(C(CCO)CC(CO)=O)O)=O,4,6,13,19,46,0.000296
G4,C(CC(C(C(C=O)O)O)CCO)=O,8,8,18,26,46,0.00041500000000000006
G4,C(CC(C(C(CO)O)O)CC=O)=O,4,3,11,14,4,0.000155
G4,C(C1C(CC(C1O)=O)O)(O)=O,8,6,14,20,29,0.000296
G4,C(C1C(C(C(C1)=O)O)O)(O)=O,8,3,16,19,29,0.000154
G4,C(CC(CO)(CO)O)(O)=O,1,2,6,8,29,0.000117
G4,C(CC(C(CO)O)O)(O)=O,4,3,10,13,29,0.000176
G4,C(C(C(C=O)O)C(C(C)=O)O)(O)=O,8,4,12,16,45,0.000202
G4,C(C(C(C(O)=O)C(C=O)(C)O)O)=O,8,4,12,16,29,0.000202
G4,C(CC(C(C)=O)O)(O)=O,2,6,32,38,27,0.000296
G4,C(C(C)(CC(O)=O)O)=O,2,4,18,22,29,0.00020099999999999998
G4,C(CC(C(C(C)=O)O)O)(O)=O,4,5,13,18,28,0.000261
G4,C(CC(C)(C(C=O)O)O)(O)=O,4,3,13,16,6,0.000156
G4,C(C(C(C=O)O)C(C=O)O)(O)=O,3,3,7,10,29,0.000154
G4,C(CC(C)(C(CO)O)O)(O)=O,4,2,8,10,29,0.000117
G4,C(CC(CO)(CC(C=O)O)O)(O)=O,4,2,12,14,29,0.000106
G4,C(C(CO)C(C=O)O)(O)=O,4,5,16,21,29,0.000263
G4,C(CCO)(O)=O,1,6,147,153,18,0.000319
G4,C(C(CO)C(CC(C=O)=O)O)(O)=O,4,5,13,18,29,0.000263
G4,C(C(CO)C(C(CC=O)=O)O)(O)=O,4,5,12,17,29,0.000262
G4,C(C(CO)CC(C(C=O)O)=O)(O)=O,4,2,11,13,29,0.000117
G4,C(C(CCO)(CC(O)=O)O)=O,2,1,9,10,29,5.9e-05
G4,C(CC(CO)(CCO)O)(O)=O,2,3,7,10,29,0.000176
G4,C(CC(C)(C(C(C=O)O)O)O)(O)=O,8,3,14,17,29,0.000156
G4,C(CC(C(C=O)O)O)(O)=O,4,5,20,25,28,0.000262
G4,C(C(C(CO)(C)O)C(C=O)O)(O)=O,8,5,12,17,29,0.000261
G4,C(CC(C)(CO)O)(O)=O,2,3,14,17,29,0.000165
G4,C(C(C(C)O)C(C=O)O)(O)=O,8,4,12,16,29,0.00020299999999999997
G4,C(CC(CC(C=O)O)O)(O)=O,4,2,12,14,29,0.000106
G4,C(CC(C)O)(O)=O,2,2,67,69,28,0.000106
G4,C(CC(CO)(C(CO)O)O)(O)=O,4,4,8,12,29,0.00023500000000000002
G4,C(C(C(CO)O)C(C=O)O)(O)=O,8,5,13,18,29,0.000261
G4,C(C(C(CC(CO)O)=O)=O)(O)=O,2,2,13,15,29,0.000106
G4,C(C(CO)O)(CC(C(O)=O)=O)=O,2,4,13,17,29,0.00020099999999999998
G4,C(CCO)(C(C(C(O)=O)=O)O)=O,2,2,9,11,29,0.000106
G4,C(CO)(CC(C(C(O)=O)=O)O)=O,2,3,11,14,29,0.000154
G4,C(C)(C(C(C(C(O)=O)=O)O)O)=O,4,5,13,18,33,0.00025
G4,C(CC(C(C(C(O)=O)=O)O)O)=O,4,5,14,19,33,0.00025
G4,C(C(O)=O)(O)=O,1,1,1,2,33,5.9e-05
G4,C(C(C(O)=O)O)(O)=O,1,16,37,53,17,0.000771
G4,C(C(C(C(O)=O)O)O)(O)=O,3,9,10,19,33,0.000472
G4,C(CC(C(O)=O)O)(O)=O,2,5,19,24,29,0.00028199999999999997
G4,C(C)(C(CO)(C(C(O)=O)O)O)=O,4,9,13,22,33,0.000466
G4,C(C(C(OCC(C)=O)O)O)(O)=O,4,1,7,8,29,5.9e-05
G4,C(C(CO)OCC(CO)=O)(O)=O,2,1,2,3,29,5.9e-05
G4,C(C(CO)OC(C(C)=O)O)(O)=O,4,1,3,4,29,5.9e-05
G4,C(C)(C(CO)OC(C(O)=O)O)=O,4,1,4,5,29,5.9e-05
G4,C(C(COCC(CO)=O)O)(O)=O,2,1,4,5,29,5.9e-05
G4,C(C(COC(C(C)=O)O)O)(O)=O,4,1,5,6,29,5.9e-05
G4,C(CO)(CC(OCC(O)=O)O)=O,2,3,5,8,29,0.000154
G4,C(C)(C(C(OCC(O)=O)O)O)=O,4,2,7,9,29,0.000106
G4,C(C)(C(COC(C(O)=O)O)O)=O,4,1,4,5,29,5.9e-05
G4,C(CO)(CCOC(C(O)=O)O)=O,2,1,4,5,29,5.9e-05
G4,C=CC(C(O)=O)=O,1,8,118,126,7,0.000391
G4,C(CC(CO)(OCC(O)=O)O)=O,2,2,8,10,29,0.000106
G4,C(CC(CO)(OCC=O)O)(O)=O,2,1,6,7,29,5.9e-05
G4,C(C(C(C)(OCC(O)=O)O)O)=O,4,2,8,10,29,0.000106
G4,C(C(C(C)(OCC=O)O)O)(O)=O,4,1,8,9,29,5.9e-05
G4,C(C(CC(OCC(O)=O)O)O)=O,4,3,7,10,29,0.000154
G4,C(C(CC(OCC=O)O)O)(O)=O,4,1,7,8,29,5.9e-05
G4,C(C(C(CC(C(O)=O)O)O)O)(O)=O,8,7,11,18,29,0.000399
G4,C(C(CCC(C=O)=O)O)(O)=O,2,8,15,23,29,0.000425
G4,C(CC(CC(C(O)=O)=O)O)(O)=O,2,4,8,12,29,0.000213
G4,C(CC(C(CC(O)=O)O)=O)(O)=O,2,5,8,13,29,0.000261
G4,C(C(C(CCC(O)=O)=O)O)(O)=O,2,3,8,11,29,0.000165
G4,C(CC(CC(C(O)=O)O)=O)(O)=O,2,8,10,18,29,0.000425
G4,C(C(C(C=CC(O)=O)O)O)(O)=O,8,5,7,12,29,0.00026000000000000003
G4,C(C1(C(CCC1O)=O)O)(O)=O,4,4,10,14,17,0.00020099999999999998
G4,C(C1(C(C=CC1O)O)O)(O)=O,3,4,5,9,43,0.00020099999999999998
G4,C(C(CO)(C(CO)(CO)O)O)(O)=O,2,8,8,16,5,0.000429
G4,C(C(C=O)(C(CO)(CO)O)O)(O)=O,2,7,9,16,5,0.000368
G4,C(C(CO)(C(C(CO)O)O)O)(O)=O,8,14,13,27,33,0.000781
G4,C(C(CO)(C(C(C)=O)O)O)(O)=O,4,10,13,23,33,0.000515
G4,C(C(CO)(C(C=O)(C)O)O)(O)=O,4,8,13,21,45,0.00041900000000000005
G4,C(C(C)(C(C=O)(CO)O)O)(O)=O,4,8,14,22,28,0.00041900000000000005
G4,C(C(CO)(C(C=O)O)O)(O)=O,4,14,16,30,33,0.0007160000000000001
G4,C(C(CO)(C(C(O)=O)O)O)=O,4,10,16,26,33,0.0005139999999999999
G4,C(C(CO)(CO)O)(O)=O,1,6,5,11,33,0.000334
G4,C(C(C=O)(C(C(CO)O)O)O)(O)=O,8,11,15,26,17,0.000602
G4,C(C(CO)(C(C(C=O)O)O)O)(O)=O,8,12,17,29,1,0.0006320000000000001
G4,C(C(CO)(C(C(C(O)=O)O)O)O)=O,8,13,17,30,17,0.000711
G4,C(C(CO)(C(CO)(C)O)O)(O)=O,4,8,9,17,49,0.00043
G4,C(C(CO)(C(C)O)O)(O)=O,4,8,8,16,4,0.00043099999999999996
G4,C(C(C(C)=O)(C(C(C)=O)O)O)(O)=O,4,5,12,17,0,0.000251
G4,C(C(C)(C(C=O)(C(C)=O)O)O)(O)=O,4,4,9,13,1,0.000202
G4,C(C(C)(C(C(O)=O)(C(C)=O)O)O)=O,4,5,11,16,45,0.000251
G4,C(C(C)(C(C(C)=O)(CO)O)O)(O)=O,4,8,12,20,28,0.00041799999999999997
G4,C(C(C=O)(C(C(C)=O)O)O)(O)=O,4,8,14,22,17,0.000405
G4,C(C(C=O)(C(C(O)=O)(C)O)O)=O,2,4,9,13,1,0.000202
G4,C(C(C=O)(C(C=O)(C)O)O)(O)=O,4,5,13,18,45,0.000251
G4,C(C(C(C)=O)(C(C=O)O)O)(O)=O,4,9,14,23,0,0.000452
G4,C(C(C(C)=O)(C(C(O)=O)O)O)=O,4,5,11,16,33,0.00025
G4,C(C(C(C)=O)(CO)O)(O)=O,2,11,11,22,0,0.0005610000000000001
G4,C(C(C(C)=O)(C(CO)(C)O)O)(O)=O,4,6,9,15,49,0.00031
G4,C(C(C(C)=O)(C(C)O)O)(O)=O,4,7,9,16,4,0.000348
G4,C(C(C=O)(C(C(O)=O)O)O)=O,2,4,11,15,1,0.000202
G4,C(C(C=O)(C(C=O)O)O)(O)=O,4,10,16,26,17,0.0005
G4,C(C(C(C=O)(C(C=O)O)O)O)(O)=O,8,10,19,29,33,0.0005009999999999999
G4,C(C(C(C=O)O)(C(C=O)O)O)(O)=O,3,5,10,15,0,0.000261
G4,C(CO)(C(CO)(C(C(O)=O)O)O)=O,4,10,14,24,33,0.000525
G4,C(C(C=O)(CO)O)(O)=O,2,11,13,24,17,0.000562
G4,C(CC(O)=O)(C(C(C)=O)(CO)O)=O,2,4,9,13,17,0.000206
G4,C(C(C(CC(C)=O)=O)(CO)O)(O)=O,2,6,9,15,17,0.00031299999999999996
G4,C(C(C(CCC=O)=O)(CO)O)(O)=O,2,6,10,16,17,0.00031299999999999996
G4,C(C(C(CCC(O)=O)=O)(CO)O)=O,2,3,9,12,29,0.00015800000000000002
G4,C(C(C(C=CCO)=O)(CO)O)(O)=O,4,7,7,14,17,0.00037200000000000004
G4,C(C=CC(C(CO)(CO)O)=O)(O)=O,2,3,6,9,2,0.00015800000000000002
G4,C(C(CO)(C(C(C=C)=O)O)O)(O)=O,4,8,13,21,7,0.000408
G4,C(C(C(C(C=C)=O)(CO)O)O)(O)=O,4,6,14,20,33,0.000301
G4,C(C(CO)(C(C=CC=O)O)O)(O)=O,8,6,8,14,43,0.000312
G4,C(C(CO)(C(C=CC(O)=O)O)O)=O,8,5,10,15,18,0.00025299999999999997
G4,C(C(C(C)O)(C(C(C)=O)O)O)(O)=O,8,7,13,20,4,0.000348
G4,C(C)(C(C(C)O)(C(C(O)=O)O)O)=O,8,6,13,19,33,0.0003
G4,C(C(C=O)(C(C(C(O)=O)O)O)O)=O,4,4,12,16,1,0.000202
G4,C(C(C=O)(C(C(C=O)O)O)O)(O)=O,8,9,17,26,1,0.000454
G4,C(C(C=O)(C(CO)(C)O)O)(O)=O,4,6,11,17,49,0.00031
G4,C(C(C=O)(C(C)O)O)(O)=O,4,7,10,17,17,0.000359
G4,C(C(C(C)O)(C(C=O)O)O)(O)=O,8,9,15,24,4,0.000455
G4,C(C(C(C)O)(C(C(O)=O)O)O)=O,8,8,15,23,33,0.000417
G4,C(C(C(C)=O)(C(CO)O)O)(O)=O,4,8,11,19,0,0.000417
G4,C(C(C=O)(C(CO)O)O)(O)=O,4,9,12,21,17,0.00048600000000000005
G4,C(C(C(CO)O)(C(C(O)=O)O)O)=O,8,10,17,27,33,0.000533
G4,C(C1(C(C(C(C1)O)O)O)O)(O)=O,16,7,13,20,29,0.000399
G4,C(C1(C(CC(C1)=O)O)O)(O)=O,4,5,15,20,29,0.00024900000000000004
G4,C(C(CC=O)(C(C(C)=O)O)O)(O)=O,4,4,13,17,49,0.00020299999999999997
G4,C(CC(C=O)(C(C(C)=O)O)O)(O)=O,4,4,12,16,17,0.00020299999999999997
G4,C(C(C)(C(C=O)(CC=O)O)O)(O)=O,4,4,12,16,43,0.00020299999999999997
G4,C(CC(C(O)=O)(C(C=O)(C)O)O)=O,4,3,12,15,11,0.000155
G4,C(CC(C=O)(C(C=O)(C)O)O)(O)=O,4,3,11,14,29,0.000155
G4,C(C(C)(C(C(O)=O)O)O)(O)=O,4,9,9,18,28,0.000484
G4,C(CC(CO)(C(C(O)=O)O)O)(O)=O,4,4,9,13,29,0.00022400000000000002
G4,C(C(C(C)(C(C(O)=O)O)O)O)(O)=O,3,4,6,10,29,0.00022400000000000002
G4,C(C(C(C=O)(CC=O)O)O)(O)=O,4,5,15,20,33,0.000251
G4,C(C(CC=O)(C(C=O)O)O)(O)=O,4,6,16,22,0,0.000299
G4,C(CC(C=O)(C(C=O)O)O)(O)=O,4,4,14,18,0,0.000204
G4,C(C(CO)(CC(CO)=O)O)(O)=O,2,5,10,15,33,0.000262
G4,C(C(C(C)O)(CC(CO)=O)O)(O)=O,4,3,10,13,4,0.000156
G4,C(C(CO)(CC=O)O)(O)=O,2,7,17,24,33,0.00036899999999999997
G4,C(C(CO)(CC(O)=O)O)=O,2,2,12,14,29,0.00010800000000000001
G4,C(C(CO)(CC=O)O)(CC(O)=O)=O,2,4,14,18,45,0.000205
G4,C(C(CO)(CC(O)=O)O)(CC=O)=O,2,2,11,13,29,0.00010800000000000001
G4,C(C(CO)(CC(C(C)=O)=O)O)(O)=O,2,4,10,14,14,0.000215
G4,C(C(CO)(CC(CC=O)=O)O)(O)=O,2,4,11,15,2,0.000215
G4,C(C(CO)(CC(CC(O)=O)=O)O)=O,2,3,14,17,17,0.000156
G4,C(C(C=CC(CO)=O)(CO)O)(O)=O,4,3,5,8,29,0.000167
G4,C(C(CCO)(C(C(O)=O)O)O)(O)=O,4,5,10,15,29,0.000272
G4,C(C(C(C(C(O)=O)O)O)O)(O)=O,3,6,6,12,29,0.000341
G4,C(C(C(CO)(C)O)(CC=O)O)(O)=O,4,4,11,15,29,0.00022400000000000002
G4,C(C(C(CO)(C)O)(CC(O)=O)O)=O,4,3,10,13,29,0.000166
G4,C(C(C(C)O)(CC(O)=O)O)=O,4,2,10,12,29,0.00010800000000000001
G4,C(C(C(CO)O)(CC=O)O)(O)=O,4,7,14,21,0,0.000379
G4,C(C(C(CO)O)(CC(O)=O)O)=O,4,3,12,15,29,0.000166
G4,C(C(C(CO)O)OC(CO)=O)(O)=O,4,1,4,5,29,5.9e-05
G4,C(C(C(CO)OC(CO)=O)O)(O)=O,4,1,2,3,29,5.9e-05
G4,C(C(C(COC(CO)=O)O)O)(O)=O,4,2,4,6,40,0.00010700000000000001
G4,C1(CC(C(CC(O)=O)O1)O)=O,4,3,4,7,29,0.000154
G4,C(CC1C(C(CO1)=O)O)(O)=O,4,3,8,11,29,0.000154
G4,C(CC1CC(C(O)O1)=O)(O)=O,4,3,9,12,29,0.000154
G4,C(CC1C(CC(O1)O)=O)(O)=O,4,3,10,13,29,0.000154
G4,C(C(C=CC(C)=O)=O)(O)=O,2,4,20,24,29,0.00020099999999999998
G4,C(CC=CC(C(O)=O)=O)=O,2,4,17,21,29,0.00020099999999999998
G4,C(CC=CC(C=O)=O)(O)=O,2,4,14,18,29,0.00020099999999999998
G4,C(C=CC(C(C)=O)=O)(O)=O,2,5,21,26,29,0.00024900000000000004
G4,C(CC(C=CC(O)=O)=O)=O,2,6,26,32,29,0.000296
G4,C(CC(C=CC=O)=O)(O)=O,2,5,28,33,29,0.00024900000000000004
G4,C=CC(CC(C(O)=O)=O)=O,1,4,21,25,29,0.00020099999999999998
G4,C(CC(C(C=C)=O)=O)(O)=O,1,4,23,27,29,0.00020099999999999998
G4,C(CC(C(O)=O)=O)=CC=O,2,4,17,21,29,0.00020099999999999998
G4,C(CC(C=O)=O)=CC(O)=O,2,5,19,24,29,0.00024900000000000004
G4,C(C1C(C(C(CO)O1)O)O)(O)=O,16,4,5,9,29,0.000234
G4,C(CC1C(C(CO1)O)=O)(O)=O,4,3,7,10,29,0.000154
G4,C(CC1(C(CCO1)=O)O)(O)=O,2,3,7,10,29,0.000154
G4,C(CC1(CC(CO1)=O)O)(O)=O,2,3,11,14,29,0.000154
G4,C(C(C1CC(CO1)O)=O)(O)=O,4,2,5,7,29,0.000106
G4,C(C1C(CC(C=O)O1)O)(O)=O,8,2,9,11,29,0.000106
G4,C(C1CC(C(C=O)O1)O)(O)=O,8,2,10,12,29,0.000106
G4,C(C1C(CC(C)(O1)O)=O)(O)=O,4,3,12,15,26,0.000154
G4,C1(CC(C(O)=O)OC1(C)O)=O,4,3,8,11,29,0.000154
G4,C(C1C(C(C(C)O1)=O)O)(O)=O,8,2,8,10,29,0.000106
G4,C(C1C(C(C(CO1)O)O)O)(O)=O,16,3,7,10,29,0.000176
G4,C1(CC(C(O)=O)(O)OCC1)=O,2,3,11,14,2,0.000154
G4,C(C1(CCC(CO1)=O)O)(O)=O,2,3,9,12,29,0.000154
G4,C(C1C(CCC(O1)O)=O)(O)=O,4,3,10,13,37,0.000154
G4,C1(CC(C(O)=O)OC(C1)O)=O,4,4,12,16,2,0.00020099999999999998
G4,C(CC1C(C(C(O1)=O)O)O)(O)=O,8,3,5,8,29,0.000154
G4,C1C(C(C(C=1C(O)=O)O)O)O,8,3,7,10,29,0.000154
G4,C(C(C(C(C=C)O)O)O)(O)=O,8,7,11,18,29,0.000377
G4,C(C1(C=CC(C1O)O)O)(O)=O,8,4,9,13,29,0.00020099999999999998
G4,C1C(C(CO)OC=1C(O)=O)O,4,2,1,3,29,0.000106
G4,C(C1(C=CC(CO)O1)O)(O)=O,4,3,4,7,29,0.000154
G4,C1(C(C(CO1)O)O)=CC(O)=O,8,2,4,6,29,0.000106
G4,C(C(C1OCC(C=1)O)O)(O)=O,4,2,5,7,29,0.000106
G4,C(C(C1(C=CCO1)O)O)(O)=O,4,3,7,10,29,0.000154
G4,C(C1C=CC(CO)(O1)O)(O)=O,4,3,5,8,29,0.000154
G4,C(C1C(C=C(CO)O1)O)(O)=O,4,2,4,6,29,0.000106
G4,C(C1C(C(C(O1)=C)O)O)(O)=O,8,2,7,9,29,0.000106
G4,C(C(C1C=CC(O)O1)O)(O)=O,8,3,5,8,29,0.000154
G4,C(C(C1C(C=CO1)O)O)(O)=O,8,2,5,7,29,0.000106
G4,C1C(C(COC=1C(O)=O)O)O,4,2,3,5,29,0.000106
G4,C(C1(C=CC(CO1)O)O)(O)=O,4,3,4,7,29,0.000154
G4,C(C1C(C=CC(O)O1)O)(O)=O,8,3,5,8,29,0.000154
G4,C(C1C(C(C=CO1)O)O)(O)=O,8,2,7,9,29,0.000106
G4,C(C1(C(C(C(CO)O1)O)O)O)(O)=O,16,2,8,10,29,0.000106
G4,C(C1(C(CC(CO)O1)O)O)(O)=O,8,3,6,9,29,0.000165
G4,C(C1CC(C(CO)(O1)O)O)(O)=O,8,3,7,10,29,0.000165
G4,C(C(C1(C(CCO1)O)O)O)(O)=O,8,3,7,10,29,0.000165
G4,C(C(C1CC(C(O)O1)O)O)(O)=O,16,3,7,10,29,0.000165
G4,C(C1(C(C(C(CO1)O)O)O)O)(O)=O,16,2,10,12,29,0.000106
G4,C(C1(C(CC(CO1)O)O)O)(O)=O,8,3,7,10,29,0.000165
G4,C(C1C(CC(C(O1)O)O)O)(O)=O,16,3,8,11,29,0.000165
G4,C(C1CC(C(C(O1)O)O)O)(O)=O,16,3,9,12,29,0.000165
G4,C1(CC(C(C(C(O)=O)O)O1)O)=O,8,5,3,8,29,0.00024900000000000004
G4,C1(CC(C(C(C(O)=O)O1)O)O)=O,8,4,6,10,29,0.00020099999999999998
G4,C(CO)(C1(C(C(CC1O)O)O)O)=O,16,4,15,19,51,0.00018999999999999998
G4,C(C1(C(C(CC1(C=O)O)O)O)O)=O,16,5,21,26,0,0.00023700000000000001
G4,C1(C(C(CO)C(C1(CO)O)O)O)=O,16,7,14,21,2,0.00035800000000000003
G4,C1(C(CC(C(C1(CO)O)O)O)O)=O,16,6,14,20,32,0.0003
G4,C1(C(CC(CO)(C1(CO)O)O)O)=O,8,5,13,18,32,0.000241
G4,C1(CC(C(CO)(C1(CO)O)O)O)=O,8,7,13,20,2,0.00035800000000000003
G4,C1(C(CO)(CO)C(C(C1)=O)O)=O,2,5,9,14,30,0.000239
G4,C1(CCC(C(C1(CO)O)O)=O)=O,4,8,15,23,12,0.000384
G4,C1(C(CO)(C(C=O)(CC1)O)O)=O,4,7,15,22,12,0.000336
G4,C(C1(CO)C(CC(C1O)=O)O)=O,8,5,14,19,23,0.000239
G4,C1(C(CC(C1(CO)CO)O)=O)=O,2,3,9,12,2,0.000144
G4,C(C1(C(C(CC1O)O)=O)CO)=O,8,3,11,14,2,0.000144
G4,C(C1(C(CC(CO)C1O)=O)O)=O,8,4,15,19,55,0.00018999999999999998
G4,C(C1(CO)C(C(C(C1)=O)O)O)=O,8,4,18,22,2,0.000192
G4,C(C1(C(CC(C1O)O)=O)CO)=O,8,3,13,16,2,0.000144
G4,C1C(C(C(C(C=1)=O)(CO)O)O)O,8,6,14,20,32,0.00028900000000000003
G4,C(C)(C1(C(C(CC1O)O)O)O)=O,16,4,15,19,49,0.00018999999999999998
G4,C(C1(C(C(C)(CC1O)O)O)O)=O,16,4,16,20,16,0.00018999999999999998
G4,C(C1(C(C(CC1(CO)O)O)O)O)=O,16,5,16,21,20,0.00024900000000000004
G4,C(C)(C1(C(C(C(C1O)O)O)O)O)=O,10,4,9,13,49,0.000212
G4,C(C1(C(C(C(C1(C)O)O)O)O)O)=O,32,7,18,25,49,0.000365
G4,C1(C(CO)(C(C)O)C(C(C1)=O)O)=O,8,3,12,15,4,0.000144
G4,C1(CCC(C(C1(C(C)O)O)O)=O)=O,8,4,14,18,12,0.000192
G4,C1(C(C(C)O)(C(C=O)(CC1)O)O)=O,8,5,14,19,12,0.00023999999999999998
G4,C(C1(C(CC(C1O)=O)O)C(C)O)=O,16,4,13,17,4,0.00019099999999999998
G4,C1(C(CC(C1(CO)C(C)O)O)=O)=O,8,2,13,15,4,9.6e-05
G4,C1(CC(CC(C1(C(C)=O)O)O)O)=O,8,2,9,11,9,9.499999999999999e-05
G4,C(C1(C(C(CC1O)O)=O)C(C)O)=O,16,3,11,14,4,0.000144
G4,C(C1(C(CC(C)(CC1O)O)=O)O)=O,8,3,11,14,6,0.00014199999999999998
G4,C(C1(C(CCC(CC1O)O)=O)O)=O,8,2,13,15,44,9.499999999999999e-05
G4,C(C1(C(CC(C1O)C(C)O)=O)O)=O,16,2,14,16,46,9.499999999999999e-05
G4,C(C1(C(C(C(C1)=O)O)O)C(C)O)=O,16,2,17,19,46,9.6e-05
G4,C(C1(C(CC(C1O)O)=O)C(C)O)=O,16,2,12,14,4,9.6e-05
G4,C1C(CC(C(C(C=1)=O)(CO)O)O)O,8,2,12,14,21,9.499999999999999e-05
G4,C=CC(C1(C(C(CC1O)O)O)O)=O,16,4,18,22,7,0.00018999999999999998
G4,C(C1(C(C(C=C)(CC1O)O)O)O)=O,16,2,14,16,7,9.499999999999999e-05
G4,C1C(C(C(C(C=1)=O)(C(C)O)O)O)O,16,4,14,18,32,0.000192
G4,C(C1(C(CC(C=CC1O)O)O)O)=O,16,2,12,14,43,9.499999999999999e-05
G4,C(C1(C(C(C)(C(C1O)O)O)O)O)=O,32,6,18,24,16,0.000307
G4,C(C1(C(C(C(C1O)O)O)O)O)=O,10,6,11,17,15,0.00032900000000000003
G4,C(C1(C(C(CO)C(C1O)O)O)O)=O,32,9,18,27,43,0.00048300000000000003
G4,C1(C(CO)(C(C(C1)=O)O)O)=O,4,3,19,22,2,0.00014199999999999998
G4,C(C1(C(O)OCC1(C)O)O)=O,8,3,11,14,35,0.00014199999999999998
G4,C(C1(COCC1(CO)O)O)=O,4,2,7,9,36,9.499999999999999e-05
G4,C(C1(COC(C1(C)O)O)O)=O,8,3,9,12,41,0.00014199999999999998
G4,C(C)(C1(C(O)OCC1O)O)=O,8,4,11,15,19,0.00018999999999999998
G4,C(C)(C1(COC(C1O)O)O)=O,8,5,10,15,2,0.00023700000000000001
G4,C(C1(C(C)(O)OCC1O)O)=O,8,3,11,14,1,0.00014199999999999998
G4,C1(C(CO)(C(CC1(CO)O)O)O)=O,8,8,13,21,2,0.00041900000000000005
G4,C(C1(C(C(CO)(CC1O)O)O)O)=O,16,8,17,25,43,0.000424
G4,C(C1(C(C(C=O)(CC1O)O)O)O)=O,16,3,21,24,1,0.00014199999999999998
G4,C(C1(C(C(C(C1O)O)O)O)O)(O)=O,10,5,9,14,33,0.000271
G4,C1(C2C(C(CC2O)O1)O)=O,16,3,6,9,48,0.00014199999999999998
G4,C1(C2CC(C1(CO2)O)O)=O,8,3,9,12,9,0.00014199999999999998
G4,C1(C2(C(C(CC2O)O1)O)O)=O,16,6,7,13,27,0.000285
G4,C1(C2C(C(C(C2O)O1)O)O)=O,32,5,6,11,8,0.00023700000000000001
G4,C(C1(C(CC(CO)CC1O)=O)O)=O,8,3,12,15,55,0.00014199999999999998
G4,C(C1CC(C(C(C1)=O)(CO)O)O)=O,8,3,16,19,43,0.00014199999999999998
G4,C1(CC(C(C1(CO)O)O)CC=O)=O,8,4,18,22,43,0.00019099999999999998
G4,C1(C(CC(C1(CO)O)O)CC=O)=O,8,3,17,20,46,0.00014199999999999998
G4,C(C1(C(CCCC(C1O)=O)O)O)=O,8,7,17,24,7,0.000332
G4,C1(C(C(CCC1)O)(C(C=O)O)O)=O,8,3,16,19,7,0.00014199999999999998
G4,C(C1(C(C(CC1O)CC=O)O)O)=O,16,5,20,25,43,0.00023700000000000001
G4,C(C1(C(CC(C1O)O)=O)O)(O)=O,8,7,13,20,17,0.00034500000000000004
G4,C(C1(C(CC(C1O)=O)=O)CO)(O)=O,4,3,10,13,30,0.000143
G4,C(C1(C(CCC(C1O)=O)=O)O)(O)=O,4,4,11,15,12,0.00019099999999999998
G4,C1(CCC(C=O)(C1(C(O)=O)O)O)=O,4,5,11,16,12,0.000239
G4,C(C1(C=O)C(CC(C1O)=O)O)(O)=O,8,4,11,15,17,0.00019099999999999998
G4,C(C1(C(C(CC1O)=O)=O)CO)(O)=O,4,2,11,13,17,9.6e-05
G4,C(C1(C(CC(CC1O)=O)=O)O)(O)=O,4,5,10,15,17,0.000239
G4,C(C1(C(CC(CC1=O)O)=O)O)(O)=O,1,3,5,8,9,0.000144
G4,C(C1(C=O)C(C(CC1O)O)=O)(O)=O,8,3,11,14,17,0.000143
G4,C(C1C(C(C(O)=O)(C(C1)=O)O)O)=O,8,4,14,18,17,0.00019099999999999998
G4,C(C1(C=O)C(C(C(C1)=O)O)O)(O)=O,8,2,16,18,17,9.6e-05
G4,C(C1(C=O)C(CC(C1O)O)=O)(O)=O,8,2,12,14,17,9.6e-05
G4,C(C1(C(C=CC(C1O)O)=O)O)(O)=O,8,4,10,14,32,0.00019099999999999998
G4,C(C(C(CO)=O)(C(C=O)O)O)(O)=O,4,6,16,22,17,0.000299
G4,C(C(C=O)(C(C(CO)=O)O)O)(O)=O,4,6,16,22,5,0.000298
G4,C(C(C(CO)=O)(C(C)O)O)(O)=O,4,6,9,15,17,0.0003
G4,C(C(C=O)(C(CO)=O)CO)(O)=O,2,3,8,11,2,0.000145
G4,C(C(C(CC=O)=O)(CO)O)(O)=O,2,7,13,20,2,0.000349
G4,C(C(C=O)(C(CO)=O)C(C)O)(O)=O,4,3,8,11,4,0.000144
G4,C(C(C(CC=O)=O)(C(C)O)O)(O)=O,4,4,11,15,17,0.000194
G4,C(C(C=O)(C(CCO)=O)O)(O)=O,2,5,9,14,17,0.000252
G4,C(C(C=O)(C(CC(C)O)=O)O)(O)=O,4,3,8,11,17,0.000145
G4,C(CC(C(C(O)=O)(C(C)=O)O)O)=O,4,6,12,18,45,0.0003
G4,C(C(C=O)(C(C)(CC=O)O)O)(O)=O,4,6,12,18,17,0.0003
G4,C(C(C(CCO)=O)(CO)O)(O)=O,2,9,10,19,2,0.000468
G4,C(C(C(CC(C)O)=O)(CO)O)(O)=O,4,7,10,17,17,0.000362
G4,C(C(C(C=O)=O)(CO)CO)(O)=O,1,2,9,11,17,9.8e-05
G4,C(C(C(CO)=O)(CO)CO)(O)=O,1,5,5,10,2,0.00027400000000000005
G4,C(C(C=O)(CO)C(C=O)O)(O)=O,4,4,12,16,17,0.000193
G4,C(C)(C(C(C)O)(C(CCO)O)O)=O,8,5,12,17,4,0.000252
G4,C(C(C(C)O)(C(CCO)O)O)=O,8,6,14,20,18,0.00031099999999999997
G4,C(C(C(CO)(C(CCO)O)O)=O)=O,4,8,16,24,18,0.000429
G4,C(C(C(CO)=O)(C(CCO)O)O)=O,4,5,11,16,5,0.000261
G4,C(C(C(C)=O)(C(CCO)O)O)(O)=O,4,6,10,16,0,0.00031
G4,C(C(C=O)(C(CCO)O)O)(O)=O,4,7,12,19,17,0.000368
G4,C(C(C(CCO)O)C(C=O)O)(O)=O,8,4,12,16,29,0.000213
G4,C1(C(C(CO1)O)(C(CCO)O)O)=O,8,3,9,12,40,0.000155
G4,C1(C(C(CO1)O)C(CCO)O)=O,8,2,7,9,8,0.00010700000000000001
G4,C(C(C(C)O)(C(CCO)O)O)(O)=O,8,6,11,17,4,0.00031099999999999997
G4,C1(COCC1(C(CCO)O)O)=O,4,3,7,10,10,0.000155
G4,C(C(C(C(CO)O)=O)(CO)O)(O)=O,4,9,13,22,2,0.000459
G4,C(C(C(C=O)=O)(CO)C(C)O)(O)=O,4,3,10,13,4,0.000146
G4,C(C(C(CCO)=O)(C(C)O)O)(O)=O,4,7,10,17,4,0.000361
G4,C(C(C(CO)=O)(CO)C(C)O)(O)=O,4,6,8,14,4,0.000323
G4,C(C(C=O)(C(CC=O)O)O)(O)=O,4,7,15,22,17,0.00034700000000000003
G4,C(C)(C(C(C)O)(C(C(C)O)O)O)=O,16,4,13,17,11,0.000193
G4,C(C(C=O)(C(C)O)C(C=O)O)(O)=O,8,4,11,15,4,0.000192
G4,C(C(C(C)O)(C(CC(C)O)O)O)=O,16,5,14,19,28,0.000252
G4,C(C(C=O)(C(CC(C)O)O)O)(O)=O,8,5,12,17,17,0.000251
G4,C1(C(C(CO1)O)C(CC(C)O)O)=O,16,1,8,9,8,4.8e-05
G4,C(C(CO)(C(CC(C)O)O)O)(O)=O,8,6,11,17,33,0.000312
G4,C1(COCC1(C(CC(C)O)O)O)=O,8,2,8,10,10,9.6e-05
G4,C(C(C(C)O)(C(C=O)(CO)O)O)=O,8,12,19,31,25,0.0006219999999999999
G4,C(C(C)(C(C=O)(C(C)O)O)O)(O)=O,8,8,14,22,28,0.000417
G4,C(C(C(C)O)(C(C(C)=O)(C)O)O)=O,8,5,14,19,14,0.000252
G4,C(C(C(CC(C)=O)O)(C(C)O)O)=O,8,6,15,21,6,0.0003
G4,C(C(C=C)(C(C=O)(C(C)O)O)O)=O,8,6,13,19,7,0.0003
G4,C(C(C(C)O)(C(C=C)(CO)O)O)=O,8,6,11,17,7,0.00031099999999999997
G4,C(C(C(C)O)(C(C(C)O)O)O)=O,16,5,15,20,11,0.000252
G4,C(CC(C(C(C=O)=O)(CO)O)O)=O,4,6,19,25,5,0.000312
G4,C(C(C(C=O)=O)(CO)O)(O)=O,2,6,13,19,17,0.000301
G4,C(C(C(C(C=O)=O)(CO)O)O)(O)=O,4,6,17,23,33,0.000312
G4,C(C(C(CO)(C(C(C)O)O)O)=O)=O,8,7,17,24,11,0.00037
G4,C(C(C=O)(C(C=O)(CO)O)O)(O)=O,4,8,17,25,17,0.00040899999999999997
G4,C1(C(C(CO1)O)C(C=O)(CO)O)=O,8,2,10,12,8,9.7e-05
G4,C1(C(C(CO1)O)C(C(CO)=O)O)=O,8,2,8,10,8,9.499999999999999e-05
G4,C(C(CO)(C(C=O)(CO)O)O)(O)=O,4,11,17,28,33,0.0005650000000000001
G4,C(C(CO)(C(C(CO)=O)O)O)(O)=O,4,11,14,25,5,0.0005610000000000001
G4,C(C(CO)(C1(C(COC1)=O)O)O)=O,4,4,14,18,10,0.000195
G4,C1(COCC1(C(C(CO)=O)O)O)=O,4,3,13,16,10,0.000143
G4,C(C(C(CO)=O)(C(C)=O)O)(O)=O,2,5,6,11,17,0.00025
G4,C(CC(C(C=O)(C(CO)=O)O)O)=O,4,5,14,19,5,0.000251
G4,C(C(C(CC=O)O)C(C=O)O)(O)=O,8,4,16,20,43,0.00020299999999999997
G4,C1(C(C(CC=O)O)(C(CO1)O)O)=O,8,2,11,13,40,9.6e-05
G4,C1(C(C(CC=O)O)C(CO1)O)=O,8,2,10,12,8,9.499999999999999e-05
G4,C(C(CO)(C(CC=O)O)O)(O)=O,4,8,15,23,17,0.000408
G4,C(C(C(CC=O)O)(C(C)O)O)(O)=O,8,6,14,20,4,0.000301
G4,C(CC(C1(C(COC1)=O)O)O)=O,4,3,12,15,10,0.000143
G4,C(C(C=O)(C(CO)=O)O)(O)=O,2,4,9,13,17,0.00020299999999999997
G4,C(C(C(CO)=O)(C(C(O)=O)O)O)=O,4,4,12,16,33,0.000202
G4,C(C(C(CO)=O)(C(C(C)O)O)O)=O,8,4,12,16,11,0.000202
G4,C(C(C=O)(C(C(O)=O)(C)O)O)(O)=O,4,6,11,17,17,0.00031
G4,C1(C(C(CO1)O)C(C(O)=O)(C)O)=O,8,2,8,10,8,0.00010700000000000001
G4,C(C(CO)(C(C(O)=O)(C)O)O)(O)=O,4,8,11,19,28,0.00041799999999999997
G4,C(C(C)(C1(C(COC1)=O)O)O)(O)=O,4,3,7,10,10,0.000154
G4,C(C(C(O)=O)(C(C)=O)O)(O)=O,1,4,4,8,0,0.00020299999999999997
G4,C(C(C(O)=O)(C(C(C)=O)O)O)(O)=O,2,5,8,13,17,0.000251
G4,C(C(C(C)=O)(C(C(O)=O)O)O)(O)=O,4,6,10,16,33,0.00031
G4,C(C(C(O)=O)(C=O)O)(O)=O,1,3,5,8,17,0.000155
G4,C(C(C(O)=O)(C(C=O)O)O)(O)=O,2,5,10,15,17,0.000251
G4,C(C(C=O)(C(C(O)=O)O)O)(O)=O,4,6,12,18,33,0.00031
G4,C(C(C(O)=O)C(C=O)O)(O)=O,2,3,9,12,17,0.000154
G4,C1(C(C(O)=O)(C(CO1)O)O)=O,4,3,4,7,17,0.000144
G4,C1(C(C(O)=O)C(CO1)O)=O,4,1,6,7,17,4.8e-05
G4,C(C(C=O)(C(C(C)O)=O)O)(O)=O,4,4,8,12,17,0.00020299999999999997
G4,C(C(C(CO)=O)(C(C=C)=O)O)(O)=O,2,3,6,9,32,0.000144
G4,C(C(C=O)(C(C(C=C)O)=O)O)(O)=O,4,3,6,9,17,0.000144
G4,C(CCO)(C(C(O)=O)(C(C)=O)O)=O,2,4,6,10,9,0.00021400000000000002
G4,C(C(C=O)(C(CCCO)=O)O)(O)=O,2,3,8,11,29,0.000155
G4,C(C(C(C=C)=O)(C(CO)O)O)(O)=O,4,5,12,17,17,0.000252
G4,C(C(C=O)(C(C=CCO)O)O)(O)=O,8,5,7,12,17,0.000251
G4,C(C(C(O)=O)(CO)O)(O)=O,1,6,4,10,17,0.00031299999999999996
G4,C(C(C=O)(C(C=O)(C=O)O)O)(O)=O,2,4,11,15,17,0.000192
G4,C(C(C(O)=O)(C(C=O)(C)O)O)(O)=O,2,5,8,13,17,0.000251
G4,C(C(C(O)=O)(C(CO)(C)O)O)(O)=O,2,6,6,12,17,0.00031
G4,C(C(C(O)=O)(C(C)O)O)(O)=O,2,5,5,10,17,0.00025299999999999997
G4,C1(CC(C(C1(C(O)=O)CO)=O)O)=O,4,2,8,10,17,9.6e-05
G4,C1(C(CO)CC(C1(C(O)=O)O)=O)=O,4,2,9,11,17,9.6e-05
G4,C(C1(C(C(C(C1)=O)O)=O)CO)(O)=O,4,1,12,13,17,4.8e-05
G4,C(C1C(OC(C(C)=O)C1O)=O)(O)=O,8,1,6,7,48,4.8e-05
G4,C1(CC(C(C(O)=O)(C(C)=O)O1)O)=O,4,2,5,7,48,9.6e-05
G4,C1(C(C(O)=O)C(C(CC=O)O1)O)=O,8,1,7,8,17,4.8e-05
G4,C(C1(C(COC1C(C)=O)=O)O)(O)=O,4,2,6,8,17,9.6e-05
G4,C(C1(C(C)=O)C(C(CO1)=O)O)(O)=O,4,2,7,9,17,9.6e-05
G4,C(CC1C(C(O)=O)(C(CO1)=O)O)=O,4,2,7,9,9,9.6e-05
G4,C1(CC(OC1(C(O)=O)C(C)=O)O)=O,4,3,5,8,9,0.000144
G4,C(C1(C(CCC(O1)=O)=O)CO)(O)=O,2,3,4,7,17,0.000144
G4,C(C1(C(CC(CO1)=O)=O)CO)(O)=O,2,2,6,8,54,9.6e-05
G4,C(C1(C(CCC(OC1)=O)=O)O)(O)=O,2,2,4,6,17,9.6e-05
G4,C1(C(C(O)=O)C(C(CCO1)=O)O)=O,4,1,5,6,19,4.8e-05
G4,C(C1C(OCC(CC1O)=O)=O)(O)=O,4,1,6,7,48,4.8e-05
G4,C(C1(C(CC(COC1)=O)=O)O)(O)=O,2,2,4,6,36,9.6e-05
G4,C1(CCOCC(C1(C(O)=O)O)=O)=O,2,2,2,4,36,9.6e-05
G4,C(C1(C(COC1)=O)O)(O)=O,2,2,9,11,17,9.7e-05
G4,C(CC1C(C(C(O)=O)(CO1)O)=O)=O,4,2,5,7,9,9.6e-05
G4,C(C1(C=O)C(CC(C=O)O1)O)(O)=O,8,2,9,11,40,9.6e-05
G4,C(C1(C=O)C(CC(C)(O1)O)=O)(O)=O,4,3,7,10,26,0.000144
G4,C(C1(C=O)C(C(C(C)O1)=O)O)(O)=O,8,2,7,9,17,9.6e-05
G4,C1(C(C)OC(C=O)C1(C(O)=O)O)=O,8,2,6,8,29,9.6e-05
G4,C(C1(C=O)C(CCC(O1)O)=O)(O)=O,4,3,6,9,37,0.000144
G4,C(C1(C(C(CO)=CC1O)=O)O)(O)=O,4,2,7,9,17,9.6e-05
G4,C(C1(C(C(C(C1O)O)=C)=O)O)(O)=O,8,2,11,13,17,9.6e-05
G4,C(C(C=O)(C(C(C=C)O)O)O)(O)=O,8,4,11,15,28,0.000192
G4,C(C1(C(C=CO1)=O)C(CO)O)(O)=O,4,2,8,10,17,9.6e-05
G4,C(C1(C(C=COC1CO)=O)O)(O)=O,4,2,4,6,9,9.6e-05
G4,C(C1(C(C=CC(O1)O)=O)CO)(O)=O,4,2,5,7,17,9.6e-05
G4,C(C1(C(C=COCC1O)=O)O)(O)=O,4,2,6,8,38,9.6e-05
G4,C(C1(C(C=CCOC1O)=O)O)(O)=O,4,2,6,8,19,9.6e-05
G4,C(C1(C(C=CC(O)OC1)=O)O)(O)=O,4,2,2,4,38,9.6e-05
G4,C(C(C=O)(C1OCC(C=1)O)O)(O)=O,4,2,4,6,36,9.6e-05
G4,C(C(C=O)(C1(C=CCO1)O)O)(O)=O,4,2,6,8,17,9.6e-05
G4,C(C1(C=O)C(C=C(CO)O1)O)(O)=O,4,2,5,7,40,9.6e-05
G4,C(C1(C=O)C(C(C(O1)=C)O)O)(O)=O,8,2,9,11,26,9.6e-05
G4,C(C(C=O)(C1C=CC(O)O1)O)(O)=O,8,2,3,5,43,9.6e-05
G4,C(C(C=O)(C1C(C=CO1)O)O)(O)=O,8,2,5,7,36,9.6e-05
G4,C(C1(C=O)C(C=CC(O1)O)O)(O)=O,8,2,5,7,37,9.6e-05
G4,C(C1(C=O)C(C(C=CO1)O)O)(O)=O,8,2,9,11,37,9.6e-05
G4,C(C(C(C)=O)(C(C(C)O)O)O)(O)=O,8,5,11,16,11,0.000251
G4,C(C(C(C(O)=O)C(C=O)O)O)(O)=O,8,7,12,19,33,0.00037799999999999997
G4,C1(C(C(CO1)O)(C(C(O)=O)O)O)=O,8,3,10,13,33,0.000154
G4,C1(C(C(CO1)O)C(C(O)=O)O)=O,8,2,7,9,29,0.00010700000000000001
G4,C(C(CO)(C(C(O)=O)O)O)(O)=O,4,12,11,23,33,0.000653
G4,C(C(C(C)O)(C(C(O)=O)O)O)(O)=O,8,7,12,19,4,0.00035800000000000003
G4,C1(COCC1(C(C(O)=O)O)O)=O,4,3,7,10,10,0.000154
G4,C(C(C=O)(C(C(C)=O)(C)O)O)(O)=O,4,5,11,16,17,0.000251
G4,C(C(C=O)(C(CC(C)=O)O)O)(O)=O,4,6,12,18,17,0.000299
G4,C(C(C=O)(C(C(C=C)=O)O)O)(O)=O,4,7,11,18,17,0.000357
G4,C(C(C=O)(C(C=O)(C=C)O)O)(O)=O,4,5,10,15,17,0.000251
G4,C(C(C=O)(C(C=C)(CO)O)O)(O)=O,4,6,9,15,17,0.00031
G4,C(C(C=O)(C(C=CC=O)O)O)(O)=O,8,6,8,14,17,0.000309
G4,C(C(C=O)(C(C(C)O)O)O)(O)=O,8,5,13,18,11,0.000251
G4,C(C(C(C(C)O)O)C(C=O)O)(O)=O,16,3,13,16,11,0.000154
G4,C1(C(C(CO1)O)C(C(C)=O)(C)O)=O,8,1,6,7,8,4.8e-05
G4,C(C(CO)(C(C(C)=O)(C)O)O)(O)=O,4,6,11,17,14,0.000312
G4,C(C)(C(C)(C1(C(COC1)=O)O)O)=O,4,2,9,11,10,9.6e-05
G4,C1(C(C(CO1)O)C(C)(CC=O)O)=O,8,1,9,10,8,4.8e-05
G4,C1(C(C(CC(C)=O)O)C(CO1)O)=O,8,1,7,8,8,4.8e-05
G4,C(C(CO)(C(C)(CC=O)O)O)(O)=O,4,7,13,20,33,0.000361
G4,C(C(CO)(C(CC(C)=O)O)O)(O)=O,4,7,12,19,6,0.00036
G4,C(CC(C)(C1(C(COC1)=O)O)O)=O,4,2,10,12,10,9.6e-05
G4,C(C)(CC(C1(C(COC1)=O)O)O)=O,4,2,10,12,10,9.6e-05
G4,C1(C(C(CO1)O)C(C(C=C)=O)O)=O,8,1,9,10,8,4.8e-05
G4,C(C(C=C)(C1C(OCC1O)=O)O)=O,8,1,6,7,8,4.8e-05
G4,C(C(C=C)(C(C(O)=O)(CO)O)O)=O,4,7,11,18,7,0.00036
G4,C1(COCC1(C(C(C=C)=O)O)O)=O,4,2,11,13,10,9.6e-05
G4,C(C(C=C)(C1(C(COC1)=O)O)O)=O,4,2,8,10,10,9.6e-05
G4,C1(C(C(CO1)O)C(C=C)(CO)O)=O,8,2,6,8,8,0.00010700000000000001
G4,C(C(CO)(C(C=C)(CO)O)O)(O)=O,4,7,8,15,7,0.000371
G4,C1(COCC1(C(C=C)(CO)O)O)=O,4,3,5,8,10,0.000155
G4,C1(C(C(CO1)O)C(C=CC=O)O)=O,16,1,7,8,8,4.8e-05
G4,C1(COCC1(C(C=CC=O)O)O)=O,8,2,8,10,10,9.6e-05
G4,C1(C(C(CO1)O)(C(C(C)O)O)O)=O,16,2,10,12,40,9.6e-05
G4,C1(C(C(CO1)O)C(C(C)O)O)=O,16,1,8,9,8,4.8e-05
G4,C(C(CO)(C(C(C)O)O)O)(O)=O,8,8,11,19,11,0.000429
G4,C(C(C(C)O)(C(C(C)O)O)O)(O)=O,16,5,12,17,4,0.000252
G4,C1(COCC1(C(C(C)O)O)O)=O,8,2,8,10,10,9.6e-05
G4,C(CO)(C(C(CO)O)(C(C)O)O)=O,8,9,13,22,2,0.00047599999999999997
G4,C(C(C(CO)=O)(CO)C(CO)O)=O,4,4,11,15,0,0.000204
G4,C(C(C(CO)(CO)C(CO)O)=O)=O,2,3,11,14,0,0.000157
G4,C(CO)(C(CO)(CO)C(CO)O)=O,2,5,8,13,2,0.00027400000000000005
G4,C(C(CO)(C(CO)O)C(C=O)O)=O,8,5,15,20,0,0.000252
G4,C1(C(C(CO)O)(C(CO1)O)O)=O,8,5,9,14,0,0.00025
G4,C1(C(C(CO)O)C(CO1)O)=O,8,4,8,12,0,0.000202
G4,C1(COCC1(C(CO)O)O)=O,4,4,9,13,0,0.00020299999999999997
G4,C(C(C(CO)O)(C(CCO)O)O)=O,8,10,15,25,0,0.000544
G4,C(C(C(CO)O)(C(C(C)O)O)O)=O,16,8,16,24,11,0.00042699999999999997
G4,C(C(C(C)O)(C(CO)(CO)O)O)=O,4,7,11,18,5,0.00036899999999999997
G4,C1(C(C(CO1)O)C(CO)(CO)O)=O,4,2,6,8,8,0.00010700000000000001
G4,C1(COCC1(C(CO)(CO)O)O)=O,2,3,5,8,10,0.000155
G4,C(C(CO)(C(CCO)O)O)=O,4,7,13,20,18,0.000371
G4,C(C(CO)(C(CC(C)O)O)O)=O,8,6,14,20,28,0.000312
G4,C(C(C(C)O)(C(C(CO)O)O)O)=O,16,11,16,27,41,0.000603
G4,C(C(CO)(C(C(C(C)O)O)O)O)=O,16,10,16,26,28,0.000546
G4,C(C(CO)(C(C=O)(CO)O)O)=O,3,6,10,16,5,0.000312
G4,C(C(CO)(C(C(C)=O)(CO)O)O)=O,4,13,18,31,2,0.000672
G4,C(C(CO)(C(CO)(C(C)O)O)O)=O,8,9,13,22,25,0.000488
G4,C(CC(C=O)(C(C=O)(CO)O)O)=O,4,7,17,24,23,0.00036
G4,C(C(CO)(C(C(C)=O)(C)O)O)=O,4,7,15,22,14,0.000359
G4,C(C(CO)(C(CC(C)=O)O)O)=O,4,9,17,26,41,0.000455
G4,C(C(CO)(C1(COC(C1)O)O)O)=O,8,7,12,19,35,0.000359
G4,C(C(C=C)(C(C=O)(CO)O)O)=O,4,9,16,25,7,0.000455
G4,C(C(CO)(C(C=C)(CO)O)O)=O,4,9,13,22,7,0.000466
G4,C1(C(C(CO1)O)C(C(CO)O)O)=O,16,4,10,14,8,0.00022400000000000002
G4,C(C(CO)(C(C(C)O)O)O)=O,8,6,14,20,11,0.000312
G4,C1(COCC1(C(C(CO)O)O)O)=O,8,5,10,15,10,0.000272
G4,C(C(CO)(C1(COCC1O)O)O)=O,8,6,10,16,10,0.000312
G4,C(C(CO)(C1(C(O)OCC1)O)O)=O,8,7,12,19,34,0.000359
G4,C(C)(C(C(C)O)(C(C(C)=O)O)O)=O,8,6,15,21,45,0.00029
G4,C(C(C)(C(C(C)=O)(C(C)O)O)O)=O,8,5,14,19,45,0.000242
G4,C(C(C(C)O)(C(C=O)(C)O)O)=O,8,7,16,23,45,0.000359
G4,C(C(C(C(C=O)=O)(CO)O)O)(C)=O,4,5,18,23,1,0.000254
G4,C(C(C)(C(C(C=O)=O)(CO)O)O)=O,4,5,16,21,45,0.000254
G4,C1(C(C(CO1)O)(C(C(C)=O)O)O)=O,8,2,10,12,45,9.6e-05
G4,C1(C(C(CO1)O)(C(C=O)(C)O)O)=O,8,2,10,12,45,9.6e-05
G4,C1(C(C(CO1)O)C(C(C)=O)O)=O,8,3,7,10,8,0.000143
G4,C1(C(C(CO1)O)C(C=O)(C)O)=O,8,2,8,10,8,9.6e-05
G4,C(C(C(C)O)(C(C=O)(C)O)O)(O)=O,8,6,13,19,4,0.0003
G4,C1(COCC1(C(C(C)=O)O)O)=O,4,3,11,14,10,0.000144
G4,C(C(C)(C1(C(COC1)=O)O)O)=O,4,2,10,12,10,9.6e-05
G4,C(C(C(C)=O)(C(CCO)O)O)=O,4,4,11,15,1,0.000202
G4,C(C(C(C)=O)(C(CC(C)O)O)O)=O,8,2,10,12,1,9.6e-05
G4,C(C(CO)(C(C=O)(C(C)=O)O)O)=O,4,6,15,21,1,0.000291
G4,C(CC(C(C=O)(C(C)=O)O)O)=O,4,6,14,20,1,0.000298
G4,C(C(C=O)(C(C)=O)O)(O)=O,2,8,10,18,17,0.000393
G4,C(C(C(C)=O)(C(C(C)=O)(C)O)O)=O,4,2,10,12,14,9.6e-05
G4,C(CC(C)(C(C=O)(C(C)=O)O)O)=O,4,3,10,13,1,0.000145
G4,C(C(C(C)=O)(C(CC(C)=O)O)O)=O,4,5,11,16,6,0.00025
G4,C(C(C(C)=O)(C(C(C=C)=O)O)O)=O,4,4,10,14,1,0.000192
G4,C(C(C=C)(C(C=O)(C(C)=O)O)O)=O,4,3,8,11,7,0.000144
G4,C(C(C(C)=O)(C(C=C)(CO)O)O)=O,4,3,7,10,1,0.000155
G4,C(C(C(C)=O)(C(C=CC=O)O)O)=O,8,2,8,10,1,9.6e-05
G4,C(C(C(C)=O)(C(C(C)O)O)O)=O,8,3,12,15,11,0.000143
G4,C(CO)(C(C(C)O)(C(C=O)O)O)=O,8,8,18,26,5,0.000396
G4,C(CO)(C(C=O)(CO)C(C=O)O)=O,4,3,13,16,2,0.000145
G4,C(C(CO)(C(C=O)O)O)(CC=O)=O,4,8,21,29,2,0.00040899999999999997
G4,C(C(C(C(C=O)=O)(CO)CO)O)=O,2,2,10,12,0,9.8e-05
G4,C(C(CO)(C(C=O)O)C(C=O)O)=O,3,3,9,12,2,0.000145
G4,C(C(C(C(C=O)=O)(CO)O)O)=O,4,6,21,27,0,0.000301
G4,C1(C(C(CO1)O)(C(C=O)O)O)=O,8,3,12,15,40,0.000144
G4,C1(C(C(CO1)O)C(C=O)O)=O,8,6,10,16,8,0.000285
G4,C1(COCC1(C(C=O)O)O)=O,4,5,15,20,10,0.000239
G4,C(C)(C(CO)(C(CCO)O)O)=O,4,7,12,19,18,0.000371
G4,C(C)(C(CO)(C(CC(C)O)O)O)=O,8,6,12,18,28,0.000312
G4,C(C)(C(CO)(C(C(C)=O)(C)O)O)=O,4,6,13,19,14,0.000312
G4,C(CC(C)(C(C(C)=O)(CO)O)O)=O,4,7,14,21,6,0.000361
G4,C(C)(C(CO)(C(CC(C)=O)O)O)=O,4,7,14,21,6,0.00036
G4,C(C(C=C)(C(C(C)=O)(CO)O)O)=O,4,7,12,19,7,0.00036
G4,C(C)(C(CO)(C(C=C)(CO)O)O)=O,4,7,9,16,7,0.000371
G4,C(C)(C(CO)(C(C=CC=O)O)O)=O,8,8,11,19,43,0.00041799999999999997
G4,C(C)(C(CO)(C(C(C)O)O)O)=O,8,6,13,19,11,0.000312
G4,C(C(C(CO)=O)(CO)CO)=O,1,2,8,10,2,9.7e-05
G4,C(CC(C(CO)(CO)O)=O)=O,1,5,12,17,2,0.00025299999999999997
G4,C(C(C(CO)=O)(CO)C(C)O)=O,4,3,9,12,4,0.000146
G4,C(CC(C(CO)(C(C)O)O)=O)=O,4,6,16,22,4,0.000291
G4,C(C(C(CO)(CO)CO)=O)=O,1,1,7,8,2,4.9e-05
G4,C(CO)(C(CO)(CO)CO)=O,1,3,5,8,2,0.000167
G4,C(C(CO)(CO)C(C=O)O)=O,2,3,11,14,2,0.000145
G4,C(C(C(CO)(CO)C(C)O)=O)=O,2,2,11,13,4,9.8e-05
G4,C(CO)(C(CO)(CO)C(C)O)=O,2,4,6,10,4,0.00021600000000000002
G4,C(C(CO)(C(C)O)C(C=O)O)=O,8,4,14,18,4,0.000194
G4,C(C(CO)(CO)O)(CC(C=O)=O)=O,1,2,9,11,2,9.9e-05
G4,C(CCO)(C(C(C=O)=O)(CO)O)=O,2,2,13,15,2,9.9e-05
G4,C(C(C(OCC(C)=O)O)(CO)O)=O,4,5,12,17,35,0.000241
G4,C(C(CO)(CO)OCC(CO)=O)=O,1,2,7,9,2,9.9e-05
G4,C(C(CO)(CO)OC(C(C)=O)O)=O,2,2,6,8,2,9.9e-05
G4,C(C(CO)(COCC(CO)=O)O)=O,2,2,10,12,36,9.9e-05
G4,C(C(CO)(COC(C(C)=O)O)O)=O,4,2,8,10,41,9.9e-05
G4,C1(C(CO)(C(CO1)O)O)=O,4,4,6,10,2,0.000194
G4,C1(C(CO)C(CO1)O)=O,4,4,15,19,27,0.000192
G4,C(C(CO)(C(C)(OCC=O)O)O)=O,4,4,12,16,1,0.000194
G4,C(C(CCO)=O)(C(CO)(CO)O)=O,1,4,9,13,2,0.000205
G4,C(C(CO)(CO)O)(C(C(C)=O)O)=O,2,4,8,12,2,0.000205
G4,C(C(C(C(CO)(C(C)O)O)=O)O)=O,8,7,15,22,2,0.000361
G4,C1(C(C(CO)O)OCC1(CO)O)=O,8,6,9,15,10,0.00031299999999999996
G4,C1(C(COC1(CO)C(CO)O)O)=O,8,6,10,16,10,0.00031299999999999996
G4,C1(C(C(CO)OCC1(CO)O)O)=O,8,3,6,9,2,0.000157
G4,C1(C(COC(CO)C1(CO)O)O)=O,8,3,6,9,2,0.000157
G4,C1(C(CC(OC1(CO)CO)O)O)=O,4,5,7,12,2,0.000252
G4,C1(C(C(COCC1(CO)O)O)O)=O,8,4,9,13,36,0.00021600000000000002
G4,C1(C(COCC(C1(CO)O)O)O)=O,8,4,9,13,36,0.00021600000000000002
G4,C1(C(CC(O)OCC1(CO)O)O)=O,8,6,9,15,38,0.00031099999999999997
G4,C1(C(CCOC(C1(CO)O)O)O)=O,8,5,11,16,19,0.000252
G4,C(CO)(C1(CO)C(CC(O1)O)O)=O,8,3,10,13,38,0.000146
G4,C(C(C=O)(C(C(C)=O)(CO)O)O)=O,2,6,13,19,1,0.00029
G4,C(C(C=O)(C(C=O)(CO)O)O)=O,2,6,15,21,1,0.000291
G4,C1(C(CO)(C(C(C1(C)O)O)O)O)=O,16,6,14,20,0,0.0003
G4,C1(CC(C(C1(CO)CO)=O)O)=O,2,3,6,9,2,0.000144
G4,C1(C(CO)(CO)CC(C1O)=O)=O,2,2,8,10,2,9.7e-05
G4,C(C(C)=O)(C(CO)(C(CO)O)O)=O,4,7,15,22,0,0.000371
G4,C1(C(CO)C(C(C(C)=O)O1)O)=O,8,3,8,11,48,0.000144
G4,C1(CC(C(C(C)=O)(CO)O1)O)=O,4,3,8,11,48,0.000146
G4,C1(C(CO)C(C(CC=O)O1)O)=O,8,3,10,13,48,0.000144
G4,C1(COC(C(C)=O)C1(CO)O)=O,4,3,9,12,17,0.000146
G4,C(C)(C1(CO)C(C(CO1)=O)O)=O,4,3,10,13,17,0.000146
G4,C(CC1C(C(CO1)=O)(CO)O)=O,4,3,11,14,9,0.000146
G4,C1(CC(OC1(C(C)=O)CO)O)=O,4,5,8,13,9,0.000241
G4,C1(CCC(OC1(CO)CO)=O)=O,1,4,4,8,2,0.000194
G4,C1(C(CO)(CO)OCC(C1)=O)=O,1,4,6,10,54,0.000194
G4,C1(CCC(OCC1(CO)O)=O)=O,2,4,7,11,4,0.000194
G4,C1(C(CO)C(C(CCO1)=O)O)=O,4,3,7,10,48,0.000144
G4,C1(C(CO)C(CC(CO1)=O)O)=O,4,3,8,11,48,0.000144
G4,C1(C(CO)(COCC(C1)=O)O)=O,2,4,8,12,36,0.000194
G4,C1(CCOCC(C1(CO)O)=O)=O,2,4,5,9,36,0.000194
G4,C1(COCC1(CO)O)=O,2,5,25,30,10,0.000241
G4,C(C1(CO)C(C(C(CO)O1)O)O)=O,16,4,11,15,26,0.00021600000000000002
G4,C1(C(C(CO)OC1(CO)CO)O)=O,4,2,5,7,2,9.9e-05
G4,C1(C(CO)OC(CO)C1(CO)O)=O,8,2,7,9,2,9.9e-05
G4,C1(CC(CO)(OC1(CO)CO)O)=O,2,3,8,11,2,0.000146
G4,C(CC1C(C(CO)(CO1)O)=O)=O,4,4,9,13,9,0.000194
G4,C(C1(CO)C(CC(C=O)O1)O)=O,8,3,13,16,40,0.000146
G4,C(C1(C(CC(C)(O1)O)=O)CO)=O,4,4,10,14,26,0.000194
G4,C(C1(CO)C(C(C(C)O1)=O)O)=O,8,3,10,13,29,0.000146
G4,C1(C(CO)(C(C=O)OC1C)O)=O,8,2,9,11,29,9.9e-05
G4,C(C1(CO)C(C(C(CO1)O)O)O)=O,16,3,13,16,37,0.000157
G4,C1(C(C(COC1(CO)CO)O)O)=O,4,3,8,11,2,0.000157
G4,C1(C(CO)OCC(C1(CO)O)O)=O,8,3,10,13,2,0.000157
G4,C1(CC(CO)(O)OCC1(CO)O)=O,4,4,9,13,2,0.000205
G4,C1(CCOC(CO)(C1(CO)O)O)=O,4,3,10,13,2,0.000146
G4,C(C1(C(CCC(O1)O)=O)CO)=O,4,4,9,13,37,0.000194
G4,C1(CC(C(CO)(C(CO)O)O1)=O)=O,4,4,9,13,2,0.000194
G4,C1(C(CO)(C(C(C(C)=O)O1)O)O)=O,8,2,10,12,2,9.9e-05
G4,C1(C(C(C(C(C)=O)(CO)O1)O)O)=O,8,2,10,12,2,9.9e-05
G4,C1(C(CO)(C(C(CC=O)O1)O)O)=O,8,2,10,12,27,9.9e-05
G4,C1(CC(C(CO)(C(CO)O1)O)=O)=O,4,3,7,10,2,0.000146
G4,C1(C(C(CC(CO)O1)=O)(CO)O)=O,4,3,5,8,50,0.000146
G4,C1(CC(C(OC1(CO)CO)=O)O)=O,2,3,5,8,2,0.000146
G4,C1(CC(C(CO)(C(CO1)O)O)=O)=O,4,2,11,13,2,9.9e-05
G4,C1(C(C(CC(CO1)O)=O)(CO)O)=O,4,2,7,9,2,9.9e-05
G4,C1(CC(C(OCC1(CO)O)=O)O)=O,4,3,8,11,2,0.000146
G4,C1(C(CO)(C(C(CCO1)=O)O)O)=O,4,2,10,12,2,9.9e-05
G4,C1(C(CO)(C(C(OCC1)=O)O)O)=O,4,2,10,12,2,9.9e-05
G4,C1(C(CO)(C(CC(CO1)=O)O)O)=O,4,2,10,12,2,9.9e-05
G4,C1C(C(C(C=1CO)=O)(CO)O)O,4,6,11,17,2,0.00028900000000000003
G4,C=C1C(C(CO)(C(C1O)O)O)=O,8,6,14,20,47,0.00028900000000000003
G4,C(C(CO)(C(C(C=C)O)O)O)=O,8,6,15,21,28,0.00029
G4,C1OC(C(C=1)=O)(CO)C(CO)O,4,3,10,13,9,0.000146
G4,C1OC(CO)C(C(C=1)=O)(CO)O,4,3,6,9,9,0.000146
G4,C1C(OC(C(C=1)=O)(CO)CO)O,2,4,6,10,2,0.000194
G4,C1OCC(C(C(C=1)=O)(CO)O)O,4,3,9,12,38,0.000146
G4,C1COC(C(C(C=1)=O)(CO)O)O,4,4,11,15,19,0.000194
G4,C1C(O)OCC(C(C=1)=O)(CO)O,4,4,7,11,38,0.000194
G4,C(C(C1OCC(C=1)O)(CO)O)=O,4,3,7,10,36,0.000146
G4,C(C(CO)(C1(C=CCO1)O)O)=O,4,4,11,15,2,0.000194
G4,C(C1(CO)C(C=C(CO)O1)O)=O,4,3,9,12,40,0.000146
G4,C(C1(CO)C(C(C(O1)=C)O)O)=O,8,3,12,15,26,0.000146
G4,C(C(CO)(C1C=CC(O1)O)O)=O,8,4,8,12,43,0.000194
G4,C(C(CO)(C1C(C=CO1)O)O)=O,8,3,8,11,36,0.000146
G4,C(C1(CO)C(C=CC(O1)O)O)=O,8,4,10,14,37,0.000194
G4,C(C1(CO)C(C(C=CO1)O)O)=O,8,3,12,15,37,0.000146
G4,C1(COC(CCO)(C1(CO)O)O)=O,4,3,11,14,2,0.000146
G4,C1(C(CCO)OC(C1(CO)O)O)=O,8,3,11,14,2,0.000146
G4,C(C(CO)(C1(C(CCO1)O)O)O)=O,8,4,12,16,2,0.000205
G4,C(C(CO)(C1CC(C(O)O1)O)O)=O,16,5,11,16,43,0.000264
G4,C(C1(CO)C(CC(C(O1)O)O)O)=O,16,5,13,18,37,0.000264
G4,C1(COC(C)(C(C1(CO)O)O)O)=O,8,4,11,15,24,0.000205
G4,C1(C(C)OC(C(C1(CO)O)O)O)=O,16,3,11,14,24,0.000146
G4,C1(COC(CC(C1(CO)O)O)O)=O,8,4,11,15,38,0.000205
G4,C(C(CO)(C1C(CC(O1)=O)O)O)=O,8,3,8,11,8,0.000146
G4,C1(C(CO)C(C(C(C=O)O)O1)O)=O,16,2,9,11,8,9.7e-05
G4,C(C1(CO)C(C(CC(O1)=O)O)O)=O,8,2,13,15,8,9.9e-05
G4,C1(C(CO)C(C(C(C=O)O1)O)O)=O,16,1,13,14,8,4.9e-05
G4,C(C(C=O)(C(CCO)O)O)=O,2,3,9,12,1,0.000155
G4,C(C(C=O)(C(CC(C)O)O)O)=O,4,2,10,12,1,9.6e-05
G4,C(C(C=O)(C(C(C(C)O)O)O)O)=O,8,3,12,15,1,0.000154
G4,C(C(C=O)(C(C=O)(C(C)O)O)O)=O,4,7,14,21,1,0.00034700000000000003
G4,C(C(C=O)(C(CO)(C(C)O)O)O)=O,4,4,9,13,1,0.000213
G4,C(C(C=O)(C(CC=O)O)O)=O,2,4,14,18,1,0.000192
G4,C(C(C=O)(C=O)O)(O)=O,1,7,8,15,1,0.00034500000000000004
G4,C(C(C=O)(C(C(CC=O)=O)O)O)=O,2,4,13,17,23,0.00019099999999999998
G4,C(C(C=O)(C(C=O)(CC=O)O)O)=O,2,3,11,14,1,0.000144
G4,C(C(C=O)(C(CC(C=O)=O)O)O)=O,2,3,11,14,1,0.000144
G4,C(C(C=O)(C(C(C)=O)(C)O)O)=O,2,3,10,13,14,0.000143
G4,C(C(C=O)(C(C)(CC=O)O)O)=O,2,4,12,16,1,0.000192
G4,C(C(C=O)(C(CC(C)=O)O)O)=O,2,6,12,18,1,0.000297
G4,C(C(C=O)(C1(COC(C1)O)O)O)=O,4,3,8,11,1,0.000143
G4,C(C(C=O)(C(C(C=C)=O)O)O)=O,2,6,11,17,7,0.00028700000000000004
G4,C(C(C=O)(C(C=O)(C=C)O)O)=O,2,5,11,16,7,0.000239
G4,C(C(C=O)(C(C=C)(CO)O)O)=O,2,5,9,14,1,0.00025
G4,C(C(C=O)(C(C=CC=O)O)O)=O,4,4,10,14,1,0.00019099999999999998
G4,C1(C(C(C(C=O)O)O)C(CO1)O)=O,16,2,12,14,8,9.499999999999999e-05
G4,C(C(C=O)(C(C(C)O)O)O)=O,4,3,10,13,11,0.000155
G4,C(C(C(C1(C(COC1)=O)O)O)O)=O,8,3,14,17,10,0.000143
G4,C(C(C=O)(C1(COCC1O)O)O)=O,4,2,6,8,10,9.6e-05
G4,C(C(C=O)(C1(C(O)OCC1)O)O)=O,4,3,8,11,34,0.000143
G4,C(C)(C(C(C)O)(C(CO)(C)O)O)=O,8,5,11,16,4,0.000252
G4,C(C(C(C)O)(C(CO)(C)O)O)=O,8,6,13,19,49,0.00031099999999999997
G4,C(C(C(CO)(C(CO)(C)O)O)=O)=O,4,6,15,21,49,0.000312
G4,C1(C(C(CO1)O)(C(CO)(C)O)O)=O,8,3,8,11,49,0.000155
G4,C1(C(C(CO1)O)C(C)(CO)O)=O,8,3,7,10,8,0.000154
G4,C(C(C(C)O)(C(CO)(C)O)O)(O)=O,8,6,10,16,49,0.00031099999999999997
G4,C1(COCC1(C(CO)(C)O)O)=O,4,3,6,9,10,0.000155
G4,C(C(C(CCO)O)(C(C=O)O)O)=O,8,10,18,28,0,0.000512
G4,C(C(C(C(C)O)O)(C(C=O)O)O)=O,16,10,19,29,11,0.000512
G4,C(CO)(C(C(C)O)(C(C)O)O)=O,3,2,6,8,4,9.8e-05
G4,C(C(C(CO)=O)(C(C)O)C(C)O)=O,3,2,6,8,4,9.6e-05
G4,C(CC(C(C(C)O)(C(C)O)O)=O)=O,3,2,8,10,4,9.8e-05
G4,C(C(C(CO)(C(C)O)C(C)O)=O)=O,3,2,8,10,4,9.8e-05
G4,C(CCO)(C(C(C)O)(C(C)O)O)=O,3,4,7,11,4,0.000206
G4,C(CO)(C(CO)(C(C)O)C(C)O)=O,3,4,6,10,4,0.00021600000000000002
G4,C(C)(C(C(C)O)(C(C)O)O)=O,3,3,7,10,4,0.000145
G4,C(C(C(C)O)(C(C)O)C(C=O)O)=O,6,3,9,12,4,0.000144
G4,C(C(C(C)O)(C(C)O)O)=O,3,3,8,11,4,0.000156
G4,C(C(C(CO)(C(C)O)O)=O)=O,4,7,16,23,0,0.000361
G4,C1(C(C(C)O)(C(CO1)O)O)=O,8,3,7,10,4,0.000145
G4,C1(C(C(C)O)C(CO1)O)=O,8,2,8,10,4,9.6e-05
G4,C(C(C(C)O)(C(C)O)O)(O)=O,3,3,5,8,4,0.000156
G4,C1(CC(C(C1(CO)C(C)O)=O)O)=O,8,2,8,10,4,9.6e-05
G4,C1(C(CO)CC(C1(C(C)O)O)=O)=O,8,2,10,12,47,9.8e-05
G4,C1(C(CO)(C(C)O)CC(C1O)=O)=O,8,1,13,14,47,4.9e-05
G4,C1(C(C(C(C(C)=O)O1)O)C(C)O)=O,16,1,8,9,48,4.9e-05
G4,C1(CC(C(C(C)=O)(C(C)O)O1)O)=O,8,2,8,10,48,9.8e-05
G4,C1(C(C(C)O)C(C(CC=O)O1)O)=O,16,1,9,10,48,4.9e-05
G4,C1(COC(C(C)=O)C1(C(C)O)O)=O,8,2,9,11,17,9.8e-05
G4,C(C)(C1(C(C)O)C(C(CO1)=O)O)=O,8,2,10,12,4,9.8e-05
G4,C(CC1C(C(CO1)=O)(C(C)O)O)=O,8,2,10,12,9,9.8e-05
G4,C1(CC(OC1(C(C)=O)C(C)O)O)=O,8,3,7,10,9,0.000145
G4,C1(CCC(OC1(CO)C(C)O)=O)=O,4,3,7,10,4,0.000145
G4,C1(C(CO)(C(C)O)OCC(C1)=O)=O,4,2,9,11,54,9.8e-05
G4,C1(CCC(OCC1(C(C)O)O)=O)=O,4,2,7,9,4,9.8e-05
G4,C1(C(C(C)O)C(C(CCO1)=O)O)=O,8,1,7,8,19,4.9e-05
G4,C1(C(C(CC(CO1)=O)O)C(C)O)=O,8,1,8,9,48,4.9e-05
G4,C1(C(COCC(C1)=O)(C(C)O)O)=O,4,2,7,9,36,9.8e-05
G4,C1(CCOCC(C1(C(C)O)O)=O)=O,4,2,5,7,36,9.8e-05
G4,C1(COCC1(C(C)O)O)=O,4,2,12,14,4,9.8e-05
G4,C(CC1C(C(CO1)(C(C)O)O)=O)=O,8,2,8,10,9,9.8e-05
G4,C(C1(C(C)O)C(CC(C=O)O1)O)=O,16,2,12,14,40,9.8e-05
G4,C(C1(C(CC(C)(O1)O)=O)C(C)O)=O,8,3,9,12,26,0.000145
G4,C(C1(C(C)O)C(C(C(C)O1)=O)O)=O,16,2,10,12,29,9.8e-05
G4,C1(C(C(C)O)(C(C=O)OC1C)O)=O,16,2,9,11,29,9.8e-05
G4,C(C1(C(CCC(O1)O)=O)C(C)O)=O,8,3,8,11,37,0.000145
G4,C1C(C(C(C=1CO)=O)(C(C)O)O)O,8,2,11,13,4,9.8e-05
G4,C=C1C(C(C(C1O)O)(C(C)O)O)=O,16,2,14,16,4,9.8e-05
G4,C(C(C(C(C=C)O)O)(C(C)O)O)=O,16,4,13,17,28,0.000193
G4,C1OC(C(C=1)=O)(C(CO)O)C(C)O,8,2,10,12,4,9.8e-05
G4,C1OC(CO)C(C(C=1)=O)(C(C)O)O,8,2,6,8,9,9.8e-05
G4,C1C(OC(C(C=1)=O)(CO)C(C)O)O,8,2,10,12,4,9.8e-05
G4,C1OCC(C(C(C=1)=O)(C(C)O)O)O,8,2,9,11,38,9.8e-05
G4,C1COC(C(C(C=1)=O)(C(C)O)O)O,8,2,11,13,19,9.8e-05
G4,C1C(O)OCC(C(C=1)=O)(C(C)O)O,8,2,7,9,38,9.8e-05
G4,C(C(C1OCC(C=1)O)(C(C)O)O)=O,8,2,6,8,36,9.8e-05
G4,C(C(C(C)O)(C1(C=CCO1)O)O)=O,8,2,9,11,39,9.8e-05
G4,C(C1(C(C)O)C(C=C(CO)O1)O)=O,8,2,8,10,40,9.8e-05
G4,C(C1(C(C(C(O1)=C)O)O)C(C)O)=O,16,2,11,13,26,9.8e-05
G4,C(C(C(C)O)(C1C=CC(O1)O)O)=O,16,2,6,8,43,9.8e-05
G4,C(C(C1C(C=CO1)O)(C(C)O)O)=O,16,2,7,9,36,9.8e-05
G4,C(C1(C(C)O)C(C=CC(O1)O)O)=O,16,2,8,10,37,9.8e-05
G4,C(C1(C(C(C=CO1)O)O)C(C)O)=O,16,2,11,13,37,9.8e-05
G4,C(C(C(CO)=O)(CO)O)(O)=O,2,11,10,21,2,0.000573
G4,C(CO)(C(CO)(C(C(C)O)O)O)=O,8,9,13,22,11,0.00047699999999999994
G4,C(C(C(O)=O)(C(CO)O)O)(O)=O,2,9,7,16,17,0.00048600000000000005
G4,C(C(C(CC=O)=O)(C(C)=O)O)(O)=O,2,5,6,11,9,0.00025
G4,C(C(C=O)(C(CC(C)=O)=O)O)(O)=O,2,5,6,11,17,0.00025
G4,C(C(C=O)(C(CCC=O)=O)O)(O)=O,2,5,7,12,17,0.00025
G4,C(C(C=O)(C(C=CCO)=O)O)(O)=O,4,2,3,5,2,9.6e-05
G4,C(C(C(C=CC=O)=O)(CO)O)(O)=O,4,6,8,14,17,0.000301
G4,C(C(C(C=C)=O)(C(C=O)O)O)(O)=O,4,8,12,20,17,0.000393
G4,C(C1(CC(C(C1(CO)O)O)O)O)=O,16,5,14,19,51,0.00028199999999999997
G4,C(C)(C1(C(C(C(C1)=O)O)O)O)=O,8,6,15,21,25,0.000285
G4,C(C1(CC(CC1(C=O)O)O)O)=O,3,1,8,9,20,4.7e-05
G4,C(C1(CC(CO)(CC1O)O)O)=O,8,1,14,15,21,4.7e-05
G4,C(C1(CC(CC1(CO)O)O)O)=O,8,2,12,14,21,0.000106
G4,C(C1(CC(C(C1(C)O)O)O)O)=O,16,1,14,15,49,4.7e-05
G4,C(C1(C(CC(C1)O)O)O)=O,8,1,12,13,43,4.7e-05
G4,C1(C(C(CC1)(CO)O)(CC=O)O)=O,4,1,13,14,7,4.7e-05
G4,C1(C(C(C(C1)O)(C)O)(CC=O)O)=O,8,3,14,17,45,0.000144
G4,C(C)(C1(C(CC(C(C1)=O)O)O)O)=O,8,1,12,13,45,4.7e-05
G4,C(C1(CC(C(C)=O)(C(C1)O)O)O)=O,8,1,15,16,22,4.7e-05
G4,C1(C(C(CC(C1)O)O)(CC=O)O)=O,8,3,14,17,13,0.000144
G4,C(CC(C1(C(CC(C1)O)O)O)=O)=O,8,1,13,14,13,4.7e-05
G4,C(C1(CC(C(C)=O)(CC1O)O)O)=O,8,1,15,16,21,4.7e-05
G4,C(C1(C(CC(C(C1)=O)(C)O)O)O)=O,8,1,11,12,21,4.7e-05
G4,C(C1(C(CC(CC(C1)=O)O)O)O)=O,8,1,16,17,26,4.7e-05
G4,C(C1(C=CC(CO)(CC1O)O)O)=O,8,1,9,10,32,4.7e-05
G4,C(C1(CC(CO)(C(C1O)O)O)O)=O,16,3,16,19,20,0.000164
G4,C(C1(C(CC(C1)O)O)O)(O)=O,8,3,9,12,9,0.000165
G4,C(C)(C1(C(C(CO1)O)O)O)=O,8,4,9,13,41,0.00020099999999999998
G4,C(C1(C(C)(C(CO1)O)O)O)=O,8,2,8,10,2,9.499999999999999e-05
G4,C(C1(C(CO)(CCO1)O)O)=O,4,2,8,10,30,9.499999999999999e-05
G4,C(C1(C(COC(C1)O)O)O)=O,8,2,9,11,37,9.499999999999999e-05
G4,C1(C(CC(C1(C)O)O)=O)=O,4,4,16,20,4,0.00020099999999999998
G4,C(C1(C(C(CO)(C(C1)O)O)O)O)=O,16,3,15,18,43,0.000165
G4,C1(C(C(CO)(C(C1(C)O)O)O)O)=O,16,4,12,16,5,0.00018999999999999998
G4,C1(C2(C(CC(C1)O2)O)O)=O,8,3,13,16,23,0.00014199999999999998
G4,C1(C(C(O)=O)(C(C(C1)=O)CO)O)=O,4,1,13,14,17,4.8e-05
G4,C(C1(C(CC(C(C1)=O)O)=O)O)(O)=O,4,2,10,12,17,9.6e-05
G4,C(C1(CC(C(O)=O)(C(C1)=O)O)O)=O,4,2,13,15,17,9.6e-05
G4,C1(CC(C(C=O)C1(C(O)=O)O)O)=O,8,3,14,17,17,0.000143
G4,C(C1C(C(C(O)=O)(CC1O)O)=O)=O,8,3,14,17,17,0.000143
G4,C(C(C=O)(CC(C=O)=O)O)(O)=O,2,3,14,17,29,0.000154
G4,C(C(C(C)=O)(CC(CO)=O)O)(O)=O,2,3,11,14,17,0.000166
G4,C(C(CC(C)O)(C(C=O)(C)O)O)=O,8,2,12,14,11,9.6e-05
G4,C(C)(C(C(CCO)O)(CC=O)O)=O,4,3,12,15,45,0.000155
G4,C(C(C(C)=O)(CC=O)O)(O)=O,2,5,13,18,29,0.00024900000000000004
G4,C(C(C(C(C)=O)(CC=O)O)O)(O)=O,4,4,12,16,45,0.00020299999999999997
G4,C(C(C)(C(C)(C(CC=O)O)O)O)=O,8,2,14,16,11,9.7e-05
G4,C(C(C)(C(CC(C(C)=O)O)O)O)=O,8,1,13,14,11,4.8e-05
G4,C(C)(C(C(C(C)O)O)(CC=O)O)=O,8,2,13,15,45,9.7e-05
G4,C(C(C)(CC(C(C=O)(C)O)O)O)=O,8,1,12,13,11,4.8e-05
G4,C(C(C=O)(C(C=O)CO)O)(O)=O,4,5,16,21,17,0.00025299999999999997
G4,C(C(C)(C(CCO)O)O)(O)=O,4,4,7,11,25,0.00022400000000000002
G4,C(C(CCO)(C(CCO)O)O)(O)=O,4,4,9,13,29,0.00022400000000000002
G4,C(C(C(C)(C(CCO)O)O)=O)=O,4,2,14,16,18,0.00010700000000000001
G4,C(CO)(C(C)(C(CCO)O)O)=O,4,3,8,11,18,0.000165
G4,C(C(CCO)(C(CCO)O)O)=O,4,3,11,14,29,0.000165
G4,C(C(C(CCO)O)(CC(O)=O)O)=O,4,3,11,14,29,0.000165
G4,C(C(C)(C(CCO)O)O)=O,4,2,10,12,11,0.00010700000000000001
G4,C(C(C(CCO)O)(CC=O)O)(O)=O,4,4,12,16,29,0.00022400000000000002
G4,C1(C(C(CCO)O)(O)OCC1)=O,4,2,8,10,34,0.00010700000000000001
G4,C(CCO)(C(C(O)=O)(CC=O)O)=O,2,4,12,16,4,0.000215
G4,C(C(C)(C(CO)(CC(C)O)O)O)=O,8,2,10,12,11,0.00010700000000000001
G4,C(C(C)(C(C)(C(C(C)O)O)O)O)=O,16,1,11,12,11,4.8e-05
G4,C(C(C)(C(CC(CO)(C)O)O)O)=O,8,2,11,13,11,0.00010700000000000001
G4,C(C(C=O)(C(C=O)C(C)O)O)(O)=O,8,3,14,17,17,0.000146
G4,C(C(C=O)(CC(CC=O)O)O)(O)=O,4,2,14,16,17,9.7e-05
G4,C(C(C)(C(CC(C)O)O)O)(O)=O,8,2,8,10,25,0.00010700000000000001
G4,C(C(C(C)(C(CC(C)O)O)O)=O)=O,8,1,12,13,25,4.8e-05
G4,C(CO)(C(C)(C(CC(C)O)O)O)=O,8,2,9,11,25,0.00010700000000000001
G4,C(C(CCO)(C(CC(C)O)O)O)=O,8,2,11,13,29,0.00010700000000000001
G4,C(C(C)(C(CC(C)O)O)O)=O,8,1,10,11,11,4.8e-05
G4,C1(C(C(CC(C)O)O)(O)OCC1)=O,8,1,8,9,34,4.8e-05
G4,C(C(C)(C(C(C(C)O)O)O)O)(O)=O,16,4,11,15,25,0.00022400000000000002
G4,C(C(C)(C(C(C(C)O)O)O)O)=O,16,2,13,15,11,0.000106
G4,C(C(C)(C(CC(CO)O)O)O)(O)=O,8,4,10,14,25,0.00022400000000000002
G4,C(C(C)(C(CC(CO)O)O)O)=O,8,3,12,15,11,0.000165
G4,C(C(C)(C(C(CO)=O)(C)O)O)(O)=O,4,5,9,14,25,0.000261
G4,C(C(C)(C(CO)(C(C)O)O)O)(O)=O,8,5,8,13,28,0.00028199999999999997
G4,C(C(C)(C(C(CCO)O)O)O)(O)=O,8,4,10,14,25,0.00022400000000000002
G4,C(C(C)(C(C(O)=O)(C)O)O)(O)=O,3,2,4,6,25,0.00010700000000000001
G4,C(C(C(O)=O)(C)O)(O)=O,1,2,3,5,29,0.00010700000000000001
G4,C(C(C)(C(C(C(O)=O)O)O)O)(O)=O,8,8,11,19,29,0.00044699999999999997
G4,C(C(C)(C(CC(C=O)=O)O)O)(O)=O,4,3,12,15,25,0.000155
G4,C(C(C)(C(C(C)=O)(C)O)O)(O)=O,4,3,8,11,25,0.000154
G4,C(C(C)(C(C)(CC=O)O)O)(O)=O,4,3,11,14,25,0.000154
G4,C(C(C)(C(CC(C)=O)O)O)(O)=O,4,5,10,15,25,0.00024900000000000004
G4,C(C(C)(C1(COC(C1)O)O)O)(O)=O,8,3,7,10,25,0.000154
G4,C(C(C=C)(C(C(O)=O)(C)O)O)=O,4,5,10,15,28,0.00024900000000000004
G4,C(C(C)(C(C=C)(CO)O)O)(O)=O,4,5,7,12,29,0.00026000000000000003
G4,C(C(C)(C(C=CC=O)O)O)(O)=O,8,4,8,12,29,0.00020099999999999998
G4,C(C(C)(C(C(C)O)O)O)(O)=O,8,3,8,11,29,0.000165
G4,C(C(C)(C1(COCC1O)O)O)(O)=O,8,2,5,7,25,0.00010700000000000001
G4,C(C(C)(C1(C(O)OCC1)O)O)(O)=O,8,3,7,10,25,0.000154
G4,C(C(C(CC=O)O)(CCO)O)(O)=O,4,5,12,17,45,0.000273
G4,C(C(C(O)=O)(CCO)O)(O)=O,1,3,4,7,17,0.000166
G4,C(C(CCO)(C(C(C)O)O)O)(O)=O,8,3,10,13,11,0.000165
G4,C(C(CO)(C(C(C=O)=O)(C)O)O)=O,4,5,16,21,25,0.00024300000000000002
G4,C(C(C(C(C=O)=O)(C)O)O)(CO)=O,4,4,17,21,5,0.00019099999999999998
G4,C(C(CO)(C1(C(CCO1)=O)O)O)=O,4,3,14,17,34,0.000147
G4,C(C(C1(C(CCO1)=O)O)O)(CO)=O,4,2,13,15,5,9.499999999999999e-05
G4,C(C(C(CO)=O)(CC=O)O)(O)=O,2,4,13,17,17,0.000202
G4,C(C(C)(C(C(CO)=O)(C)O)O)=O,4,5,12,17,25,0.000261
G4,C(CC(C(C(C=O)=O)(C)O)O)=O,4,5,18,23,25,0.00025
G4,C(C(C)(C(C(C=O)=O)(C)O)O)(O)=O,4,3,11,14,25,0.000154
G4,C(C(C(C=O)=O)(C)O)(O)=O,2,4,11,15,28,0.000202
G4,C(C(C(C(C=O)=O)(C)O)O)(O)=O,4,4,14,18,33,0.000202
G4,C(C)(C(C)(C(C(C=O)=O)(C)O)O)=O,4,1,11,12,25,4.8e-05
G4,C(CC(C)(C(C(C=O)=O)(C)O)O)=O,4,1,13,14,25,4.8e-05
G4,C(C)(CC(C(C(C=O)=O)(C)O)O)=O,4,2,14,16,25,9.6e-05
G4,C=CC(C(C(C(C=O)=O)(C)O)O)=O,4,3,11,14,25,0.000144
G4,C(C(C=C)(C(C(C=O)=O)(C)O)O)=O,4,2,9,11,25,9.6e-05
G4,C=CC(CO)(C(C(C=O)=O)(C)O)O,4,2,9,11,25,0.00010700000000000001
G4,C(C(C(C(C=O)=O)(C)O)O)=CC=O,8,1,8,9,25,4.8e-05
G4,C(C(C(C)(C(C(C)O)O)O)=O)=O,8,2,15,17,11,9.499999999999999e-05
G4,C(CC(C(C(CO)=O)(C)O)O)=O,4,5,14,19,25,0.00025
G4,C(C(C(CO)=O)(C)O)(O)=O,2,5,12,17,17,0.000261
G4,C(C)(C(C)(C(C(CO)=O)(C)O)O)=O,4,2,11,13,25,0.00010700000000000001
G4,C(CC(C)(C(C(CO)=O)(C)O)O)=O,4,2,12,14,25,0.00010700000000000001
G4,C(C)(CC(C(C(CO)=O)(C)O)O)=O,4,3,12,15,25,0.000154
G4,C(C(C=C)(C(C(CO)=O)(C)O)O)=O,4,3,10,13,25,0.000154
G4,C(CO)(C(C)(C(C=C)(CO)O)O)=O,4,3,6,9,25,0.000165
G4,C(CO)(C(C)(C(C=CC=O)O)O)=O,8,2,9,11,25,0.00010700000000000001
G4,C(C(C)(C(CO)(C(C)O)O)O)=O,8,4,10,14,25,0.00022400000000000002
G4,C(CO)(C(C)(C(C(C)O)O)O)=O,8,3,9,12,11,0.000154
G4,C(C(C(CC=O)O)(CCO)O)=O,4,3,15,18,29,0.000154
G4,C(CC(C(C=O)(CC(O)=O)O)O)=O,4,2,13,15,29,0.00010700000000000001
G4,C(C(C)(C(CC=O)O)O)=O,4,2,20,22,11,9.6e-05
G4,C(C(C(CC=O)O)(CC=O)O)(O)=O,4,3,17,20,33,0.000155
G4,C(CC(C1(C(CCO1)=O)O)O)=O,4,3,13,16,34,0.000143
G4,C(C(C)(C(C=O)(CCO)O)O)(O)=O,4,6,11,17,25,0.000319
G4,C(C(C=O)(CCO)O)(O)=O,2,3,9,12,17,0.000154
G4,C(C(CCO)(C(C(C)=O)(C)O)O)=O,4,2,11,13,14,0.00010700000000000001
G4,C(C(CCO)(C(C)(CC=O)O)O)=O,4,2,12,14,29,0.00010700000000000001
G4,C(C(C(CC(C)=O)O)(CCO)O)=O,4,2,12,14,29,0.00010700000000000001
G4,C(C(C=C)(C(C=O)(CCO)O)O)=O,4,3,10,13,28,0.000154
G4,C(C(CCO)(C(C=C)(CO)O)O)=O,4,3,8,11,7,0.000165
G4,C(C(CCO)(C(C=CC=O)O)O)=O,8,3,9,12,43,0.000165
G4,C(C(C)(C(C(CCO)O)O)O)=O,8,2,12,14,29,0.00010700000000000001
G4,C(C(CCO)(C(C(C)O)O)O)=O,8,2,12,14,11,0.00010700000000000001
G4,C(C(C)(C(C=O)(C)O)O)(O)=O,4,3,9,12,11,0.000155
G4,C(C(C)(C1(C(CCO1)=O)O)O)(O)=O,4,2,7,9,28,0.00010700000000000001
G4,C(C(C(O)=O)(CC(CO)=O)O)(O)=O,1,2,6,8,17,0.00010700000000000001
G4,C(C(C=O)(CC(O)=O)O)(O)=O,2,2,8,10,29,0.00010700000000000001
G4,C(C(C=O)(CC(C=O)O)O)(O)=O,4,2,13,15,17,9.6e-05
G4,C(C(C(C(C=O)O)=O)(C)O)(O)=O,4,2,10,12,17,9.6e-05
G4,C(C(C=O)(C)O)(O)=O,2,13,23,36,25,0.000629
G4,C(C(C=O)(CCC(C=O)=O)O)(O)=O,2,3,10,13,17,0.000155
G4,C(C(C(CC(C=O)=O)=O)(C)O)(O)=O,2,1,8,9,17,4.8e-05
G4,C(C(C(C(C)=O)=O)(CC=O)O)(O)=O,2,1,9,10,17,4.8e-05
G4,C(C(C(C(CC=O)=O)=O)(C)O)(O)=O,2,1,8,9,17,4.8e-05
G4,C(C(C(C=O)=O)(CC(C)=O)O)(O)=O,2,1,10,11,17,4.8e-05
G4,C(C(C(C=O)=O)(CCC=O)O)(O)=O,2,2,11,13,17,9.6e-05
G4,C(C(C=CCO)(C(C=O)=O)O)(O)=O,4,1,6,7,29,4.8e-05
G4,C(C(C(CO)=O)(C=CC=O)O)(O)=O,4,1,8,9,32,4.8e-05
G4,C(C(C(C(C=O)O)=O)(C=C)O)(O)=O,4,1,9,10,17,4.8e-05
G4,C(C(C=O)(C=CC(C=O)O)O)(O)=O,8,3,7,10,17,0.000154
G4,C(C(C(CC=O)=O)(CCO)O)(O)=O,2,2,10,12,17,0.00010700000000000001
G4,C(C(C=O)(CC(CCO)=O)O)(O)=O,2,2,12,14,29,0.00010700000000000001
G4,C(C(C(O)=O)(CC=O)O)(O)=O,1,3,9,12,17,0.000154
G4,C1(C(C(O)=O)(CC(C1CO)=O)O)=O,4,1,11,12,17,4.8e-05
G4,C(C1(C(CC(C(C)=O)O1)=O)O)(O)=O,4,1,5,6,22,4.8e-05
G4,C(C1(C(C)=O)CC(C(O1)O)=O)(O)=O,4,2,6,8,17,9.6e-05
G4,C(C1(C(CC(CC=O)O1)=O)O)(O)=O,4,1,5,6,17,4.8e-05
G4,C1(CC(OC1(C(O)=O)CC=O)O)=O,4,2,10,12,17,9.6e-05
G4,C1(CCOC(CC1(C(O)=O)O)=O)=O,2,1,4,5,19,4.8e-05
G4,C(C1(C(COCC(C1)=O)=O)O)(O)=O,2,1,5,6,17,4.8e-05
G4,C1(C(C(O)=O)(O)OCCC(C1)=O)=O,2,1,5,6,17,4.8e-05
G4,C(C1(C(CCC(CO1)=O)=O)O)(O)=O,2,1,4,5,12,4.8e-05
G4,C(C1(C(CCO1)=O)O)(O)=O,2,1,11,12,17,4.8e-05
G4,C1(C(COC1(C(O)=O)CC=O)O)=O,4,1,8,9,17,4.8e-05
G4,C(C1(C(C=O)=O)CC(CO1)O)(O)=O,4,1,7,8,17,4.8e-05
G4,C(C1(C=O)CC(C(C=O)O1)O)(O)=O,8,1,9,10,40,4.8e-05
G4,C(C1(C=O)CC(C(C)(O1)O)=O)(O)=O,4,2,6,8,14,9.6e-05
G4,C(C1C(C(C(C(O)=O)(C)O1)=O)O)=O,8,1,7,8,29,4.8e-05
G4,C(C1(C=O)CC(CC(O1)O)=O)(O)=O,4,2,9,11,37,9.6e-05
G4,C(C1(C(C=CC(CO)O1)=O)O)(O)=O,4,1,2,3,46,4.8e-05
G4,C(C1(C(C=CC(CO1)O)=O)O)(O)=O,4,1,2,3,41,4.8e-05
G4,C(C1(C=O)C=CC(CO)(O1)O)(O)=O,4,1,4,5,40,4.8e-05
G4,C(C(C)(C(CO)(CC(O)=O)O)O)=O,4,3,10,13,29,0.000165
G4,C(C(C)(C(C)(C(C(O)=O)O)O)O)=O,8,4,11,15,11,0.00022400000000000002
G4,C(CC(C=O)(C(C(O)=O)O)O)(O)=O,4,4,11,15,33,0.000213
G4,C(C(C(C(O)=O)(CC=O)O)O)(O)=O,4,4,12,16,33,0.000213
G4,C(C(C1(C(CCO1)=O)O)O)(O)=O,4,2,8,10,34,0.00010700000000000001
G4,C(C(C)(C(C(C(O)=O)O)O)O)=O,8,5,13,18,29,0.00028199999999999997
G4,C(C(C)(C(C(CC(O)=O)O)O)O)=O,8,2,13,15,29,0.00010700000000000001
G4,C(C(C(C(C)O)O)(CC(O)=O)O)=O,8,2,12,14,29,0.00010700000000000001
G4,C(C(C)(C(C(CC(C)=O)=O)O)O)=O,4,3,13,16,26,0.000144
G4,C(CC(C=O)(C(C=O)(C)O)O)(C)=O,4,3,12,15,27,0.000144
G4,C(C(C)(C(C)(CC(C=O)=O)O)O)=O,4,1,11,12,11,4.8e-05
G4,C(C(C)(C(CC(C=O)=O)O)O)=O,4,4,16,20,11,0.00020099999999999998
G4,C(C(C)(C(CC(C(C)=O)=O)O)O)=O,4,1,11,12,14,4.8e-05
G4,C(CC(C(C)=O)(C(C=O)(C)O)O)=O,4,3,12,15,45,0.000143
G4,C(CC(C(C)(C(C=O)(C)O)O)=O)=O,4,2,12,14,45,9.6e-05
G4,C(C(C)(C(C(C)=O)(C)O)O)=O,4,2,11,13,11,9.499999999999999e-05
G4,C(C)(C(C)(C1(C(CCO1)=O)O)O)=O,4,1,9,10,14,4.8e-05
G4,C(C(C)(C(C)(CC=O)O)O)=O,4,2,14,16,11,9.6e-05
G4,C(C(C)(C(CC(C)=O)O)O)=O,4,3,15,18,11,0.000143
G4,C(CC(C)(C1(C(CCO1)=O)O)O)=O,4,1,10,11,34,4.8e-05
G4,C1(C(C(CC(C)=O)O)(O)OCC1)=O,4,1,10,11,34,4.8e-05
G4,C(C(C)(C1(COC(C1)O)O)O)=O,8,2,9,11,11,9.499999999999999e-05
G4,C(C(C)(C(C=CC(CO)=O)O)O)=O,8,1,8,9,11,4.8e-05
G4,C(C(C)(C(C=CC=O)(CO)O)O)=O,8,1,7,8,11,4.8e-05
G4,C(C(C=C)(C(C=O)(C)O)O)=O,4,4,11,15,28,0.00019099999999999998
G4,C1(C(C(C(C=C)=O)O)(O)OCC1)=O,4,1,11,12,7,4.8e-05
G4,C(C(C=C)(C1(C(CCO1)=O)O)O)=O,4,1,8,9,7,4.8e-05
G4,C(C(C)(C(C=C)(CO)O)O)=O,4,4,9,13,7,0.000202
G4,C1(C(C(C=C)(CO)O)(O)OCC1)=O,4,2,5,7,34,0.00010700000000000001
G4,C(C(C)(C(C=CC=O)O)O)=O,8,3,11,14,11,0.000143
G4,C1(C(C(C=CC=O)O)(O)OCC1)=O,8,1,9,10,34,4.8e-05
G4,C(C(C)(C(C(C)O)O)O)=O,8,1,11,12,11,4.8e-05
G4,C(C(CCO)(C(C=O)(C)O)O)(O)=O,4,4,11,15,11,0.000213
G4,C(C(C(C(C)O)O)(CC=O)O)(O)=O,8,2,13,15,11,0.00010700000000000001
G4,C(C(C)(C(CC(C(O)=O)O)O)O)=O,8,4,13,17,11,0.00022400000000000002
G4,C(C(C)(C(C(CO)(CO)O)O)O)=O,4,2,9,11,11,0.00010700000000000001
G4,C(C(CO)(C(C(C=O)(C)O)O)O)=O,8,3,17,20,11,0.000147
G4,C(C(C)(C1(COCC1O)O)O)=O,8,1,7,8,10,4.8e-05
G4,C1(C(C(C(C)O)O)(O)OCC1)=O,8,1,9,10,34,4.8e-05
G4,C(C(C)(C1(C(O)OCC1)O)O)=O,8,2,9,11,29,9.499999999999999e-05
G4,C(C)(C(C(CO)O)(CC=O)O)=O,4,6,15,21,0,0.000309
G4,C(C(C)(C(CO)O)O)(O)=O,4,5,7,12,0,0.000283
G4,C(CO)(C(C(CO)O)(CC=O)O)=O,4,5,15,20,0,0.000262
G4,C(C(C(C(C)(C(CO)O)O)=O)O)=O,8,4,13,17,0,0.000213
G4,C1(C(C(CO)O)(O)OCC1)=O,4,5,10,15,2,0.000261
G4,C(C(C)(C(C(C(CO)O)O)O)O)=O,16,8,14,22,45,0.000458
G4,C(C(C)(C(CO)(CO)O)O)(O)=O,2,4,5,9,29,0.00022400000000000002
G4,C(C(C(C)(C(CO)(CO)O)O)=O)=O,2,3,9,12,25,0.000165
G4,C(CO)(C(C)(C(CO)(CO)O)O)=O,2,6,6,12,25,0.00033
G4,C1(C(C(CO)(CO)O)(O)OCC1)=O,2,4,5,9,34,0.000213
G4,C(C(C(C)(C(C(CO)O)O)O)=O)=O,8,5,15,20,25,0.00028199999999999997
G4,C(CO)(C(C)(C(C(CO)O)O)O)=O,8,8,11,19,25,0.00044699999999999997
G4,C(C(C)(C(C(CO)O)O)O)=O,8,5,12,17,11,0.00028199999999999997
G4,C1(C(C(C(CO)O)O)(O)OCC1)=O,8,5,10,15,34,0.000271
G4,C(C(C(C(C=O)=O)(C)O)O)(C)=O,4,6,16,22,49,0.000298
G4,C(C(C)(C(C(C=O)=O)(C)O)O)=O,4,4,14,18,11,0.000202
G4,C(C(C)(C(C=O)(C)O)O)=O,3,2,6,8,11,9.6e-05
G4,C(C(C1(C(CCO1)=O)O)O)(C)=O,4,2,12,14,34,9.6e-05
G4,C(C(C)(C1(C(CCO1)=O)O)O)=O,4,1,11,12,45,4.8e-05
G4,C(C(C)(C(CC(CO)=O)O)O)(O)=O,4,6,10,16,25,0.000319
G4,C(C(C)(C(CO)(CC=O)O)O)(O)=O,4,7,11,18,29,0.000379
G4,C(C(C)(C(CC(CO)=O)O)O)=O,4,4,14,18,11,0.000202
G4,C(C(C)(C(C(C(C)=O)O)O)O)(O)=O,8,7,12,19,25,0.000367
G4,C(C(C)(C(C)(C(C=O)O)O)O)(O)=O,8,3,12,15,25,0.000154
G4,C(C(C)(C(C(C(C)=O)O)O)O)=O,8,4,15,19,11,0.00020099999999999998
G4,C(C(C)(C(C)(C(C=O)O)O)O)=O,8,2,14,16,11,9.499999999999999e-05
G4,C(C(C(C=O)(CC(C=O)=O)O)O)=O,4,2,16,18,0,9.6e-05
G4,C(CC(C(CO)=O)(C(C=O)O)O)=O,4,4,18,22,0,0.00020299999999999997
G4,C(C(C)(C(C=O)O)O)(C(C=O)O)=O,8,4,18,22,25,0.000192
G4,C(C(C1(C(CCO1)=O)O)O)=O,4,6,16,22,34,0.000285
G4,C(C(C)(C(C)(C(CO)O)O)O)(O)=O,8,5,9,14,25,0.00028199999999999997
G4,C(C(C)(C(C)(C(CO)O)O)O)=O,8,4,11,15,11,0.00022400000000000002
G4,C(C(C=O)(CC(CO)=O)O)(O)=O,2,5,13,18,17,0.000261
G4,C(C(CO)(CCO)O)(O)=O,2,5,6,11,29,0.00028399999999999996
G4,C(C(CO)(CC(CCO)=O)O)(O)=O,2,7,10,17,33,0.000381
G4,C(C(CO)(CCC(CO)=O)O)(O)=O,2,6,10,16,7,0.000332
G4,C(C(CO)(CC(C(C)=O)O)O)(O)=O,4,2,10,12,5,0.00010800000000000001
G4,C(C(CO)(CC(CC=O)O)O)(O)=O,4,5,12,17,33,0.00027400000000000005
G4,C(C(C=CC(CO)O)(CO)O)(O)=O,8,1,6,7,29,4.9e-05
G4,C(CC(C(C=O)=O)(CO)O)(CO)=O,2,2,16,18,49,0.00010800000000000001
G4,C(C(CO)(OC(C(C)=O)CO)O)=O,4,4,7,11,2,0.000196
G4,C(C(CO)(O)OCC(C(C)=O)O)=O,4,5,8,13,2,0.000239
G4,C(C(CO)(O)OCCC(CO)=O)=O,2,5,9,14,30,0.000239
G4,C(C(CO)(CC(OCC=O)O)O)=O,4,1,10,11,37,4.9e-05
G4,C1(C(C(C(CO)C1(CO)O)O)O)=O,16,3,13,16,2,0.000155
G4,C(C(C(C(CO)(C)O)=O)O)=O,4,2,12,14,2,9.7e-05
G4,C(C(CO)(C)O)=O,2,7,68,75,11,0.000334
G4,C(C(CO)(CCC(C=O)=O)O)=O,2,6,16,22,12,0.000321
G4,C(C(CO)(C)O)(CC(C=O)=O)=O,2,3,14,17,24,0.000155
G4,C(CC(C(C(C)=O)=O)(CO)O)=O,2,6,14,20,2,0.000309
G4,C(CC(C(C(CO)(C)O)=O)=O)=O,2,5,13,18,4,0.000261
G4,C(CC(C(C=O)=O)(CO)O)(C)=O,2,4,16,20,17,0.00020299999999999997
G4,C(CCC(C(C=O)=O)(CO)O)=O,2,4,17,21,27,0.00020299999999999997
G4,C1(C(CO)(CC(C(CO)O)O1)O)=O,8,4,5,9,48,0.00020299999999999997
G4,C1(C(CO)(CC(C(CO)O1)O)O)=O,8,3,5,8,48,0.000155
G4,C1(C(CO)OC(CC1(CO)O)O)=O,8,3,8,11,2,0.000155
G4,C1(C(CO)(O)OC(CO)CC1O)=O,8,2,7,9,2,0.00010800000000000001
G4,C1(C(O)OC(CO)CC1(CO)O)=O,8,3,7,10,2,0.000155
G4,C1(C(CO)(CC(C(CO1)O)O)O)=O,8,2,8,10,48,0.00010800000000000001
G4,C1(C(COC(CC1(CO)O)O)O)=O,8,4,8,12,38,0.00020299999999999997
G4,C1(C(CO)(O)OCC(CC1O)O)=O,8,2,8,10,41,0.00010800000000000001
G4,C1(C(O)OCC(CC1(CO)O)O)=O,8,3,8,11,41,0.000155
G4,C1(COC(C(CC1(CO)O)O)O)=O,8,3,9,12,2,0.000155
G4,C1(C(C(O)OCCC1(CO)O)O)=O,8,3,10,13,19,0.000155
G4,C(C(C(C=O)=O)(CO)O)=CCO,4,3,11,14,29,0.000144
G4,C(CO)(C(C=CC=O)(CO)O)=O,4,4,10,14,2,0.000192
G4,C(C(C=O)O)(C(C=C)(CO)O)=O,4,4,11,15,2,0.000192
G4,C1(CC(C(C)=O)OC1(CO)O)=O,4,4,8,12,2,0.000192
G4,C(C)(C1(CO)CC(C(O1)O)=O)=O,4,4,8,12,22,0.000192
G4,C(CC1CC(C(CO)(O)O1)=O)=O,4,4,9,13,2,0.000192
G4,C1(C(CO)(CC=O)OC(C1)O)=O,4,3,13,16,2,0.000144
G4,C1(C(CO)(CC(OCC1)=O)O)=O,2,2,6,8,19,9.7e-05
G4,C1(COCC(CC1(CO)O)=O)=O,2,3,7,10,2,0.000144
G4,C1(CCOC(C(C1)=O)(CO)O)=O,2,4,9,13,30,0.000192
G4,C1(CCC(C(CO)(OC1)O)=O)=O,2,4,7,11,12,0.000192
G4,C1(C(CO)(O)OCC1)=O,2,5,26,31,34,0.000239
G4,C1(C(CO)(CC=O)OCC1O)=O,4,2,10,12,9,9.7e-05
G4,C(C(C1(CO)CC(CO1)O)=O)=O,4,1,10,11,39,4.9e-05
G4,C(C1(CO)CC(C(C=O)O1)O)=O,8,2,11,13,40,9.7e-05
G4,C(C1(CO)CC(C(C)(O1)O)=O)=O,4,3,8,11,14,0.000144
G4,C(C1C(C(C(CO)(C)O1)=O)O)=O,8,1,8,9,29,4.9e-05
G4,C(C1(CO)CC(CC(O1)O)=O)=O,4,4,12,16,37,0.000192
G4,C1(C(CO)(CC(C(CO)O1)=O)O)=O,4,2,7,9,2,9.7e-05
G4,C1(C(CO)(CC(C(CO1)O)=O)O)=O,4,1,7,8,2,4.9e-05
G4,C1C(CO)OC(C(C=1)=O)(CO)O,4,3,6,9,2,0.000144
G4,C1C(COC(C(C=1)=O)(CO)O)O,4,3,6,9,41,0.000144
G4,C(C1(C=CC(CO)(O1)O)CO)=O,4,3,7,10,40,0.000144
G4,C(C1(CO)CC(C(CO)(O1)O)O)=O,8,3,9,12,40,0.000155
G4,C(CO)(C1(CO)CC(C(O1)O)O)=O,8,3,8,11,32,0.000144
G4,C1(C(C(OC1(CO)CCO)O)O)=O,8,2,10,12,2,9.7e-05
G4,C1(COC(CO)(CC1(CO)O)O)=O,4,2,8,10,32,9.7e-05
G4,C(C1(CO)CC(C(C(O1)O)O)O)=O,16,3,11,14,37,0.000155
G4,C1(C(C(C(OC1(CO)C)O)O)O)=O,16,2,10,12,24,9.7e-05
G4,C(C(C)(C(CO)(CCO)O)O)(O)=O,4,5,8,13,29,0.000283
G4,C(C(C)(C(CO)(CCO)O)O)=O,4,4,10,14,3,0.00022400000000000002
G4,C(C(C)(C(C(C=O)O)O)O)(O)=O,8,7,14,21,25,0.000368
G4,C(C(C(C(C(C=O)=O)(C)O)O)O)=O,8,5,18,23,0,0.000251
G4,C(C(C(C1(C(CCO1)=O)O)O)O)=O,8,2,14,16,34,9.499999999999999e-05
G4,C(C)(C(C(CO)(C)O)(CC=O)O)=O,4,2,11,13,45,0.00010700000000000001
G4,C(C(C)(C(CO)(C)O)O)(O)=O,4,3,6,9,29,0.000166
G4,C(C(CCO)(C(CO)(C)O)O)(O)=O,4,4,8,12,29,0.00022400000000000002
G4,C(C(C(C)(C(CO)(C)O)O)=O)=O,4,3,13,16,49,0.000165
G4,C(CO)(C(C)(C(CO)(C)O)O)=O,4,4,7,11,25,0.00022400000000000002
G4,C(C(C)(C(CO)(C)O)O)=O,4,2,9,11,11,0.00010700000000000001
G4,C1(C(C(CO)(C)O)(O)OCC1)=O,4,2,7,9,49,0.00010700000000000001
G4,C(C(C(CCO)O)(CC=O)O)=O,4,4,15,19,43,0.00020299999999999997
G4,C(C(C(CC(C)O)O)(CC=O)O)=O,8,2,13,15,43,9.7e-05
G4,C(C(C)(C(C(CC=O)O)O)O)(O)=O,8,6,13,19,25,0.000331
G4,C(C(C)(C(CC(C=O)O)O)O)(O)=O,8,5,12,17,25,0.000271
G4,C(CC(C(C=O)(CC=O)O)O)=O,4,5,21,26,43,0.00025
G4,C(C(C=O)(CC=O)O)(O)=O,2,9,18,27,17,0.000439
G4,C(C)(C(C)(C(C=O)(CC=O)O)O)=O,4,1,12,13,14,4.8e-05
G4,C(CC(C)(C(C=O)(CC=O)O)O)=O,4,2,16,18,6,9.7e-05
G4,C(C(C=C)(C(C=O)(CC=O)O)O)=O,4,2,10,12,28,9.6e-05
G4,C(CC(C=O)(C(C=C)(CO)O)O)=O,4,2,10,12,7,0.00010700000000000001
G4,C(CC(C=O)(C(C=CC=O)O)O)=O,8,2,11,13,43,9.7e-05
G4,C(C(C)(C(CC(C=O)O)O)O)=O,8,3,15,18,11,0.000154
G4,C(C(C(C(C)O)O)(CC=O)O)=O,8,4,16,20,11,0.00020299999999999997
G4,C1(C(CO)C(C(C1)=O)(C(C)O)O)=O,8,1,14,15,30,4.9e-05
G4,C(C)(C(C(C)O)(CC=O)O)=O,4,4,15,19,4,0.000192
G4,C(C(C)(C(C)O)O)(O)=O,4,3,8,11,27,0.000166
G4,C(C(C(C)O)(CCO)O)(O)=O,4,4,7,11,29,0.000225
G4,C(CO)(C(C(C)O)(CC=O)O)=O,4,5,14,19,4,0.000251
G4,C(C(C(C)(C(C)O)O)=O)=O,4,2,13,15,4,0.00010700000000000001
G4,C(CO)(C(C)(C(C)O)O)=O,4,3,13,16,4,0.000166
G4,C(C(C(C(C)(C(C)O)O)=O)O)=O,8,1,11,12,4,4.9e-05
G4,C(C(C)(C(C)O)O)=O,4,1,31,32,18,4.9e-05
G4,C(C(CCC(C=O)=O)(C(C)O)O)=O,4,4,12,16,12,0.00021400000000000002
G4,C(C(C)(C(C)O)O)(CC(C=O)=O)=O,4,2,10,12,4,0.00010700000000000001
G4,C(CC(C(C(C)=O)=O)(C(C)O)O)=O,4,2,11,13,25,0.00010700000000000001
G4,C(CC(C(C(C)(C(C)O)O)=O)=O)=O,4,2,10,12,4,0.00010700000000000001
G4,C(CC(C(C=O)=O)(C(C)O)O)(C)=O,4,2,12,14,17,0.00010700000000000001
G4,C(CCC(C(C=O)=O)(C(C)O)O)=O,4,3,13,16,27,0.000155
G4,C(C(C(C=O)=O)(C(C)O)O)=CCO,8,1,7,8,29,4.9e-05
G4,C(CO)(C(C=CC=O)(C(C)O)O)=O,8,1,8,9,32,4.9e-05
G4,C(C(C=O)O)(C(C=C)(C(C)O)O)=O,8,2,9,11,4,0.00010700000000000001
G4,C1(C(C(C)O)(CC(C1CO)=O)O)=O,8,1,11,12,4,4.9e-05
G4,C1(CC(C(C)=O)OC1(C(C)O)O)=O,8,1,7,8,22,4.9e-05
G4,C(C)(C1(C(C)O)CC(C(O1)O)=O)=O,8,2,7,9,4,9.6e-05
G4,C(CC1CC(C(C(C)O)(O)O1)=O)=O,8,2,7,9,4,9.6e-05
G4,C1(C(C(C)O)(CC=O)OC(C1)O)=O,8,2,11,13,4,9.6e-05
G4,C1(C(C(C)O)(CC(OCC1)=O)O)=O,4,1,6,7,19,4.9e-05
G4,C1(COCC(CC1(C(C)O)O)=O)=O,4,1,7,8,17,4.9e-05
G4,C1(CCOC(C(C1)=O)(C(C)O)O)=O,4,1,7,8,30,4.9e-05
G4,C1(CCC(C(C(C)O)(OC1)O)=O)=O,4,1,6,7,12,4.9e-05
G4,C1(C(C(C)O)(O)OCC1)=O,4,3,13,16,4,0.000144
G4,C1(C(C(C)O)(CC=O)OCC1O)=O,8,1,9,10,9,4.9e-05
G4,C(C(C1(C(C)O)CC(CO1)O)=O)=O,8,1,8,9,4,4.9e-05
G4,C(C1(C(C)O)CC(C(C=O)O1)O)=O,16,1,10,11,40,4.9e-05
G4,C(C1(C(C)O)CC(C(C)(O1)O)=O)=O,8,2,7,9,14,9.6e-05
G4,C(C1C(C(C(C)(C(C)O)O1)=O)O)=O,16,1,8,9,29,4.9e-05
G4,C(C1(C(C)O)CC(CC(O1)O)=O)=O,8,2,10,12,25,9.6e-05
G4,C1C(CO)OC(C(C=1)=O)(C(C)O)O,8,1,6,7,46,4.9e-05
G4,C1C(COC(C(C=1)=O)(C(C)O)O)O,8,1,6,7,41,4.9e-05
G4,C(C1(C=CC(CO)(O1)O)C(C)O)=O,8,1,5,6,40,4.9e-05
G4,C(C(CC(C)O)(C(C(O)=O)O)O)=O,8,3,12,15,33,0.000154
G4,C(C(C(CC(C(C)=O)O)O)O)(O)=O,8,4,13,17,45,0.00022400000000000002
G4,C(C(C)(CC(C(C(O)=O)O)O)O)=O,8,4,14,18,16,0.00022400000000000002
G4,C(C(C(CCO)O)O)(O)=O,4,9,13,22,17,0.000472
G4,C(C(C(CO)(CC(C)O)O)O)(O)=O,8,3,9,12,33,0.000165
G4,C(C(C(C)(C(C(C)O)O)O)O)(O)=O,16,4,10,14,33,0.00022400000000000002
G4,C(C(C(CC(CO)(C)O)O)O)(O)=O,8,5,10,15,49,0.00028199999999999997
G4,C(C(C(CC(C)O)O)O)(O)=O,8,6,10,16,33,0.000319
G4,C(C(C(C(C(C)O)O)O)O)(O)=O,16,10,11,21,29,0.000575
G4,C(C(C(CO)(C(C)O)O)O)(O)=O,8,8,8,16,29,0.000458
G4,C(C(C(CO)(C(C=O)O)O)O)(O)=O,8,11,14,25,33,0.000602
G4,C(C(C(C(CC(C)=O)=O)O)O)(O)=O,4,4,13,17,26,0.000202
G4,C(C(C(C=O)(CC(C)=O)O)O)(O)=O,4,4,12,16,27,0.000202
G4,C(C(C)(C(C(O)=O)O)O)(CC=O)=O,4,3,13,16,14,0.000154
G4,C(C)(C(C)(C(C(O)=O)O)O)=O,4,5,11,16,14,0.00024900000000000004
G4,C(C(C1(COC(C1)O)O)O)(O)=O,8,3,7,10,33,0.000154
G4,C(C(C(C=CC(CO)=O)O)O)(O)=O,8,2,7,9,11,0.00010700000000000001
G4,C(C(C(C=CC=O)(CO)O)O)(O)=O,8,2,8,10,11,0.00010700000000000001
G4,C(C(C=C)(C(C(O)=O)O)O)=O,4,7,12,19,7,0.000344
G4,C(C(C(C=C)(CO)O)O)(O)=O,4,7,9,16,29,0.00035499999999999996
G4,C(C(C(C(C)O)O)O)(O)=O,8,10,14,24,11,0.000531
G4,C(C(C(C(CO)(CO)O)O)O)(O)=O,4,9,8,17,29,0.000516
G4,C(C(C1(COCC1O)O)O)(O)=O,8,2,5,7,33,0.00010700000000000001
G4,C(C(C1(C(O)OCC1)O)O)(O)=O,8,3,7,10,29,0.000154
G4,C(C(C(C)=O)(CC(C=O)=O)O)(O)=O,2,5,10,15,17,0.00024900000000000004
G4,C(C(C(CC=O)=O)(CC=O)O)(O)=O,2,7,13,20,17,0.000344
G4,C(C(C=O)(CC(C(C)=O)=O)O)(O)=O,2,3,9,12,14,0.000154
G4,C(C(C=O)(CC(CC=O)=O)O)(O)=O,2,3,11,14,37,0.000154
G4,C(C(C=O)(C=CC(CO)=O)O)(O)=O,4,3,7,10,32,0.000154
G4,C(CCO)(OC(C=O)C(CO)O)=O,4,1,8,9,48,4.7e-05
G4,C(CCO)(OC(CO)C(C=O)O)=O,4,1,5,6,48,4.7e-05
G4,C(CCO)(OCC(C(C=O)O)O)=O,4,1,8,9,48,4.7e-05
G4,C(C(C(C)=O)OC(CO)=O)=O,2,3,9,12,2,0.00014199999999999998
G4,C(CO)(OC(C=O)CC=O)=O,2,4,11,15,27,0.00018999999999999998
G4,C(CO)(OCCC(C=O)=O)=O,1,3,10,13,2,0.00014199999999999998
G4,C(CC(COC(CO)=O)=O)=O,1,3,11,14,2,0.00014199999999999998
G4,C(C(CCO)(O)OC(CO)=O)=O,2,1,6,7,2,4.7e-05
G4,C(CC(CO)(O)OC(CO)=O)=O,2,1,8,9,17,4.7e-05
G4,C(C(C(C)(O)OC(CO)=O)O)=O,4,1,8,9,14,4.7e-05
G4,C(C(CC(O)OC(CO)=O)O)=O,4,1,7,8,43,4.7e-05
G4,C1(C(C(C(C1C)O)O)=O)=O,8,5,20,25,42,0.00023700000000000001
G4,C1(C(C)C(C(C1O)=O)O)=O,8,3,20,23,42,0.00014199999999999998
G4,C1(CCC(C(C1)=O)=O)=O,1,4,86,90,45,0.00018999999999999998
G4,C(C1C(C(CC1)=O)=O)=O,2,3,64,67,45,0.00014199999999999998
G4,C1(CC(CC(C1)=O)=O)=O,1,1,36,37,45,4.7e-05
G4,C(C1C(CC(C1)=O)=O)=O,2,5,88,93,45,0.00023700000000000001
G4,C(C1CC(C(C1)=O)=O)=O,1,3,39,42,45,0.00014199999999999998
G4,C(C1C(CCC1=O)=O)=O,1,3,48,51,45,0.00014199999999999998
G4,C1(CC=CC(C1O)=O)=O,2,3,75,78,32,0.00014199999999999998
G4,C1(CC(C=CC1O)=O)=O,2,5,76,81,45,0.00023700000000000001
G4,C(C(CO)=O)(C(CO)CO)=O,1,6,11,17,2,0.00028900000000000003
G4,C(C(C(C(CO)=O)=O)C)=O,2,5,22,27,42,0.00023700000000000001
G4,C(C(CO)CC(C=O)=O)=O,2,8,22,30,55,0.000393
G4,C(CO)(CCC(C(CO)=O)=O)=O,1,8,15,23,12,0.00037999999999999997
G4,C(CC(CO)=O)(CC(CO)=O)=O,1,3,7,10,5,0.00014199999999999998
G4,C(CC(C=O)C(C(CO)=O)O)=O,4,7,18,25,5,0.000344
G4,C(C(CO)C(C=O)C(CO)=O)=O,4,6,17,23,55,0.000298
G4,C(C(C(C)=O)O)(CC(CO)=O)=O,2,5,12,17,5,0.00023700000000000001
G4,C(C(C(CO)=O)O)(CC(C)=O)=O,2,4,12,16,5,0.00018999999999999998
G4,C(C(C(C(C(CO)=O)=O)C)O)=O,4,3,13,16,42,0.000143
G4,C(C(C(C(C=O)=O)C)O)(CO)=O,4,3,16,19,5,0.000143
G4,C(C(CO)=O)(C(C)C(CO)O)=O,4,3,11,14,42,0.000155
G4,C(CO)(C(C)C(C(CO)=O)O)=O,4,2,12,14,5,0.000106
G4,C(C(C(C(CO)=O)=O)CCO)=O,2,3,15,18,5,0.00014199999999999998
G4,C(C(CO)C(C(C=O)=O)CO)=O,4,6,18,24,55,0.0003
G4,C(C(CO)=O)(C(CO)CCO)=O,2,5,11,16,55,0.000262
G4,C(C(CCO)C(C(CO)=O)O)=O,4,4,14,18,55,0.000212
G4,C(C(CO)C(C(CO)=O)CO)=O,4,11,16,27,55,0.00056
G4,C(C(CO)=O)(C(CO)C)=O,2,5,18,23,42,0.000251
G4,C(C(C)C(C(CO)=O)O)=O,4,6,24,30,49,0.000296
G4,C(C(CO)CC(CO)=O)=O,2,15,26,41,55,0.0007480000000000001
G4,C(C(C)=O)(C(CO)CO)=O,1,8,15,23,2,0.000395
G4,C(CC(C(CC(CO)=O)=O)O)=O,2,8,17,25,51,0.000381
G4,C(CCC(C(C(CO)=O)O)=O)=O,2,4,14,18,51,0.00018999999999999998
G4,C(C(CCC(C(CO)=O)=O)O)=O,2,5,14,19,12,0.00023799999999999998
G4,C(C(CC(CC(CO)=O)=O)O)=O,2,6,16,22,51,0.000297
G4,C(C(C(C=O)C(C=O)CO)O)=O,8,8,18,26,29,0.000395
G4,C(C(CO)=O)(CC)=O,1,6,91,97,42,0.000285
G4,C(C(CO)CC=O)=O,2,13,81,94,55,0.000642
G4,C(CCO)(C(C=O)C(CO)=O)=O,2,7,13,20,2,0.00034500000000000004
G4,C(C(C(CO)=O)CC(CO)=O)=O,2,7,17,24,29,0.00035499999999999996
G4,C(C(C(CCC(CO)=O)=O)O)=O,2,5,16,21,20,0.00024900000000000004
G4,C(CCO)(C(C=O)C(C=O)O)=O,4,12,17,29,2,0.000595
G4,C(C(C(C=O)CC(CO)=O)O)=O,4,9,18,27,12,0.00044
G4,C(CC(C=O)CC(C=O)=O)=O,2,8,16,24,43,0.00038199999999999996
G4,C(CC=O)(CC(C(C)=O)=O)=O,1,6,17,23,2,0.000285
G4,C(CC(C(CC(C)=O)=O)=O)=O,1,4,19,23,26,0.00018999999999999998
G4,C(C(C(C(CC=O)=O)=O)C)=O,2,4,15,19,42,0.00018999999999999998
G4,C(CC(C)=O)(CC(C=O)=O)=O,1,4,18,22,26,0.00018999999999999998
G4,C(C(CCC(C(C)=O)=O)=O)=O,1,4,13,17,12,0.00018999999999999998
G4,C(C=O)(C(C)CC(C=O)=O)=O,2,2,12,14,29,9.499999999999999e-05
G4,C(CO)(C(C)CC(C=O)=O)=O,2,2,17,19,52,0.000106
G4,C(C(CCO)CC(C=O)=O)=O,2,4,15,19,29,0.000202
G4,C(CCO)(CC(C(C)=O)=O)=O,1,6,17,23,2,0.000298
G4,C(C)(CC(C(CCO)=O)=O)=O,1,5,17,22,2,0.000251
G4,C(C(C(C(CCO)=O)=O)C)=O,2,3,15,18,29,0.000156
G4,C(C(CCC(C=O)=O)=O)=O,1,4,12,16,7,0.00018999999999999998
G4,C(C(C)CC(C=O)=O)=O,2,2,39,41,28,9.499999999999999e-05
G4,C(C)(CC(C(C)=O)=O)=O,1,11,64,75,14,0.000522
G4,C(C(C(C(C)=O)=O)C)=O,2,2,46,48,45,9.499999999999999e-05
G4,C(CCC(CC(C=O)=O)=O)=O,1,3,19,22,20,0.00014199999999999998
G4,C(CC(CCC(C=O)=O)=O)=O,1,4,19,23,20,0.00018999999999999998
G4,C(C(C(CCC(C=O)=O)=O)O)=O,2,3,17,20,29,0.00014199999999999998
G4,C(C(C(CO)O)CC(C=O)=O)=O,4,8,18,26,0,0.000425
G4,C(C(C(C(C(CO)O)=O)=O)C)=O,4,4,16,20,42,0.000205
G4,C(CC(C(CC=O)=O)=O)=O,1,3,18,21,2,0.00014199999999999998
G4,C(C(C(CC=O)=O)C(CO)=O)=O,2,3,15,18,1,0.00014199999999999998
G4,C(C(C(CO)=O)CC(C=O)=O)=O,2,3,17,20,29,0.00014199999999999998
G4,C(CC(CC(C(C=O)O)=O)=O)=O,2,3,16,19,1,0.00014199999999999998
G4,C(CC(C(C(CC=O)=O)O)=O)=O,1,1,8,9,29,4.7e-05
G4,C(C(C)C(C=O)C(CO)=O)=O,4,4,16,20,49,0.00018999999999999998
G4,C(CC(C(C(C)CO)=O)=O)=O,2,4,14,18,42,0.00020299999999999997
G4,C(C(C)C(C(CC=O)=O)O)=O,4,2,18,20,49,9.499999999999999e-05
G4,C(CC(C)=O)(CC(CO)=O)=O,1,7,18,25,49,0.000343
G4,C(CO)(CCC(C(C)=O)=O)=O,1,6,17,23,49,0.000296
G4,C(CC(C=O)C(C(C)=O)O)=O,4,8,18,26,43,0.000381
G4,C(CC(C(C(C)=O)=O)CO)=O,2,6,15,21,55,0.000298
G4,C(CC(C(CC)=O)=O)=O,1,3,55,58,27,0.00014199999999999998
G4,C(C(C)CC(C(C=O)O)=O)=O,4,1,15,16,49,4.7e-05
G4,C(CC(C(C=O)=O)C)(CO)=O,2,2,17,19,52,0.000106
G4,C(C(C(C)=O)O)(CC(C)=O)=O,2,4,15,19,49,0.00018999999999999998
G4,C(C(C(C(C=O)=O)C)O)(C)=O,4,2,15,17,28,9.499999999999999e-05
G4,C(C(C(C(C(C)=O)=O)C)O)=O,4,2,13,15,0,9.6e-05
G4,C(CCC(C(C)=O)=O)=O,1,11,55,66,46,0.000522
G4,C(CC(C(C=O)=O)C)=O,2,2,39,41,45,9.499999999999999e-05
G4,C(CC(C(C(CO)O)=O)=O)=O,2,7,20,27,2,0.00034700000000000003
G4,C(C(C)CC(C(CO)O)=O)=O,4,4,17,21,28,0.000205
G4,C(CO)(C(C)CC(CO)=O)=O,2,3,16,19,52,0.000165
G4,C(CO)(C(C)C(C(C)=O)O)=O,4,2,15,17,2,0.000106
G4,C(C(C)=O)(C(C)C(CO)O)=O,4,3,12,15,28,0.000155
G4,C(CO)(C(C)CC=O)=O,2,2,42,44,0,0.000106
G4,C(C(CC(C(CC)=O)=O)O)=O,2,2,14,16,0,9.6e-05
G4,C(C(CC(CC(C)=O)=O)O)=O,2,4,20,24,49,0.00018999999999999998
G4,C(CC(CCC(CO)=O)=O)=O,1,5,21,26,21,0.00024900000000000004
G4,C(CCC(CC(CO)=O)=O)=O,1,3,19,22,21,0.000154
G4,C(C(CC(C=O)CC=O)O)=O,4,4,18,22,21,0.00019099999999999998
G4,C(C(C(C)=O)=O)(CC(CO)O)=O,2,2,13,15,29,9.499999999999999e-05
G4,C(CC(C(CC(C=O)O)O)=O)=O,4,5,17,22,32,0.000248
G4,C(C(CC(C(C(C)=O)=O)O)O)=O,4,5,14,19,32,0.000248
G4,C(CCO)(C(C(C(C)=O)=O)O)=O,2,4,13,17,3,0.000192
G4,C(CO)(CC(C(C(C)=O)=O)O)=O,2,8,15,23,49,0.00037999999999999997
G4,C(CC(CC(CC=O)=O)=O)=O,1,3,11,14,2,0.00014199999999999998
G4,C(CC(C=CC(C=O)O)=O)=O,4,3,16,19,29,0.00014199999999999998
G4,C(C(C=CC(C(C)=O)=O)O)=O,4,3,13,16,29,0.00014199999999999998
G4,C(CC=O)(C(C(C=O)=O)CO)=O,2,7,17,24,2,0.000336
G4,C(C=O)(C(CO)CC(C=O)=O)=O,2,3,16,19,29,0.000144
G4,C(C(C)C(C(C=O)=O)CO)=O,4,3,15,18,29,0.000145
G4,C(C(C(C(C)=O)=O)CCO)=O,2,2,14,16,29,0.000106
G4,C(C(CCO)=O)(C(C)CO)=O,2,5,12,17,2,0.000264
G4,C(C(C)C(C(CCO)=O)O)=O,4,3,16,19,3,0.000156
G4,C(C(C)C(C(CO)=O)CO)=O,4,5,16,21,55,0.000262
G4,C(C(CCO)CC(CO)=O)=O,2,7,16,23,46,0.00035499999999999996
G4,C(C(CCO)C(C(C)=O)O)=O,4,3,15,18,3,0.000154
G4,C(C(C)=O)(C(CO)CCO)=O,2,3,12,15,29,0.000165
G4,C(C(CCO)=O)(CC)=O,1,4,39,43,27,0.00020299999999999997
G4,C(CCO)(CC(C)=O)=O,1,7,54,61,27,0.00034500000000000004
G4,C(C(CCO)CC=O)=O,2,6,30,36,46,0.000297
G4,C(CCC(C(C(C)=O)O)=O)=O,2,2,17,19,49,9.499999999999999e-05
G4,C(C(C)CC=O)(C(C=O)O)=O,4,1,16,17,16,4.7e-05
G4,C(C(C(CC=O)=O)C(C=O)O)=O,4,7,18,25,9,0.000333
G4,C(C(C(C=O)CC(C=O)=O)O)=O,4,5,17,22,29,0.000239
G4,C(C(C)CC(CO)=O)=O,2,5,42,47,28,0.00024900000000000004
G4,C(C(C)=O)(C(C)CO)=O,2,4,32,36,27,0.00020299999999999997
G4,C(C(C)C(C(C)=O)O)=O,4,4,41,45,27,0.00018999999999999998
G4,C(C(CCC(C(C)=O)=O)O)=O,2,2,15,17,49,9.499999999999999e-05
G4,C(C(C(C=O)C(C=O)C)O)=O,8,4,16,20,28,0.00019099999999999998
G4,C(C(CC(C(C(C)=O)O)=O)O)=O,4,5,15,20,49,0.00023799999999999998
G4,C(C(C)=O)(CC)=O,1,6,254,260,28,0.000285
G4,C(C)(CC(C)=O)=O,1,7,241,248,28,0.000332
G4,C(C(C)CC=O)=O,2,2,204,206,28,9.499999999999999e-05
G4,C(C(C(CO)O)CC(CO)=O)=O,4,9,16,25,46,0.000484
G4,C(C(C)C(C(C(CO)O)=O)O)=O,8,5,15,20,49,0.000263
G4,C(C(C(CO)O)=O)(C(CO)C)=O,4,6,12,18,42,0.00031299999999999996
G4,C(C(C(CO)O)CC=O)=O,4,8,22,30,46,0.000425
G4,C(CO)(C(CO)CC=O)=O,2,12,26,38,2,0.000594
G4,C(C(C(CO)O)=O)(CC)=O,2,6,20,26,42,0.00031099999999999997
G4,C(C(CCC(C=O)=O)CC=O)=O,2,6,17,23,28,0.000286
G4,C(CCC(C=O)=O)(CC(C)=O)=O,1,2,16,18,12,9.499999999999999e-05
G4,C(C(CCC(C=O)=O)=O)(CC)=O,1,1,10,11,29,4.7e-05
G4,C(C(C)CC=O)(CC(C=O)=O)=O,2,1,15,16,29,4.7e-05
G4,C(CC(CC(C=O)CC=O)=O)=O,2,7,18,25,43,0.000334
G4,C(CC(CC(CC(C)=O)=O)=O)=O,1,4,15,19,26,0.00018999999999999998
G4,C(CC=O)(CC(C(CC)=O)=O)=O,1,1,12,13,4,4.7e-05
G4,C(CC(C(C(C)=O)=O)CC=O)=O,1,4,8,12,46,0.00019099999999999998
G4,C(CC(C(C(C)CC=O)=O)=O)=O,2,1,13,14,29,4.7e-05
G4,C(CC(C(CC=O)CC=O)=O)=O,1,5,12,17,46,0.000239
G4,C(CCC(C(CC(C)=O)=O)=O)=O,1,2,14,16,26,9.499999999999999e-05
G4,C(CC(C(C=O)=O)CC(C)=O)=O,2,4,15,19,27,0.00019099999999999998
G4,C(CC(CC(CCC=O)=O)=O)=O,1,2,17,19,29,9.499999999999999e-05
G4,C(CCC(C(CCC=O)=O)=O)=O,1,1,7,8,29,4.7e-05
G4,C(CCC(C(C=O)=O)CC=O)=O,2,2,17,19,44,9.499999999999999e-05
G4,C(CC(CCC(C(C)=O)=O)=O)=O,1,2,15,17,21,9.499999999999999e-05
G4,C(CCC(CC(C(C)=O)=O)=O)=O,1,1,15,16,21,4.7e-05
G4,C(CC(CCC(CC=O)=O)=O)=O,1,1,10,11,6,4.7e-05
G4,C(CC=O)(CC(C=CCO)=O)=O,2,1,9,10,29,4.7e-05
G4,C(CCC(C(C=CCO)=O)=O)=O,2,1,9,10,29,4.7e-05
G4,C(CC(C=CCO)C(C=O)=O)=O,4,1,10,11,29,4.7e-05
G4,C(CC(C(CO)=O)C=CC=O)=O,4,3,15,18,29,0.00014199999999999998
G4,C(CCC(C(C(C=C)=O)O)=O)=O,2,1,14,15,7,4.7e-05
G4,C(C(C=O)O)(C(C=C)CC=O)=O,4,2,14,16,29,9.499999999999999e-05
G4,C(CC=O)(CC=CC(CO)=O)=O,2,2,14,16,32,9.499999999999999e-05
G4,C(CCC(C=CC(CO)=O)=O)=O,2,1,14,15,32,4.7e-05
G4,C(C(C=CC(C=O)O)CC=O)=O,8,3,14,17,29,0.00014199999999999998
G4,C(C(C=CC(CC(C)=O)=O)O)=O,4,1,13,14,29,4.7e-05
G4,C(C(C=CC(C(CC)=O)=O)O)=O,4,1,11,12,32,4.7e-05
G4,C(CCC(C(C=CC=O)O)=O)=O,4,2,14,16,29,9.499999999999999e-05
G4,C(C(C(C=O)=O)C)=O,2,12,91,103,49,0.0005690000000000001
G4,C(CC(C(C=O)=O)CO)=O,2,8,22,30,55,0.000393
G4,C(CC(C=O)C(C=O)O)=O,4,12,25,37,43,0.000571
G4,C(C(C(C)=O)C(CO)=O)=O,2,11,24,35,2,0.000533
G4,C(C(C(CO)=O)CC=O)=O,2,12,27,39,41,0.0005809999999999999
G4,C(C(C(C(C=O)=O)C)O)=O,4,6,20,26,28,0.000285
G4,C(C(C(C)C(CO)O)=O)=O,4,5,17,22,28,0.000261
G4,C(CO)(C(C)C(C=O)O)=O,4,4,24,28,28,0.00020099999999999998
G4,C(C(CC(C=O)C(C=O)O)O)=O,8,4,18,22,29,0.00019099999999999998
G4,C(C(C(C(CO)=O)C(C)=O)O)=O,4,6,15,21,26,0.000297
G4,C(CC(C(CO)=O)C(C=O)O)=O,4,4,18,22,0,0.00019099999999999998
G4,C(C(C(C=O)=O)CCO)=O,2,5,19,24,29,0.00024900000000000004
G4,C(C(C(CO)CCO)=O)=O,2,7,17,24,55,0.000368
G4,C(C(CCO)C(C=O)O)=O,4,7,20,27,3,0.000366
G4,C(C)(C(C(CO)=O)CO)=O,2,15,22,37,2,0.0007379999999999999
G4,C(C(C(C(C(C=O)=O)C)O)O)=O,8,6,19,25,49,0.000298
G4,C(C(C)C(C=O)O)(C(C=O)O)=O,8,2,15,17,42,9.499999999999999e-05
G4,C(CCC(C(C(C=O)O)O)=O)=O,4,14,22,36,20,0.000679
G4,C(C(C(C)CO)=O)=O,2,5,63,68,28,0.000251
G4,C(C(C)C(C=O)O)=O,4,9,79,88,49,0.00043799999999999997
G4,C(C(CC)=O)=O,1,14,439,453,28,0.000664
G4,C(CC(CO)O)(CC(CO)=O)=O,2,8,12,20,0,0.000425
G4,C(CC(CO)O)(C(C(C)=O)O)=O,4,6,11,17,49,0.000319
G4,C(C(C(CO)O)O)(CC(C)=O)=O,4,10,14,24,0,0.000532
G4,C(C(C=O)CC(CO)O)(O)=O,4,1,14,15,29,4.7e-05
G4,C(C(CCC(CO)O)=O)(O)=O,2,4,11,15,29,0.000213
G4,C(C(C(C)=O)=O)(CCO)=O,1,2,20,22,2,9.499999999999999e-05
G4,C(C(C(CCCO)=O)=O)=O,1,3,17,20,55,0.000154
G4,C(C)(C(C(C(C)=O)=O)O)=O,2,9,23,32,25,0.00042699999999999997
G4,C(C(C(C(CC)=O)=O)O)=O,2,2,20,22,42,9.499999999999999e-05
G4,C(CCC(C(C=O)O)O)=O,4,8,28,36,27,0.00041500000000000006
G4,C(C)(C(C(C=C)=O)O)=O,2,8,57,65,9,0.00037999999999999997
G4,C(C)(C(C=CC=O)O)=O,4,6,49,55,45,0.000285
G4,C(CC1(CC(CO1)O)O)=O,4,2,16,18,44,9.499999999999999e-05
G4,C(C)(C1(CC(CO1)O)O)=O,4,2,9,11,14,9.499999999999999e-05
G4,C(CC1C(CC(O)O1)O)=O,8,2,15,17,43,9.499999999999999e-05
G4,C(C)(C1C(CC(O1)O)O)=O,8,2,16,18,45,9.499999999999999e-05
G4,C(C1CC(C(CO1)O)O)=O,8,1,11,12,29,4.7e-05
G4,C1(C=CC(C1CO)=O)=O,1,2,43,45,45,9.499999999999999e-05
G4,C(C1C(CC(C(C1O)O)O)=O)=O,16,4,18,22,0,0.00018999999999999998
G4,C(C(CO)C(C=O)(C(C)=O)O)=O,4,7,15,22,25,0.000348
G4,C(C(C=O)(C(C=O)CO)O)=O,2,6,13,19,1,0.000301
G4,C(CC(C=O)C(C=O)(CO)O)=O,4,7,17,24,29,0.000357
G4,C(CCO)(C(C=O)(C(C)=O)O)=O,2,4,8,12,1,0.00020299999999999997
G4,C(C(CO)O)(C(C=O)C(C)=O)=O,4,9,15,24,2,0.000465
G4,C(C(C(C)=O)(CC(CO)=O)O)=O,2,6,14,20,25,0.000297
G4,C(C(CO)(C(C(C=O)=O)C)O)=O,4,4,15,19,28,0.000204
G4,C(C(CO)(C(C(CO)=O)C)O)=O,4,4,13,17,28,0.00021400000000000002
G4,C(C(CCO)C(C=O)(CO)O)=O,4,5,15,20,3,0.000262
G4,C(C(C=O)(C(CCO)=O)O)=O,1,3,8,11,1,0.000156
G4,C(C(C=O)C(C(CO)O)=O)=O,2,6,14,20,2,0.00031099999999999997
G4,C(C(C=O)(CC(CO)=O)O)=O,1,5,13,18,1,0.00024900000000000004
G4,C(C(C(C(C=O)O)=O)CO)=O,4,4,16,20,2,0.000205
G4,C(C(C(CC=O)=O)(CO)O)=O,2,4,14,18,1,0.000205
G4,C(C(C)C(C=O)(CO)O)=O,4,3,16,19,49,0.000156
G4,C(C(C(C)=O)C(C(C)=O)=O)=O,2,4,14,18,29,0.00018999999999999998
G4,C(C)(C(C(C(C)=O)=O)CO)=O,2,6,14,20,2,0.0003
G4,C(C(C=O)C(C(C)=O)=O)=O,1,6,19,25,14,0.000285
G4,C(C(C=O)C(CC(CO)=O)=O)=O,1,3,11,14,1,0.00014199999999999998
G4,C(C(C=O)(C(C=O)CC=O)O)=O,2,3,12,15,1,0.000143
G4,C(C(C(C)=O)C(C=O)=O)=O,2,6,24,30,23,0.000285
G4,C(C(C=O)C(C)=O)=O,1,19,85,104,6,0.0009019999999999999
G4,C(C(C=O)(C(CC(C)=O)=O)O)=O,1,1,7,8,1,4.7e-05
G4,C(C(C=O)C(C(C(C)=O)O)=O)=O,2,1,9,10,1,4.7e-05
G4,C(C(C=O)(CC(C(C)=O)=O)O)=O,1,2,9,11,1,9.499999999999999e-05
G4,C(C(C=O)(C(C(C=O)=O)C)O)=O,2,2,10,12,28,9.499999999999999e-05
G4,C(C(C(C(C=O)O)=O)C(C)=O)=O,4,1,13,14,1,4.7e-05
G4,C(C(C(CC=O)=O)(C(C)=O)O)=O,2,1,9,10,1,4.7e-05
G4,C(C(C(C)=O)(CC(C=O)=O)O)=O,2,3,13,16,25,0.000143
G4,C(C(C)C(C=O)(C(C)=O)O)=O,4,2,11,13,29,9.499999999999999e-05
G4,C(C(C(C)=O)C(C)=O)=O,1,6,35,41,6,0.000285
G4,C(C(C=O)C(C=O)=O)=O,1,10,32,42,23,0.000475
G4,C(C(C=O)(C(C(CO)=O)C)O)=O,2,2,9,11,28,0.000106
G4,C(C(C)C(C(C)=O)(CO)O)=O,4,3,13,16,29,0.000156
G4,C(C)(C(C(C)=O)CO)=O,1,4,26,30,28,0.000205
G4,C(C(C=O)C=O)=O,1,18,106,124,1,0.0008539999999999999
G4,C(C(C=O)C(C(CCO)O)=O)=O,2,5,10,15,2,0.00026000000000000003
G4,C(C(C(CCO)=O)C(CO)O)=O,4,8,15,23,2,0.00040599999999999995
G4,C(C(C(CC=O)=O)C(C)=O)=O,2,5,15,20,1,0.00023700000000000001
G4,C(C(C=O)C(CC(C)=O)=O)=O,1,4,12,16,1,0.00018999999999999998
G4,C(C(C=O)C(CCC=O)=O)=O,1,3,13,16,29,0.00014199999999999998
G4,C(C1C(COC1C(CO)O)=O)=O,8,2,10,12,29,9.499999999999999e-05
G4,C1(C(CO)CC(C(CO)O1)=O)=O,4,5,6,11,48,0.00023799999999999998
G4,C(C1C(COC(CO)C1O)=O)=O,8,2,9,11,29,9.499999999999999e-05
G4,C(C1C(CC(O)OC1CO)=O)=O,8,2,11,13,9,9.499999999999999e-05
G4,C(C1C(CC(CO)OC1O)=O)=O,8,2,11,13,29,9.499999999999999e-05
G4,C1(C(CO)CC(C(CO1)O)=O)=O,4,4,6,10,46,0.00018999999999999998
G4,C(C1C(COCC(C1O)O)=O)=O,8,2,11,13,29,9.499999999999999e-05
G4,C(C1C(CC(O)OCC1O)=O)=O,8,2,12,14,38,9.499999999999999e-05
G4,C(C1C(CC(COC1O)O)=O)=O,8,2,12,14,44,9.499999999999999e-05
G4,C(C1C(CC(C(O)OC1)O)=O)=O,8,4,13,17,2,0.00018999999999999998
G4,C(C1C(CCOC(C1O)O)=O)=O,8,3,13,16,30,0.00014199999999999998
G4,C(C(C=O)C(C=CCO)=O)=O,2,3,8,11,29,0.00014199999999999998
G4,C(C(C(C=C)=O)C(C=O)O)=O,4,3,16,19,7,0.00014199999999999998
G4,C(C(C=O)C1(CC(CO1)O)O)=O,4,2,10,12,44,9.499999999999999e-05
G4,C(C(C=O)C1C(CC(O)O1)O)=O,8,2,8,10,43,9.499999999999999e-05
G4,C(C(C=O)C(C(CCO)=O)=O)=O,1,3,12,15,7,0.000144
G4,C(C(C=O)(C(C=O)CCO)O)=O,2,3,11,14,29,0.000154
G4,C(C(C(C(C)=O)C(C)=O)O)=O,2,3,12,15,28,0.000144
G4,C(C(C=O)(C(CC=O)=O)O)=O,1,1,9,10,1,4.7e-05
G4,C(C(C=O)C(C(C=O)O)=O)=O,2,1,12,13,1,4.7e-05
G4,C(C(C=O)(CC(C=O)=O)O)=O,1,2,12,14,1,9.6e-05
G4,C(C(C=O)(C(C=O)C)O)=O,2,1,12,13,49,4.7e-05
G4,C(C(C=O)C(C(CC=O)O)=O)=O,2,3,14,17,23,0.000144
G4,C(C(C=O)(C(CCC=O)=O)O)=O,1,1,8,9,29,4.7e-05
G4,C(C(C=O)(CC(CC=O)=O)O)=O,1,2,12,14,1,9.499999999999999e-05
G4,C(C(C=O)C(CC(C=O)O)=O)=O,2,5,13,18,29,0.00023799999999999998
G4,C(C(C(C=O)(C(C=O)C)O)O)=O,8,5,16,21,49,0.000251
G4,C(C(C)C(C(CO)=O)(CO)O)=O,4,4,13,17,49,0.00021400000000000002
G4,C(C(C(C)=O)C(CO)O)(O)=O,4,4,13,17,0,0.00020299999999999997
G4,C(CC(C(C(C)=O)C(C)=O)=O)=O,1,1,8,9,29,4.7e-05
G4,C(C(C(CC(C)=O)=O)C(C)=O)=O,2,3,12,15,29,0.00014199999999999998
G4,C(C(C(CCC=O)=O)C(C)=O)=O,2,2,14,16,29,9.499999999999999e-05
G4,C(C(C(C)=O)C(C=CCO)=O)=O,4,1,9,10,29,4.7e-05
G4,C(C)(C(C(C=CC=O)=O)CO)=O,4,2,15,17,29,9.499999999999999e-05
G4,C(C(C(C(C)=O)C(C=C)=O)O)=O,4,1,14,15,0,4.7e-05
G4,C(C(C(C)=O)(C(C)=O)O)=O,1,3,8,11,1,0.00014199999999999998
G4,C(C(C(C)=O)(CC=O)O)=O,2,9,21,30,25,0.00042800000000000005
G4,C(C)(C(C(C)=O)(CO)O)=O,1,9,9,18,49,0.000453
G4,C(C(C(C(C)=O)(C(C)=O)O)O)=O,2,3,11,14,49,0.000144
G4,C(C(C)C(C=O)(C(CO)O)O)=O,8,6,15,21,49,0.00033
G4,C(C(C(CC=O)=O)C(CO)O)=O,4,11,17,28,9,0.000557
G4,C(C(C=O)C(CC(CO)O)=O)=O,2,11,12,23,29,0.000567
G4,C(C1(C(CC(C1)O)=O)O)=O,4,4,17,21,43,0.000212
G4,C(C1C(C(C(C1)O)O)=O)=O,8,8,26,34,41,0.000413
G4,C1(CC(C(C1(C)O)=O)O)=O,4,3,16,19,45,0.000153
G4,C1(C(C(C(C1C)=O)O)O)=O,3,2,15,17,42,9.499999999999999e-05
G4,C1(C(C)(CC(C1O)=O)O)=O,4,4,20,24,25,0.00020099999999999998
G4,C(CCO)(C(C=O)(CC=O)O)=O,2,4,14,18,29,0.00020299999999999997
G4,C(C(CO)O)(C(C=O)CC=O)=O,4,9,18,27,41,0.000465
G4,C(C(C(C(C)=O)=O)CC=O)=O,2,5,14,19,29,0.00023700000000000001
G4,C(C(C(C(O)=O)=O)C)=O,2,2,23,25,27,0.000106
G4,C(C(C(C=O)CC=O)O)(O)=O,4,8,16,24,33,0.000414
G4,C(CC(C(C(O)=O)=O)CO)=O,2,3,13,16,29,0.000154
G4,C(C(C(C(C=O)=O)C)O)(O)=O,4,3,13,16,28,0.000154
G4,C(C(C(C(C(O)=O)=O)C)O)=O,4,3,11,14,28,0.000154
G4,C(C(C(C=O)=O)CC(CO)=O)=O,2,4,19,23,51,0.00018999999999999998
G4,C(C(C(C=O)=O)CC=O)=O,2,5,25,30,33,0.00023700000000000001
G4,C(CO)(C(C)C(C(O)=O)O)=O,4,3,11,14,28,0.000165
G4,C(C(C(C)C(CO)O)=O)(O)=O,4,4,10,14,0,0.000213
G4,C(C(C(C)=O)CC(CO)=O)=O,2,5,19,24,41,0.00024900000000000004
G4,C(C(C=O)CC=O)=O,1,14,92,106,43,0.000664
G4,C(C(C(C=O)=O)CC(CO)O)=O,4,2,18,20,29,9.499999999999999e-05
G4,C(C(C=O)CC(C(CO)=O)O)=O,2,4,11,15,43,0.00020099999999999998
G4,C(C(CC(C=O)C(CO)=O)O)=O,4,5,16,21,32,0.00023799999999999998
G4,C(C(C(C(C=O)O)=O)CCO)=O,4,4,14,18,29,0.00020099999999999998
G4,C(C(C=O)CC(C(C=O)O)O)=O,4,6,17,23,43,0.000309
G4,C(C(C(C(C(C=O)O)O)=O)C)=O,8,5,19,24,49,0.00025
G4,C(C(C(C)=O)CC(C=O)=O)=O,2,4,15,19,29,0.00018999999999999998
G4,C(C(C(CC=O)=O)CC=O)=O,2,5,18,23,2,0.00023700000000000001
G4,C(C(C=O)CC(C(C)=O)=O)=O,1,3,10,13,14,0.00014199999999999998
G4,C(C(C=O)CC(CC=O)=O)=O,1,4,15,19,2,0.00018999999999999998
G4,C(C1C(CC(C(CO)O)O1)=O)=O,8,1,8,9,29,4.7e-05
G4,C(C1C(CC(C(CO)O1)O)=O)=O,8,1,7,8,29,4.7e-05
G4,C(C1C(CC(C(CO1)O)O)=O)=O,8,1,10,11,29,4.7e-05
G4,C(C(C=O)C=CC(CO)=O)=O,2,3,12,15,43,0.00014199999999999998
G4,C(C(C(C(O)=O)=O)CCO)=O,2,2,12,14,29,0.000106
G4,C(C(CCO)C(C(O)=O)O)=O,4,6,13,19,29,0.00033
G4,C(C(C(CO)CCO)=O)(O)=O,2,4,10,14,29,0.00022400000000000002
G4,C(C(C(CC=O)=O)(CC=O)O)=O,2,1,16,17,29,4.7e-05
G4,C(C(C(C(C=O)O)=O)CC=O)=O,4,2,16,18,1,9.499999999999999e-05
G4,C(CC(C=O)(C(C=O)C)O)=O,4,3,15,18,49,0.000144
G4,C(C(C)C(C(O)=O)O)=O,4,4,28,32,49,0.000223
G4,C(C(C(C)CO)=O)(O)=O,2,4,19,23,28,0.00021400000000000002
G4,C(C(C(C)=O)CC=O)=O,2,8,57,65,45,0.00037999999999999997
G4,C(C(O)=O)(CC)=O,1,5,105,110,28,0.00024900000000000004
G4,C(C)(C(C(C)=O)CC(C=O)=O)=O,1,2,9,11,29,9.499999999999999e-05
G4,C(CC=O)(C(C(C)=O)CC=O)=O,2,3,15,18,29,0.00014199999999999998
G4,C(C(C(C)=O)CC(C(C)=O)=O)=O,2,4,12,16,29,0.00018999999999999998
G4,C(C(C(C)=O)CC(CC=O)=O)=O,2,4,17,21,29,0.00018999999999999998
G4,C(C(C(C)=O)C=CC(CO)=O)=O,4,2,13,15,32,9.499999999999999e-05
G4,C(C(C=O)CC(C(CO)O)=O)=O,2,10,13,23,2,0.0005009999999999999
G4,C(C1C(CC(CO)O1)=O)=O,4,4,19,23,26,0.00020099999999999998
G4,C1(CC(C=O)OC1CO)=O,4,4,23,27,2,0.00020099999999999998
G4,C(C1C(CC(CO1)O)=O)=O,4,4,20,24,37,0.00020099999999999998
G4,C1(CC(C=O)OCC1O)=O,4,4,24,28,37,0.00020099999999999998
G4,C1(C(C(C=O)OCC1)O)=O,4,3,28,31,37,0.000153
G4,C(C1C(CC(CO1)=O)O)=O,4,4,27,31,37,0.00020099999999999998
G4,C1(C(C(CO)OCC1)=O)=O,2,2,19,21,2,9.499999999999999e-05
G4,C(C)(C1CC(C(O1)=O)=O)=O,2,3,24,27,27,0.00014199999999999998
G4,C(CC1CC(C(O1)=O)=O)=O,2,3,25,28,27,0.00014199999999999998
G4,C1(C(C(C)=O)OC(C1)=O)=O,2,3,27,30,27,0.00014199999999999998
G4,C1(CC(C(CC=O)O1)=O)=O,2,4,31,35,27,0.00018999999999999998
G4,C1(CCOC(C(C1)=O)=O)=O,1,4,24,28,27,0.00018999999999999998
G4,C1(COC(C(CC1)=O)=O)=O,1,4,23,27,27,0.00018999999999999998
G4,C1(CC(C(CCO1)=O)=O)=O,1,3,24,27,27,0.00014199999999999998
G4,C1(CC(OCC(C1)=O)=O)=O,1,5,32,37,27,0.00023700000000000001
G4,C1(C(CO)=CC(C1)=O)=O,1,4,75,79,45,0.00018999999999999998
G4,C1CC(C(C=1CO)=O)=O,1,2,50,52,45,9.499999999999999e-05
G4,C=C1C(CC(C1=O)O)=O,2,4,76,80,45,0.00018999999999999998
G4,C1(CC(C(C1O)=O)=C)=O,2,3,75,78,47,0.00014199999999999998
G4,C1(CC(C(C1O)=C)=O)=O,2,5,76,81,45,0.00023700000000000001
G4,C=C1C(C(CC1O)=O)=O,2,3,64,67,45,0.00014199999999999998
G4,C(C1C(CC(C=1)=O)O)=O,2,3,78,81,45,0.00014199999999999998
G4,C1(CC=C(C=O)C1O)=O,2,5,65,70,27,0.00023700000000000001
G4,C1(CC(C=O)=CC1O)=O,2,4,64,68,45,0.00018999999999999998
G4,C1C(CC(C=1C=O)=O)O,2,3,65,68,45,0.00014199999999999998
G4,C(C=CC(CCO)=O)(O)=O,2,5,22,27,46,0.00026000000000000003
G4,C(CO)(CC=CC(O)=O)=O,2,5,19,24,12,0.00026000000000000003
G4,C(C)(C(C=CC(O)=O)O)=O,4,4,16,20,45,0.00020099999999999998
G4,C(CC(C=CC(O)=O)O)=O,4,5,19,24,18,0.00025
G4,C=CC(CC(C=O)=O)O,2,4,42,46,27,0.00018999999999999998
G4,C(CC(C(C=C)O)=O)=O,2,9,49,58,27,0.00042699999999999997
G4,C(C(C(CC=C)=O)O)=O,2,3,48,51,4,0.00014199999999999998
G4,C(C(CC(C=C)=O)O)=O,2,5,60,65,27,0.00023700000000000001
G4,C(C1C(C(C=C1)O)=O)=O,4,5,54,59,45,0.00023700000000000001
G4,C(C1(C(CC=C1)=O)O)=O,2,3,36,39,45,0.00014199999999999998
G4,C(C)(C1C=CC(O1)=O)=O,2,3,53,56,48,0.00014199999999999998
G4,C(CC1C=CC(O1)=O)=O,2,3,55,58,48,0.00014199999999999998
G4,C(C)(C1C(C=CO1)=O)=O,2,2,60,62,9,9.499999999999999e-05
G4,C(CC1C(C=CO1)=O)=O,2,2,62,64,45,9.499999999999999e-05
G4,C1(C=CC(OCC1)=O)=O,1,3,65,68,19,0.00014199999999999998
G4,C1(COC(C=CC1)=O)=O,1,3,65,68,48,0.00014199999999999998
G4,C1OCCC(C(C=1)=O)=O,1,2,49,51,45,9.499999999999999e-05
G4,C1(COC=CC(C1)=O)=O,1,3,73,76,38,0.00014199999999999998
G4,C1(CC(C=CCO1)=O)=O,1,3,53,56,19,0.00014199999999999998
G4,C1COCC(C(C=1)=O)=O,1,3,61,64,36,0.00014199999999999998
G4,C1(CC=CC(CO1)=O)=O,1,3,52,55,48,0.00014199999999999998
G4,C1(C=CC(COC1)=O)=O,1,2,48,50,45,9.499999999999999e-05
G4,C1(C(OCC1)=CC=O)=O,2,2,50,52,45,9.499999999999999e-05
G4,C1(COC(C1)=CC=O)=O,2,2,74,76,45,9.499999999999999e-05
G4,C1C(C(C=O)=O)OCC=1,2,3,40,43,39,0.00014199999999999998
G4,C(C1C=CC(C=O)O1)=O,3,2,26,28,40,9.499999999999999e-05
G4,C(C1C(CC(O1)=C)=O)=O,2,2,74,76,26,9.499999999999999e-05
G4,C(C1CC(C(O1)=C)=O)=O,2,2,62,64,14,9.499999999999999e-05
G4,C(C1OCCC(C=1)=O)=O,1,2,50,52,30,9.499999999999999e-05
G4,C1(COC(C=O)=CC1)=O,1,2,62,64,12,9.499999999999999e-05
G4,C(C1C(CC=CO1)=O)=O,2,2,62,64,37,9.499999999999999e-05
G4,C(C1CC(C=CO1)=O)=O,2,2,62,64,37,9.499999999999999e-05
G4,C1(C2(CC(C(C1)O2)O)O)=O,8,2,11,13,14,9.499999999999999e-05
G4,C1(C2CC(C(C1O)O2)O)=O,16,2,13,15,9,9.499999999999999e-05
G4,C1(C2C(C(C(O2)O)C1)O)=O,16,4,17,21,2,0.00018999999999999998
G4,C1(C(O)OC(C(C)=O)C1O)=O,8,2,13,15,1,9.499999999999999e-05
G4,C(CC1C(C(C(O)O1)=O)O)=O,8,2,14,16,5,9.499999999999999e-05
G4,C(C1C(C(C(CO)O1)O)=O)=O,8,1,10,11,2,4.7e-05
G4,C(C1(C(CC(CO)O1)=O)O)=O,4,2,8,10,0,9.499999999999999e-05
G4,C1(CC(C=O)(OC1CO)O)=O,4,2,13,15,2,9.499999999999999e-05
G4,C1(COC(C(CO)=O)C1)=O,2,4,28,32,32,0.00018999999999999998
G4,C(C)(C1(CC(CO1)=O)O)=O,2,3,23,26,24,0.00014199999999999998
G4,C1(CCC(C(CO)=O)O1)=O,2,3,12,15,32,0.00014199999999999998
G4,C1(C(COC1CCO)=O)=O,2,2,14,16,4,9.499999999999999e-05
G4,C1(CC(C(CCO)O1)=O)=O,2,5,13,18,2,0.00024900000000000004
G4,C(C(C1C(CCO1)O)=O)=O,4,2,16,18,39,0.000106
G4,C(C(C1C(CCO1)=O)O)=O,4,3,28,31,4,0.000153
G4,C(C(C1CC(CO1)=O)O)=O,4,4,27,31,4,0.00020099999999999998
G4,C1(CCC(C(C=O)O)O1)=O,4,3,11,14,32,0.00014199999999999998
G4,C1(C(CC(C(CO)=O)O1)O)=O,4,4,7,11,2,0.00018999999999999998
G4,C1(C(CC(C(C)=O)(O)O1)O)=O,4,2,7,9,14,9.499999999999999e-05
G4,C(CC1(CC(C(O1)=O)O)O)=O,4,2,13,15,2,9.499999999999999e-05
G4,C1(C(CC(CCO)(O)O1)=O)=O,2,2,9,11,2,9.499999999999999e-05
G4,C1(CC(C(CCO)(O)O1)=O)=O,2,2,7,9,2,9.499999999999999e-05
G4,C1(C(C(C(CCO)O1)=O)O)=O,4,3,6,9,2,0.00014199999999999998
G4,C(CC1(C(O)OCC1O)O)=O,8,3,12,15,0,0.000144
G4,C1(C2C(CO)OC1CO2)=O,8,2,14,16,17,9.499999999999999e-05
G4,C1(C2CC(C(CO)O2)O1)=O,8,2,3,5,41,9.499999999999999e-05
G4,C1(CC2C(CC(O)O2)O1)=O,8,2,5,7,48,9.499999999999999e-05
G4,C1(COC2CC(OC12)O)=O,8,2,15,17,9,9.499999999999999e-05
G4,C1(C2CC(OC1CO2)O)=O,8,2,12,14,9,9.499999999999999e-05
G4,C1(CC2(CC(CO2)O1)O)=O,4,2,4,6,19,9.499999999999999e-05
G4,C1(COC2COC1(C2)O)=O,4,2,8,10,54,9.499999999999999e-05
G4,C1(C(O)OC2COC1C2)=O,8,2,9,11,39,9.499999999999999e-05
G4,C1(C2COCC(C1O)O2)=O,8,2,14,16,4,9.499999999999999e-05
G4,C1(C2(COCC(C1)O2)O)=O,4,2,9,11,36,9.499999999999999e-05
G4,C1(C2COCC(C1)(O2)O)=O,4,2,16,18,36,9.499999999999999e-05
G4,C1(C2CC(C(CO1)O2)O)=O,8,1,5,6,41,4.7e-05
G4,C1(COC2C(CC1O2)O)=O,8,2,12,14,4,9.499999999999999e-05
G4,C1(C2OCCC(C1)(O2)O)=O,4,2,13,15,30,9.499999999999999e-05
G4,C1(C2(CCOC(C1)O2)O)=O,4,2,9,11,17,9.499999999999999e-05
G4,C1(C2CCOC(C1O)O2)=O,8,1,11,12,4,4.7e-05
G4,C1(C2CC(C(CO2)O)O1)=O,8,2,3,5,30,9.499999999999999e-05
G4,C1(C(C(O)OC(CO)C1)=O)=O,4,2,10,12,0,9.499999999999999e-05
G4,C1(C(CO)OC(C(C1)=O)O)=O,4,3,12,15,2,0.00014199999999999998
G4,C(C1C(C(C(CO1)O)O)=O)=O,8,1,13,14,2,4.7e-05
G4,C(C1(C(CC(CO1)O)=O)O)=O,4,2,9,11,15,9.499999999999999e-05
G4,C1(CC(C=O)(O)OCC1O)=O,4,2,14,16,2,9.499999999999999e-05
G4,C1(C(C(C=O)(O)OCC1)O)=O,4,2,16,18,2,9.499999999999999e-05
G4,C(C1(C(CC(CO1)=O)O)O)=O,4,2,13,15,15,9.499999999999999e-05
G4,C(C1CC(C(CO1)=O)O)=O,4,3,19,22,4,0.00014199999999999998
G4,C1(CCC(C(C=O)O1)O)=O,4,1,14,15,37,4.7e-05
G4,C1(CC(CC(C=O)O1)O)=O,4,3,13,16,48,0.00014199999999999998
G4,C(C1CCC(C(O1)O)=O)=O,4,2,17,19,12,9.499999999999999e-05
G4,C1(C(COC(C)(C1)O)=O)=O,2,2,20,22,26,9.499999999999999e-05
G4,C1(C(C)(OCC(C1)=O)O)=O,2,3,18,21,24,0.00014199999999999998
G4,C1(C(C)OCC(C1O)=O)=O,4,2,19,21,24,9.499999999999999e-05
G4,C1(CC(C(C(C)O1)=O)O)=O,4,1,12,13,24,4.7e-05
G4,C1(C(C)OC(C(C1)=O)O)=O,4,2,18,20,24,9.499999999999999e-05
G4,C1(C(C(C)OC(C1)O)=O)=O,4,3,16,19,4,0.00014199999999999998
G4,C1(COC(C)(C(C1)O)O)=O,4,6,19,25,45,0.000285
G4,C1(C(C(C)(O)OCC1)O)=O,4,2,20,22,9,9.499999999999999e-05
G4,C1(C(COC(C)(C1)O)O)=O,4,2,19,21,26,9.499999999999999e-05
G4,C1(C(C)(O)OCC(C1)O)=O,4,2,12,14,14,9.499999999999999e-05
G4,C1(C(C)OCC(C1O)O)=O,8,1,15,16,4,4.7e-05
G4,C1(C(CCC(CO)(O)O1)=O)=O,2,2,7,9,17,9.499999999999999e-05
G4,C1(CC(CC(CO)(O)O1)=O)=O,2,3,11,14,17,0.00014199999999999998
G4,C1(C(C(CC(C=O)O1)O)O)=O,8,6,13,19,27,0.000296
G4,C1(C(CC(C(C)(O)O1)O)=O)=O,4,2,8,10,14,9.499999999999999e-05
G4,C1(CC(C(C(C)(O)O1)O)=O)=O,4,2,11,13,17,9.499999999999999e-05
G4,C1(C(C(CC(C)(O)O1)=O)O)=O,4,2,10,12,14,9.499999999999999e-05
G4,C1(CC(C(OC1(C)O)=O)O)=O,4,2,8,10,14,9.499999999999999e-05
G4,C1(C(C(C(OC1C)=O)O)O)=O,8,2,11,13,2,9.499999999999999e-05
G4,C1(C2C(COC1CO2)O)=O,8,2,15,17,17,9.499999999999999e-05
G4,C1(C2COC(CO2)C1O)=O,8,2,14,16,4,9.499999999999999e-05
G4,C1(C2(COC(CO2)C1)O)=O,4,2,9,11,54,9.499999999999999e-05
G4,C1(C2COC(CO2)(C1)O)=O,4,3,16,19,54,0.00014199999999999998
G4,C1(C2CC(C(CO2)O1)O)=O,8,1,5,6,30,4.7e-05
G4,C1(C(C(O)OCC(C1)O)=O)=O,4,2,11,13,2,9.499999999999999e-05
G4,C1(C(COC(C(C1)=O)O)O)=O,4,3,12,15,2,0.00014199999999999998
G4,C1(CCOC(C(C1O)=O)O)=O,4,2,11,13,2,9.499999999999999e-05
G4,C1(C(O)OCC(CC1O)=O)=O,4,2,12,14,2,9.499999999999999e-05
G4,C1(C(COC(CC1)O)=O)=O,2,2,17,19,17,9.499999999999999e-05
G4,C1(COC(CC(C1)O)O)=O,4,2,19,21,17,9.499999999999999e-05
G4,C1(C(CC(O)OCC1)O)=O,4,3,16,19,4,0.00014199999999999998
G4,C1(C(COC(CC1)O)O)=O,4,2,16,18,7,9.499999999999999e-05
G4,C1(CC(COC(C1)O)O)=O,4,3,20,23,44,0.00014199999999999998
G4,C1(CC(C(CCO1)O)O)=O,4,1,8,9,29,4.7e-05
G4,C1(COCCC(C1O)O)=O,4,1,19,20,4,4.7e-05
G4,C1(C(O)OCCC(C1)O)=O,4,2,16,18,4,9.499999999999999e-05
G4,C1(C(CCOC(C1)O)O)=O,4,3,16,19,4,0.00014199999999999998
G4,C1(C(C(O)OCCC1)O)=O,4,2,18,20,29,9.499999999999999e-05
G4,C1(CC(C(O)OCC1)O)=O,4,3,21,24,29,0.00014199999999999998
G4,C1(C(CC(CC(O)O1)O)=O)=O,4,2,8,10,45,9.499999999999999e-05
G4,C1(CC(C(CC(O)O1)O)=O)=O,4,3,9,12,45,0.00014199999999999998
G4,C1(C(C(CCC(O)O1)=O)O)=O,4,2,9,11,17,9.499999999999999e-05
G4,C1(CC(C(OC(C1)O)=O)O)=O,4,3,12,15,2,0.00014199999999999998
G4,C1(CC(C(CC(O1)=O)O)O)=O,3,1,4,5,29,4.7e-05
G4,C1(CC(C(C(CO1)=O)O)O)=O,4,5,12,17,2,0.000248
G4,C1(CC(CC(C(O)O1)=O)O)=O,4,2,10,12,28,9.499999999999999e-05
G4,C1(CC(C(CC(O)O1)=O)O)=O,4,3,10,13,29,0.00014199999999999998
G4,C1(CCC(OC(C1O)O)=O)=O,4,2,10,12,29,9.499999999999999e-05
G4,C1(CC(CC(C(O)O1)O)=O)=O,4,3,12,15,17,0.00014199999999999998
G4,C1(C2OC(CC(C1)O2)O)=O,8,2,13,15,23,9.499999999999999e-05
G4,C1(C2CC(O)OC(C1)O2)=O,8,2,14,16,17,9.499999999999999e-05
G4,C1(CC2C(CC(O2)O1)O)=O,8,1,4,5,43,4.7e-05
G4,C1(COC2CC(C1O2)O)=O,8,2,16,18,17,9.499999999999999e-05
G4,C(C1C(CCC(O1)=O)=O)=O,2,3,20,23,27,0.00014199999999999998
G4,C1(CC(CC(C=O)O1)=O)=O,2,5,31,36,27,0.00023700000000000001
G4,C(CC(C(C)=O)CC(C=O)=O)=O,2,5,16,21,46,0.000239
G4,C(CC(CC=O)CC(C=O)=O)=O,1,5,12,17,4,0.00023999999999999998
G4,C(CC(C=O)CC(C(C)=O)=O)=O,2,6,14,20,14,0.000286
G4,C(CCCC(CC(C=O)=O)=O)=O,1,4,17,21,27,0.00019099999999999998
G4,C(CC(C(CCCC=O)=O)=O)=O,1,4,16,20,27,0.00019099999999999998
G4,C1(CO)C(C(C(C=1)=O)O)O,4,6,18,24,46,0.000296
G4,C(C1CC(C(C=1)=O)O)=O,2,3,64,67,45,0.00014199999999999998
G4,C1C(C(C(C=1)=O)=O)CO,2,3,52,55,45,0.00014199999999999998
G4,C1CC(C(C=1C=O)=O)O,2,3,52,55,27,0.00014199999999999998
G4,C1C(C(C(C(C=1CO)=O)O)O)O,8,4,11,15,29,0.00018999999999999998
G4,C=C1C(C(C(C(C1O)O)O)O)=O,16,3,14,17,9,0.00014199999999999998
G4,C(CO)(C(C(C=O)=C)O)=O,2,10,26,36,2,0.000475
G4,C(CO)(CO)=CC(C=O)=O,1,2,12,14,55,9.499999999999999e-05
G4,C(CO)(C(C=CC(CO)=O)O)=O,4,5,9,14,5,0.00023700000000000001
G4,C(CO)(C(C(CO)=CC=O)O)=O,4,3,9,12,5,0.00014199999999999998
G4,C(CO)(CO)=C(C=O)C(CO)=O,1,2,6,8,29,9.499999999999999e-05
G4,C(C(C(C(C(CO)=O)O)=C)O)=O,4,5,12,17,5,0.00023700000000000001
G4,C(C(C(C=C(CO)CO)=O)O)=O,2,2,6,8,5,9.499999999999999e-05
G4,C(CO)(C(C(C(CO)O)=C)O)=O,4,4,8,12,29,0.00020099999999999998
G4,C(CO)(CO)=CC(C(CO)O)=O,2,6,8,14,49,0.00031099999999999997
G4,C(CO)(C(C(C=O)=CCO)O)=O,4,2,11,13,5,9.499999999999999e-05
G4,C(CO)(CO)=C(C(C=O)=O)CO,1,1,8,9,29,4.7e-05
G4,C=C(C(C=O)=O)C(CO)(CO)O,1,2,11,13,29,9.499999999999999e-05
G4,C(CO)(C(C(CO)=CCO)O)=O,4,5,5,10,5,0.00026000000000000003
G4,C(CO)(CO)=C(C(CO)=O)CO,1,3,4,7,29,0.000165
G4,C=C(C(CO)=O)C(CO)(CO)O,1,3,6,9,29,0.000154
G4,C(CO)(C(C(CO)=C)O)=O,2,6,15,21,49,0.000296
G4,C(CO)(CO)=CC(CO)=O,1,6,14,20,49,0.000307
G4,C(C(C(C=O)=C(CO)CO)O)=O,2,3,8,11,29,0.00014199999999999998
G4,C(C=C(C=O)C(CO)(CO)O)=O,2,2,9,11,29,9.499999999999999e-05
G4,C(CO)(C(C=C)O)=O,2,13,73,86,31,0.000617
G4,C(CO)(CO)=CC=O,1,5,46,51,18,0.00024900000000000004
G4,C(C(CO)O)=C(C=O)C(CO)=O,4,4,8,12,29,0.000212
G4,C(C(C(C=CC(CO)O)=O)O)=O,8,5,8,13,29,0.000271
G4,C(C(CO)O)=C(C(C=O)=O)CO,4,5,10,15,29,0.000271
G4,C=C(C(C=O)=O)C(C(CO)O)O,4,10,17,27,41,0.00053
G4,C(C(CO)O)=C(C(CO)=O)CO,4,6,6,12,29,0.00033
G4,C=C(C(CO)=O)C(C(CO)O)O,4,5,11,16,29,0.000271
G4,C(C(C(C=O)=CC(CO)O)O)=O,8,5,10,15,29,0.00026000000000000003
G4,C(C=C(C=O)C(C(CO)O)O)=O,8,4,14,18,29,0.000212
G4,C(C(CO)O)=CC=O,4,9,51,60,46,0.00046100000000000004
G4,C(C(C)=CC(C=O)=O)=O,2,3,59,62,45,0.00014199999999999998
G4,C=C(C=O)CC(C=O)=O,1,4,60,64,45,0.00018999999999999998
G4,C(CO)(CC=CC(C=O)=O)=O,2,4,17,21,20,0.00018999999999999998
G4,C(CC(C=O)=O)=CC(CO)=O,2,4,16,20,20,0.00018999999999999998
G4,C(CC(CO)=CC(C=O)=O)=O,2,3,13,16,29,0.00014199999999999998
G4,C(CO)(CC(C=O)=O)=CC=O,2,2,13,15,29,9.499999999999999e-05
G4,C(C(C(CO)=O)=CC(C)=O)=O,2,3,16,19,55,0.00014199999999999998
G4,C(C(C(CO)=O)C(C=O)=C)=O,2,5,18,23,55,0.00023700000000000001
G4,C(C(C(CO)=O)=C(C=O)C)=O,2,2,14,16,49,9.499999999999999e-05
G4,C(CC(C(C(C=O)=C)O)=O)=O,2,5,18,23,23,0.00023700000000000001
G4,C(C)(C(C=CC(C=O)=O)O)=O,4,3,14,17,49,0.00014199999999999998
G4,C(C(C(C)=CC(C=O)=O)O)=O,4,1,12,13,26,4.7e-05
G4,C(C(C(CC(C=O)=O)=C)O)=O,2,4,15,19,29,0.00018999999999999998
G4,C(C(C(C=CC(C)=O)=O)O)=O,4,2,16,18,29,9.499999999999999e-05
G4,C(C(C(CC(C=O)=C)=O)O)=O,2,3,17,20,16,0.00014199999999999998
G4,C(C(C(C=C(C=O)C)=O)O)=O,4,1,14,15,16,4.7e-05
G4,C(C(C=CC=O)=O)=O,2,30,156,186,20,0.001424
G4,C(C)(C(CO)O)=CC(C=O)=O,4,2,9,11,29,0.000106
G4,C=C(C(CO)O)CC(C=O)=O,2,3,14,17,29,0.000154
G4,C(C=CC(C)=O)(C(CO)O)=O,4,5,17,22,45,0.00025299999999999997
G4,C(C(CO)O)(CC(C=O)=C)=O,2,7,20,27,16,0.00034700000000000003
G4,C(C=C(C=O)C)(C(CO)O)=O,4,5,16,21,16,0.00025299999999999997
G4,C(C(C=C(C=O)CCO)=O)=O,2,1,12,13,29,4.7e-05
G4,C(CO)=C(C=O)CC(C=O)=O,2,2,11,13,29,9.499999999999999e-05
G4,C(C(C(CO)=CC(C)=O)=O)=O,2,3,14,17,29,0.00014199999999999998
G4,C(C)(C(C(C(C=O)=O)=C)O)=O,2,3,16,19,45,0.00014199999999999998
G4,C=C(C=O)C(C(C=O)=O)CO,2,3,15,18,29,0.000144
G4,C(C(C(CO)=C(C=O)C)=O)=O,2,1,12,13,29,4.7e-05
G4,C(C(C(C(C=O)=O)=C)(C)O)=O,2,2,12,14,29,9.499999999999999e-05
G4,C(CO)(CCO)=CC(C=O)=O,2,3,8,11,29,0.000165
G4,C(CO)=C(CO)CC(C=O)=O,2,4,10,14,29,0.000212
G4,C(CCO)(C(C(C=O)=C)O)=O,2,5,18,23,2,0.000251
G4,C(C(CO)=CC(C)=O)(CO)=O,2,4,13,17,45,0.000212
G4,C(C)(C(C(C(CO)=O)=C)O)=O,2,5,16,21,45,0.00024900000000000004
G4,C(CO)(C(C(C=O)=C)CO)=O,2,5,17,22,55,0.000262
G4,C(C(C)=C(C(CO)=O)CO)=O,2,4,12,16,3,0.000212
G4,C(C(C(C(CO)=O)=C)(C)O)=O,2,3,13,16,3,0.000154
G4,C(C(C=CC(C=O)=O)O)=O,4,8,22,30,12,0.00037999999999999997
G4,C(C)(CO)=CC(C=O)=O,2,3,30,33,49,0.000154
G4,C=C(CO)CC(C=O)=O,1,3,32,35,49,0.000154
G4,C(CO)(CC(C=O)=C)=O,1,8,61,69,16,0.000391
G4,C(C(C)=CC(CO)=O)=O,2,7,59,66,16,0.000343
G4,C(C)(C(C(C=O)=C)O)=O,2,6,51,57,45,0.000285
G4,C(CC(C=CC(C=O)=O)O)=O,4,3,18,21,20,0.000144
G4,C(C(CC=CC(C=O)=O)O)=O,4,2,14,16,20,9.499999999999999e-05
G4,C(C(C=CCC(C=O)=O)O)=O,4,3,15,18,20,0.00014199999999999998
G4,C(C(C(C=O)=CC(C)=O)O)=O,4,4,15,19,55,0.00018999999999999998
G4,C(C)(C(C(C=O)=CC=O)O)=O,4,3,16,19,55,0.00014199999999999998
G4,C(C(C(C=O)=C)C(C=O)O)=O,4,4,16,20,45,0.00018999999999999998
G4,C(C(C(C=O)=C(C=O)C)O)=O,4,3,13,16,49,0.00014199999999999998
G4,C(C(C(C=O)=CC=O)(C)O)=O,4,2,12,14,55,9.499999999999999e-05
G4,C(C(C(C=CC(C=O)=O)O)O)=O,8,4,17,21,20,0.000192
G4,C(C)=CC(C=O)=O,2,8,263,271,28,0.00037999999999999997
G4,C=CCC(C=O)=O,1,10,249,259,28,0.000475
G4,C(C=CC(C)=O)=O,2,14,426,440,28,0.000664
G4,C(CC(C=O)=C)=O,1,14,338,352,28,0.000664
G4,C(C(C)=CC=O)=O,2,7,351,358,28,0.000332
G4,C(CO)(C(CO)O)=CC(C=O)=O,4,4,8,12,29,0.000212
G4,C(C(CO)O)(C(C(C=O)=C)O)=O,4,7,17,24,2,0.00034700000000000003
G4,C(C(C(CO)=O)=CC=O)=O,2,6,30,36,55,0.000285
G4,C=C(C=O)C(CO)=O,1,10,112,122,9,0.000475
G4,C(C(C=C(C=O)C(CO)=O)O)=O,4,2,11,13,29,9.499999999999999e-05
G4,C(C)(CO)=C(C=O)C(CO)=O,2,3,9,12,49,0.000154
G4,C(C(C(CO)=O)C(CO)=C)=O,2,5,13,18,49,0.00024900000000000004
G4,C(CC(C(C(CO)=C)O)=O)=O,2,4,13,17,29,0.00020099999999999998
G4,C(CO)(CC=CC(CO)=O)=O,2,7,15,22,49,0.00035499999999999996
G4,C(CO)(CC(CO)=CC=O)=O,2,4,13,17,55,0.00020099999999999998
G4,C(CC(CO)=CC(CO)=O)=O,2,5,13,18,49,0.00024900000000000004
G4,C(C)(C(C=CC(CO)=O)O)=O,4,5,13,18,49,0.00024900000000000004
G4,C(C)(C(C(CO)=CC=O)O)=O,4,3,11,14,49,0.000154
G4,C(C)=C(C=O)C(CO)=O,2,2,48,50,45,9.499999999999999e-05
G4,C(C(C(CO)=O)C=C)=O,2,4,49,53,45,0.00018999999999999998
G4,C(CC(CO)=CC=O)=O,2,2,41,43,46,9.499999999999999e-05
G4,C(C(C(C=CC=O)=O)O)=O,4,12,30,42,46,0.0005690000000000001
G4,C(C(C(C=C)=O)O)=O,2,24,112,136,0,0.001139
G4,C(C(C(C=CC(C=O)O)=O)O)=O,8,2,12,14,29,9.499999999999999e-05
G4,C(C(C(C=C(CO)C)=O)O)=O,4,2,9,11,49,0.000106
G4,C(C(C=O)O)(CC(CO)=C)=O,2,3,12,15,49,0.000154
G4,C(C(C(CC(CO)=O)=C)O)=O,2,3,15,18,55,0.000154
G4,C(C(C(C)=CC(CO)=O)O)=O,4,2,12,14,0,0.000106
G4,C(C(C(C(C(C)=O)O)=C)O)=O,4,3,13,16,49,0.00014199999999999998
G4,C(C(C(C=CC)=O)O)=O,4,1,48,49,28,4.7e-05
G4,C(CC(C(C=O)O)=C)=O,2,2,41,43,6,9.499999999999999e-05
G4,C(C(C(C)=CC=O)O)=O,4,1,40,41,6,4.7e-05
G4,C(C(C(C(CO)=O)=CC=O)O)=O,4,2,14,16,0,9.499999999999999e-05
G4,C(C(C(CO)=CC=O)=O)=O,2,6,22,28,55,0.000285
G4,C(C(C(C(C=O)=O)=C)O)=O,2,3,23,26,0,0.00014199999999999998
G4,C(C(C(C=O)=CC=O)O)=O,4,6,26,32,43,0.000285
G4,C(CO)(C)=CC(C(CO)O)=O,4,5,11,16,49,0.000264
G4,C(C(CO)O)(CC(CO)=C)=O,2,6,12,18,49,0.00031099999999999997
G4,C(CO)(CC(C(CO)O)=C)=O,2,4,11,15,52,0.000212
G4,C(C)(C(CO)O)=CC(CO)=O,4,3,8,11,52,0.000165
G4,C(C)(C(C(C(CO)O)=C)O)=O,4,2,10,12,29,0.000106
G4,C(C)=CC(C(CO)O)=O,4,4,37,41,28,0.000205
G4,C(C(CO)O)(CC=C)=O,2,6,36,42,28,0.0003
G4,C(CC(C(CO)O)=C)=O,2,2,23,25,27,0.000106
G4,C(C)(C(CO)O)=CC=O,4,2,21,23,46,0.000106
G4,C(C=C(C(CO)=O)C(C)O)=O,4,2,13,15,11,9.499999999999999e-05
G4,C(C(C(C(CO)=O)=CC)O)=O,4,1,14,15,11,4.7e-05
G4,C(C(C(C(CO)=O)C=C)O)=O,4,2,16,18,11,9.6e-05
G4,C(C(CC(C(C=C)O)=O)O)=O,4,2,15,17,0,9.6e-05
G4,C(CC(CO)=CC(C=O)O)=O,4,3,13,16,21,0.00014199999999999998
G4,C(C(CC(CO)=CC=O)O)=O,4,2,12,14,21,9.499999999999999e-05
G4,C=C(C(C=O)=O)CO,1,12,74,86,49,0.0005690000000000001
G4,C=C(C(CO)=O)CO,1,12,81,93,49,0.000592
G4,C(C(C(C=O)=C)O)=O,2,17,94,111,16,0.000807
G4,C(C(CO)=CC=O)=O,2,7,99,106,18,0.000332
G4,C=CC=O,1,58,2289,2347,27,0.0027530000000000002
G4,C(C=C(C=O)CO)(C(CO)O)=O,4,8,13,21,2,0.00040599999999999995
G4,C=C(C(C(CO)=O)=O)C(CO)O,2,2,12,14,0,9.499999999999999e-05
G4,C(CO)=C(C(C(CO)=O)=O)CO,2,3,8,11,2,0.00014199999999999998
G4,C=C(C(C(CO)O)=O)C(CO)=O,2,4,12,16,2,0.00020099999999999998
G4,C(CO)(C(C(C(CO)=C)=O)O)=O,2,3,9,12,2,0.00014199999999999998
G4,C(CO)(C(C(C(CO)=O)=C)O)=O,2,5,13,18,5,0.00023700000000000001
G4,C(C(CO)=CC(CO)=O)(CO)=O,2,3,9,12,32,0.00014199999999999998
G4,C(CO)(C(C(C(C=O)=C)O)O)=O,4,5,16,21,5,0.000248
G4,C(CO)(C(C=C(C=O)CO)O)=O,4,4,9,13,43,0.00018999999999999998
G4,C=C(C(C(C(CO)O)O)=O)CO,4,7,13,20,49,0.000357
G4,C=C(C(C(CO)O)=O)C(CO)O,4,7,12,19,29,0.000359
G4,C(CO)=C(C(C(CO)O)=O)CO,4,8,9,17,2,0.00040599999999999995
G4,C=C(C=O)C(C(C(CO)O)O)O,8,5,16,21,29,0.000271
G4,C(C(C(CO)O)O)=C(C=O)CO,8,3,9,12,29,0.000154
G4,C=C(C(CCO)=O)C(C=O)=O,1,2,17,19,2,9.499999999999999e-05
G4,C=C(C(CC(C=O)=O)=O)CO,1,3,14,17,29,0.00014199999999999998
G4,C(CO)(CC(C(C=O)=O)=C)=O,1,2,19,21,12,9.499999999999999e-05
G4,C=C(C(CO)=O)CC(C=O)=O,1,4,18,22,12,0.00018999999999999998
G4,C(CC(C(C(C=O)=O)=C)O)=O,2,3,18,21,29,0.00014199999999999998
G4,C(CC=C(C(C=O)=O)CO)=O,2,3,14,17,29,0.00014199999999999998
G4,C=C(C=O)C(CC(C=O)=O)O,2,3,16,19,29,0.00014199999999999998
G4,C(CC(C=O)=O)=C(C=O)CO,2,3,12,15,29,0.00014199999999999998
G4,C=C(C=O)C(C(CCO)=O)=O,1,2,17,19,29,9.499999999999999e-05
G4,C(CC(C(C(CO)=C)=O)=O)=O,1,3,14,17,2,0.00014199999999999998
G4,C(CO)(CC(C(C=O)=C)=O)=O,1,4,17,21,2,0.00018999999999999998
G4,C(CC(C(C(CO)=O)=C)=O)=O,1,4,16,20,2,0.00018999999999999998
G4,C(C)(C(C(C(C=O)=C)=O)O)=O,2,2,14,16,9,9.499999999999999e-05
G4,C(CC(C(C(C=C)=O)O)=O)=O,2,4,15,19,9,0.00018999999999999998
G4,C(CC(C(C(C=O)=C)=O)O)=O,2,4,18,22,9,0.00018999999999999998
G4,C(CC(C=C(C=O)CO)=O)=O,2,4,15,19,2,0.00018999999999999998
G4,C(C(C(C(C(C)=O)=C)=O)O)=O,2,2,13,15,29,9.499999999999999e-05
G4,C(C(C(CC(C=C)=O)=O)O)=O,2,3,15,18,2,0.00014199999999999998
G4,C(CC(C(C(C=O)O)=O)=C)=O,2,2,17,19,29,9.499999999999999e-05
G4,C(C(C(C(C(C)=O)=O)=C)O)=O,2,2,14,16,14,9.499999999999999e-05
G4,C(C=C(C(C(C)=O)=O)CO)=O,2,3,13,16,14,0.00014199999999999998
G4,C(C(CC(C(C=C)=O)=O)O)=O,2,2,16,18,0,9.499999999999999e-05
G4,C(CC(C(C(C=O)O)=C)=O)=O,2,5,18,23,2,0.00023700000000000001
G4,C(CC(C(CO)=CC=O)=O)=O,2,3,16,19,2,0.00014199999999999998
G4,C(C(CC(C(C=O)=C)=O)O)=O,2,3,17,20,2,0.00014199999999999998
G4,C=C1C(C(OC1C(CO)O)O)=O,8,2,9,11,41,9.499999999999999e-05
G4,C=C1C(C(C(CO)O)OC1O)=O,8,2,11,13,0,9.499999999999999e-05
G4,C1OC(C(C=1CO)=O)C(CO)O,4,1,7,8,0,4.7e-05
G4,C=CC(C1C(C(C(O1)O)O)O)=O,16,2,13,15,0,9.499999999999999e-05
G4,C=C(C=O)C1C(C(C(O1)O)O)O,16,2,14,16,29,9.499999999999999e-05
G4,C=C1C(C(O)OC(CO)C1O)=O,8,2,7,9,41,9.499999999999999e-05
G4,C1C(CO)OC(C(C=1CO)=O)O,4,2,4,6,2,9.499999999999999e-05
G4,C=C1C(C(C(CO)OC1O)O)=O,8,2,8,10,9,9.499999999999999e-05
G4,C1OC(CO)C(C(C=1CO)=O)O,4,1,4,5,9,4.7e-05
G4,C=C1C(C(C(OC1CO)O)O)=O,8,2,10,12,54,9.499999999999999e-05
G4,C=C1C(C(CO)OC(C1O)O)=O,8,2,9,11,47,9.499999999999999e-05
G4,C1C(OC(C(C=1CO)=O)CO)O,4,2,6,8,2,9.499999999999999e-05
G4,C=C1C(C(O)OCC(C1O)O)=O,8,2,9,11,41,9.499999999999999e-05
G4,C1C(COC(C(C=1CO)=O)O)O,4,2,4,6,41,9.499999999999999e-05
G4,C=C1C(C(C(COC1O)O)O)=O,8,2,11,13,38,9.499999999999999e-05
G4,C1OCC(C(C(C=1CO)=O)O)O,4,1,7,8,38,4.7e-05
G4,C=C1C(C(C(O)OCC1O)O)=O,8,2,10,12,19,9.499999999999999e-05
G4,C1COC(C(C(C=1CO)=O)O)O,4,2,8,10,19,9.499999999999999e-05
G4,C=C1C(C(COC(C1O)O)O)=O,8,2,9,11,47,9.499999999999999e-05
G4,C1C(O)OCC(C(C=1CO)=O)O,4,2,4,6,29,9.499999999999999e-05
G4,C=C1C(C(C(C(OC1)O)O)O)=O,8,3,13,16,30,0.00014199999999999998
G4,C=C1C(COC(C(C1O)O)O)=O,8,2,10,12,9,9.499999999999999e-05
G4,C1C(C(OCC(C=1CO)=O)O)O,4,2,5,7,29,9.499999999999999e-05
G4,C=C(C=O)C1(C(C(CO1)O)O)O,8,2,13,15,29,9.499999999999999e-05
G4,C1(C(C(CO1)O)O)=C(C=O)CO,8,1,6,7,29,4.7e-05
G4,C(C(C(C(C(C=O)=O)=C)O)O)=O,4,2,19,21,29,9.499999999999999e-05
G4,C(C(C=C(C(C=O)=O)CO)O)=O,4,1,12,13,29,4.7e-05
G4,C=C(C(C=O)=O)C(CO)(C)O,2,3,13,16,49,0.000154
G4,C(C)(CO)=C(C(C=O)=O)CO,2,2,9,11,29,0.000106
G4,C=C(CO)C(C(C=O)=O)CO,2,3,13,16,29,0.000156
G4,C(C=CC(CO)=O)(CCO)=O,2,4,17,21,2,0.00020299999999999997
G4,C(CO)(CC(C=O)=CCO)=O,2,3,14,17,3,0.000154
G4,C(C(CCO)=CC(CO)=O)=O,2,3,13,16,3,0.000154
G4,C(C)(C(C(C=O)=CCO)O)=O,4,3,12,15,3,0.000154
G4,C=C(C(C=O)=O)C(C)O,2,3,33,36,4,0.00014199999999999998
G4,C(C)=C(C(C=O)=O)CO,2,1,32,33,27,4.7e-05
G4,C=CC(C(C=O)=O)CO,2,4,33,37,28,0.000192
G4,C(CC(C=O)=CCO)=O,2,3,40,43,3,0.00014199999999999998
G4,C(C=C(C=O)CCO)=O,2,2,42,44,46,9.499999999999999e-05
G4,C(C(C(C(C(CO)=O)=C)O)O)=O,4,12,15,27,9,0.000605
G4,C(C(C=C(C(CO)=O)CO)O)=O,4,8,9,17,29,0.00040199999999999996
G4,C(CCO)(C(C(CO)=C)O)=O,2,4,10,14,29,0.00021400000000000002
G4,C=C(C(CO)=O)C(CO)(C)O,2,4,10,14,49,0.000212
G4,C(C)(CO)=C(C(CO)=O)CO,2,4,7,11,49,0.00022400000000000002
G4,C(CO)(C(C(CO)=C)CO)=O,2,5,10,15,29,0.000273
G4,C(CO)(CC(CO)=CCO)=O,2,5,8,13,29,0.000271
G4,C(CO)(CCO)=CC(CO)=O,2,4,7,11,29,0.00022400000000000002
G4,C(C)(C(C(CO)=CCO)O)=O,4,3,7,10,3,0.000165
G4,C(CCO)(C(C=C)O)=O,2,5,34,39,27,0.000251
G4,C=C(C(CO)=O)C(C)O,2,3,34,37,4,0.000154
G4,C(C)=C(C(CO)=O)CO,2,3,33,36,27,0.000165
G4,C(CO)(C(C=C)CO)=O,2,4,34,38,28,0.00021400000000000002
G4,C(CC(CO)=CCO)=O,2,3,20,23,3,0.000165
G4,C(CO)(CCO)=CC=O,2,3,20,23,46,0.000165
G4,C(C(C(C(C=CC)=O)O)O)=O,8,5,18,23,28,0.00023999999999999998
G4,C(C(C(C(CC=C)=O)O)O)=O,4,6,19,25,28,0.000288
G4,C(CC(C(C(C=O)O)O)=C)=O,4,4,20,24,28,0.000192
G4,C(C(C(C(C)=CC=O)O)O)=O,8,3,16,19,28,0.000144
G4,C(C(C(C=O)=CC(C=O)O)O)=O,8,4,13,17,29,0.00018999999999999998
G4,C(C(C(C(C=O)=CC=O)O)O)=O,8,2,17,19,29,9.499999999999999e-05
G4,C(C)(CO)=CC(CO)=O,2,6,32,38,49,0.000307
G4,C(CO)(CC(CO)=C)=O,1,6,33,39,49,0.000307
G4,C(C)(C(C(CO)=C)O)=O,2,5,26,31,49,0.00024900000000000004
G4,C(C(CC=CC(CO)=O)O)=O,4,3,14,17,21,0.000154
G4,C(C(C=CCC(CO)=O)O)=O,4,4,15,19,21,0.00020099999999999998
G4,C(C(C=CC(C(C)=O)O)O)=O,8,3,13,16,49,0.00014199999999999998
G4,C(C(C(CO)=C)C(C=O)O)=O,4,4,14,18,49,0.000202
G4,C(C(C(C=O)=C(CO)C)O)=O,4,3,10,13,49,0.000154
G4,C(C=C(C=O)C(CO)(C)O)=O,4,3,12,15,55,0.000154
G4,C(C)=CC(CO)=O,2,8,254,262,28,0.000391
G4,C(CO)(CC=C)=O,1,11,243,254,28,0.000533
G4,C(C)(C(C=C)O)=O,2,10,190,200,28,0.000475
G4,C(CC(CO)=C)=O,1,3,139,142,28,0.000154
G4,C(C)(CO)=CC=O,2,3,149,152,28,0.000154
G4,C(CO)(C(CO)O)=CC(CO)=O,4,5,5,10,29,0.000271
G4,C(C(CO)O)(C(C(CO)=C)O)=O,4,7,9,16,49,0.000359
G4,C(C=C(C=O)C(C)O)=O,4,3,42,45,28,0.00014199999999999998
G4,C(C(C(C=O)=CC)O)=O,4,2,41,43,45,9.499999999999999e-05
G4,C(C(C=C)C(C=O)O)=O,4,5,42,47,45,0.00023799999999999998
G4,C(CC=CC(C=O)O)=O,4,6,42,48,43,0.000285
G4,C(C(CC=CC=O)O)=O,4,5,42,47,27,0.00023700000000000001
G4,C(C)=CC=O,2,4,1340,1344,45,0.00018999999999999998
G4,C(CC=C)=O,1,4,1187,1191,45,0.00018999999999999998
G4,C(CO)(C(CO)O)=CC=O,4,5,11,16,46,0.000271
G4,C(CCO)(CC(C=CC=O)=O)=O,2,3,18,21,30,0.00014199999999999998
G4,C(CCO)(CC(C=O)=CC=O)=O,2,1,18,19,23,4.7e-05
G4,C(CC(C=O)=CC(CCO)=O)=O,2,2,15,17,23,9.499999999999999e-05
G4,C(CCO)(CC(C=O)=O)=CC=O,2,1,12,13,29,4.7e-05
G4,C(CC(CCO)=CC(C=O)=O)=O,2,1,12,13,29,4.7e-05
G4,C(CC(CC(C=O)=O)=CCO)=O,2,2,11,13,29,9.499999999999999e-05
G4,C(CCO)(C(C=C)C(C=O)=O)=O,2,1,15,16,29,4.7e-05
G4,C(C)=C(C(CCO)=O)C(C=O)=O,2,1,14,15,29,4.7e-05
G4,C(CC(C=O)=O)(C(C=C)CO)=O,2,1,14,15,29,4.7e-05
G4,C(C)=C(C(CC(C=O)=O)=O)CO,2,1,11,12,29,4.7e-05
G4,C=C(C(CC(C=O)=O)=O)C(C)O,2,2,12,14,29,9.499999999999999e-05
G4,C(CO)(CCC(C=CC=O)=O)=O,2,1,17,18,7,4.7e-05
G4,C(CO)(CCC(C=O)=CC=O)=O,2,2,16,18,29,9.499999999999999e-05
G4,C(CC(C=O)=CCC(CO)=O)=O,2,2,15,17,29,9.499999999999999e-05
G4,C(CO)(CCC(C=O)=O)=CC=O,2,2,12,14,29,9.499999999999999e-05
G4,C(CC(CO)=CCC(C=O)=O)=O,2,1,14,15,29,4.7e-05
G4,C(CC(C=C)C(C=O)=O)(CO)=O,2,1,15,16,12,4.7e-05
G4,C(CO)(CC(C(C=O)=O)=CC)=O,2,1,15,16,12,4.7e-05
G4,C(CO)(C(C=C)CC(C=O)=O)=O,2,1,15,16,12,4.7e-05
G4,C(C)=C(C(CO)=O)CC(C=O)=O,2,1,14,15,12,4.7e-05
G4,C(CCC(C=O)=O)(C(C=C)O)=O,2,2,13,15,12,9.499999999999999e-05
G4,C(C)(C(CC(C=CC=O)=O)O)=O,4,2,17,19,45,9.499999999999999e-05
G4,C(C)(C(CC(C=O)=CC=O)O)=O,4,1,15,16,29,4.7e-05
G4,C(CC(C=O)=CC(C(C)=O)O)=O,4,2,13,15,29,9.499999999999999e-05
G4,C(C)(C(CC(C=O)=O)O)=CC=O,4,2,14,16,22,9.499999999999999e-05
G4,C(CC(C(CC(C=O)=O)O)=C)=O,2,2,18,20,22,9.499999999999999e-05
G4,C(C)(C(C(C=C)C(C=O)=O)O)=O,4,2,14,16,45,9.499999999999999e-05
G4,C(C)(C(C(C(C=O)=O)=CC)O)=O,4,1,13,14,45,4.7e-05
G4,C(C(C(C(C)O)=CC(C)=O)=O)=O,4,2,12,14,29,9.499999999999999e-05
G4,C(C(CC(C=O)=O)O)(CC=C)=O,2,2,14,16,22,9.499999999999999e-05
G4,C(C)=CC(C(CC(C=O)=O)O)=O,4,2,12,14,22,9.499999999999999e-05
G4,C(CC(CC(C=O)=CC=O)O)=O,4,1,18,19,29,4.7e-05
G4,C(CC(C=O)=CC(CC=O)O)=O,4,2,17,19,29,9.499999999999999e-05
G4,C(CC(CC(C=O)=O)O)=CC=O,4,2,15,17,13,9.499999999999999e-05
G4,C(CC=CC(CC(C=O)=O)O)=O,4,2,17,19,13,9.499999999999999e-05
G4,C(CC(C(C=C)C(C=O)=O)O)=O,4,2,17,19,29,9.499999999999999e-05
G4,C(CC(C(C(C=O)=O)=CC)O)=O,4,1,15,16,29,4.7e-05
G4,C(CC=C(C(C=O)=O)C(C)O)=O,4,2,13,15,29,9.499999999999999e-05
G4,C(C(C=C)C(CC(C=O)=O)O)=O,4,2,16,18,29,9.499999999999999e-05
G4,C(C)=C(C=O)C(CC(C=O)=O)O,4,1,13,14,29,4.7e-05
G4,C(CC(C=O)=O)=C(C=O)C(C)O,4,2,11,13,29,9.499999999999999e-05
G4,C(CC(C(CCO)=O)=O)=CC=O,2,2,14,16,53,9.499999999999999e-05
G4,C(CC=CC(C(CCO)=O)=O)=O,2,1,15,16,53,4.7e-05
G4,C(CC(C(CCO)=O)=CC=O)=O,2,1,16,17,29,4.7e-05
G4,C(CC(C(CCO)=CC=O)=O)=O,2,1,13,14,29,4.7e-05
G4,C(CC(C(CC=O)=CCO)=O)=O,2,2,12,14,29,9.499999999999999e-05
G4,C(C(C=C)C(C(CCO)=O)=O)=O,2,2,14,16,29,9.499999999999999e-05
G4,C(C)=C(C=O)C(C(CCO)=O)=O,2,1,14,15,4,4.7e-05
G4,C(CC(C(C(C=C)CO)=O)=O)=O,2,2,13,15,29,9.499999999999999e-05
G4,C(CC(C(C(CO)=CC)=O)=O)=O,2,1,11,12,4,4.7e-05
G4,C(CC(C(C(C(C)O)=C)=O)=O)=O,2,2,12,14,29,9.499999999999999e-05
G4,C(CC(CO)=O)(CC=CC=O)=O,2,2,14,16,26,9.499999999999999e-05
G4,C(CC=CC(CC(CO)=O)=O)=O,2,2,15,17,26,9.499999999999999e-05
G4,C(CC(CC(CO)=O)=CC=O)=O,2,3,14,17,32,0.00014199999999999998
G4,C(CC(CC=O)=CC(CO)=O)=O,1,3,8,11,46,0.00014199999999999998
G4,C(CC=O)(CC(CO)=CC=O)=O,2,1,13,14,29,4.7e-05
G4,C(CC(CO)=CC(CC=O)=O)=O,2,1,13,14,26,4.7e-05
G4,C(C(C(CC(CO)=O)=O)C=C)=O,2,2,13,15,4,9.499999999999999e-05
G4,C(CO)(CC(C(C=O)=CC)=O)=O,2,2,12,14,4,9.499999999999999e-05
G4,C(CC(C(C(CO)=O)C=C)=O)=O,2,2,13,15,4,9.499999999999999e-05
G4,C(CC(C(C(CO)=O)=CC)=O)=O,2,2,11,13,4,9.499999999999999e-05
G4,C(CC(CC(C(C=C)O)=O)=O)=O,2,3,12,15,7,0.00014199999999999998
G4,C(C(C(C)=O)O)(CC=CC=O)=O,4,1,12,13,9,4.7e-05
G4,C(CC=CC(C(C(C)=O)O)=O)=O,4,1,13,14,9,4.7e-05
G4,C(CC(C(C(C)=O)O)=CC=O)=O,4,1,12,13,29,4.7e-05
G4,C(CC(C(C(C)=CC=O)O)=O)=O,4,1,12,13,29,4.7e-05
G4,C(CC(C(C(CC=O)=O)O)=C)=O,2,1,15,16,29,4.7e-05
G4,C(C(C(C(C(C)=O)O)=O)C=C)=O,4,1,11,12,29,4.7e-05
G4,C(C)(C(C(C(C=O)=CC)=O)O)=O,4,1,10,11,9,4.7e-05
G4,C(CC(C(C(CC=C)=O)O)=O)=O,2,1,11,12,9,4.7e-05
G4,C(CC(C(C(C=CC)=O)O)=O)=O,4,1,10,11,9,4.7e-05
G4,C(CC(C(CC=O)O)=CC=O)=O,4,1,18,19,29,4.7e-05
G4,C(CC(C(CC=CC=O)O)=O)=O,4,2,15,17,29,9.499999999999999e-05
G4,C(CC(C(C=CCC=O)O)=O)=O,4,3,16,19,13,0.00014199999999999998
G4,C(C(C(C(CC=O)O)=O)C=C)=O,4,2,16,18,29,9.499999999999999e-05
G4,C(CC(C(C(C=O)=CC)=O)O)=O,4,2,14,16,29,9.499999999999999e-05
G4,C(C(C=C)C(C(CC=O)=O)O)=O,4,4,16,20,29,0.00018999999999999998
G4,C(CC(C(C(C=O)=CC)O)=O)=O,4,2,14,16,29,9.499999999999999e-05
G4,C(CC(C=C(C=O)C(C)O)=O)=O,4,2,12,14,29,9.499999999999999e-05
G4,C(C(C=CC=O)O)(CC(C)=O)=O,4,2,13,15,29,9.499999999999999e-05
G4,C(C(C(CC(C)=O)=CC=O)O)=O,4,1,12,13,29,4.7e-05
G4,C(CC(C(C=O)O)=CC(C)=O)=O,4,1,12,13,29,4.7e-05
G4,C(C(C=O)O)(CC(C)=CC=O)=O,4,1,11,12,29,4.7e-05
G4,C(CC(C)=CC(C(C=O)O)=O)=O,4,1,12,13,6,4.7e-05
G4,C(CC(CC(C(C=O)O)=O)=C)=O,2,2,14,16,29,9.499999999999999e-05
G4,C(C(C(C(C(C)=O)C=C)=O)O)=O,4,2,11,13,29,9.499999999999999e-05
G4,C(C(C(C(C(C)=O)=CC)=O)O)=O,4,1,9,10,29,4.7e-05
G4,C(C(C(CC(CC=C)=O)=O)O)=O,2,1,11,12,4,4.7e-05
G4,C(C(C=O)O)(CC(C=CC)=O)=O,4,1,10,11,29,4.7e-05
G4,C(C(C(CCC=O)=CC=O)O)=O,4,1,14,15,29,4.7e-05
G4,C(CC(C(C=O)O)=CCC=O)=O,4,1,16,17,29,4.7e-05
G4,C(C(C(CCC=CC=O)=O)O)=O,4,1,13,14,44,4.7e-05
G4,C(CC=CCC(C(C=O)O)=O)=O,4,1,15,16,44,4.7e-05
G4,C(CC(C(C(C=O)O)=O)=CC)=O,4,1,13,14,4,4.7e-05
G4,C(C(C=C)CC(C(C=O)O)=O)=O,4,2,13,15,29,9.499999999999999e-05
G4,C(C(C=O)O)(CC(C=O)=CC)=O,4,1,13,14,46,4.7e-05
G4,C(C(CC(C(C)=O)=CC=O)O)=O,4,1,13,14,29,4.7e-05
G4,C(CC(C(C)=O)=CC(C=O)O)=O,4,1,13,14,29,4.7e-05
G4,C(C(CC(C(C)=CC=O)=O)O)=O,4,1,14,15,29,4.7e-05
G4,C(CC(C(CC(C=O)O)=O)=C)=O,2,1,17,18,21,4.7e-05
G4,C(C(C(C=C)C(C(C)=O)=O)O)=O,4,1,12,13,29,4.7e-05
G4,C(C(C(C(C(C)=O)=O)=CC)O)=O,4,1,11,12,14,4.7e-05
G4,C(C(C(C(C)O)=CC=O)=O)(C)=O,4,2,11,13,14,9.499999999999999e-05
G4,C(C(CC(C(CC=C)=O)=O)O)=O,2,1,12,13,29,4.7e-05
G4,C(C(CC(C(C=CC)=O)=O)O)=O,4,1,12,13,29,4.7e-05
G4,C(CC(CC(C=O)O)=CC=O)=O,4,3,15,18,29,0.00014199999999999998
G4,C(CC(CC=O)=CC(C=O)O)=O,2,3,10,13,29,0.00014199999999999998
G4,C(C(CC(CC=CC=O)=O)O)=O,4,2,16,18,26,9.499999999999999e-05
G4,C(CC=CC(CC(C=O)O)=O)=O,4,2,16,18,29,9.499999999999999e-05
G4,C(CC=O)(C(C=C)C(C=O)O)=O,4,2,16,18,29,9.499999999999999e-05
G4,C(CC(C(C(C=O)O)=CC)=O)=O,4,2,14,16,29,9.499999999999999e-05
G4,C(CC(C(C(C)O)=CC=O)=O)=O,4,2,13,15,29,9.499999999999999e-05
G4,C(C(C(CC(C=O)O)=O)C=C)=O,4,2,15,17,29,9.499999999999999e-05
G4,C(C(CC(C(C=O)=CC)=O)O)=O,4,2,13,15,29,9.499999999999999e-05
G4,C(C(CO)O)=CC(C=CC=O)=O,8,1,12,13,29,4.7e-05
G4,C(C(CO)O)=CC(C=O)=CC=O,8,1,13,14,29,4.7e-05
G4,C(C(C(C=CCO)=O)O)=CC=O,8,1,8,9,29,4.7e-05
G4,C(C(C(C=CCO)=CC=O)O)=O,8,1,9,10,29,4.7e-05
G4,C(C=CC=CC(C(CO)O)=O)=O,8,2,16,18,21,9.499999999999999e-05
G4,C(C=CC(C(CO)O)=CC=O)=O,8,1,10,11,29,4.7e-05
G4,C(C(C(C(C=C)=CC=O)O)O)=O,8,1,15,16,29,4.7e-05
G4,C(C(C=CC(CO)=O)O)=CC=O,8,1,10,11,32,4.7e-05
G4,C(C(C=CC(CO)=CC=O)O)=O,8,1,10,11,29,4.7e-05
G4,C(C(C=CC(C(C=C)O)=O)O)=O,8,1,9,10,29,4.7e-05
G4,C(C(C(C=CC=O)O)O)=CC=O,10,1,5,6,29,4.7e-05
G4,C(C(C(C=CC=CC=O)O)O)=O,16,1,16,17,29,4.7e-05
G4,C(C(C(CO)=CC=O)O)=O,4,6,17,23,29,0.000296
G4,C(CO)=C(C=O)C(CO)=O,2,4,18,22,55,0.00020099999999999998
G4,C(C(C(C(C=O)O)=C)O)=O,3,5,10,15,29,0.00023700000000000001
G4,C(C(C(C(CO)O)=C)O)=O,4,7,13,20,29,0.00035499999999999996
G4,C(C(C=C(CO)C(C=O)O)O)=O,8,4,11,15,29,0.00020099999999999998
G4,C(C(C(C(CO)=O)=CCO)O)=O,4,2,10,12,0,0.000106
G4,C(C=C(C(CO)=O)C(CO)O)=O,4,3,11,14,0,0.000154
G4,C(C(C(C=O)=CCO)O)=O,4,6,17,23,43,0.000296
G4,C(CO)=C(C(C=O)=O)CO,2,5,14,19,29,0.00024900000000000004
G4,C=C(C(C=O)=O)C(CO)O,2,5,18,23,0,0.00024900000000000004
G4,C(C(C(CO)=CCO)O)=O,4,7,10,17,29,0.00035499999999999996
G4,C(CO)=C(C(CO)=O)CO,2,8,15,23,2,0.000414
G4,C=C(C(CO)=O)C(CO)O,2,7,18,25,0,0.00035499999999999996
G4,C(C(C(C(C(C=O)O)O)=C)O)=O,8,8,18,26,16,0.000404
G4,C(C(C(C(C=CCO)=O)O)O)=O,8,8,13,21,29,0.000394
G4,C(C(C(CO)=C)O)=O,2,11,43,54,49,0.000533
G4,C(C=C(C=O)C(CO)O)=O,4,4,20,24,46,0.00020099999999999998
G4,C(C(C(CO)O)O)=CC(C=O)=O,8,7,10,17,20,0.000388
G4,C(C(C(CO)O)O)=CC(CO)=O,8,8,7,15,29,0.000446
G4,C=C(C=O)C(C(C(CO)O)O)=O,4,13,17,30,9,0.000663
G4,C(C(C(C(CO)=CCO)=O)O)=O,4,3,8,11,29,0.00014199999999999998
G4,C(C(C(C(C(CO)O)=C)=O)O)=O,4,7,12,19,29,0.000354
G4,C(C(CO)=CC=O)(C(CO)O)=O,4,11,13,24,2,0.0005480000000000001
G4,C(C(C(C(C(CO)O)=O)=C)O)=O,4,13,16,29,47,0.000643
G4,C(C(C(C(C(CO)=C)=O)O)O)=O,4,11,15,26,49,0.000547
G4,C(C(C(C=C(C=O)CO)O)O)=O,8,7,14,21,18,0.000356
G4,C(C(C(C(C(C=O)=C)O)O)O)=O,8,10,20,30,16,0.000521
G4,C=CC(O)=O,1,8,530,538,18,0.000391
G4,C(CO)=CC(O)=O,2,6,70,76,18,0.000307
G4,C(C(CO)O)=C(C(O)=O)CO,4,1,5,6,29,4.7e-05
G4,C(C(CCO)=CC=O)(O)=O,2,2,15,17,46,0.000106
G4,C(CC(C(O)=O)=CCO)=O,2,2,14,16,7,0.000106
G4,C(C(C=C(C(O)=O)C)O)=O,4,1,13,14,14,4.7e-05
G4,C(C(CC(C(O)=O)=C)O)=O,2,1,16,17,14,4.7e-05
G4,C=C1C(C(C(C1O)O)O)O,10,1,5,6,29,4.7e-05
G4,C=C,1,2,1,3,46,9.499999999999999e-05
G4,C=CC1C(C(C(O1)O)O)O,16,2,7,9,4,9.499999999999999e-05
G4,C=CC1(C(C(CO1)O)O)O,8,3,6,9,29,0.00014199999999999998
G4,C1(C(C=CC1(CO)O)O)=O,4,4,10,14,2,0.00020099999999999998
G4,C(C(C(C=O)=C)(CO)O)=O,2,5,17,22,16,0.000251
G4,C(C(C(CO)=CC=O)(CO)O)=O,4,3,10,13,29,0.000156
G4,C(C(C(C(C=O)O)=C)(CO)O)=O,4,3,13,16,29,0.000156
G4,C(C(C(C(CO)O)=C)(CO)O)=O,4,4,11,15,29,0.00021400000000000002
G4,C(C(C(C=O)=CCO)(CO)O)=O,4,4,11,15,43,0.00020299999999999997
G4,C(C(C(CO)=CCO)(CO)O)=O,4,5,8,13,29,0.000273
G4,C(C(C(CO)=C)(CO)O)=O,2,4,9,13,49,0.00021400000000000002
G4,C(C(C=C)(CO)O)=O,2,6,25,31,29,0.000298
G4,C(C(C(C)=O)(C(C=O)=C)O)=O,2,3,12,15,25,0.00014199999999999998
G4,C(C)(C(C(C=O)=C)(CO)O)=O,2,4,14,18,25,0.00020299999999999997
G4,C(C(C=O)(C(C=O)=C)O)=O,1,3,13,16,1,0.00014199999999999998
G4,C(C(C(C=O)=C)(C(C=O)O)O)=O,4,3,16,19,29,0.000143
G4,C(CO)(C(C(C=O)=C)(CO)O)=O,2,3,14,17,2,0.000155
G4,C(C(C=O)(C=CC(CO)=O)O)=O,2,2,7,9,1,9.499999999999999e-05
G4,C(C(C=O)(C(CO)=CC=O)O)=O,2,1,7,8,29,4.7e-05
G4,C(C(C=O)(C(C(C=O)O)=C)O)=O,2,1,9,10,29,4.7e-05
G4,C(C(C(C)=O)(C(CO)=C)O)=O,2,3,8,11,29,0.000154
G4,C(C(C(C)=O)(C=C)O)=O,2,3,26,29,27,0.00014199999999999998
G4,C(C(C=O)(C(C(CO)O)=C)O)=O,2,2,8,10,29,0.000106
G4,C(C)(C(C(CO)=C)(CO)O)=O,2,4,8,12,49,0.00021400000000000002
G4,C(C)(C(C=C)(CO)O)=O,2,4,19,23,27,0.00020299999999999997
G4,C=C1C(OC(C(CO)O)C1O)=O,8,3,6,9,48,0.00014199999999999998
G4,C1C(C(CO)O)OC(C=1CO)=O,4,2,4,6,48,9.499999999999999e-05
G4,C=C1C(OC(CO)C(C1O)O)=O,8,2,7,9,48,9.499999999999999e-05
G4,C1C(C(CO)OC(C=1CO)=O)O,4,2,2,4,48,9.499999999999999e-05
G4,C=C1C(OCC(C(C1O)O)O)=O,8,1,10,11,48,4.7e-05
G4,C1C(C(COC(C=1CO)=O)O)O,4,2,4,6,48,9.499999999999999e-05
G4,C(C(C=O)(C(C=O)=CCO)O)=O,2,1,7,8,29,4.7e-05
G4,C(C(C=O)(C(CO)=CCO)O)=O,2,3,5,8,29,0.000165
G4,C(C(C(C(C)=O)(C=C)O)O)=O,4,2,15,17,0,9.6e-05
G4,C(C(C=O)(C(CO)=C)O)=O,1,2,6,8,29,0.000106
G4,C(C(C=O)(C=CC(C=O)O)O)=O,4,2,8,10,29,9.499999999999999e-05
G4,C(C(C=O)(C=C)O)=O,1,3,21,24,28,0.00014199999999999998
G4,C(C(C(CO)=C)(C(C=O)O)O)=O,4,6,14,20,49,0.000298
G4,C(CO)(C(C(CO)=C)(CO)O)=O,2,4,7,11,49,0.00021400000000000002
G4,C(CO)(C(C=C)(CO)O)=O,2,5,13,18,2,0.00025
G4,C(C(C=C)(C(CO)O)O)(O)=O,4,6,9,15,29,0.000319
G4,C(CC(C(C(C)=O)(C=C)O)=O)=O,2,1,9,10,29,4.7e-05
G4,C(C(C(CC(C)=O)=O)(C=C)O)=O,2,1,9,10,29,4.7e-05
G4,C(C(C(CCC=O)=O)(C=C)O)=O,2,1,10,11,29,4.7e-05
G4,C(C(C=C)(C(C=CCO)=O)O)=O,4,1,6,7,29,4.7e-05
G4,C=CC(C(C=CC=O)=O)(CO)O,4,1,10,11,29,4.7e-05
G4,C(C(C(C=C)(C(C=C)=O)O)O)=O,4,1,13,14,7,4.7e-05
G4,C(C(C=C)(C(C=CC=O)O)O)=O,8,3,11,14,43,0.000143
G4,C(C(C(C=O)=C)(C(CO)O)O)=O,4,7,16,23,0,0.00037799999999999997
G4,C(C(C(CO)=C)(C(CO)O)O)=O,4,7,11,18,29,0.000389
G4,C(C(C=C)(C(CO)O)O)=O,4,7,11,18,7,0.00037799999999999997
G4,C(C(C(C=O)=C)(CC=O)O)=O,2,3,15,18,23,0.00014199999999999998
G4,C(C(C(C=O)=C)O)(O)=O,2,4,28,32,33,0.00020099999999999998
G4,C(C(C(CO)=CC=O)O)(O)=O,4,5,9,14,29,0.000271
G4,C(C(C(C(C=O)O)=C)O)(O)=O,4,5,12,17,29,0.000271
G4,C(C(C(C=O)=CC(CO)=O)O)=O,4,3,13,16,29,0.00014199999999999998
G4,C(C(C(C(CO)O)=C)O)(O)=O,4,6,9,15,29,0.00032900000000000003
G4,C(C(CO)=CC(CO)=O)=O,2,8,24,32,46,0.00037999999999999997
G4,C(C(C(C)O)=CC(CO)=O)=O,4,2,13,15,41,9.499999999999999e-05
G4,C(C(C=C(C(C)=O)CO)=O)=O,2,3,13,16,29,0.00014199999999999998
G4,C(C(CO)=CC(C(C)=O)=O)=O,2,3,12,15,2,0.00014199999999999998
G4,C(C(C(C=O)=CCO)O)(O)=O,4,3,10,13,29,0.000154
G4,C(C(C(CO)=CCO)O)(O)=O,4,7,6,13,29,0.000388
G4,C(C(C(CO)=C)(CC=O)O)=O,2,5,13,18,29,0.00025
G4,C(C(C(CO)=C)O)(O)=O,2,6,14,20,49,0.00032900000000000003
G4,C(C)(C(C=C)(CC(C=O)=O)O)=O,2,1,13,14,29,4.7e-05
G4,C(C(C=C(C(C)=O)C(C)O)=O)=O,4,2,11,13,29,9.499999999999999e-05
G4,C(C(C=C(C=O)C(C)O)=O)(C)=O,4,2,10,12,29,9.499999999999999e-05
G4,C(C(C=C)(C=CC(CO)=O)O)=O,4,1,9,10,32,4.7e-05
G4,C(C(C(CO)O)=CC(CO)=O)=O,4,3,11,14,29,0.000154
G4,C1(CO)OC(C(C=1)=O)CO,2,1,10,11,2,4.7e-05
G4,C(CC1OCC(C=1)=O)=O,1,2,74,76,48,9.499999999999999e-05
G4,C(C1C(C=C(C)O1)=O)=O,2,1,49,50,26,4.7e-05
G4,C1COC(C(C=1)=O)(CO)O,2,2,11,13,46,9.499999999999999e-05
G4,C1(CO)OCC(C(C=1)=O)O,2,2,9,11,32,9.499999999999999e-05
G4,C1C(CO)(OCC(C=1)=O)O,2,2,14,16,32,9.499999999999999e-05
G4,C1C(CO)OC(C(C=1)=O)=O,2,3,9,12,50,0.00014199999999999998
G4,C1(C=CC(C(CO)O1)=O)=O,2,5,24,29,2,0.00023700000000000001
G4,C1C(COC(C(C=1)=O)=O)O,2,3,9,12,27,0.00014199999999999998
G4,C1(C(C(C=CCO1)=O)O)=O,2,2,18,20,2,9.499999999999999e-05
G4,C1(C=CC(C(CO1)O)=O)=O,2,5,22,27,46,0.00023700000000000001
G4,C1(C(C=CC(CO1)=O)O)=O,2,2,21,23,27,9.499999999999999e-05
G4,C1C2C(C(C(C=1)(O2)O)O)O,16,3,6,9,32,0.00014199999999999998
G4,C1(C(CO)O)OCC(C=1)=O,2,2,10,12,2,0.000106
G4,C1(COC(C1O)=CCO)=O,4,1,15,16,2,4.7e-05
G4,C1(COC(C=C)(C1O)O)=O,4,3,20,23,32,0.00014199999999999998
G4,C1(C(C(OC1C=C)O)O)=O,8,3,18,21,2,0.00014199999999999998
G4,C1C(C(CO)O)(O)OC(C=1)=O,4,2,6,8,29,9.499999999999999e-05
G4,C1(C(C=C(C(CO)O)O1)O)=O,4,1,4,5,29,4.7e-05
G4,C1(C(C(C(O1)=CCO)O)O)=O,8,1,6,7,2,4.7e-05
G4,C1(C(C(C(C=C)(O)O1)O)O)=O,8,3,9,12,2,0.00014199999999999998
G4,C1C2(C(OC(C=1)C2O)O)O,16,3,5,8,43,0.00014199999999999998
G4,C1OC2C(COC2(C=1)O)O,8,2,2,4,9,9.499999999999999e-05
G4,C12C(C(CO1)O)OC(C=2)O,8,1,1,2,29,4.7e-05
G4,C=C1C2C(C(C(O2)O)O1)O,16,2,2,4,26,9.499999999999999e-05
G4,C1OC2C(C(OC2C=1)O)O,16,2,4,6,29,9.499999999999999e-05
G4,C1OC2COC(C=1)(C2O)O,8,2,3,5,9,9.499999999999999e-05
G4,C1C2COC(C(C=1)(O2)O)O,8,2,3,5,41,9.499999999999999e-05
G4,C1C2(C(COC(C=1)O2)O)O,8,2,3,5,38,9.499999999999999e-05
G4,C1C2C(O)OCC(C=1)(O2)O,8,2,2,4,40,9.499999999999999e-05
G4,C1OC2C(C(C=1)OC2O)O,16,2,2,4,37,9.499999999999999e-05
G4,C(C1(C(C=CCO1)O)O)=O,4,2,8,10,30,9.499999999999999e-05
G4,C1(COC(CO)=CC1O)=O,2,2,12,14,32,9.499999999999999e-05
G4,C(C1C=CC(C(O1)O)O)=O,8,2,10,12,29,9.499999999999999e-05
G4,C1(COC(C(C1O)O)=C)=O,4,1,19,20,24,4.7e-05
G4,C=C1C(C(C(CO1)O)O)O,8,1,5,6,29,4.7e-05
G4,C1(C(C=CC(CO)(O)O1)O)=O,4,2,4,6,17,9.499999999999999e-05
G4,C1(C(C(C=C(CO)O1)O)O)=O,4,1,6,7,17,4.7e-05
G4,C1(C(C(C(C(O1)=C)O)O)O)=O,8,1,8,9,14,4.7e-05
G4,C1C2COC(C=1)(C(O2)O)O,8,2,3,5,30,9.499999999999999e-05
G4,C1(COC=CC(C1O)O)=O,4,3,19,22,38,0.000153
G4,C1C(C(COC(C=1)O)O)O,8,2,4,6,29,9.499999999999999e-05
G4,C1OCC(C(C(C=1)O)O)O,8,1,5,6,29,4.7e-05
G4,C1C(C(C(OCC=1)O)O)O,8,2,6,8,4,9.499999999999999e-05
G4,C1(C(C(C=CC(O)O1)O)O)=O,8,2,7,9,43,9.499999999999999e-05
G4,C1(C(C(C(C=CO1)O)O)O)=O,8,1,8,9,43,4.7e-05
G4,C1C(C(C(O)OC(C=1)=O)O)O,8,2,7,9,29,9.499999999999999e-05
G4,C1OC2C(C(C(C=1)O2)O)O,16,1,3,4,29,4.7e-05
G4,C1C2C(C(OC(C=1)O2)O)O,16,2,4,6,43,9.499999999999999e-05
G4,C(C(C1C=CC(O1)=O)O)=O,4,2,20,22,8,9.499999999999999e-05
G4,C(C1C(C=CC(O1)=O)O)=O,4,2,21,23,8,9.499999999999999e-05
G4,C1(C(C(C(C1O)O)O)O)O,1,1,1,2,4,5.9e-05
G4,CC(CO)(C(C(C(CO)O)O)O)O,16,5,9,14,29,0.000293
G4,CC(C(CO)O)(C(C(CO)O)O)O,16,5,9,14,29,0.000293
G4,CC(C(C(C(CO)O)O)O)O,16,7,9,16,29,0.00041
G4,C(C(C(C(CO)O)(C(C)O)O)O)=O,16,8,13,21,0,0.000437
G4,C(C(C(C(C(C(C)O)O)O)O)O)=O,32,8,16,24,11,0.000437
G4,C(C(C(C(C(CO)CO)O)O)=O)=O,4,5,12,17,18,0.00026000000000000003
G4,C(C(C(C(CO)(CCO)O)O)O)O,8,5,8,13,29,0.000293
G4,CC(CO)(C(C(CO)O)O)O,8,4,7,11,29,0.00023500000000000002
G4,CC(C(C(CO)O)O)O,8,5,12,17,27,0.000293
G4,C(OC(C(CO)O)C(CO)O)=O,3,1,2,3,35,5.9e-05
G4,C(C(C(O)OCC(CO)O)O)=O,8,1,9,10,29,5.9e-05
G4,C(C(CO)OC(C(CO)O)O)=O,8,1,8,9,2,5.9e-05
G4,C(OC(CO)C(C(CO)O)O)=O,8,2,4,6,9,0.000117
G4,C(C(O)OC(CO)C(CO)O)=O,8,3,5,8,29,0.000176
G4,C1C(C(C(C(O)O1)O)O)O,16,5,7,12,27,0.00028199999999999997
G4,C(C(COC(C(CO)O)O)O)=O,8,1,7,8,29,5.9e-05
G4,C(OCC(C(C(CO)O)O)O)=O,8,2,6,8,29,0.000117
G4,C(COC(C(C(CO)O)O)O)=O,8,3,8,11,29,0.000176
G4,C(C(O)OCC(C(CO)O)O)=O,8,4,7,11,29,0.000234
G4,C(COC(CO)(C(CO)O)O)=O,4,2,6,8,29,0.000117
G4,C(C1(C(C(CCO1)O)O)O)=O,8,4,10,14,30,0.000212
G4,C(C(C1C(C(CO1)O)O)O)=O,16,6,9,15,36,0.00033999999999999997
G4,C(C(C(C=C)O)O)=O,4,7,62,69,27,0.00034500000000000004
G4,C=CC(C(CO)O)O,4,7,15,22,27,0.000366
G4,C(C(CO)O)=CCO,4,4,13,17,27,0.00020099999999999998
G4,C12CC(C(C(C1O)O)(O)O2)O,32,3,6,9,32,0.000164
G4,C1C2(C(C(CC2O)(O)O1)O)O,16,4,6,10,2,0.000212
G4,C1C2(CC(C(C2O)(O)O1)O)O,16,2,6,8,32,9.499999999999999e-05
G4,C1C2(CC(C(C2O)O)(O)O1)O,16,4,6,10,2,0.000212
G4,C(C1C2(C(C(C(C1O)O2)O)O)O)O,64,1,6,7,9,4.7e-05
G4,C1C(CO)(C(C(CO)(O)O1)O)O,8,1,5,6,5,4.7e-05
G4,C(C1(CC(CO)(CO1)O)O)=O,4,1,8,9,5,4.7e-05
G4,C1(C(O)OC(CO)(CO)C1)=O,2,3,7,10,5,0.00014199999999999998
G4,C(CO)(C1C(CC(CO)(O1)O)O)=O,8,2,8,10,20,9.499999999999999e-05
G4,C(CO)(C1C(CO)(CC(O1)O)O)=O,8,1,8,9,5,4.7e-05
G4,C(CC1(COC(CO)(C1O)O)O)=O,8,1,10,11,5,4.7e-05
G4,C(CO)(C1C(O)OCC1(CO)O)=O,8,2,10,12,5,9.499999999999999e-05
G4,C(C1C(CO)(O)OCC1(CO)O)=O,8,1,12,13,20,4.7e-05
G4,C(CC1(C(C(CO1)(CO)O)O)O)=O,8,3,10,13,23,0.000164
G4,C(CO)(C1C(C(C(C)(O1)O)O)O)=O,16,2,9,11,5,9.499999999999999e-05
G4,C(C)(C1C(C(C(CO)(O1)O)O)O)=O,16,2,9,11,5,0.000106
G4,C(CO)(C1C(C)(C(C(O1)O)O)O)=O,16,2,9,11,5,9.499999999999999e-05
G4,C(C1C(C)(C(C(CO)(O1)O)O)O)=O,16,1,10,11,5,4.7e-05
G4,C(C(C1(CC(CO1)(CO)O)O)O)=O,8,2,11,13,5,0.000106
G4,CC1(C(CO)OC(CO)(C1O)O)O,16,2,5,7,5,0.000106
G4,C1C(CO)(CC(C(CO)O)(O)O1)O,8,3,7,10,5,0.000165
G4,C(C1(C(CO)C(CO)(CO1)O)O)=O,8,1,9,10,5,4.7e-05
G4,C1(C(O)OC(CO)(CO)C1CO)=O,4,3,6,9,5,0.000146
G4,C1C(CCO)(C(C(CO)(O)O1)O)O,8,2,6,8,3,0.000106
G4,C1C(CO)(C(C(CCO)(O)O1)O)O,8,3,6,9,29,0.000165
G4,C1C(CO)(C(CO)C(CO)(O)O1)O,8,3,6,9,5,0.000165
G4,C(CO)(C1C(C(C(O1)O)O)O)=O,16,2,9,11,15,9.499999999999999e-05
G4,C(C1C(C(C(CO)(O1)O)O)O)=O,16,1,11,12,5,4.7e-05
G4,C1C(C)(C(C(CO)(O)O1)O)O,8,1,5,6,49,4.7e-05
G4,C1C(CO)(CC(CO)(O)O1)O,4,3,5,8,5,0.000165
G4,C1C(CO)(C(C(C)(O)O1)O)O,8,2,5,7,5,0.000106
G4,C(CO)(C(C1C(CC(O)O1)O)O)=O,16,2,7,9,38,9.499999999999999e-05
G4,C(CC1C(C(C(CO)(O)O1)O)O)=O,16,2,9,11,51,0.000106
G4,C(CO)(C(C1CC(C(O)O1)O)O)=O,16,2,8,10,51,9.499999999999999e-05
G4,C(C(C1C(O)OCC1(CO)O)O)=O,16,2,10,12,5,9.499999999999999e-05
G4,C(C1C(C(O)OC1(CO)CO)O)=O,8,1,9,10,5,4.7e-05
G4,C1C(CO)(CC(O)O1)O,4,2,8,10,27,0.000106
G4,C(CO)(C1C(O)OC(CO)C1O)=O,16,5,9,14,38,0.00024900000000000004
G4,C(C1C(CO)(O)OC(CO)C1O)=O,16,4,11,15,40,0.00020099999999999998
G4,C(CC1(C(C(C(CO)O1)O)O)O)=O,16,3,9,12,49,0.000165
G4,C(C(C1(CC(C(CO)O1)O)O)O)=O,16,2,9,11,29,0.000106
G4,C(C(C1(CC(C(CO)O1)O)O)O)O,16,3,6,9,41,0.000165
G4,C(C1(C(CO)C(C(CO)O1)O)O)=O,16,4,8,12,41,0.00020099999999999998
G4,C(CC1(C(C(C(CO)O1)O)O)O)O,16,3,6,9,3,0.000165
G4,C(C1(C(CO)C(C(CO)O1)O)O)O,16,4,5,9,41,0.00022400000000000002
G4,C(C(C1C(O)OC(CO)C1O)O)=O,32,3,9,12,41,0.000154
G4,C(C1C(C(CO)O)OC(C1O)O)=O,32,3,12,15,41,0.000165
G4,C(C1C(CC(O)O1)O)O,8,2,8,10,27,0.000106
G4,C(C1(C)CC(C(O1)O)=O)=O,4,3,16,19,4,0.00014199999999999998
G4,C(CO)(CC1CC(C(O)O1)=O)=O,4,4,10,14,20,0.00018999999999999998
G4,C(CC1(CO)CC(C(O)O1)=O)=O,4,2,10,12,51,9.499999999999999e-05
G4,C(CC1(COC(C=O)(C1)O)O)=O,4,2,14,16,51,9.499999999999999e-05
G4,C(C)(C(C1CC(C(O)O1)=O)O)=O,8,3,9,12,20,0.00014199999999999998
G4,C(C1(CC(C(C(C)=O)O1)O)O)=O,8,2,10,12,20,9.499999999999999e-05
G4,C(C(C1(C)CC(C(O)O1)=O)O)=O,8,2,9,11,26,9.499999999999999e-05
G4,C(C1C(C)(CC(C=O)(O1)O)O)=O,8,1,11,12,26,4.7e-05
G4,C(C1CC(C(O)O1)=O)=O,4,7,44,51,0,0.000332
G4,C1(C(O)OC(C)(C(CO)O)C1)=O,8,2,7,9,16,0.000106
G4,C(C1(CC(C)(C(CO)O1)O)O)=O,8,2,8,10,29,0.000106
G4,C(C1(CCO)CC(C(O1)O)=O)=O,4,1,8,9,29,4.7e-05
G4,C(C(C1COC(C)(C1O)O)=O)=O,8,1,14,15,45,4.7e-05
G4,C(C1(C)C(C(C(O1)O)=O)CO)=O,8,3,9,12,4,0.000146
G4,C(C(C1COC(C1(C)O)O)=O)=O,8,1,14,15,42,4.7e-05
G4,C1(C(O)OC(CO)(CCO)C1)=O,4,3,6,9,29,0.000165
G4,C(C1(CC(CO1)(CCO)O)O)=O,4,2,9,11,29,0.000106
G4,C(CO)(C1COC(C)(C1O)O)=O,8,3,9,12,45,0.000154
G4,C(CO)(C1COC(C1(C)O)O)=O,8,2,9,11,42,0.000106
G4,C(C(C1CC(C(O)O1)=O)O)=O,8,4,14,18,15,0.00018999999999999998
G4,C(C1C(CC(C=O)(O1)O)O)=O,8,1,12,13,15,4.7e-05
G4,C1(C(O)OC(CO)(C)C1)=O,4,4,14,18,49,0.00020099999999999998
G4,C(C1(CC(CO1)(C)O)O)=O,4,1,8,9,49,4.7e-05
G4,C(CC(C1CC(C(O)O1)=O)O)=O,8,3,14,17,20,0.000144
G4,C(C(CC1C(CC(O)O1)O)=O)=O,8,1,11,12,20,4.7e-05
G4,C(CC1C(CC(C=O)(O)O1)O)=O,8,2,13,15,20,9.499999999999999e-05
G4,C(C(CC1CC(C(O)O1)=O)O)=O,8,2,12,14,20,9.499999999999999e-05
G4,C(C(CC1CC(C(O)O1)O)=O)=O,8,1,12,13,20,4.7e-05
G4,C(C1C(C(C)(OC1C=O)O)O)=O,16,1,13,14,45,4.7e-05
G4,C(C1C(C(OC1C(C)=O)O)O)=O,16,2,13,15,45,9.499999999999999e-05
G4,C(C1C(C)(C(OC1C=O)O)O)=O,16,1,13,14,45,4.7e-05
G4,C(C1C(C(OC1(C=O)C)O)O)=O,16,1,13,14,45,4.7e-05
G4,C(C(C(C1CC(C(O)O1)=O)O)O)=O,16,3,15,18,0,0.000144
G4,C(C(CC1C(C(C(O)O1)O)O)=O)=O,16,1,11,12,0,4.7e-05
G4,C(C(C1C(CC(C=O)(O)O1)O)O)=O,16,1,12,13,0,4.7e-05
G4,C1(C(O)OC(C)C1)=O,4,7,78,85,45,0.000332
G4,C1(C(O)OC(CO)(C(CO)O)C1)=O,8,3,7,10,51,0.000164
G4,C(C1(CC(CO1)(C(CO)O)O)O)=O,8,4,10,14,51,0.000223
G4,C(C1(CC(CO)(C(CO)O1)O)O)=O,8,1,8,9,51,4.7e-05
G4,C(C1C(C(C(CO)=O)C(O1)O)O)=O,16,2,14,16,1,9.499999999999999e-05
G4,C(C1C(C(C=O)OC1(CO)O)O)=O,16,1,14,15,40,4.7e-05
G4,C(CC(C1C(C(C(O1)O)O)O)=O)=O,16,1,11,12,1,4.7e-05
G4,C(CC1(C(C(C(C=O)O1)O)O)O)=O,16,1,17,18,1,4.7e-05
G4,C(CO)(C1C(O)OCC1(C)O)=O,8,3,10,13,49,0.00014199999999999998
G4,C(C1C(CO)(O)OCC1(C)O)=O,8,2,13,15,49,9.499999999999999e-05
G4,C(CC1(C(C(CO1)(C)O)O)O)=O,8,2,11,13,49,9.499999999999999e-05
G4,C(CC1(COC(CO)(C1)O)O)=O,4,4,11,15,51,0.000202
G4,C(C)(C1C(CC(CO)(O1)O)O)=O,8,3,8,11,49,0.000154
G4,C(CC1(COC(C)(C1O)O)O)=O,8,3,11,14,0,0.000144
G4,C(C)(C1C(CO)(CC(O1)O)O)=O,8,2,8,10,49,0.000106
G4,C(C(C1(CC(C(C=O)O1)O)O)O)=O,16,1,17,18,1,4.7e-05
G4,C(C(C1(CC(CO1)(C)O)O)O)=O,8,1,11,12,49,4.7e-05
G4,C(C1C(C)(CC(CO)(O1)O)O)=O,8,2,10,12,55,0.000106
G4,C(C)(C1C(C(C(C)(O1)O)O)O)=O,16,2,9,11,49,9.499999999999999e-05
G4,C(C1C(C)(C(C(C)(O1)O)O)O)=O,16,1,10,11,49,4.7e-05
G4,C(C)(C1C(C)(C(C(O1)O)O)O)=O,16,1,9,10,49,4.7e-05
G4,C(C1C(C)(CC(O1)O)O)=O,8,1,15,16,6,4.7e-05
G4,C(CO)(C1C(C(OC1C=O)O)O)=O,16,1,13,14,0,4.7e-05
G4,C1(C(OC(C=O)C1CO)O)=O,8,3,12,15,0,0.000146
G4,C(C(C1COC(C1O)O)=O)=O,8,1,15,16,0,4.7e-05
G4,C(C1C(C(OC1C=O)O)O)=O,16,1,15,16,43,4.7e-05
G4,C(C1C(CC(C(CO)O)(O1)O)O)=O,16,3,10,13,41,0.000154
G4,C1C(C)(CC(C(CO)O)(O)O1)O,8,2,7,9,49,0.000106
G4,CC1(CC(CO)(O)OC1CO)O,8,3,5,8,52,0.000165
G4,CC1(C(C(C)(C(CO)O1)O)O)O,16,2,5,7,28,0.000106
G4,CC1(CC(O)OC1CO)O,8,2,4,6,17,0.000106
G4,C(CO)(C1C(C)OC(C1O)O)=O,16,1,9,10,11,4.7e-05
G4,C(CO)(CC1C(CC(O)O1)O)=O,8,2,7,9,21,0.000106
G4,C(CC1C(CC(CO)(O)O1)O)=O,8,3,9,12,21,0.000154
G4,C(C(CC1(COC(C1)O)O)O)=O,8,2,10,12,21,9.499999999999999e-05
G4,C(CC1(CO)CC(C(O)O1)O)=O,8,1,10,11,21,4.7e-05
G4,C(C1COC(C1O)O)=O,8,2,25,27,27,9.499999999999999e-05
G4,C(C1COC(C1O)(C(CO)O)O)=O,16,2,12,14,2,0.000106
G4,C1(C(CC(CO)O)(O)OCC1O)=O,8,1,8,9,0,4.7e-05
G4,C1(C(C(CO)O)(O)OC(CO)C1)=O,8,2,8,10,0,9.6e-05
G4,C1(C(CO)(O)OCC1C(CO)O)=O,8,4,10,14,0,0.000194
G4,C(CO)(C1(C(CO)C(CO1)O)O)=O,8,2,7,9,0,9.499999999999999e-05
G4,C(C1CC(C(C(CO)O)(O1)O)O)=O,16,1,9,10,32,4.7e-05
G4,C1(COC(C(CO)CO)(C1O)O)=O,4,1,8,9,2,4.7e-05
G4,C(CO)(C1COC(CO)(C1O)O)=O,8,3,9,12,30,0.00014199999999999998
G4,C(CO)(C1C(C(C(O1)O)CO)O)=O,16,2,8,10,5,9.499999999999999e-05
G4,C1C(C(CO)C(C(CO)O)(O)O1)O,16,2,7,9,54,0.000106
G4,C(C(C1C(C(C(O)O1)CO)O)O)O,32,2,6,8,43,0.000106
G4,C(CCO)(C1C(C(O)OC1)=O)=O,4,3,9,12,2,0.00014199999999999998
G4,C(CC1C(C(O)OC1)=O)(CO)=O,4,2,11,13,12,9.499999999999999e-05
G4,C(C(C1COC(C1)(CO)O)=O)=O,4,1,13,14,12,4.7e-05
G4,C(C1(CC(C(CO)=O)CO1)O)=O,4,2,11,13,12,9.499999999999999e-05
G4,C(C1C(C(CCO)(O)OC1)=O)=O,4,2,10,12,2,9.499999999999999e-05
G4,C(C1COC(C1O)(CC=O)O)=O,8,3,18,21,23,0.00014199999999999998
G4,C(C1C(CC(CCO)(O1)O)=O)=O,4,2,9,11,30,9.499999999999999e-05
G4,C(C(C(C1COC(C1)O)=O)O)=O,8,1,10,11,43,4.7e-05
G4,C(C1COC(C1)(C(C=O)O)O)=O,8,2,17,19,55,9.499999999999999e-05
G4,C(C(C)=O)(C1COC(C1O)O)=O,8,2,12,14,30,9.499999999999999e-05
G4,C1(C(C)(O)OCC1C(C=O)O)=O,8,1,10,11,14,4.7e-05
G4,C1(CC(C=O)OC1(CCO)O)=O,4,2,7,9,14,9.499999999999999e-05
G4,C(C(CC1(C(CCO1)=O)O)O)=O,4,2,11,13,14,9.499999999999999e-05
G4,C(CC(C1COC(C1O)O)=O)=O,8,2,14,16,30,9.499999999999999e-05
G4,C(C1C2C(C(C(CO)O2)(O)O1)O)O,32,1,2,3,2,4.7e-05
G4,C1(C2(C(CO)C(C(CO)O2)O1)O)O,32,2,4,6,41,9.499999999999999e-05
G4,C1C(C2C(C(C(O)O2)CO)(O)O1)O,32,2,5,7,9,9.499999999999999e-05
G4,C1(C2C(C(C(CCO)(O)O2)O1)O)O,32,2,4,6,30,9.499999999999999e-05
G4,C1(C(C2C(C(C(O)O2)CO)O1)O)O,64,2,6,8,43,9.499999999999999e-05
G4,C1C2C(C(C(C(O)O2)CO)(O)O1)O,32,2,5,7,9,9.499999999999999e-05
G4,C1C2C(CO)C(C(C(O)O2)O)(O)O1,32,2,6,8,54,9.499999999999999e-05
G4,C1C2C(C(C(C(CO)O1)(O)O2)O)O,32,1,4,5,36,4.7e-05
G4,C1C2C(C(CO)C(C(O)O1)(O)O2)O,32,2,5,7,41,9.499999999999999e-05
G4,C12C(C(CO)C(C(CO1)O)(O)O2)O,32,1,4,5,47,4.7e-05
G4,C1C(CO)C2(C(C(C(O1)O2)O)O)O,32,1,5,6,30,4.7e-05
G4,C1C2(C(CO)C(C(C(O)O1)O2)O)O,32,2,4,6,40,9.499999999999999e-05
G4,C1(C2C(CC(C(CO)O1)(O)O2)O)O,32,2,3,5,41,9.499999999999999e-05
G4,C(C(C1C(C(C(O)O1)=O)CO)O)=O,16,3,11,14,15,0.000146
G4,C(C1C(C(CO)C(C=O)(O1)O)O)=O,16,1,11,12,15,4.7e-05
G4,C1(C(O)OC(CO)(C)C1CO)=O,8,4,7,11,49,0.000205
G4,C(C1(C(CO)C(CO1)(C)O)O)=O,8,1,9,10,49,4.7e-05
G4,C1(C(O)OC(C)C1CO)=O,8,3,13,16,4,0.000146
G4,C(C1C(C(C(CCO)(O1)O)O)O)=O,16,5,10,15,30,0.000271
G4,C(C1C(C(CO)C(CO)(O1)O)O)=O,16,6,10,16,40,0.000307
G4,C1C(C)(C(C(CCO)(O)O1)O)O,8,2,6,8,3,0.000106
G4,C1C(C)(C(CO)C(CO)(O)O1)O,8,3,6,9,49,0.000165
G4,C1C(CCO)(CC(CO)(O)O1)O,4,3,6,9,29,0.000165
G4,CC1(C(C(CO1)(CCO)O)O)O,8,2,6,8,3,0.000106
G4,C1C(CC(O)O1)(CCO)O,4,2,5,7,3,0.000106
G4,C(C)(C(C1C(CC(O)O1)O)O)=O,16,1,7,8,49,4.7e-05
G4,C(CC1C(C(C(C)(O)O1)O)O)=O,16,2,11,13,49,9.499999999999999e-05
G4,C(C(C1C(C)(CC(O)O1)O)O)=O,16,1,9,10,16,4.7e-05
G4,C(CC1(C)C(C(C(O)O1)O)O)=O,16,1,11,12,16,4.7e-05
G4,C(C(C1C(OC(C=O)C1O)O)O)=O,32,2,15,17,43,9.499999999999999e-05
G4,C(C1C(C(C=O)O)OC(C1O)O)=O,32,1,13,14,43,4.7e-05
G4,C(C1C(CC(O1)O)O)=O,8,2,29,31,0,9.499999999999999e-05
G4,C1C(C)(CC(CO)(O)O1)O,4,2,5,7,49,0.000106
G4,C1C(C)(C(C(C)(O)O1)O)O,8,1,5,6,49,4.7e-05
G4,C(CO)(CC1CC(C(O)O1)O)=O,8,2,8,10,21,0.000106
G4,C(C)(C(C1CC(C(O)O1)O)O)=O,16,1,8,9,49,4.7e-05
G4,C(C(C1C(O)OCC1(C)O)O)=O,16,2,10,12,49,9.499999999999999e-05
G4,C(C1C(C(O)OC1(C)CO)O)=O,16,2,11,13,49,0.000106
G4,C(CO)(CC1C(C(C(O)O1)O)O)=O,16,3,9,12,20,0.000165
G4,C(C(C1C(CC(CO)(O)O1)O)O)=O,16,3,8,11,20,0.000154
G4,C(C)(C(C1C(C(C(O)O1)O)O)O)=O,32,3,9,12,20,0.000164
G4,C(C(C1C(C(C(C)(O)O1)O)O)O)=O,32,2,10,12,5,9.499999999999999e-05
G4,C1C(C)(CC(O)O1)O,4,1,16,17,18,4.7e-05
G4,C1C(CC(CO)(O)O1)(C(CO)O)O,8,3,7,10,51,0.000165
G4,C(C1(CC(CO)(C(CO)O1)O)O)O,8,3,5,8,29,0.000165
G4,C1C(C(CO)O)(C(C(C)(O)O1)O)O,16,4,7,11,0,0.000223
G4,CC1(C(C(CO)(C(CO)O1)O)O)O,16,2,5,7,29,0.000106
G4,C1C(C)(C(C(C(CO)O)(O)O1)O)O,16,2,7,9,49,0.000106
G4,C(C1C(C)OC(C1O)O)=O,16,1,14,15,4,4.7e-05
G4,C(CC1CC(C(O)O1)O)=O,8,2,16,18,43,9.499999999999999e-05
G4,C1C(CC(O)O1)(C(CO)O)O,8,3,6,9,35,0.000165
G4,C(C1(CC(O)OC1CO)O)O,8,3,4,7,29,0.000165
G4,C(CC1C(CC(CCO)(O1)O)=O)=O,4,1,10,11,30,4.7e-05
G4,C(CC1(CCO)CC(C(O)O1)=O)=O,4,1,8,9,30,4.7e-05
G4,C(CCO)(C1C(C(O)OC1C)=O)=O,8,1,6,7,30,4.7e-05
G4,C(C1(CCC(CO)(O1)O)CC=O)=O,4,1,7,8,29,4.7e-05
G4,C(CC1(CO)CCC(C=O)(O)O1)=O,4,1,9,10,29,4.7e-05
G4,C(C(CCC1(COC(C1)O)O)=O)=O,4,2,9,11,29,9.499999999999999e-05
G4,C(CC1C(C(O)OC1C)=O)(CO)=O,8,1,9,10,12,4.7e-05
G4,C(C(C1C(C)OC(C1)(CO)O)=O)=O,8,1,9,10,12,4.7e-05
G4,C(C1(CC(C(CO)=O)C(C)O1)O)=O,8,1,9,10,12,4.7e-05
G4,C(C1(CC(C(C)(O1)O)O)CC=O)=O,8,1,9,10,22,4.7e-05
G4,C(CC1(C)C(CC(C=O)(O)O1)O)=O,8,1,10,11,22,4.7e-05
G4,C(C(CC1C(C)(CC(O)O1)O)=O)=O,8,1,8,9,22,4.7e-05
G4,C(C(C1C(C(O)OC1C)=O)O)(C)=O,16,3,9,12,45,0.000144
G4,C(C(C1C(C)OC(C)(C1O)O)=O)=O,16,1,10,11,45,4.7e-05
G4,C(CC(C1C(C(O)OC1C)=O)O)=O,16,3,10,13,45,0.000143
G4,C(CC1CC(C(CCO)(O)O1)=O)=O,4,1,6,7,53,4.7e-05
G4,C1(C(CCO)(CC=O)OC(C1)O)=O,4,1,10,11,53,4.7e-05
G4,C(C1C(C(CCO)(O)OC1C)=O)=O,8,1,7,8,7,4.7e-05
G4,C(CC1(C(C(CO)C(C)O1)=O)O)=O,8,1,9,10,4,4.7e-05
G4,C(CC(C1C(C)(CC(O1)O)O)=O)=O,8,1,8,9,6,4.7e-05
G4,C(CC1(C(CC(O)O1)O)CC=O)=O,4,1,6,7,13,4.7e-05
G4,C(CC1CC(C(CC=O)(O)O1)O)=O,8,1,14,15,13,4.7e-05
G4,C(C1C(C)OC(C1O)(CC=O)O)=O,16,1,14,15,4,4.7e-05
G4,C(C1C(CC(O1)O)O)(CC(C)=O)=O,8,1,6,7,26,4.7e-05
G4,C(C1C(CC(O1)O)(CC(C)=O)O)=O,8,1,10,11,27,4.7e-05
G4,C(C1C(CC(CC(C)O)(O1)O)=O)=O,8,1,8,9,4,4.7e-05
G4,C(CCC=O)(C1C(CC(O1)O)O)=O,8,1,9,10,45,4.7e-05
G4,C(CC1(CCC(O)O1)C(C=O)O)=O,8,1,8,9,29,4.7e-05
G4,C(CCC1(CC(OC1C=O)O)O)=O,8,2,14,16,44,9.499999999999999e-05
G4,C(CC1CCC(C(C=O)O)(O)O1)=O,8,1,13,14,44,4.7e-05
G4,C(C(C(C1C(C)OC(C1)O)=O)O)=O,16,1,8,9,46,4.7e-05
G4,C(C1C(C)OC(C1)(C(C=O)O)O)=O,16,1,14,15,46,4.7e-05
G4,C(CC1C(CC(C(C)=O)(O)O1)O)=O,8,1,10,11,21,4.7e-05
G4,C(C(C)=O)(CC1C(CC(O)O1)O)=O,8,1,6,7,21,4.7e-05
G4,C(C)(C1(CC(C(O1)O)O)CC=O)=O,8,1,9,10,21,4.7e-05
G4,C(C(C)=O)(C1C(C)OC(C1O)O)=O,16,1,9,10,14,4.7e-05
G4,C1(C(C)(O)OC(C)C1C(C=O)O)=O,16,1,8,9,14,4.7e-05
G4,C1(CC(C=O)OC1(CC(C)O)O)=O,8,1,6,7,14,4.7e-05
G4,C(C(CC1(C(CC(C)O1)=O)O)O)=O,8,1,9,10,14,4.7e-05
G4,C(CC1C(CC(CC=O)(O)O1)O)=O,8,1,14,15,6,4.7e-05
G4,C(CC(CC1C(CC(O)O1)O)=O)=O,8,1,7,8,6,4.7e-05
G4,C(CC1(CC(C(O)O1)O)CC=O)=O,4,1,7,8,4,4.7e-05
G4,C(CC(C1C(C)OC(C1O)O)=O)=O,16,1,10,11,37,4.7e-05
G4,C(CO)=CC(C1C(CC(O1)O)O)=O,16,1,8,9,11,4.7e-05
G4,C(C1C(C=CCO)(CC(O1)O)O)=O,16,1,6,7,0,4.7e-05
G4,C(C1(C(CO)OC(C1)O)O)=CC=O,16,1,4,5,21,4.7e-05
G4,C(CC1C(C(C(C=C)(O)O1)O)O)=O,16,1,8,9,7,4.7e-05
G4,C=CC(C(C1C(CC(O)O1)O)O)=O,16,1,10,11,7,4.7e-05
G4,C(CC1(C=C)C(C(C(O1)O)O)O)=O,16,1,9,10,7,4.7e-05
G4,C(C(C1C(C=C)(CC(O)O1)O)O)=O,16,1,7,8,7,4.7e-05
G4,C(C1C(CC(O1)O)O)=CC(CO)=O,16,1,4,5,32,4.7e-05
G4,C(C(C=CC1(COC(C1)O)O)O)=O,16,1,5,6,32,4.7e-05
G4,C(C(C1C(CC(O)O1)O)O)=CC=O,32,1,6,7,43,4.7e-05
G4,C1C(CO)(C(C(O)O1)O)O,8,4,5,9,34,0.000223
G4,C1C(C(C(CO)(O)O1)O)O,8,3,5,8,27,0.000164
G4,C(C1C(C(C(O)O1)O)O)O,16,4,5,9,27,0.000223
G4,C(C1(CC(CO1)O)O)=O,4,3,13,16,0,0.00014199999999999998
G4,C(CC1(COC(C1O)O)O)=O,8,3,13,16,5,0.000144
G4,CC1(C(CO)OC(C1O)O)O,16,2,5,7,28,0.000106
G4,C(C(C1(CO)CC(C(O)O1)O)O)=O,16,2,9,11,20,9.499999999999999e-05
G4,C(C(CC1(COC(C1O)O)O)O)=O,16,1,11,12,12,4.7e-05
G4,C(C(C1C(CO)(O)OCC1O)O)=O,16,1,10,11,0,4.7e-05
G4,C(CO)(C1C(CO)OC(C1O)O)=O,16,2,9,11,0,0.000106
G4,C(C(CC1(C(C(CO1)O)O)O)O)=O,16,2,11,13,0,0.000106
G4,C(C1(C(CO)C(CO1)O)O)=O,8,1,8,9,0,4.7e-05
G4,C1(C(O)OC(CO)C1CO)=O,8,7,9,16,0,0.00034700000000000003
G4,C1C(CCO)(C(C(O)O1)O)O,8,2,6,8,3,0.000106
G4,C1C(C(CO)C(CO)(O)O1)O,8,3,5,8,40,0.000165
G4,C(C(C1(C)C(C(C(O)O1)O)O)O)=O,32,2,10,12,26,0.000106
G4,C(C(C1C(C)(C(C(O)O1)O)O)O)=O,32,2,10,12,5,9.499999999999999e-05
G4,C(C(C(C1(CC(CO1)O)O)O)O)=O,16,3,12,15,0,0.000144
G4,C(C1C(C(C(O1)O)O)O)=O,16,5,17,22,1,0.000248
G4,C1C(C)(C(C(O)O1)O)O,8,1,9,10,27,4.7e-05
G4,C1C(CC(CO)(O)O1)O,4,2,8,10,27,0.000106
G4,CC1(C(C(CO1)O)O)O,8,1,9,10,27,4.7e-05
G4,C(C(C1C(O)OCC1O)O)=O,16,2,10,12,38,9.499999999999999e-05
G4,C(C1C(CO)OC(C1O)O)=O,16,5,12,17,41,0.00024900000000000004
G4,C(C(C1C(C(C(O)O1)O)O)O)=O,32,4,11,15,15,0.000212
G4,C1C(CC(O)O1)O,4,2,35,37,43,9.499999999999999e-05
G4,C1C(C(C(O)O1)O)(C(CO)O)O,16,5,7,12,29,0.00028199999999999997
G4,C1(C(C(CO)(C(CO)O1)O)O)O,16,4,5,9,0,0.000223
G4,C(C1(CC(C(C(CO)O)O1)O)O)=O,16,4,8,12,20,0.000223
G4,C1(C(O)OC(C(C(CO)O)O)C1)=O,16,6,9,15,20,0.00033999999999999997
G4,C(C1(CC(C(C(CO)O)O1)O)O)O,16,5,6,11,49,0.00028199999999999997
G4,CC1(C(C(C(C(CO)O)O1)O)O)O,32,4,7,11,49,0.000223
G4,C(C(C1(C(CO)C(CO1)O)O)O)=O,16,3,11,14,54,0.00014199999999999998
G4,C(C(CO)O)(C1COC(C1O)O)=O,16,7,12,19,30,0.00035800000000000003
G4,C(C(C1C(C(C(O)O1)CO)O)O)=O,32,3,9,12,43,0.00014199999999999998
G4,C1(C(CC(CCO)(O)O1)O)=O,4,2,6,8,30,0.000106
G4,C(C1CCC(CO)(O1)O)(O)=O,4,1,6,7,12,4.7e-05
G4,C(C1CC(C(C)(O1)O)O)(O)=O,8,1,7,8,45,4.7e-05
G4,C1(C(CCO)(CC(O)O1)O)=O,4,1,5,6,7,4.7e-05
G4,C(C1(C)CC(C(O1)O)O)(O)=O,8,1,6,7,14,4.7e-05
G4,C1(C(O)OCC1O)=O,4,10,75,85,0,0.000475
G4,C1(COC(C)(C1O)O)=O,4,4,41,45,0,0.00018999999999999998
G4,C1(COC(C1O)O)=O,4,7,94,101,5,0.000332
G4,C1CC(C(O)O1)O,4,1,36,37,28,4.8e-05
G4,C1(C(CC(CO)(O)O1)O)=O,4,1,7,8,33,4.7e-05
G4,C1(C(C(C(C)(O)O1)O)O)=O,8,1,12,13,17,4.7e-05
G4,C1(C(C(C(O)O1)O)O)=O,8,3,23,26,0,0.00014199999999999998
G4,C1(CC(C(O)O1)O)=O,4,1,29,30,45,4.7e-05
G4,C(OC1C(C)(O)OCC1O)=O,8,1,2,3,35,4.7e-05
G4,C(OC1COC(C)(C1O)O)=O,8,1,3,4,9,4.7e-05
G4,C(OC1COC(CO)(C1)O)=O,4,1,3,4,2,4.7e-05
G4,C(COC1(COC(C1)O)O)=O,4,1,7,8,40,4.7e-05
G4,C(COC1CC(C(O)O1)O)=O,8,1,8,9,37,4.7e-05
G4,C1C2C(C(C(C2O)O)(O)O1)O,32,3,6,9,2,0.000153
G4,C(C(C1(C(C(CO1)O)O)O)O)=O,16,2,12,14,34,0.000106
G4,C(C1CC(C(O1)O)O)=O,8,1,22,23,27,4.7e-05
G4,C1(C(C)OC(C1O)O)=O,8,1,35,36,0,4.7e-05
G4,C1(C(CO)OC(C)(C1O)O)=O,8,4,12,16,0,0.000194
G4,C1(COC(C(C)O)(C1O)O)=O,8,2,12,14,2,0.000106
G4,C1(C(C)OC(CO)(C1O)O)=O,8,1,10,11,2,4.7e-05
G4,C1(C(C(C)O)OC(C1O)O)=O,16,4,13,17,2,0.00020299999999999997
G4,CC(C1(C(C(CO1)O)O)O)O,16,3,6,9,4,0.000164
G4,C1(CC(C(C(CO)O)(O)O1)O)=O,8,3,6,9,29,0.000164
G4,C1(C(C(C(C(C)O)(O)O1)O)O)=O,16,2,7,9,2,0.000106
G4,C(C1CCC(C=O)(O1)O)=O,4,1,11,12,12,4.7e-05
G4,C1(CC(C=O)(OC1C)O)=O,4,1,17,18,24,4.7e-05
G4,C(C(C1CCC(O1)O)=O)=O,4,1,12,13,27,4.7e-05
G4,C1C(C2(C(C(CO2)O)O1)O)O,16,2,2,4,10,0.000106
G4,C1C(C2(C(C(CO2)O1)O)O)O,16,2,3,5,2,0.000106
G4,C1C(C2(C(CC(O2)O1)O)O)O,16,2,4,6,38,0.000106
G4,C1C2CC(C(C(O)O1)(O)O2)O,16,3,5,8,41,0.000153
G4,C1C2(C(CC(C(O)O1)O2)O)O,16,3,4,7,40,0.000153
G4,C1C2CC(C(CO)(O)O2)(O)O1,8,2,3,5,0,9.499999999999999e-05
G4,C(CC1(C(CCO1)O)O)=O,4,2,16,18,4,9.499999999999999e-05
G4,C(C(C1(CCCO1)O)O)=O,4,1,15,16,29,4.7e-05
G4,C1(C(CC(O)O1)O)=O,4,1,28,29,45,4.7e-05
G4,C1(CC(C(CC=O)(O)O1)O)=O,4,2,13,15,29,9.499999999999999e-05
G4,C1(CCC(C(C=O)O)(O)O1)=O,4,1,11,12,45,4.7e-05
G4,C(C1(C2(CC(C(C1O)O2)O)O)O)O,32,1,4,5,2,4.7e-05
G4,C(C12C(O)OC(C(C1O)O)C2O)O,64,2,4,6,2,9.499999999999999e-05
G4,C1C(CO)(C(C(O)O1)(CO)O)O,8,2,4,6,5,0.000106
G4,C(C)(C1(C(O)OCC1(CO)O)O)=O,8,1,10,11,5,4.7e-05
G4,C(C1(C(C)(O)OCC1(CO)O)O)=O,8,1,11,12,5,4.7e-05
G4,C1C(CO)(C(CO)(C(C)(O)O1)O)O,8,2,4,6,5,0.000106
G4,C(C1(C(O)OCC1(CO)O)O)=O,8,1,12,13,5,4.7e-05
G4,C1(C(CO)(C(C(CO)O1)O)O)O,16,3,4,7,41,0.000165
G4,C(C1(COC(C)(C1O)O)O)=O,8,1,10,11,24,4.7e-05
G4,C(C1(CO)C(CO)(CC(O1)O)O)=O,8,6,12,18,38,0.0003
G4,C(CC1(COC(C1(CO)O)O)O)=O,8,2,9,11,29,0.000106
G4,C(C)(C1(C(O)OC(CO)C1O)O)=O,16,4,10,14,19,0.00020099999999999998
G4,C(C1(C(C)(O)OC(CO)C1O)O)=O,16,4,11,15,1,0.00020099999999999998
G4,C(C)(C1C(C(CO)(C(O1)O)O)O)=O,16,6,8,14,35,0.000307
G4,C(C1(CO)C(C)(C(C(O1)O)O)O)=O,16,6,13,19,19,0.0003
G4,C(C1C(C)(C(CO)(C(O1)O)O)O)=O,16,4,9,13,19,0.00020099999999999998
G4,C(C1(COC(C1O)O)O)=O,8,1,11,12,34,4.7e-05
G4,CC1(C(CO)(C(C(CO)O1)O)O)O,16,3,4,7,41,0.000165
G4,CC1(C(CO)OC(C1(CO)O)O)O,16,3,4,7,28,0.000165
G4,C(C1(COC(C1O)(CCO)O)O)=O,8,3,11,14,7,0.000164
G4,C(C1(COC(C1(CCO)O)O)O)=O,8,3,10,13,41,0.00014199999999999998
G4,C1C(CCO)(C(C(O)O1)(CO)O)O,8,3,5,8,3,0.000165
G4,C(C1(C(O)OC(CO)C1O)O)=O,16,2,12,14,1,0.000106
G4,C(C1(CO)C(C(C(O1)O)O)O)=O,16,4,14,18,1,0.000205
G4,C(C1C(C(CO)(C(O1)O)O)O)=O,16,2,10,12,1,0.000106
G4,C1C(C)(C(C(O)O1)(CO)O)O,8,2,4,6,49,0.000106
G4,C(CC1C(C(C(O)O1)(CO)O)O)=O,16,5,9,14,43,0.00026000000000000003
G4,C(C)(C1(COC(C)(C1O)O)O)=O,8,2,9,11,0,9.499999999999999e-05
G4,C(C)(C1(COC(C1(C)O)O)O)=O,8,1,8,9,45,4.7e-05
G4,C(C1(C(C(OC1C(C)=O)O)O)O)=O,16,1,13,14,0,4.7e-05
G4,C(C1(C(C(C)(OC1C=O)O)O)O)=O,16,1,13,14,0,4.7e-05
G4,C(C1(C(C(OC1(C=O)C)O)O)O)=O,16,1,13,14,45,4.7e-05
G4,C(C1(C(C(OC1C=O)O)(C)O)O)=O,16,1,12,13,45,4.7e-05
G4,C(CO)(C1(COC(C)(C1O)O)O)=O,8,1,9,10,0,4.7e-05
G4,C(CO)(C1(COC(C1(C)O)O)O)=O,8,1,8,9,42,4.7e-05
G4,C(C1(C=O)C(CC(CO)(O1)O)O)=O,4,1,9,10,40,4.7e-05
G4,C(C1(C(O)OCC1(CC=O)O)O)=O,8,1,14,15,1,4.7e-05
G4,C(C1(C=O)C(CO)(CC(O1)O)O)=O,4,1,9,10,1,4.7e-05
G4,C(C1(C(OC(C(C)=O)C1O)O)O)=O,16,1,14,15,1,4.7e-05
G4,C(C1(C=O)C(C(C(C)(O1)O)O)O)=O,8,1,10,11,1,4.7e-05
G4,C(C1(C(OC(C=O)C1(C)O)O)O)=O,16,1,14,15,1,4.7e-05
G4,C(C1(C=O)C(C)(C(C(O1)O)O)O)=O,8,1,10,11,1,4.7e-05
G4,C(C1(C(C)=O)C(C(C(O1)O)O)O)=O,16,1,11,12,1,4.7e-05
G4,C(C1C(C(C(C)=O)(C(O1)O)O)O)=O,16,1,14,15,1,4.7e-05
G4,C(C1(C(C(C=O)OC1(C)O)O)O)=O,16,1,14,15,1,4.7e-05
G4,C(C)(C1(C(O)OCC1(C)O)O)=O,8,2,10,12,49,9.499999999999999e-05
G4,C(C1(C(C)(O)OCC1(C)O)O)=O,8,1,11,12,49,4.7e-05
G4,C(C)(C1(C(C(OC1C=O)O)O)O)=O,16,1,13,14,0,4.7e-05
G4,C(C1(C(C(OC1C=O)O)O)O)=O,16,1,15,16,0,4.7e-05
G4,C(CO)(C1(COC(C1O)O)O)=O,8,1,9,10,5,4.7e-05
G4,C1(C(C(CO)O)(C(C(O)O1)O)O)=O,16,3,11,14,0,0.000144
G4,C(C1(C(CO)OC(C1O)O)O)(O)=O,16,2,9,11,0,0.000106
G4,C(C1(C(O)OC(CO)C1(C)O)O)=O,16,4,11,15,35,0.00020099999999999998
G4,C(C1C(C(CO)(C(C)(O1)O)O)O)=O,16,6,9,15,1,0.000307
G4,C1C(C)(C(CO)(C(C)(O)O1)O)O,8,2,4,6,49,0.000106
G4,C1(COC(C(CO)(CO)O)(C1)O)=O,2,2,6,8,2,0.000106
G4,C(C)(C1(COC(CO)(C1O)O)O)=O,8,3,9,12,2,0.00014199999999999998
G4,C(C1(COC(C1O)(C(C)O)O)O)=O,16,2,11,13,25,0.000106
G4,C(C(C)O)(C1(COC(C1O)O)O)=O,16,2,10,12,12,0.000106
G4,C1C(C(CO)(C(CCO)(O)O1)O)O,8,2,5,7,9,0.000106
G4,C1(C(CO)(C(C(CCO)O1)O)O)O,16,2,5,7,29,0.000106
G4,C1C2(C(CO)(C(C(CO)O2)O1)O)O,16,1,2,3,2,4.7e-05
G4,C1C(C2(CO)C(CC(O)O2)(O)O1)O,16,2,4,6,9,9.499999999999999e-05
G4,CC1(C2(CO)C(C(C(O)O2)O1)O)O,32,2,3,5,1,9.499999999999999e-05
G4,C1C2C(CO)(C(CC(O)O2)(O)O1)O,16,2,4,6,9,9.499999999999999e-05
G4,C1C2CC(C(C(O)O2)(CO)O)(O)O1,16,2,4,6,2,9.499999999999999e-05
G4,C1C2(C(CO)(C(C(CO1)O2)O)O)O,16,1,3,4,36,4.7e-05
G4,C12C(CC(C(CO1)(CO)O)(O)O2)O,16,1,3,4,2,4.7e-05
G4,C12C(C(CO)(C(CCO1)(O)O2)O)O,16,1,3,4,30,4.7e-05
G4,C(C1(COC(C=C)(C1O)O)O)=O,8,3,11,14,7,0.00014199999999999998
G4,C=CC(C1(COC(C1O)O)O)=O,8,3,13,16,12,0.00014199999999999998
G4,CC1(C2C(C(C(O)O2)(CO)O1)O)O,32,2,3,5,35,9.499999999999999e-05
G4,C1(C(CO)(C2C(CC(O)O2)O1)O)O,32,2,5,7,43,9.499999999999999e-05
G4,C1(C2(CO)C(C(CC(O)O2)O1)O)O,32,2,3,5,37,9.499999999999999e-05
G4,C(C1(C(O)OCC1(CCO)O)O)=O,8,4,12,16,1,0.00020099999999999998
G4,C(C1(C(C)OC(C)(C1O)O)O)=O,16,1,10,11,0,4.7e-05
G4,C(C)(C1(C(C)OC(C1O)O)O)=O,16,1,9,10,11,4.7e-05
G4,C(C1(C(OC(C=O)C1O)O)O)=O,16,1,16,17,1,4.7e-05
G4,C(C1(C=O)C(C(C(O1)O)O)O)=O,8,1,11,12,1,4.7e-05
G4,C(C(C=O)(C1C(CC(O)O1)O)O)=O,8,1,6,7,43,4.7e-05
G4,C(C1(C(O)OC(C1O)CC=O)O)=O,16,1,16,17,43,4.7e-05
G4,C(C(C=O)(C1CC(C(O)O1)O)O)=O,8,1,7,8,1,4.7e-05
G4,C(C(C1(C(O)OCC1(C)O)O)O)=O,16,1,10,11,49,4.7e-05
G4,C(C1(C(C(O)OC1(CO)C)O)O)=O,16,2,10,12,49,0.000106
G4,C1C(C)(C(CO)(C(CO)(O)O1)O)O,8,2,4,6,49,0.000106
G4,C(C1(C(C)OC(C1O)O)O)=O,16,1,10,11,25,4.7e-05
G4,C(C1(C(C(C=C)(O)OC1C)O)O)=O,16,1,8,9,7,4.7e-05
G4,C=CC(C1(C(C)OC(C1O)O)O)=O,16,1,12,13,12,4.7e-05
G4,C1C(C(C(O)O1)(CO)O)O,8,3,4,7,27,0.000165
G4,C1C(C(CO)(C(C)(O)O1)O)O,8,2,4,6,0,0.000106
G4,C(C)(C(C1(C(O)OCC1O)O)O)=O,16,4,9,13,0,0.000202
G4,C(C1(C(CO)OC(C)(C1O)O)O)=O,16,2,10,12,0,0.000106
G4,C(C(C1(C(C)(O)OCC1O)O)O)=O,16,1,10,11,0,4.7e-05
G4,C(C)(C1(C(CO)OC(C1O)O)O)=O,16,2,9,11,0,0.000106
G4,C(C1(C(O)OCC1O)O)=O,8,1,12,13,1,4.7e-05
G4,C(C(C1(C(O)OCC1O)O)O)=O,16,4,11,15,0,0.00020299999999999997
G4,C(C1(C(CO)OC(C1O)O)O)=O,16,4,11,15,0,0.00020099999999999998
G4,C1C(C(CO)(C(CO)(O)O1)O)O,8,2,4,6,40,0.000106
G4,C(C1(C(CO)OC(C1(C)O)O)O)=O,16,2,9,11,45,0.000106
G4,C(C(C)(C1(C(O)OCC1O)O)O)=O,16,3,9,12,45,0.000154
G4,CC(CO)(C1(C(O)OCC1O)O)O,16,3,5,8,49,0.000165
G4,C1C(C)(C(C(O)O1)(C(CO)O)O)O,16,5,6,11,49,0.00028199999999999997
G4,C1C(C(C(O)O1)(C(C)O)O)O,16,2,5,7,4,0.000106
G4,C(CC1(C(CO)(C(CO1)O)O)O)=O,8,4,9,13,9,0.00020099999999999998
G4,C(CCO)(C1(COC(C1O)O)O)=O,8,6,10,16,2,0.000309
G4,C1(C2(CC(C(C2O)O1)O)O)O,32,3,5,8,43,0.000153
G4,C1(C2(CC(C(C2O)O)O1)O)O,32,3,6,9,43,0.000153
G4,C(CC1(C(O)OCC1(CO)O)O)=O,8,1,9,10,43,4.7e-05
G4,C(C1(CC(O)OC1(CO)CO)O)=O,4,1,6,7,43,4.7e-05
G4,C(CC1(C(O)OC(CO)C1O)O)=O,16,2,9,11,41,0.000106
G4,C(C1(CC(O)OC1C(CO)O)O)=O,16,3,9,12,41,0.000165
G4,C(C1(CC(OC1C(C)=O)O)O)=O,8,2,10,12,49,9.499999999999999e-05
G4,C(C1(CC(OC1(C=O)C)O)O)=O,8,1,10,11,49,4.7e-05
G4,C1(C(C(C)(C(O)O1)O)O)=O,8,1,11,12,45,4.7e-05
G4,C(C1C(CO)(CC(O1)O)O)(O)=O,8,3,7,10,29,0.000154
G4,C(C1C(C)(C(C(O1)O)O)O)(O)=O,16,3,8,11,29,0.000154
G4,C(C1(CC(CO)(OC1C=O)O)O)=O,8,1,11,12,51,4.7e-05
G4,C(C1(CC(OC1C=O)O)O)=O,8,1,12,13,2,4.7e-05
G4,C(C1(COC(CO)(C1)O)O)=O,4,1,8,9,2,4.7e-05
G4,C(C1(C(C)OC(CO)(C1)O)O)=O,8,1,8,9,41,4.7e-05
G4,C(C1(COC(C1)O)O)=O,4,2,13,15,27,9.499999999999999e-05
G4,C(C(CO)O)(C1(COC(C1)O)O)=O,8,3,9,12,2,0.000153
G4,C1(C(O)OCC1(CC(CO)O)O)=O,8,1,8,9,20,4.7e-05
G4,C(C1(C(CO)(CC(CO)O1)O)O)=O,8,1,8,9,0,4.7e-05
G4,C(CO)(C1CC(C(O1)O)(CO)O)=O,8,2,7,9,43,9.499999999999999e-05
G4,C(C1CC(CO)(C(CO)(O1)O)O)=O,8,1,8,9,32,4.7e-05
G4,C(C(C1(C(CO)(CCO1)O)O)O)=O,8,1,10,11,2,4.7e-05
G4,C(CO)(C1(COC(CO)(C1)O)O)=O,4,1,7,8,32,4.7e-05
G4,C(C(C1CC(C(O)O1)(CO)O)O)=O,16,2,9,11,43,9.499999999999999e-05
G4,C(C1(CC(C(C)=O)(CO1)O)O)=O,4,2,9,11,45,9.499999999999999e-05
G4,C(CC(C1(COC(C1)O)O)=O)=O,4,2,10,12,2,9.499999999999999e-05
G4,C(C1(COC(C(C)=O)(C1)O)O)=O,4,2,9,11,14,9.499999999999999e-05
G4,C(C1(COC(C1)(CC=O)O)O)=O,4,2,14,16,14,9.499999999999999e-05
G4,C(C1(C2(CC(C(CO)O2)O1)O)O)O,16,1,3,4,2,4.7e-05
G4,C1C2C(CC(C(CO)(O)O1)(O)O2)O,16,1,4,5,41,4.7e-05
G4,C1(C(C(C(O)O1)(CCO)O)O)=O,8,1,6,7,29,4.7e-05
G4,C(CC1(C(C(C=O)OC1O)O)O)=O,16,1,16,17,1,4.7e-05
G4,C(C1(C(C(C=O)O)OC(C1)O)O)=O,16,1,10,11,1,4.7e-05
G4,C(C1(C(C(C(O1)O)O)O)CC=O)=O,16,1,13,14,1,4.7e-05
G4,C(C1C(C(C(O1)O)O)O)(O)=O,16,3,10,13,17,0.000165
G4,C(CC1(C(O)OCC1(C)O)O)=O,8,2,10,12,49,9.499999999999999e-05
G4,C(C1(CC(O)OC1(CO)C)O)=O,8,2,7,9,29,0.000106
G4,C(C1(C(C)OC(C1)O)O)=O,8,1,7,8,4,4.7e-05
G4,C(C(C1C(C(C(O)O1)O)O)O)(O)=O,32,3,9,12,29,0.000165
G4,C(C1(CC(C(C)=O)(C(C)O1)O)O)=O,8,1,7,8,45,4.7e-05
G4,C(CC(C1(C(C)OC(C1)O)O)=O)=O,8,1,7,8,4,4.7e-05
G4,C(C1(CC(C(C)=O)(O)OC1C)O)=O,8,1,7,8,14,4.7e-05
G4,C(C1(C(C)OC(C1)(CC=O)O)O)=O,8,1,11,12,25,4.7e-05
G4,C(CO)(CC1(C(O)OCC1O)O)=O,8,2,8,10,51,9.499999999999999e-05
G4,C(C1(C(CO)OC(CO)(C1)O)O)=O,8,2,8,10,51,0.000106
G4,C(C1(C(CO)OC(C1)O)O)=O,8,2,7,9,0,0.000106
G4,C(C1(COC(C1)(C(CO)O)O)O)=O,8,3,10,13,14,0.000164
G4,C(CO)(OC1C(O)OCC1O)=O,8,1,1,2,40,4.7e-05
G4,C(CO)(OC1COC(C1O)O)=O,8,1,3,4,50,4.7e-05
G4,C1(C(C2(CC1CO2)O)O)=O,8,3,18,21,47,0.00014199999999999998
G4,C1(C(C)(O)OC(CO)C1O)=O,8,2,6,8,0,9.499999999999999e-05
G4,C1(CC2(CC1(CO2)O)O)=O,4,3,11,14,2,0.00014199999999999998
G4,C1(C2C(C(C(CO)O2)O1)O)O,32,2,1,3,26,0.000106
G4,C1C2C(C(C(CO)O2)(O)O1)O,16,1,2,3,2,4.7e-05
G4,C1C2(CC(C(CO)O2)(O)O1)O,8,2,2,4,2,9.499999999999999e-05
G4,C(C1(C2CC(CO2)O1)O)=O,8,1,4,5,39,4.7e-05
G4,C(C1C2CC(C(O)O2)O1)=O,16,2,11,13,40,9.499999999999999e-05
G4,C1C(C2C(C(C(O)O2)O1)O)O,32,2,1,3,37,0.000106
G4,C1C2(CC(C(CO2)O)(O)O1)O,8,2,3,5,2,9.499999999999999e-05
G4,C1C2(C(C(CCO2)(O)O1)O)O,8,2,4,6,2,9.499999999999999e-05
G4,C1(C2(CC(C(CO)O2)O1)O)=O,8,3,1,4,27,0.00014199999999999998
G4,C1(CC2(C(C(CO2)O)O1)O)=O,8,3,3,6,2,0.00014199999999999998
G4,C1(C2C(C(C(C)(O2)O)O1)O)=O,16,2,5,7,2,9.499999999999999e-05
G4,C1(C(C2C(CC(O)O2)O1)O)=O,16,2,4,6,27,9.499999999999999e-05
G4,C1(CC2(C(C(CO2)O1)O)O)=O,8,2,4,6,2,9.499999999999999e-05
G4,C1(C(C2(CC(CO2)O1)O)O)=O,8,2,5,7,50,9.499999999999999e-05
G4,C1(C2(CC(C(CO1)O2)O)O)=O,8,2,3,5,27,9.499999999999999e-05
G4,C1(C2C(CC(CO1)(O2)O)O)=O,8,2,6,8,2,9.499999999999999e-05
G4,C1(C2(C(C(C(CO)O2)O1)O)O)O,32,2,4,6,5,9.499999999999999e-05
G4,C1(C2CC(C(CO)(O)O2)O1)O,16,2,3,5,40,9.499999999999999e-05
G4,C1CC2C(C(C(O)O2)O)(O)O1,16,2,5,7,2,9.499999999999999e-05
G4,C1C(C2C(C(C(O)O2)(O)O1)O)O,32,2,4,6,5,9.499999999999999e-05
G4,C1(C2CC(C(C(O)O2)O)O1)O,32,2,4,6,37,9.499999999999999e-05
G4,C1C2C(C(C(C(O)O1)(O)O2)O)O,32,2,6,8,2,9.499999999999999e-05
G4,C1(CC2C(C(C(O)O2)O)O1)=O,16,3,4,7,8,0.00014199999999999998
G4,C1(CC2C(C(C(O)O2)O1)O)=O,16,2,3,5,8,9.499999999999999e-05
G4,C(C(CC1C(CO)OC(C1)O)=O)=O,8,1,9,10,46,4.7e-05
G4,C(CC1CC(C=O)(O)OC1CO)=O,8,1,10,11,46,4.7e-05
G4,C(C(C(CC1COC(C1)O)=O)O)=O,8,1,8,9,55,4.7e-05
G4,C(CC1COC(C1)(C(C=O)O)O)=O,8,1,15,16,55,4.7e-05
G4,C(C1C(CC(O1)O)CC(CO)=O)=O,8,1,10,11,32,4.7e-05
G4,C(CC1CC(CO)(OC1C=O)O)=O,8,1,10,11,32,4.7e-05
G4,C(CC1C(C(C=O)O)OC(C1)O)=O,16,1,13,14,43,4.7e-05
G4,C1(COC(C(C)(C1O)O)O)=O,8,8,11,19,2,0.00037999999999999997
G4,C1(C(O)OCC(CO)(C1)O)=O,4,4,10,14,5,0.00018999999999999998
G4,C1(C(C(CO)(CO)OC(C1)O)O)=O,4,2,5,7,2,9.499999999999999e-05
G4,C1(C(C(O)OC(CO)(CO)C1)O)=O,4,1,7,8,5,4.7e-05
G4,C1(COC(C(C1O)O)O)=O,8,6,21,27,5,0.000285
G4,CC1(C(COC(CO)(C1O)O)O)O,16,1,6,7,5,4.7e-05
G4,C1(COC(C(C1O)O)(CCO)O)=O,8,2,10,12,5,9.499999999999999e-05
G4,C1(COC(C(CCO)(C1O)O)O)=O,8,1,9,10,5,4.7e-05
G4,C(C1(CCOC(CO)(C1O)O)O)=O,8,1,10,11,5,4.7e-05
G4,C1(C(O)OCC(CO)(C1CO)O)=O,8,3,10,13,5,0.000146
G4,C1CC(CO)(C(C(CO)(O)O1)O)O,8,2,6,8,55,0.000106
G4,C(CO)(C1C(C(CC(O1)O)O)O)=O,16,1,9,10,51,4.7e-05
G4,C(CO)(C1C(CC(C(O1)O)O)O)=O,16,1,9,10,51,4.7e-05
G4,C(C1CC(C(C(CO)(O1)O)O)O)=O,16,1,9,10,51,4.7e-05
G4,C(C1C(C(O)OCC1(CO)O)O)=O,16,1,13,14,51,4.7e-05
G4,C(CO)(C1C(O)OCC(C1O)O)=O,16,2,11,13,41,9.499999999999999e-05
G4,C(C1C(CO)(O)OCC(C1O)O)=O,16,1,13,14,30,4.7e-05
G4,C(CC1(C(C(C(CO1)O)O)O)O)=O,16,3,12,15,3,0.000164
G4,C1(C(C(C(CO)O)OC(C1)O)O)=O,16,3,8,11,49,0.000165
G4,C(C(C1(CC(C(CO1)O)O)O)O)=O,16,2,12,14,41,0.000106
G4,C1(C(C(O)OC(C(CO)O)C1)O)=O,16,3,10,13,29,0.000165
G4,C1C(C(CC(C(CO)O)(O)O1)O)O,16,2,8,10,41,0.000106
G4,C(C1(C(CO)C(C(CO1)O)O)O)=O,16,5,10,15,41,0.000259
G4,C1C(C(C(C(CCO)(O)O1)O)O)O,16,3,8,11,3,0.000165
G4,C1C(C(C(CO)C(CO)(O)O1)O)O,16,3,7,10,41,0.000165
G4,C(C1C(C(O)OC(CO)C1O)O)=O,32,2,12,14,37,0.000106
G4,C(C(C1C(O)OCC(C1O)O)O)=O,32,2,11,13,41,9.499999999999999e-05
G4,C1C(C(CC(O)O1)O)O,8,1,10,11,27,4.7e-05
G4,C(CC1(COC(C(C1)=O)O)O)=O,4,2,12,14,51,9.499999999999999e-05
G4,C(C1C(COC(C)(C1O)O)=O)=O,8,3,11,14,24,0.00014199999999999998
G4,C(C1C(COC(C1(C)O)O)=O)=O,8,3,11,14,16,0.00014199999999999998
G4,C1(C(C(C(C)=O)OC(C1)O)O)=O,8,3,11,14,49,0.00014199999999999998
G4,C(C1(C)C(C(CC(O1)O)=O)O)=O,8,1,11,12,49,4.7e-05
G4,C(C)(C1C(CC(C(O1)O)=O)O)=O,8,3,9,12,49,0.00014199999999999998
G4,C(C1C(C)(CC(C(O1)O)=O)O)=O,8,2,10,12,26,9.499999999999999e-05
G4,C(C1C(CC(C(C)(O1)O)O)=O)=O,8,2,9,11,29,9.499999999999999e-05
G4,C1(CC(C(C)=O)OC(C1O)O)=O,8,3,12,15,29,0.00014199999999999998
G4,C(C1C(CC(C)(C(O1)O)O)=O)=O,8,1,9,10,16,4.7e-05
G4,C(C1(C)CC(C(C(O1)O)O)=O)=O,8,1,12,13,16,4.7e-05
G4,C1(C(O)OC(CO)C(C)(C1)O)=O,8,2,7,9,29,0.000106
G4,C(C1(CC(C)(C(CO1)O)O)O)=O,8,1,9,10,29,4.7e-05
G4,C1(C(CO)OC(C(C1)O)(C)O)=O,8,5,8,13,45,0.00025299999999999997
G4,C1(C(CO)OC(C(C)(C1)O)O)=O,8,4,8,12,16,0.000205
G4,C(C1(CC(C=O)(O)OCC1)O)=O,4,1,10,11,29,4.7e-05
G4,C1(C(O)OCC(CCO)(C1)O)=O,4,2,8,10,29,0.000106
G4,C(C1(CC(CO)(CCO1)O)O)=O,4,2,9,11,29,0.000106
G4,C1(COC(C)(C(C1CO)O)O)=O,8,5,10,15,45,0.00025299999999999997
G4,C1(COC(C(C)(C1CO)O)O)=O,8,4,10,14,16,0.000205
G4,C(C1C(CC(C(O1)O)=O)O)=O,8,4,14,18,15,0.00018999999999999998
G4,C1(C(O)OCC(C)(C1)O)=O,4,3,16,19,49,0.00014199999999999998
G4,C1(COC(C(C)(C1)O)O)=O,4,5,19,24,16,0.00023700000000000001
G4,C(CC1C(CC(C(O)O1)=O)O)=O,8,2,14,16,20,9.499999999999999e-05
G4,C(C1CC(CC(C=O)(O1)O)O)=O,8,1,10,11,20,4.7e-05
G4,C(C(C1C(CC(C(O)O1)=O)O)O)=O,16,1,13,14,0,4.7e-05
G4,C(C1C(C(CC(C=O)(O1)O)O)O)=O,16,1,12,13,0,4.7e-05
G4,C1(C(O)OCC(C(CO)O)(C1)O)=O,8,4,9,13,51,0.000223
G4,C1(C(O)OC(CO)C(CO)(C1)O)=O,8,1,7,8,51,4.7e-05
G4,C(C1(CC(CO)(C(CO1)O)O)O)=O,8,2,9,11,51,0.000106
G4,C1(C(CO)OC(C(C)(C1O)O)O)=O,16,3,9,12,2,0.000146
G4,C(C1C(COC(C1O)O)=O)=O,8,3,14,17,15,0.00014199999999999998
G4,C1(C(C(C=O)OC(C1)O)O)=O,8,2,17,19,2,9.499999999999999e-05
G4,C1(C(COC(C1)O)O)=O,4,6,41,47,27,0.000285
G4,C1(C(C(C(C=O)O)OC(C1)O)O)=O,16,1,10,11,1,4.7e-05
G4,C1(C(C(CO)(C)OC(C1)O)O)=O,8,2,6,8,49,0.000106
G4,C1(C(C(C)OC(C1)O)O)=O,8,1,18,19,4,4.7e-05
G4,C(C1C(CC(C(O1)O)O)=O)=O,8,2,13,15,15,9.499999999999999e-05
G4,C1(CC(C=O)OC(C1O)O)=O,8,2,17,19,15,9.499999999999999e-05
G4,C1(C(C(O)OCC1)O)=O,4,4,43,47,27,0.00018999999999999998
G4,C1(C(C(O)OC(C(C=O)O)C1)O)=O,16,1,12,13,1,4.7e-05
G4,C1(C(C(O)OC(CO)(C)C1)O)=O,8,2,8,10,49,0.000106
G4,C1(C(C(O)OC(C)C1)O)=O,8,1,20,21,4,4.7e-05
G4,C1(C(CO)OC(C(C1O)O)O)=O,16,5,10,15,5,0.000252
G4,C1C(C(C)(CC(CO)(O)O1)O)O,8,2,6,8,52,0.000106
G4,CC1(C(COC(C)(C1O)O)O)O,16,1,6,7,28,4.7e-05
G4,C1C(C(C)(CC(O)O1)O)O,8,1,5,6,17,4.7e-05
G4,C(C1CC(CO)(CC(O1)O)O)=O,8,1,9,10,21,4.7e-05
G4,C1(C(C(CO)O)(O)OCC(C1)O)=O,8,2,9,11,0,9.6e-05
G4,C1(C(COC(C(CO)O)(C1)O)O)=O,8,3,9,12,2,0.000153
G4,C1(C(C(CCO)(O)OCC1O)O)=O,8,2,9,11,5,9.499999999999999e-05
G4,C1(C(C(C(CO)O)(O)OCC1)O)=O,8,2,10,12,9,0.000106
G4,C1(COC(C(C1)O)(C(CO)O)O)=O,8,1,9,10,32,4.7e-05
G4,C1(COC(CO)(C(CO)C1O)O)=O,8,2,8,10,2,9.499999999999999e-05
G4,C1(COC(CC1O)(C(CO)O)O)=O,8,2,9,11,2,9.499999999999999e-05
G4,C(C1COC(CO)(C(C1O)O)O)=O,16,2,12,14,5,0.000106
G4,C1(C(CO)C(C(C(CO)O1)O)O)O,32,3,6,9,55,0.000165
G4,C(C1(C(CO)CC(CO1)=O)O)=O,4,2,10,12,12,9.499999999999999e-05
G4,C(CO)(C1COC(C(C1)=O)O)=O,4,3,11,14,12,0.00014199999999999998
G4,C(C(C1COC(CC1O)O)=O)=O,8,1,14,15,33,4.7e-05
G4,C(C1COC(C=O)(CC1O)O)=O,8,1,14,15,23,4.7e-05
G4,C(C1C(CC(CO)(O)OC1)=O)=O,4,4,12,16,30,0.00018999999999999998
G4,C1(CC(O)OCC1C(CO)=O)=O,4,5,9,14,12,0.00023700000000000001
G4,C(CC1(CC(C(CO1)O)=O)O)=O,4,3,13,16,3,0.00014199999999999998
G4,C(C1C(C(C(C)(O)OC1)O)=O)=O,8,2,12,14,26,9.499999999999999e-05
G4,C(CC1(C(C(CCO1)=O)O)O)=O,4,3,14,17,9,0.00014199999999999998
G4,C1(C(C(O)OCC1C(C)=O)O)=O,8,3,11,14,12,0.00014199999999999998
G4,C1(CCOC(C(C=O)O)(C1)O)=O,4,2,14,16,41,9.499999999999999e-05
G4,C1(C(COC(C1O)O)CC=O)=O,8,2,15,17,43,9.499999999999999e-05
G4,C(C1C(CC(CO)C(O1)O)=O)=O,8,2,10,12,55,9.499999999999999e-05
G4,C1(C(COC(C1)O)C(C=O)O)=O,8,2,14,16,2,9.499999999999999e-05
G4,C1C(C2C(C(C(CO)O2)(O)O1)O)O,32,1,2,3,2,4.7e-05
G4,C1C(C2C(CO)C(C(O)O2)(O)O1)O,32,2,4,6,41,9.499999999999999e-05
G4,C1(C(CO)C2C(C(C(O)O2)O1)O)O,64,2,4,6,55,9.499999999999999e-05
G4,C1C2C(C(C(C(CO)O2)(O)O1)O)O,32,1,4,5,2,4.7e-05
G4,C1C2C(C(CO)C(C(O)O2)(O)O1)O,32,2,5,7,41,9.499999999999999e-05
G4,C(C(C1COC(C(C1O)O)O)=O)=O,16,1,14,15,15,4.7e-05
G4,C(C1C(C(C(C(O1)O)=O)CO)O)=O,16,3,12,15,15,0.000146
G4,C1(C(O)OCC(C)(C1CO)O)=O,8,3,10,13,49,0.000146
G4,C1(COC(C(C1)O)(CCO)O)=O,4,2,8,10,3,9.499999999999999e-05
G4,C(C1(CCOC(CO)(C1)O)O)=O,4,2,9,11,3,0.000106
G4,C1(COC(C(CCO)(C1)O)O)=O,4,1,8,9,3,4.7e-05
G4,C(C1(CCOC(C)(C1O)O)O)=O,8,1,10,11,3,4.7e-05
G4,C(C1(CC(O)OCC1)O)=O,4,1,8,9,3,4.7e-05
G4,C(CO)(C1COC(C(C1O)O)O)=O,16,4,11,15,12,0.000223
G4,C1CC(CO)(CC(CO)(O)O1)O,4,3,6,9,29,0.000165
G4,CC1(C(C(CO)(CCO1)O)O)O,8,2,6,8,3,0.000106
G4,C1CC(CO)(CC(O)O1)O,4,2,5,7,3,0.000106
G4,C(C)(C1C(C(CC(O1)O)O)O)=O,16,1,9,10,43,4.7e-05
G4,C(C1C(C(C)(CC(O1)O)O)O)=O,16,1,10,11,16,4.7e-05
G4,C(C1C(C(C=O)OC(C1O)O)O)=O,32,1,15,16,43,4.7e-05
G4,C(C1C(C(C(OC1C=O)O)O)O)=O,32,1,14,15,43,4.7e-05
G4,C(C1CC(CC(CO)(O1)O)O)=O,8,2,8,10,21,0.000106
G4,C(C)(C1C(CC(C(O1)O)O)O)=O,16,1,9,10,49,4.7e-05
G4,C(C1CC(C(C(C)(O1)O)O)O)=O,16,1,10,11,49,4.7e-05
G4,C(C1C(C(O)OCC1(C)O)O)=O,16,1,14,15,49,4.7e-05
G4,C(C1C(C(CC(CO)(O1)O)O)O)=O,16,2,10,12,20,0.000106
G4,C(C)(C1C(C(C(C(O1)O)O)O)O)=O,32,4,11,15,49,0.000223
G4,C(C1C(C(C(C(C)(O1)O)O)O)O)=O,32,2,12,14,24,0.000106
G4,C1C(C(CO)(CC(CO)(O)O1)O)O,8,3,6,9,29,0.000165
G4,C1C(C(CO)(C(C(C)(O)O1)O)O)O,16,3,6,9,45,0.000165
G4,C(C1CC(CC(O1)O)O)=O,8,1,11,12,43,4.7e-05
G4,C1C(C(CO)(CC(O)O1)O)O,8,2,5,7,37,0.000106
G4,C(C(CC1(CC(O)OCC1)O)=O)=O,4,1,10,11,30,4.7e-05
G4,C1(CC(C=O)(O)OC(C)C1CO)=O,8,1,9,10,4,4.7e-05
G4,C(CC1C(CCC(CO)(O1)O)=O)=O,4,1,7,8,7,4.7e-05
G4,C(CC1(CO)CCC(C(O)O1)=O)=O,4,1,10,11,29,4.7e-05
G4,C(C1(C(C(C)O)CC(CO1)=O)O)=O,8,1,9,10,12,4.7e-05
G4,C(CO)(C1C(C)OC(C(C1)=O)O)=O,8,1,9,10,12,4.7e-05
G4,C(CC1C(CC(C(C)(O1)O)O)=O)=O,8,1,9,10,45,4.7e-05
G4,C(C1(CC(C(C)=O)OC(C1)O)O)=O,8,1,8,9,22,4.7e-05
G4,C(CC1(C)C(CC(C(O)O1)=O)O)=O,8,1,11,12,22,4.7e-05
G4,C(C1(CC(CC(O1)O)O)CC=O)=O,8,1,8,9,13,4.7e-05
G4,C(C1(CC(O)OC(C1)CC=O)O)=O,8,1,10,11,13,4.7e-05
G4,C(CC1CC(CC(C=O)(O)O1)O)=O,8,1,10,11,13,4.7e-05
G4,C(C(CC1CC(CC(O)O1)O)=O)=O,8,1,7,8,13,4.7e-05
G4,C(C(C1C(C)OC(CC1O)O)=O)=O,16,1,10,11,4,4.7e-05
G4,C(C1C(CC(C=O)(O)OC1C)O)=O,16,1,11,12,23,4.7e-05
G4,C(CC(C1(CC(O)OCC1)O)=O)=O,4,1,8,9,53,4.7e-05
G4,C(CC1CC(CC(CO)(O)O1)=O)=O,4,1,8,9,26,4.7e-05
G4,C(CC1(CO)CC(CC(O)O1)=O)=O,4,1,8,9,26,4.7e-05
G4,C(C1C(CC(CO)(O)OC1C)=O)=O,8,1,8,9,4,4.7e-05
G4,C1(CC(O)OC(C)C1C(CO)=O)=O,8,2,6,8,4,9.499999999999999e-05
G4,C(CC1(CC(C(C(C)O1)O)=O)O)=O,8,1,10,11,4,4.7e-05
G4,C(CC1CC(C(C(C)(O)O1)O)=O)=O,8,1,10,11,9,4.7e-05
G4,C(CC1(C)C(C(CC(O)O1)=O)O)=O,8,1,8,9,6,4.7e-05
G4,C(C1C(C(C(C)(O)OC1C)O)=O)=O,16,1,9,10,9,4.7e-05
G4,C(CC1(C(C(CC(C)O1)=O)O)O)=O,8,1,11,12,9,4.7e-05
G4,C(CC(C1CC(CC(O1)O)O)=O)=O,8,1,7,8,13,4.7e-05
G4,C(CC1C(C(CC(C)(O)O1)=O)O)=O,8,1,9,10,26,4.7e-05
G4,C(CC1(C)CC(C(C(O)O1)O)=O)=O,8,1,10,11,6,4.7e-05
G4,C1(C(C(O)OC(C)C1C(C)=O)O)=O,16,1,8,9,2,4.7e-05
G4,C1(CC(C)OC(C(C=O)O)(C1)O)=O,8,1,11,12,4,4.7e-05
G4,C1(C(C(C)OC(C1O)O)CC=O)=O,16,1,12,13,4,4.7e-05
G4,C(C1C(CC(C(O1)O)C(C)O)=O)=O,16,1,9,10,46,4.7e-05
G4,C(CC1C(CC(C(C)(O)O1)=O)O)=O,8,1,10,11,21,4.7e-05
G4,C(C1CC(C(C)=O)(CC(O1)O)O)=O,8,1,8,9,21,4.7e-05
G4,C1(C(C)(CC=O)OC(C(C1)O)O)=O,8,1,9,10,21,4.7e-05
G4,C1(C(C(C)OC(C1)O)C(C=O)O)=O,16,2,11,13,4,9.499999999999999e-05
G4,C(C1(C(COC(C1)O)O)O)=CC=O,16,1,5,6,21,4.7e-05
G4,C=CC(C1C(C(CC(O1)O)O)O)=O,16,1,12,13,7,4.7e-05
G4,C(C1C(C(C=C)(CC(O1)O)O)O)=O,16,1,8,9,7,4.7e-05
G4,C(C1C(C(CC(O1)O)O)O)=CC=O,32,1,7,8,29,4.7e-05
G4,CC1(C(COC(C1O)O)O)O,16,1,6,7,28,4.7e-05
G4,C(C1C(CO)(CC(C(O1)O)O)O)=O,16,1,11,12,20,4.7e-05
G4,C(C1CC(CO)(C(C(O1)O)O)O)=O,16,1,10,11,20,4.7e-05
G4,C(CO)(C1C(C(O)OCC1O)O)=O,16,1,11,12,20,4.7e-05
G4,C(C1(C(C(O)OCC1)O)O)=O,8,2,10,12,30,9.499999999999999e-05
G4,C1(C(O)OCC(C1CO)O)=O,8,6,11,17,2,0.00028900000000000003
G4,C1CC(CO)(C(C(O)O1)O)O,8,2,6,8,3,0.000106
G4,C(C1C(C)(C(C(C(O1)O)O)O)O)=O,32,2,12,14,26,0.000106
G4,C(C1C(C(C)(C(C(O1)O)O)O)O)=O,32,1,11,12,0,4.7e-05
G4,C(C1C(C(O)OCC1O)O)=O,16,6,14,20,30,0.000285
G4,C(C1C(C(C(C(O1)O)O)O)O)=O,32,5,13,18,15,0.00028199999999999997
G4,C1C(C(CO)(C(C(O)O1)O)O)O,16,5,6,11,2,0.00028199999999999997
G4,C1(C(O)OC(C(C1)O)C(CO)O)=O,16,4,8,12,20,0.000223
G4,C(C1(CC(C(C(CO)O1)O)O)O)=O,16,3,8,11,20,0.000165
G4,C(C1(CC(C(C(CO)O1)O)O)O)O,16,3,6,9,49,0.000165
G4,CC1(C(C(C(C(CO)O1)O)O)O)O,32,3,7,10,45,0.000165
G4,C1(C(C(O)OCC1C(CO)O)O)=O,16,5,12,17,27,0.000261
G4,C(C1C(C(C(CO)C(O1)O)O)O)=O,32,4,11,15,55,0.000212
G4,C1(C(CCC(CO)(O)O1)O)=O,4,1,5,6,12,4.7e-05
G4,C1(C(CC(C(C)(O)O1)O)O)=O,8,1,6,7,24,4.7e-05
G4,C(C1CC(CC(O1)O)O)(O)=O,8,2,7,9,33,0.000106
G4,C1(C(C)(CC(C(O)O1)O)O)=O,8,1,6,7,14,4.7e-05
G4,C1CC(C(C(CO)(O)O1)O)O,8,3,6,9,30,0.000165
G4,C1(C(CC(C(CO)(O)O1)O)O)=O,8,2,5,7,17,0.000106
G4,C1(CC(C(C(CO)(O)O1)O)O)=O,8,2,6,8,17,0.000106
G4,C1C2CC(C(C(O)O2)(O)O1)O,16,3,5,8,30,0.000153
G4,C(C1(CC(CCO1)O)O)=O,4,1,8,9,4,4.7e-05
G4,C1(CC(CC(C=O)(O)O1)O)=O,4,1,9,10,28,4.7e-05
G4,C1C(C(C(C(O)O1)(CO)O)O)O,16,3,6,9,2,0.000165
G4,C(C1(COC(CO)(CC1O)O)O)=O,8,2,11,13,30,0.000106
G4,C(C1(COC(CC1(CO)O)O)O)=O,8,1,10,11,41,4.7e-05
G4,C(C)(C1(C(O)OCC(C1O)O)O)=O,16,1,12,13,1,4.7e-05
G4,C(C1(C(C)(O)OCC(C1O)O)O)=O,16,1,13,14,26,4.7e-05
G4,C(C1(COC(C)(C(C1O)O)O)O)=O,16,4,12,16,26,0.000223
G4,C(C1(COC(C(C1(C)O)O)O)O)=O,16,1,11,12,1,4.7e-05
G4,C1C(C(C(CO)(C(C)(O)O1)O)O)O,16,2,6,8,41,0.000106
G4,CC1(C(COC(C1(CO)O)O)O)O,16,2,5,7,28,0.000106
G4,C(C1(CCOC(C1(CO)O)O)O)=O,8,2,9,11,3,0.000106
G4,C1CC(CO)(C(C(O)O1)(CO)O)O,8,3,5,8,3,0.000165
G4,C(C1(C(O)OCC(C1O)O)O)=O,16,1,14,15,1,4.7e-05
G4,C(C1(COC(C(C1O)O)O)O)=O,16,1,13,14,1,4.7e-05
G4,C(C1CC(C(CO)(C(O1)O)O)O)=O,16,3,9,12,43,0.000165
G4,C1(COC(C(C)(C1(CO)O)O)O)=O,8,4,10,14,2,0.000205
G4,C1(COC(C(C1(CO)O)O)O)=O,8,4,11,15,5,0.000205
G4,C(C1(C(C(O)OCC1O)O)O)(O)=O,16,3,11,14,15,0.000165
G4,C(C1(C(O)OCC(C1(C)O)O)O)=O,16,1,12,13,12,4.7e-05
G4,C(C)(C1(COC(C(C1O)O)O)O)=O,16,4,11,15,12,0.000223
G4,C1(COC(C)(C(CO)(C1O)O)O)=O,8,1,8,9,5,4.7e-05
G4,C1(C(C)OC(C(CO)(C1O)O)O)=O,16,1,8,9,25,4.7e-05
G4,C(CO)(C1(COC(CC1O)O)O)=O,8,2,9,11,12,0.000106
G4,C1(CC(O)OCC1(C(C)=O)O)=O,4,3,6,9,12,0.00014199999999999998
G4,C(C1(C(CC(C)(O)OC1)=O)O)=O,4,2,8,10,26,9.499999999999999e-05
G4,C1C2(C(CO)(C(C(CO2)O)O1)O)O,16,1,2,3,2,4.7e-05
G4,C1C2(C(CO)(C(C(CO2)O1)O)O)O,16,1,3,4,54,4.7e-05
G4,C(C1(CCOC(C1(C=O)O)O)O)=O,8,1,14,15,3,4.7e-05
G4,C(C1(C(O)OCCC1(CO)O)O)=O,8,2,12,14,12,0.000106
G4,C(C1(C=O)C(C(CC(O1)O)O)O)=O,8,1,10,11,43,4.7e-05
G4,C(C1(C=O)C(CC(C(O1)O)O)O)=O,8,1,10,11,43,4.7e-05
G4,C(C1(C(OC(C=O)CC1O)O)O)=O,16,1,15,16,43,4.7e-05
G4,C(C1(C(C(O)OCC1(C)O)O)O)=O,16,1,13,14,27,4.7e-05
G4,C1(CC(O)OC(C)C1(C(C)=O)O)=O,8,1,4,5,9,4.7e-05
G4,C(C1(C(CC(C)(O)OC1C)=O)O)=O,8,1,6,7,2,4.7e-05
G4,C(C1(C(COC(C)(C1O)O)O)O)=O,16,2,13,15,24,0.000106
G4,C(C)(C1(C(C(O)OCC1O)O)O)=O,16,1,12,13,26,4.7e-05
G4,C(C1(C(C(O)OCC1O)O)O)=O,16,4,14,18,15,0.00020099999999999998
G4,C(C1(C(COC(C1(C)O)O)O)O)=O,16,2,12,14,16,0.000106
G4,C1(CC(O)OCC1(C(CO)O)O)=O,8,6,10,16,12,0.00032
G4,C(C1(CC(O)OCC1(CO)O)O)=O,8,1,9,10,43,4.7e-05
G4,C(C1(CC(O)OC(CO)C1O)O)=O,16,3,9,12,37,0.000154
G4,C(CC1(C(O)OCC(C1O)O)O)=O,16,1,11,12,41,4.7e-05
G4,C1(C(C(CO)(CC(O)O1)O)O)=O,8,1,6,7,43,4.7e-05
G4,C1(C(C(C)(C(C(O)O1)O)O)O)=O,16,1,7,8,28,4.7e-05
G4,C(C(C1(C(OCC(C1)=O)O)O)O)=O,8,1,13,14,51,4.7e-05
G4,C1(COC(C(CO)(C1)O)O)=O,4,5,11,16,2,0.00023700000000000001
G4,C1(COC(C(C(C)O)(C1)O)O)=O,8,1,8,9,41,4.7e-05
G4,C(C1(C(CO)(CC(CO1)O)O)O)=O,8,1,9,10,20,4.7e-05
G4,C(C1(COC(CO)(C(C1)O)O)O)=O,8,1,9,10,43,4.7e-05
G4,C(CO)(C1(COC(C(C1)O)O)O)=O,8,2,8,10,32,9.499999999999999e-05
G4,C1(C(C(O)OCC1(CCO)O)O)=O,8,1,9,10,2,4.7e-05
G4,C1(COC(CO)(C(CO)(C1)O)O)=O,4,1,7,8,32,4.7e-05
G4,C(C1C(CC(CO)(C(O1)O)O)O)=O,16,1,10,11,43,4.7e-05
G4,C(C)(C1(COC(C(C1)=O)O)O)=O,4,3,9,12,45,0.00014199999999999998
G4,C1(C(COC(C1)O)(CC=O)O)=O,4,2,12,14,12,9.499999999999999e-05
G4,C(C1(COC(C(C1)=O)(C)O)O)=O,4,2,8,10,14,9.499999999999999e-05
G4,C1C(C2CC(C(CO)(O)O2)(O)O1)O,16,1,3,4,2,4.7e-05
G4,C1C2C(CC(C(CO)(O)O2)(O)O1)O,16,1,4,5,2,4.7e-05
G4,C(C1(C(C(C=O)OC(C1)O)O)O)=O,16,1,12,13,1,4.7e-05
G4,C1(C(C(C(C(O)O1)O)O)O)=O,16,1,10,11,17,4.7e-05
G4,C(C1(CC(O)OCC1(C)O)O)=O,8,1,9,10,43,4.7e-05
G4,C(C1C(C(C(C(O1)O)O)O)O)(O)=O,32,3,11,14,29,0.000165
G4,C(C)(C1(C(C)OC(C(C1)=O)O)O)=O,8,1,7,8,45,4.7e-05
G4,C1(C(C(C)OC(C1)O)(CC=O)O)=O,8,2,9,11,4,9.6e-05
G4,C(C1(C(C)OC(C(C1)=O)(C)O)O)=O,8,1,6,7,14,4.7e-05
G4,C(C1(C(COC(CO)(C1)O)O)O)=O,8,1,10,11,51,4.7e-05
G4,C1(COC(C(C(CO)O)(C1)O)O)=O,8,2,9,11,51,0.000106
G4,C1(C(CO)OC(C(CO)(C1)O)O)=O,8,3,8,11,2,0.000146
G4,C1(C(C)(O)OCC(C1O)O)=O,8,5,9,14,2,0.000248
G4,C1C2C(C(C(C(O)O2)O1)O)O,32,1,3,4,37,4.7e-05
G4,C1C2(C(CC(CO2)(O)O1)O)O,8,2,4,6,32,9.499999999999999e-05
G4,C1(C2(CC(C(CO2)O)O1)O)=O,8,3,1,4,27,0.00014199999999999998
G4,C1(C2C(C(CC(O2)O)O1)O)=O,16,2,5,7,27,9.499999999999999e-05
G4,C1(C2(CC(C(CO2)O1)O)O)=O,8,2,3,5,50,9.499999999999999e-05
G4,C1C2C(C(C(C(O)O2)(O)O1)O)O,32,2,6,8,15,9.499999999999999e-05
G4,C1(C2CC(C(C(O)O2)O1)O)O,32,2,3,5,37,9.499999999999999e-05
G4,C(CC1C(CO)OC(C(C1)=O)O)=O,8,2,11,13,46,9.6e-05
G4,C(C(CC1CC(O)OCC1O)=O)=O,8,1,10,11,46,4.7e-05
G4,C(CC1CC(C=O)(O)OCC1O)=O,8,1,11,12,46,4.7e-05
G4,C(CC1C(OC(C(C1)=O)CO)O)=O,8,2,12,14,43,9.6e-05
G4,C1(C(CC(OC1CO)O)CC=O)=O,8,1,11,12,46,4.7e-05
G4,C(CC1C(C(C=O)OC(C1)O)O)=O,16,1,14,15,43,4.7e-05
G4,C1(COC(CO)(CC(C1O)O)O)=O,8,2,10,12,32,9.499999999999999e-05
G4,C1(COC(CO)(C(C(C1)O)O)O)=O,8,2,9,11,12,0.000106
G4,C1(COC(CC(CO)(C1O)O)O)=O,8,2,9,11,5,9.499999999999999e-05
G4,C1(C(C(COC(C1)O)(CO)O)O)=O,8,4,9,13,5,0.000212
G4,C1(COC(C)(C(C(C1O)O)O)O)=O,16,2,11,13,5,9.499999999999999e-05
G4,C1(COC(C(C(C)(C1O)O)O)O)=O,16,1,10,11,5,4.7e-05
G4,C1(C(C(O)OCC(CO)(C1)O)O)=O,8,2,10,12,5,0.000106
G4,C1(C(C(C(CO)(O)OCC1)O)O)=O,8,4,10,14,30,0.00020099999999999998
G4,C1(COC(C(C(C1O)O)O)O)=O,16,2,11,13,5,9.499999999999999e-05
G4,C1(C(C(C(CO)OC(C1)O)O)O)=O,16,5,9,14,38,0.00026000000000000003
G4,C1(C(C(O)OC(C(C1)O)CO)O)=O,16,3,9,12,19,0.000154
G4,C(C1C(C(O)OCC(C1O)O)O)=O,32,2,14,16,30,0.000106
G4,C(C1(CC(CC(CO1)=O)O)O)=O,4,2,11,13,20,9.499999999999999e-05
G4,C1(C(O)OCC(C(C)(C1)O)O)=O,8,1,8,9,29,4.7e-05
G4,C1(C(COC(C(C1)O)(C)O)O)=O,8,2,8,10,45,9.499999999999999e-05
G4,C1(C(COC(C(C)(C1)O)O)O)=O,8,1,8,9,16,4.7e-05
G4,C1(C(CC(C=O)(O)OCC1)O)=O,4,2,11,13,20,9.499999999999999e-05
G4,C(C1(CCOC(C(C1)=O)O)O)=O,4,1,10,11,29,4.7e-05
G4,C1(C(O)OCCC(CO)(C1)O)=O,4,2,8,10,29,0.000106
G4,C1(C(C(C(C)(O)OCC1)O)O)=O,8,2,10,12,45,9.499999999999999e-05
G4,C1(C(C(C(O)OCC1)(C)O)O)=O,8,1,9,10,45,4.7e-05
G4,C(C1CC(CC(C(O1)O)=O)O)=O,8,1,11,12,20,4.7e-05
G4,C(C1C(C(CC(C(O1)O)=O)O)O)=O,16,1,13,14,0,4.7e-05
G4,C1(C(O)OCC(C(CO)(C1)O)O)=O,8,2,8,10,51,0.000106
G4,C1(C(C(C(C)(O)OCC1O)O)O)=O,16,2,10,12,0,9.499999999999999e-05
G4,C1(C(C(C(O)OCC1O)(C)O)O)=O,16,1,9,10,42,4.7e-05
G4,C(C1C(COC(C(C1O)O)O)=O)=O,16,1,12,13,1,4.7e-05
G4,C1(C(C(C(C=O)OC(C1)O)O)O)=O,16,1,14,15,1,4.7e-05
G4,C1(C(C(COC(C1)O)(C)O)O)=O,8,1,9,10,49,4.7e-05
G4,C1(COC(CO)(CC(C1)O)O)=O,4,3,8,11,49,0.000154
G4,C1(COC(CC(CO)(C1)O)O)=O,4,1,8,9,49,4.7e-05
G4,C1(COC(C)(C(C(C1)O)O)O)=O,8,2,9,11,49,9.499999999999999e-05
G4,C(C1C(CC(C(C(O1)O)O)O)=O)=O,16,1,11,12,1,4.7e-05
G4,C1(C(C(OC(C=O)C(C1)O)O)O)=O,16,1,14,15,1,4.7e-05
G4,C1(C(C(O)OCC(C)(C1)O)O)=O,8,1,10,11,49,4.7e-05
G4,C1(COC(C(C(C)(C1)O)O)O)=O,8,1,9,10,55,4.7e-05
G4,C1(CC(C=O)OC(C(C1O)O)O)=O,16,1,14,15,0,4.7e-05
G4,C1(C(C(C=O)OC(C(C1)O)O)O)=O,16,1,13,14,0,4.7e-05
G4,C1(C(C(C(O)OCC1O)O)O)=O,16,4,10,14,5,0.00020099999999999998
G4,C1(C(C(C)OC(C(C1)O)O)O)=O,16,1,8,9,11,4.7e-05
G4,C1(C(CC(CO)(O)OCC1O)O)=O,8,2,8,10,32,9.499999999999999e-05
G4,C1(C(COC(C(C1)O)(CO)O)O)=O,8,2,8,10,2,9.499999999999999e-05
G4,C1(COC(C(CO)C(C1O)O)O)=O,16,3,10,13,5,0.000153
G4,C1C(C(C(C(C(O)O1)CO)O)O)O,32,2,8,10,38,0.000106
G4,C1(C(COC(C=O)(CC1)O)O)=O,4,2,11,13,12,9.499999999999999e-05
G4,C(C1COC(C(CC1O)=O)O)=O,8,2,13,15,23,9.499999999999999e-05
G4,C(C1C(C(CC(O)OC1)O)=O)=O,8,4,11,15,38,0.00018999999999999998
G4,C(C1COC(CC(C1O)=O)O)=O,8,4,14,18,23,0.00018999999999999998
G4,C(C1COC(C(C(C1)=O)O)O)=O,8,3,15,18,55,0.00014199999999999998
G4,C12C(C(C(C(C(O)O1)CO)O2)O)O,64,1,5,6,23,4.7e-05
G4,C1(C(CC(CO)(O)OCC1)O)=O,4,3,8,11,20,0.000154
G4,C1(C(C(C(O)OC(C)C1)O)O)=O,16,1,10,11,11,4.7e-05
G4,C1(C(CO)C(C)OC(C(C1)=O)O)=O,8,1,7,8,4,4.7e-05
G4,C1(C(C(C)OC(C=O)(CC1)O)O)=O,8,1,9,10,12,4.7e-05
G4,C1(CC(C(C)=O)OC(CC1O)O)=O,8,1,8,9,45,4.7e-05
G4,C1(C(CC(C=O)(O)OC(C)C1)O)=O,8,1,9,10,22,4.7e-05
G4,C(CC1C(CC(CC(O1)O)O)=O)=O,8,1,9,10,13,4.7e-05
G4,C(CC1CC(C(CC(O)O1)O)=O)=O,8,2,8,10,13,9.499999999999999e-05
G4,C(CC1CC(CC(C(O)O1)=O)O)=O,8,1,12,13,13,4.7e-05
G4,C(C1C(CC(C(O)OC1C)=O)O)=O,16,1,10,11,23,4.7e-05
G4,C1(C(CC(O)OC(C)C1CO)=O)=O,8,1,8,9,4,4.7e-05
G4,C1(CC(CC(OC1C(C)=O)O)O)=O,8,1,6,7,9,4.7e-05
G4,C(CC1CC(C(CC(O)O1)=O)O)=O,8,2,12,14,13,9.499999999999999e-05
G4,C(C1C(C(CC(O)OC1C)O)=O)=O,16,2,8,10,4,9.499999999999999e-05
G4,C(C1C(C)OC(CC(C1O)=O)O)=O,16,2,11,13,4,9.499999999999999e-05
G4,C(C1C(CC(C)(CC(O1)O)O)=O)=O,8,1,8,9,6,4.7e-05
G4,C(CC1C(C(CCC(O)O1)=O)O)=O,8,1,8,9,45,4.7e-05
G4,C(CC1CCC(C(C(O)O1)O)=O)=O,8,1,13,14,44,4.7e-05
G4,C(C1C(C)OC(C(C(C1)=O)O)O)=O,16,1,12,13,46,4.7e-05
G4,C1(CC(C=O)OC(CC1(C)O)O)=O,8,1,7,8,21,4.7e-05
G4,C(CC1C(CC(CC(O)O1)=O)O)=O,8,1,13,14,6,4.7e-05
G4,C(CC1CC(CC(C(O)O1)O)=O)=O,8,1,9,10,26,4.7e-05
G4,C(C1C(CC(C(O)OC1C)O)=O)=O,16,1,9,10,37,4.7e-05
G4,C1(C(C(CO)OC(C(C1)O)O)O)=O,16,3,8,11,0,0.000154
G4,C1(C(C(C(O)OC(CO)C1)O)O)=O,16,2,10,12,0,0.000106
G4,C1(C(O)OC(CO)C(C(C1)O)O)=O,16,3,8,11,12,0.000165
G4,C(C1(CC(C(C(CO1)O)O)O)O)=O,16,4,11,15,20,0.000223
G4,C1C(C(C(CC(CO)(O)O1)O)O)O,16,4,8,12,20,0.000223
G4,CC1(C(C(C(C(CO1)O)O)O)O)O,32,4,9,13,45,0.000223
G4,C(C1COC(C(C(C1O)O)O)O)=O,32,5,14,19,23,0.00028199999999999997
G4,C1(C(CC(CC(O)O1)O)O)=O,8,1,6,7,33,4.7e-05
G4,C1C(C(CC(C(O)O1)O)O)O,16,3,7,10,29,0.000164
G4,C1(C(C(CC(C(O)O1)O)O)O)=O,16,3,8,11,43,0.000164
G4,C1C(CC(C(C(O)O1)O)O)O,16,3,7,10,44,0.000164
G4,C1(C(CC(C(C(O)O1)O)O)O)=O,16,3,7,10,29,0.000164
G4,C1(COC(C(CO)(C(C1)O)O)O)=O,8,5,8,13,35,0.00026000000000000003
G4,C1(C(C(C(O)OCC1)(CO)O)O)=O,8,4,9,13,2,0.000212
G4,C(C1(COC(CC(C1O)O)O)O)=O,16,4,12,16,38,0.000223
G4,C(C1(COC(C(CC1O)O)O)O)=O,16,2,12,14,43,0.000106
G4,C(C1(C(OCC(CC1O)=O)O)O)=O,8,1,15,16,1,4.7e-05
G4,C1CC(C(C(C(O)O1)(CO)O)O)O,16,1,7,8,29,4.7e-05
G4,C(C1(C(CCC(O)OC1)=O)O)=O,4,2,8,10,38,9.499999999999999e-05
G4,C1C2(CC(C(C(O)O1)(CO)O2)O)O,16,2,3,5,35,9.499999999999999e-05
G4,C12CC(C(C(C(O)O1)(CO)O)O2)O,32,1,4,5,2,4.7e-05
G4,C(C1(C(O)OCCC(C1O)=O)O)=O,8,1,16,17,3,4.7e-05
G4,C(C1(C(CCC(O)OC1C)=O)O)=O,8,1,6,7,4,4.7e-05
G4,C(C1(CC(O)OCC(C1O)O)O)=O,16,1,11,12,41,4.7e-05
G4,C(C1(C(C(OCC(C1)=O)O)O)O)=O,8,1,13,14,51,4.7e-05
G4,C1(COC(C(CO)(CC1O)O)O)=O,8,2,8,10,43,9.499999999999999e-05
G4,C(C1(COC(C(C(C1)O)O)O)O)=O,16,2,11,13,43,0.000106
G4,C1(C(C(C(O)OCC1(C)O)O)O)=O,16,2,10,12,30,0.000106
G4,C(C1(COC(CC(C1)=O)O)O)=O,4,3,12,15,38,0.00014199999999999998
G4,C1(C(C(C(C(C(O)O1)O)O)O)O)=O,32,1,10,11,33,4.7e-05
G4,C(C1(C(C)OC(CC(C1)=O)O)O)=O,8,1,9,10,25,4.7e-05
G4,C1(C(COC(C(CO)(C1)O)O)O)=O,8,2,8,10,43,9.499999999999999e-05
G4,C1C2C(C(C(C(O)O1)O2)O)O,32,1,3,4,26,4.7e-05
G4,C12C(CC(C(C(O)O1)O)O2)O,32,2,4,6,43,0.000106
G4,C(CC1C(COC(C(C1)=O)O)O)=O,8,2,12,14,46,9.6e-05
G4,C(C1C(CC(CO)CC(O1)O)=O)=O,8,1,8,9,55,4.7e-05
G4,C(CC1COC(C(C(C1)=O)O)O)=O,8,2,14,16,55,9.6e-05
G4,C(C1CC(OC(C(C1)=O)CO)O)=O,8,1,11,12,43,4.7e-05
G4,C(CC1C(O)OCC(C(C1)=O)O)=O,8,2,13,15,38,9.6e-05
G4,C1(C(CC(O)OCC1O)CC=O)=O,8,1,11,12,46,4.7e-05
G4,C(C(C1C(CCCC(O1)O)=O)O)=O,8,1,8,9,27,4.7e-05
G4,C(C(C1CC(OCC(C1)=O)O)O)=O,8,1,11,12,32,4.7e-05
G4,C(CC1C(C(OCC(C1)=O)O)O)=O,8,2,14,16,32,9.6e-05
G4,C1(C(CO)(CC(CO)O1)O)=O,4,2,3,5,29,9.499999999999999e-05
G4,C1(C(CCO1)(CC=O)O)=O,2,3,13,16,28,0.000144
G4,C1(C(C)(CC(C=O)O1)O)=O,4,1,9,10,14,4.7e-05
G4,C1(C(C(C(C(CO)O)O1)O)=O)=O,8,3,5,8,29,0.00014199999999999998
G4,C1(C(CC(C(C=O)O)O1)O)=O,8,5,9,14,29,0.000248
G4,C1(C(C(CO)(CO1)O)O)=O,4,3,10,13,5,0.00014199999999999998
G4,C1(C(C(C(CO)O1)O)O)=O,8,4,9,13,33,0.00020099999999999998
G4,C(CC1(COC(C1O)=O)O)=O,4,3,12,15,29,0.00014199999999999998
G4,C1(C(C(C)(C(C=O)O1)O)O)=O,8,4,12,16,2,0.00018999999999999998
G4,C1(C(C(C)(C(CO)O1)O)O)=O,8,4,5,9,2,0.00020099999999999998
G4,C1(C(C(CO1)(CCO)O)O)=O,4,3,7,10,29,0.000154
G4,C1(C(C(C(C=O)O1)O)O)=O,8,2,21,23,17,9.499999999999999e-05
G4,C1(C(C(C)(CO1)O)O)=O,4,2,20,22,27,9.499999999999999e-05
G4,C1(C(C(C(C(C=O)O)O1)O)O)=O,16,2,10,12,29,9.499999999999999e-05
G4,C1(C(C(CO1)(C(CO)O)O)O)=O,8,4,7,11,29,0.00020099999999999998
G4,C1(C(C(CO)(C(CO)O1)O)O)=O,8,4,4,8,29,0.00018999999999999998
G4,C1(C(CO)(CC(CO1)O)O)=O,4,1,5,6,29,4.7e-05
G4,C1(C(C(C(C(CO)O1)O)O)=O)=O,8,3,7,10,29,0.00014199999999999998
G4,C1(C(CC(C(C=O)O1)O)O)=O,8,4,12,16,29,0.00020099999999999998
G4,C1(C2C(CC(CO)(O2)O1)O)=O,8,2,4,6,2,9.499999999999999e-05
G4,C1(C2C(C(C(C)(O2)O1)O)O)=O,16,1,5,6,2,4.7e-05
G4,C1(C(C(C(CO1)O)O)O)=O,8,3,12,15,33,0.000153
G4,C1(C(C(C)(C(CO1)O)O)O)=O,8,2,7,9,2,9.499999999999999e-05
G4,C(C1(CCOC(C1O)=O)O)=O,4,2,9,11,29,9.499999999999999e-05
G4,C1(C(C(CO)(CCO1)O)O)=O,4,4,7,11,29,0.00020099999999999998
G4,C1(C(C(C(C(C=O)O1)O)O)O)=O,16,1,14,15,29,4.7e-05
G4,C1(C(C(CO)(C(CO1)O)O)O)=O,8,3,6,9,29,0.00014199999999999998
G4,C1(C(C(C(CCO1)O)O)O)=O,8,4,9,13,29,0.000212
G4,C1(C(C(C(C(CO1)O)O)O)=O)=O,8,2,10,12,29,9.499999999999999e-05
G4,C1(CC(C(C(C(O1)=O)O)O)O)=O,8,2,9,11,29,9.499999999999999e-05
G4,C1(CC2C(C(C(O2)O1)O)O)=O,16,1,3,4,29,4.7e-05
G4,C1(C(C2C(CC(O2)O1)O)O)=O,16,1,3,4,2,4.7e-05
G4,C1(C2C(C(CC(O2)O1)O)O)=O,16,1,6,7,2,4.7e-05
G4,C1(C(C(C(C(C=O)O)C1)O)O)=O,16,4,20,24,12,0.00019099999999999998
G4,C1(C(C(C)(C(C(C=O)O)C1)O)O)=O,16,1,18,19,32,4.7e-05
G4,C1(C(C(C(CC1)O)O)O)=O,8,3,21,24,7,0.00014199999999999998
G4,C(C1(C(CCC(C1O)=O)O)O)=O,8,7,18,25,20,0.000332
G4,C1(C(C(CC1)O)(C(C=O)O)O)=O,8,3,18,21,20,0.00014199999999999998
G4,C(C1(C(CC(CO)C1(C)O)=O)O)=O,8,1,13,14,29,4.7e-05
G4,C(C1C(C)(C(C(C1)=O)(CO)O)O)=O,8,1,16,17,41,4.7e-05
G4,C(C1(C(CCC(C1O)=O)(C)O)O)=O,8,5,16,21,7,0.00023700000000000001
G4,C1(C(C(CC1)(C)O)(C(C=O)O)O)=O,8,1,16,17,7,4.7e-05
G4,C1(C(C(C(C(CO)C1)O)O)O)=O,16,3,15,18,55,0.000143
G4,C1(C(C(C(C(CCO)C1)O)O)O)=O,16,4,13,17,46,0.00020099999999999998
G4,C1(C(C(C(C(C(C)O)C1)O)O)O)=O,32,3,15,18,46,0.000143
G4,C(CC(C(C=O)CC(CO)=O)O)=O,4,7,17,24,18,0.000334
G4,C(CC(C=O)C(C=O)CO)(CO)=O,4,4,16,20,18,0.000204
G4,C(CO)(C(C(CC=O)O)CC=O)=O,4,6,18,24,18,0.000298
G4,C(CC(C(CO)=O)C(C=O)CO)=O,4,4,16,20,46,0.000205
G4,C(CC(CCC(C=O)=O)O)=O,2,5,22,27,7,0.000239
G4,C(C(CCC(C=O)=O)CO)=O,2,4,17,21,7,0.000204
G4,C(CC(CCC(CO)=O)O)=O,2,7,20,27,7,0.00034500000000000004
G4,C(C(CO)CCC(CO)=O)=O,2,5,17,22,7,0.000262
G4,C(CC(C(C=O)CC=O)O)=O,4,6,22,28,18,0.00028700000000000004
G4,C(CC(C=O)C(C=O)CO)=O,4,6,18,24,18,0.0003
G4,C(C(CCC(C=O)=O)C(C)O)=O,4,2,16,18,7,9.7e-05
G4,C(CC(CCCC(C=O)=O)O)=O,2,2,19,21,7,9.7e-05
G4,C(CC(C)(CCC(C=O)=O)O)=O,2,1,20,21,7,4.8e-05
G4,C(C(CCC(CO)=O)C(C)O)=O,4,3,14,17,7,0.000155
G4,C(CC(CCCC(CO)=O)O)=O,2,3,15,18,7,0.000155
G4,C(CC(C)(CCC(CO)=O)O)=O,2,2,16,18,7,0.00010700000000000001
G4,C(CC(C=O)C(C=O)C(C)O)=O,8,4,17,21,28,0.000193
G4,C(CC(CC(C=O)CC=O)O)=O,4,4,21,25,43,0.000192
G4,C(CC(C)(C(C=O)CC=O)O)=O,4,4,19,23,28,0.000192
G4,C(C(C(CCCC(C=O)=O)O)O)=O,4,8,17,25,7,0.000393
G4,C(C(C(CCC(C=O)=O)(C)O)O)=O,4,5,18,23,7,0.00023799999999999998
G4,C(C(CCC(CO)=O)(C(C)O)O)=O,4,4,13,17,7,0.00021400000000000002
G4,C(C(C(CCCC(CO)=O)O)O)=O,4,6,16,22,27,0.000309
G4,C(C(C(CCC(CO)=O)(C)O)O)=O,4,3,16,19,7,0.000154
G4,C(CC(C=O)C(C=O)(C(C)O)O)=O,8,4,13,17,43,0.00020299999999999997
G4,C(C(C(CC(C=O)CC=O)O)O)=O,8,11,20,31,43,0.000558
G4,C(C(C(C)(C(C=O)CC=O)O)O)=O,8,5,17,22,45,0.00023999999999999998
G4,C(C(CCC(C=O)=O)C(CO)O)=O,4,5,13,18,7,0.000272
G4,C(CC(C(CCC(CO)=O)O)O)=O,4,4,16,20,7,0.00021400000000000002
G4,C(C(CCC(CO)=O)C(CO)O)=O,4,5,14,19,7,0.000272
G4,C(CC(CO)(C(C=O)CC=O)O)=O,4,4,16,20,29,0.00020299999999999997
G4,C(CC(C(C(C=O)CC=O)O)O)=O,8,5,20,25,43,0.000261
G4,C(CC(C=O)C(C=O)C(CO)O)=O,8,5,15,20,46,0.000262
G4,C(C(C)(CCC(C=O)=O)O)(O)=O,2,3,13,16,25,0.000165
G4,C(C(CCCC(C=O)=O)O)(O)=O,2,4,13,17,7,0.00022400000000000002
G4,C(C(C)(CCC(CO)=O)O)(O)=O,2,4,9,13,25,0.00022400000000000002
G4,C(C(CCCC(CO)=O)O)(O)=O,2,5,8,13,7,0.00028199999999999997
G4,C(C(C)(C(C=O)CC=O)O)(O)=O,4,6,14,20,29,0.000308
G4,C(C(CC(C=O)CC=O)O)(O)=O,4,6,15,21,25,0.000319
G4,C(C=O)(CCC(C(C=O)=O)O)=O,2,4,17,21,20,0.00018999999999999998
G4,C(CO)(CCC(C(C=O)=O)O)=O,2,8,17,25,20,0.00040300000000000004
G4,C(CC(C=O)C(C(C=O)=O)O)=O,4,5,17,22,43,0.00023799999999999998
G4,C(C=O)(CCC(C(C(C)=O)=O)O)=O,2,1,11,12,25,4.8e-05
G4,C(C=O)(CCCC(C(CO)=O)=O)=O,1,3,11,14,7,0.000143
G4,C(CO)(CCC(C(C(C)=O)=O)O)=O,2,2,13,15,25,0.00010700000000000001
G4,C(CO)(CCCC(C(CO)=O)=O)=O,1,4,13,17,7,0.000202
G4,C(CC(C=O)C(C(C(C)=O)=O)O)=O,4,2,11,13,25,9.6e-05
G4,C(CC(C=O)CC(C(CO)=O)=O)=O,2,2,12,14,43,9.499999999999999e-05
G4,C(C=O)(C(C)(CCC(C=O)=O)O)=O,2,1,9,10,25,4.8e-05
G4,C(C=O)(CCCC(C(C=O)=O)O)=O,2,2,12,14,7,9.499999999999999e-05
G4,C(CO)(CCC(C(C=O)=O)(C)O)=O,2,4,13,17,7,0.000202
G4,C(CO)(CCCC(C(C=O)=O)O)=O,2,5,14,19,7,0.00024900000000000004
G4,C(CC(C=O)C(C(C=O)=O)(C)O)=O,4,2,10,12,25,9.6e-05
G4,C(C(CC(C(C=O)=O)O)CC=O)=O,4,3,13,16,43,0.000143
G4,C(CO)(C(C)(CCC(C=O)=O)O)=O,2,3,12,15,7,0.000154
G4,C(CO)(C(CCCC(C=O)=O)O)=O,2,4,14,18,7,0.000202
G4,C(C(CCC(CO)=O)O)(C(C)O)=O,4,5,12,17,7,0.00026000000000000003
G4,C(CO)(C(C)(CCC(CO)=O)O)=O,2,4,12,16,7,0.000213
G4,C(CO)(CCCC(C(CO)=O)O)=O,2,5,12,17,7,0.00026000000000000003
G4,C(C(C(C=O)CC=O)O)(C(C)O)=O,8,4,13,17,25,0.000202
G4,C(CO)(C(C)(C(C=O)CC=O)O)=O,4,4,14,18,25,0.000202
G4,C(C(C=O)C(C=O)CC(CO)=O)=O,2,1,11,12,45,4.8e-05
G4,C(C(C=O)C(C(CO)=O)CC=O)=O,2,1,11,12,45,4.8e-05
G4,C(C(C=O)CCC(C=O)=O)=O,1,3,13,16,45,0.000143
G4,C(C(C=O)CCC(CO)=O)=O,1,3,14,17,45,0.000154
G4,C(C(C=O)C(C=O)CC=O)=O,2,3,13,16,29,0.000143
G4,C(C(C=O)C(C(C=O)=O)CC(C)=O)=O,2,1,5,6,45,4.8e-05
G4,C(C(C=O)C(C(C)=O)CC(C=O)=O)=O,2,1,6,7,45,4.8e-05
G4,C(C(C=O)C(CC=O)CC(C=O)=O)=O,2,2,8,10,45,9.6e-05
G4,C(C(C=O)C(C=O)CC(C(C)=O)=O)=O,2,1,5,6,45,4.8e-05
G4,C(C(C=O)C(C(C(C)=O)=O)CC=O)=O,2,1,4,5,45,4.8e-05
G4,C(C(C=O)C(C=O)CC(CC=O)=O)=O,2,1,7,8,45,4.8e-05
G4,C(C(C=O)C(C(CC=O)=O)CC=O)=O,2,1,8,9,45,4.8e-05
G4,C(C(C=O)CCC(CC(C=O)=O)=O)=O,1,1,7,8,45,4.8e-05
G4,C(C(C=O)CCC(C(CC=O)=O)=O)=O,1,1,7,8,45,4.8e-05
G4,C(C(CCC(C=O)=O)(CCO)O)=O,2,2,10,12,7,0.00010700000000000001
G4,C(C(C(CCC(C=O)=O)CO)O)=O,4,4,14,18,7,0.000213
G4,C(C(CC(CCC(C=O)=O)O)O)=O,4,2,14,16,7,9.499999999999999e-05
G4,C(C(C(CCC(CO)=O)CO)O)=O,4,4,13,17,7,0.000213
G4,C(C(CC(CCC(CO)=O)O)O)=O,4,3,14,17,7,0.000154
G4,C(CC(C=O)C(C=O)(CCO)O)=O,4,3,12,15,29,0.000154
G4,C(C(C(CO)C(C=O)CC=O)O)=O,8,4,16,20,29,0.000202
G4,C(C(CC(C(C=O)CC=O)O)O)=O,8,4,17,21,43,0.000202
G4,C(C(CCCC(C(O)=O)=O)=O)=O,1,4,11,15,7,0.000202
G4,C(CO)(CCCC(C(O)=O)=O)=O,1,5,10,15,7,0.000261
G4,C(CC(C=O)CC(C(O)=O)=O)=O,2,4,12,16,29,0.000202
G4,C(C(C=O)(CCC(CO)=O)O)(O)=O,2,4,12,16,7,0.00021400000000000002
G4,C(C(C=O)(C(C=O)CC=O)O)(O)=O,4,3,11,14,17,0.000155
G4,C(C)(C(C(C=O)=O)CCC(C=O)=O)=O,2,1,7,8,7,4.8e-05
G4,C(CCCC(C=O)=O)(CC(C=O)=O)=O,1,2,10,12,7,9.6e-05
G4,C(CC(C=O)C(C(C)=O)C(C=O)=O)=O,4,1,6,7,43,4.8e-05
G4,C(CC(C=O)CC(CC(C=O)=O)=O)=O,2,1,9,10,43,4.8e-05
G4,C(C(C(C=O)=O)CCC(C=O)=O)=O,2,1,7,8,23,4.8e-05
G4,C(C(C(C=O)=O)CCC(CO)=O)=O,2,2,14,16,23,0.00010700000000000001
G4,C(C(C(C=O)=O)C(C=O)CC=O)=O,4,1,7,8,29,4.8e-05
G4,C(C(C(C(C)=O)=O)CCC(C=O)=O)=O,2,1,7,8,14,4.8e-05
G4,C(CC(C(CCCC(C=O)=O)=O)=O)=O,1,2,10,12,14,9.6e-05
G4,C(C(C(C(C)=O)=O)C(C=O)CC=O)=O,4,1,6,7,14,4.8e-05
G4,C(CC(C(CC(C=O)CC=O)=O)=O)=O,2,1,9,10,14,4.8e-05
G4,C(C=O)(CCCC(C(C)=O)=O)=O,1,3,14,17,14,0.000143
G4,C(CO)(CCCC(C(C)=O)=O)=O,1,4,14,18,14,0.000202
G4,C(CC(CCCC(C=O)=O)=O)=O,1,4,18,22,7,0.00018999999999999998
G4,C(C(C(C)=O)CCC(C=O)=O)=O,2,4,15,19,7,0.00018999999999999998
G4,C(CCCC(CO)=O)(CC=O)=O,1,5,17,22,7,0.00024900000000000004
G4,C(C)(C(C=O)CCC(CO)=O)=O,2,5,16,21,7,0.00024900000000000004
G4,C(C(C(C)=O)C(C=O)CC=O)=O,4,5,15,20,29,0.00023799999999999998
G4,C1(COC(CCC(C=O)=O)(C1)O)=O,2,1,17,18,35,4.8e-05
G4,C1(COC(C1CCC(C=O)=O)O)=O,4,2,13,15,7,9.499999999999999e-05
G4,C1(C(CCC(C=O)=O)OC(C1)O)=O,4,2,10,12,7,9.499999999999999e-05
G4,C(CO)(CCC1(CC(CO1)=O)O)=O,2,2,14,16,35,0.00010700000000000001
G4,C(CO)(CCC1C(COC1O)=O)=O,4,3,12,15,7,0.000154
G4,C1(C(CCC(CO)=O)OC(C1)O)=O,4,3,10,13,7,0.000154
G4,C1(COC(C(C=O)CC=O)(C1)O)=O,4,1,16,17,35,4.8e-05
G4,C1(COC(C1C(C=O)CC=O)O)=O,8,2,14,16,35,9.499999999999999e-05
G4,C1(C(C(C=O)CC=O)OC(C1)O)=O,8,2,11,13,43,9.499999999999999e-05
G4,C(C=O)(CCC(C(C=CC=O)=O)O)=O,4,1,11,12,7,4.8e-05
G4,C(CC(C=O)C(C(C=CC=O)=O)O)=O,8,2,11,13,43,9.6e-05
G4,C(C(CC(C=O)CC(CO)=O)O)=O,4,3,16,19,11,0.000144
G4,C(CO)(C(CC(C=O)O)CC=O)=O,4,4,17,21,11,0.00020099999999999998
G4,C(CC(C=O)C(C=O)(C)O)(CO)=O,4,2,14,16,11,9.6e-05
G4,C(CC(C(CO)=O)C(C=O)(C)O)=O,4,2,14,16,7,9.6e-05
G4,C(CO)(C(CCO)CC=O)=O,2,5,16,21,46,0.00024900000000000004
G4,C(C(C(C)O)CC(CO)=O)=O,4,6,17,23,46,0.000286
G4,C(CO)(C(C(C)O)CC=O)=O,4,5,17,22,46,0.000239
G4,C(CC(C=O)CC(CO)=O)(O)=O,2,4,13,17,18,0.000202
G4,C(CC(C(CO)=O)CC=O)(O)=O,2,3,13,16,18,0.000155
G4,C=CC(C(CCC(C=O)=O)O)=O,2,4,15,19,7,0.00018999999999999998
G4,C1(C(CCC(C=O)=O)C(CO1)O)=O,4,1,7,8,8,4.8e-05
G4,C1(CC(CO1)(CCC(C=O)=O)O)=O,2,1,8,9,8,4.8e-05
G4,C1(CC(C(CCC(C=O)=O)O1)O)=O,4,1,7,8,7,4.8e-05
G4,C(C(CCCC(C=O)=O)O)=O,2,2,17,19,7,9.499999999999999e-05
G4,C(C(C)(CCC(C=O)=O)O)=O,2,2,13,15,29,9.499999999999999e-05
G4,C(C(CCC(C(CO)O)O)=O)=O,4,6,16,22,29,0.00033
G4,C(C(CCC(CO)(CO)O)=O)=O,1,4,12,16,7,0.000213
G4,C(C(CCCO)=O)=O,1,9,64,73,55,0.00045
G4,C(C(CCCCO)=O)=O,1,4,28,32,46,0.000202
G4,C(C(CCC(C)O)=O)=O,2,4,29,33,27,0.00018999999999999998
G4,C(C(CO)(CCC(C=O)=O)O)(O)=O,2,4,12,16,7,0.000215
G4,C(C(C(CCC(C=O)=O)O)O)(O)=O,4,6,16,22,20,0.00033
G4,C(CCCC(C=O)=O)(O)=O,1,3,14,17,18,0.000155
G4,C1(C(CCC(C=O)=O)OCC1O)=O,4,2,9,11,10,9.499999999999999e-05
G4,C1(COCC1(CCC(C=O)=O)O)=O,2,1,9,10,10,4.8e-05
G4,C1(COC(CCC(C=O)=O)C1O)=O,4,2,14,16,10,9.499999999999999e-05
G4,C1(C(CCC(C=O)=O)(O)OCC1)=O,2,1,10,11,34,4.8e-05
G4,C1(C(O)OCC1CCC(C=O)=O)=O,4,2,9,11,7,9.499999999999999e-05
G4,C1(C(O)OC(CCC(C=O)=O)C1)=O,4,2,11,13,7,9.499999999999999e-05
G4,C(CO)(CCC(C(C=C)=O)O)=O,2,4,14,18,7,0.000202
G4,C(CC(C=O)C(C(C=C)=O)O)=O,4,6,15,21,7,0.000286
G4,C1(C(CCC(CO)=O)C(CO1)O)=O,4,2,6,8,8,0.00010700000000000001
G4,C1(CC(CCC(CO)=O)(CO1)O)=O,2,2,6,8,8,0.00010700000000000001
G4,C1(CC(C(CCC(CO)=O)O1)O)=O,4,2,5,7,7,0.00010700000000000001
G4,C(C(CCCC(CO)=O)O)=O,2,3,16,19,11,0.000154
G4,C(C(C)(CCC(CO)=O)O)=O,2,2,14,16,11,0.00010700000000000001
G4,C(CO)(CCC(C(CO)O)O)=O,4,6,11,17,29,0.000341
G4,C(CO)(CCC(CO)(CO)O)=O,1,4,7,11,7,0.00022400000000000002
G4,C(CO)(CCCO)=O,1,17,80,97,55,0.0008410000000000001
G4,C(CO)(CCCCO)=O,1,7,35,42,27,0.00035499999999999996
G4,C(CO)(CCC(C)O)=O,2,6,36,42,27,0.000296
G4,C(C(C(CCC(CO)=O)O)O)(O)=O,4,7,12,19,20,0.000389
G4,C(CCCC(CO)=O)(O)=O,1,4,16,20,18,0.000213
G4,C1(C(CCC(CO)=O)OCC1O)=O,4,3,9,12,10,0.000154
G4,C(CO)(CCC1(C(COC1)=O)O)=O,2,2,9,11,10,0.00010700000000000001
G4,C(CO)(CCC1C(C(CO1)=O)O)=O,4,3,11,14,10,0.000154
G4,C1(C(CCC(CO)=O)(O)OCC1)=O,2,2,10,12,34,0.00010700000000000001
G4,C(CO)(CCC1C(C(O)OC1)=O)=O,4,3,10,13,7,0.000154
G4,C(CO)(CCC1CC(C(O)O1)=O)=O,4,3,10,13,7,0.000154
G4,C1(C(C(CO1)O)C(C=O)CC=O)=O,8,1,8,9,8,4.8e-05
G4,C1(CC(CO1)(C(C=O)CC=O)O)=O,4,2,8,10,8,9.6e-05
G4,C1(CC(C(C(C=O)CC=O)O1)O)=O,8,1,8,9,8,4.8e-05
G4,C(CC(C=O)C(C=O)(C)O)=O,4,4,15,19,29,0.00019099999999999998
G4,C(C(C(C(CO)O)O)CC=O)=O,8,8,18,26,29,0.000425
G4,C(C(C(CO)(CO)O)CC=O)=O,2,6,13,19,29,0.000308
G4,C(C(C(C)O)CC=O)=O,4,8,37,45,27,0.000381
G4,C(C(CO)(C(C=O)CC=O)O)(O)=O,4,5,13,18,33,0.000262
G4,C(C(C(C(C=O)CC=O)O)O)(O)=O,8,7,16,23,43,0.00037799999999999997
G4,C(CC(C=O)CC(O)=O)=O,2,4,15,19,18,0.00020299999999999997
G4,C(CC(C=O)C1C(C(CO1)O)=O)=O,8,2,10,12,10,9.499999999999999e-05
G4,C1(COCC1(C(C=O)CC=O)O)=O,4,1,10,11,10,4.8e-05
G4,C(C(C1C(C(CO1)=O)O)CC=O)=O,8,2,13,15,10,9.499999999999999e-05
G4,C(CC(C=O)C1(C(CCO1)=O)O)=O,4,1,11,12,34,4.8e-05
G4,C1(C(O)OCC1C(C=O)CC=O)=O,8,2,11,13,34,9.499999999999999e-05
G4,C(CC(C=O)C1CC(C(O)O1)=O)=O,8,2,11,13,34,9.499999999999999e-05
G4,C(C(CO)=O)(CC(CO)CO)=O,1,4,8,12,55,0.00020099999999999998
G4,C(C(CO)=O)(CC(CO)CCO)=O,2,3,10,13,46,0.000154
G4,C(C(CO)=O)(CC(CO)C(C)O)=O,4,3,11,14,46,0.000154
G4,C(CC(CO)C(C(CO)=O)O)=O,4,8,15,23,5,0.000414
G4,C(CC(CCO)C(C(CO)=O)O)=O,4,4,13,17,46,0.00020099999999999998
G4,C(CC(C(C)O)C(C(CO)=O)O)=O,8,4,14,18,46,0.00020099999999999998
G4,C(CCCO)(C(C(CO)=O)O)=O,2,4,9,13,29,0.00020099999999999998
G4,C(CCCCO)(C(C(CO)=O)O)=O,2,3,7,10,46,0.000154
G4,C(CCC(C)O)(C(C(CO)=O)O)=O,4,2,9,11,46,9.499999999999999e-05
G4,C(CO)(C(CCO)CC(CO)=O)=O,2,3,13,16,46,0.000154
G4,C(CO)(CC(CO)C(CO)O)=O,4,7,11,18,29,0.000389
G4,C(C(CO)O)(CC(CO)CO)=O,2,5,9,14,29,0.000271
G4,C(C(C(CO)O)O)(CCCO)=O,4,4,12,16,55,0.00020299999999999997
G4,C(CC(CO)C(C(CO)O)O)=O,8,4,15,19,29,0.000213
G4,C(C(CC(CO)C(CO)O)=O)(O)=O,4,2,13,15,29,0.00010700000000000001
G4,C(C(C(CC(CO)CO)=O)O)(O)=O,2,3,8,11,55,0.000165
G4,C(C(CO)CC(C(CO)O)=O)(O)=O,4,4,11,15,29,0.00022400000000000002
G4,C(C(CO)CC(O)=O)(C(CO)O)=O,4,4,12,16,29,0.000215
G4,C(C(C(C(O)=O)O)O)(CCCO)=O,4,5,11,16,55,0.00025
G4,C(CC(CO)C(C(C(O)=O)O)O)=O,8,7,16,23,29,0.00037799999999999997
G4,C(CC(CO)C(C(C=O)O)O)(O)=O,8,3,15,18,55,0.000154
G4,C1(CC(CO)C(C1(CO)O)O)=O,8,8,15,23,55,0.000407
G4,C(CC(C(C=O)=O)CO)(C)=O,2,2,17,19,55,9.499999999999999e-05
G4,C(C)(C(CO)CC(C=O)=O)=O,2,4,17,21,55,0.00020099999999999998
G4,C(CC(CO)CC(C=O)=O)=O,2,8,19,27,55,0.000393
G4,C(C(CO)CC(C(C)=O)=O)=O,2,6,15,21,55,0.000298
G4,C(C(CO)CC(CC=O)=O)=O,2,6,20,26,55,0.000298
G4,C(C(CO)CC=O)(CC=O)=O,2,7,20,27,29,0.000346
G4,C(CCCO)(CC(C=O)=O)=O,1,4,15,19,55,0.00020099999999999998
G4,C(CC(C(CCCO)=O)=O)=O,1,3,14,17,55,0.000143
G4,C1(C(C(C(CO)C1CO)O)O)=O,16,6,14,20,55,0.000298
G4,C1(C(C(C(C1CCO)O)O)O)=O,16,2,13,15,55,9.499999999999999e-05
G4,C(C1C(C(C(C1CO)O)O)O)=O,32,2,18,20,55,9.499999999999999e-05
G4,C(CC(CO)C(C(CO)O)O)(O)=O,8,4,12,16,55,0.000213
G4,C1(CC(CO)C(C(CO)O)O1)=O,8,4,6,10,55,0.00018999999999999998
G4,C1(CC(CO)C(C(CO)O1)O)=O,8,3,6,9,55,0.000143
G4,C1(C(O)OC(CO)C(CO)C1)=O,8,2,8,10,46,9.499999999999999e-05
G4,C1(C(CO)OC(C(CO)C1)O)=O,8,4,9,13,55,0.00020099999999999998
G4,C1(CC(CO)C(C(CO1)O)O)=O,8,2,9,11,55,9.499999999999999e-05
G4,C1(C(O)OCC(C(CO)C1)O)=O,8,2,9,11,41,9.499999999999999e-05
G4,C1(C(C(O)OCC(CO)C1)O)=O,8,3,11,14,55,0.000154
G4,C1(C(COC(C(CO)C1)O)O)=O,8,3,9,12,38,0.000143
G4,C1(COC(C(C(CO)C1)O)O)=O,8,2,10,12,55,9.499999999999999e-05
G4,C(CO)(CC(C(CO)O)CCO)=O,4,4,10,14,46,0.00022400000000000002
G4,C(CO)(CC(C(CO)O)C(C)O)=O,8,3,11,14,46,0.000165
G4,C(C(CO)O)(CC(CO)CCO)=O,4,4,11,15,46,0.00022400000000000002
G4,C(C(CO)O)(CC(CO)C(C)O)=O,8,3,12,15,46,0.000165
G4,C(C(C(CO)O)O)(CCCCO)=O,4,5,11,16,46,0.000262
G4,C(C(C(CO)O)O)(CCC(C)O)=O,8,4,12,16,27,0.00020299999999999997
G4,C(CC(CCO)C(C(CO)O)O)=O,8,3,13,16,46,0.000165
G4,C(CC(C(C(CO)O)O)C(C)O)=O,16,2,14,16,46,0.000106
G4,C1(CC(C(C1(CO)O)O)CCO)=O,8,4,14,18,46,0.00020099999999999998
G4,C1(CC(C(C1(CO)O)O)C(C)O)=O,16,4,15,19,46,0.00020099999999999998
G4,C(CC(C(C=O)=O)CCO)(C)=O,2,3,15,18,46,0.000154
G4,C(CC(C(C=O)=O)C(C)O)(C)=O,4,2,15,17,46,9.499999999999999e-05
G4,C(C)(C(CCO)CC(C=O)=O)=O,2,3,15,18,29,0.000154
G4,C(C)(C(C(C)O)CC(C=O)=O)=O,4,2,15,17,46,9.499999999999999e-05
G4,C(CC(CCO)CC(C=O)=O)=O,2,6,17,23,46,0.000298
G4,C(CC(C(C)O)CC(C=O)=O)=O,4,4,18,22,46,0.00018999999999999998
G4,C(C(CCO)CC(C(C)=O)=O)=O,2,4,13,17,29,0.00020099999999999998
G4,C(C(C(C)O)CC(C(C)=O)=O)=O,4,5,13,18,46,0.000239
G4,C(CC(C(C(C)=O)=O)CCO)=O,2,4,13,17,46,0.00020099999999999998
G4,C(CC(C(C(C)=O)=O)C(C)O)=O,4,4,13,17,46,0.00019099999999999998
G4,C(C(CCO)CC(CC=O)=O)=O,2,4,15,19,29,0.00020099999999999998
G4,C(C(C(C)O)CC(CC=O)=O)=O,4,5,17,22,46,0.000239
G4,C(C(CCO)CC=O)(CC=O)=O,2,5,17,22,29,0.00024900000000000004
G4,C(C(C(C)O)CC=O)(CC=O)=O,4,6,17,23,46,0.000286
G4,C(CCCCO)(CC(C=O)=O)=O,1,3,11,14,46,0.000154
G4,C(CCC(C)O)(CC(C=O)=O)=O,2,2,13,15,46,9.499999999999999e-05
G4,C(CC(C(CCCCO)=O)=O)=O,1,3,11,14,46,0.000154
G4,C(CC(C(CCC(C)O)=O)=O)=O,2,3,12,15,46,0.000143
G4,C1(C(C(C(CCO)C1CO)O)O)=O,16,2,13,15,46,0.000106
G4,C1(C(C(C(C(C)O)C1CO)O)O)=O,32,1,14,15,46,4.8e-05
G4,C1(C(C(C(C1CCCO)O)O)O)=O,16,3,12,15,46,0.000154
G4,C1(C(C(C(C1CC(C)O)O)O)O)=O,32,2,13,15,46,9.499999999999999e-05
G4,C(C1C(C(C(C1CCO)O)O)O)=O,32,3,16,19,46,0.000154
G4,C(C1C(C(C(C1C(C)O)O)O)O)=O,64,2,17,19,46,9.499999999999999e-05
G4,C1(CC(CCO)C(C(CO)O)O1)=O,8,4,6,10,46,0.00020099999999999998
G4,C1(CC(C(C(CO)O)O1)C(C)O)=O,16,3,7,10,46,0.000143
G4,C1(CC(CCO)C(C(CO)O1)O)=O,8,3,6,9,46,0.000154
G4,C1(CC(C(C(CO)O1)O)C(C)O)=O,16,2,7,9,46,9.499999999999999e-05
G4,C1(C(O)OC(CO)C(CCO)C1)=O,8,3,7,10,46,0.000154
G4,C1(C(O)OC(CO)C(C(C)O)C1)=O,16,2,8,10,46,9.499999999999999e-05
G4,C1(C(CO)OC(C(CCO)C1)O)=O,8,3,8,11,46,0.000154
G4,C1(C(CO)OC(C(C(C)O)C1)O)=O,16,3,9,12,46,0.000154
G4,C1(CC(CCO)C(C(CO1)O)O)=O,8,2,9,11,46,0.000106
G4,C1(CC(C(C(CO1)O)O)C(C)O)=O,16,1,10,11,46,4.8e-05
G4,C1(C(O)OCC(C(CCO)C1)O)=O,8,3,8,11,46,0.000154
G4,C1(C(O)OCC(C(C(C)O)C1)O)=O,16,2,9,11,46,9.499999999999999e-05
G4,C1(C(C(O)OCC(CCO)C1)O)=O,8,3,10,13,46,0.000154
G4,C1(C(C(O)OCC(C(C)O)C1)O)=O,16,2,11,13,46,9.499999999999999e-05
G4,C1(C(COC(C(CCO)C1)O)O)=O,8,3,8,11,38,0.000154
G4,C1(C(COC(C(C(C)O)C1)O)O)=O,16,2,9,11,38,9.499999999999999e-05
G4,C1(COC(C(C(CCO)C1)O)O)=O,8,3,9,12,46,0.000154
G4,C1(COC(C(C(C(C)O)C1)O)O)=O,16,2,10,12,46,9.499999999999999e-05
G4,C(CC(C(C=O)=O)CC(C)=O)(O)=O,2,2,8,10,18,0.000106
G4,C(CC(C(C)=O)CC(C=O)=O)(O)=O,2,2,8,10,18,0.000106
G4,C(CC(CC(O)=O)CC(C=O)=O)=O,2,5,12,17,18,0.000252
G4,C(C(CC(O)=O)CC(C(C)=O)=O)=O,2,3,7,10,18,0.000154
G4,C(CC(C(C(C)=O)=O)CC(O)=O)=O,2,3,7,10,29,0.000155
G4,C(CC(CC(C=O)CC(O)=O)=O)=O,2,3,8,11,18,0.000154
G4,C(CC(C(CC=O)CC(O)=O)=O)=O,2,3,10,13,18,0.000155
G4,C(CCCC(O)=O)(CC(C=O)=O)=O,1,3,5,8,18,0.000154
G4,C(CC(C(CCCC(O)=O)=O)=O)=O,1,3,6,9,18,0.000154
G4,C(C(C(C(C=O)=O)CC(C)=O)O)=O,4,1,11,12,0,4.8e-05
G4,C(C(C(C(C)=O)CC(C=O)=O)O)=O,4,1,12,13,0,4.8e-05
G4,C(CC(C(C=O)O)CC(C=O)=O)=O,4,5,14,19,0,0.000241
G4,C(C(C(C=O)CC(C(C)=O)=O)O)=O,4,2,11,13,0,9.6e-05
G4,C(CC(C(C(C)=O)=O)C(C=O)O)=O,4,2,10,12,46,9.6e-05
G4,C(CC(CC(C=O)C(C=O)O)=O)=O,4,2,15,17,0,9.6e-05
G4,C(CC(C(CC=O)C(C=O)O)=O)=O,4,2,15,17,0,9.6e-05
G4,C(CCC(C=O)O)(CC(C=O)=O)=O,2,1,12,13,0,4.8e-05
G4,C(CC(C(CCC(C=O)O)=O)=O)=O,2,1,12,13,0,4.8e-05
G4,C(CO)(CCC(C(CO)=O)O)=O,2,7,13,20,7,0.000366
G4,C(C(C(CCC(C=O)=O)O)O)=O,4,11,23,34,20,0.000558
G4,C(C(CO)(CCC(CO)=O)O)=O,2,6,14,20,7,0.000321
G4,C(C(C(CCC(CO)=O)O)O)=O,4,9,18,27,7,0.00047400000000000003
G4,C(C(C(C(C=O)CC=O)O)O)=O,8,9,22,31,43,0.000452
G4,C(C(CC(C=O)=O)CC(CO)=O)=O,2,2,14,16,45,9.6e-05
G4,C(CC(C(CO)=O)CC(C=O)=O)=O,2,3,15,18,12,0.000144
G4,C(C(CCCC(C=O)=O)=O)=O,1,5,8,13,7,0.00023799999999999998
G4,C(CO)(CCCC(C=O)=O)=O,1,12,19,31,7,0.000582
G4,C(C)(CC(C(C=O)=O)CC(C=O)=O)=O,2,1,7,8,45,4.8e-05
G4,C(C)(C(CC(C=O)=O)CC(C=O)=O)=O,1,1,4,5,45,4.8e-05
G4,C(CC(CC(C=O)=O)CC(C=O)=O)=O,1,2,5,7,45,9.6e-05
G4,C(C(CC(C(C)=O)=O)CC(C=O)=O)=O,2,2,7,9,45,9.6e-05
G4,C(CC(C(C(C)=O)=O)CC(C=O)=O)=O,2,1,6,7,45,4.8e-05
G4,C(CC(CC(C=O)CC(C=O)=O)=O)=O,2,2,10,12,45,9.6e-05
G4,C(CC(C(CC=O)CC(C=O)=O)=O)=O,2,1,11,12,45,4.8e-05
G4,C(C(C(CO)=O)CCC(C=O)=O)=O,2,5,12,17,7,0.00025
G4,C(CC(C(CCC(C=O)=O)O)=O)=O,2,2,14,16,7,9.499999999999999e-05
G4,C(C(C(CO)=O)CCC(CO)=O)=O,2,6,15,21,7,0.000308
G4,C(C(C(CO)=O)C(C=O)CC=O)=O,4,5,13,18,55,0.00025
G4,C(CC(C(C(C=O)CC=O)O)=O)=O,4,3,15,18,43,0.000143
G4,C(C(C(C)=O)(CCC(C=O)=O)O)=O,2,1,8,9,1,4.8e-05
G4,C(C(C(CCCC(C=O)=O)=O)O)=O,2,4,13,17,7,0.00019099999999999998
G4,C(C)(C(C=O)(CCC(CO)=O)O)=O,2,2,12,14,1,0.00010700000000000001
G4,C(CCCC(CO)=O)(C(C=O)O)=O,2,5,15,20,7,0.00025
G4,C(C(C(C)=O)(C(C=O)CC=O)O)=O,4,2,9,11,1,9.6e-05
G4,C(C(C(CC(C=O)CC=O)=O)O)=O,4,4,14,18,43,0.000192
G4,C(C(CO)O)(CCCC(C=O)=O)=O,2,8,14,22,7,0.00041799999999999997
G4,C(C)(C(CO)(CCC(C=O)=O)O)=O,2,4,12,16,7,0.000215
G4,C(C)(C(C(CCC(C=O)=O)O)O)=O,4,6,19,25,20,0.000308
G4,C(C(CO)O)(CCCC(CO)=O)=O,2,9,14,23,7,0.00047699999999999994
G4,C(C)(C(CO)(CCC(CO)=O)O)=O,2,5,12,17,7,0.000273
G4,C(C)(C(C(CCC(CO)=O)O)O)=O,4,6,16,22,7,0.000309
G4,C(C)(C(CO)(C(C=O)CC=O)O)=O,4,5,13,18,43,0.000262
G4,C(C)(C(C(C(C=O)CC=O)O)O)=O,8,7,18,25,43,0.000356
G4,C(C=O)(C(CCC(C=O)=O)CO)=O,2,5,11,16,7,0.000252
G4,C(C(CCC(CC(C=O)=O)O)=O)=O,2,3,15,18,7,0.000143
G4,C(CO)(CCC(C(C=O)=O)CO)=O,2,6,14,20,7,0.00031
G4,C(CO)(CCC(CC(C=O)=O)O)=O,2,4,16,20,7,0.000202
G4,C(CC(C=O)C(C(C=O)=O)CO)=O,4,5,12,17,43,0.000252
G4,C(C(C(CC(C=O)=O)O)CC=O)=O,4,4,15,19,43,0.00019099999999999998
G4,C(C(CCC(C=O)=O)O)(CCO)=O,2,4,13,17,7,0.000215
G4,C(CO)(C(CO)CCC(C=O)=O)=O,2,6,14,20,7,0.00031
G4,C(CO)(CC(CCC(C=O)=O)O)=O,2,4,17,21,7,0.000202
G4,C(C(CCC(CO)=O)O)(CCO)=O,2,6,12,18,7,0.000321
G4,C(CO)(C(CO)CCC(CO)=O)=O,2,7,13,20,7,0.00036899999999999997
G4,C(CO)(CC(CCC(CO)=O)O)=O,2,5,14,19,7,0.000261
G4,C(C(C(C=O)CC=O)O)(CCO)=O,4,6,14,20,3,0.000321
G4,C(CO)(C(CO)C(C=O)CC=O)=O,4,8,16,24,43,0.00040599999999999995
G4,C(CO)(CC(C(C=O)CC=O)O)=O,4,6,17,23,43,0.000308
G4,C(C(C=O)(CCC(C=O)=O)O)=O,1,1,11,12,29,4.8e-05
G4,C(C(C=O)(CCC(CO)=O)O)=O,1,2,10,12,29,0.00010700000000000001
G4,C(C(CC(CO)=O)CC(CO)=O)=O,1,3,9,12,49,0.000154
G4,C(C(CC(CO)=O)C(C(C)=O)O)=O,4,2,15,17,49,9.6e-05
G4,C(CC(C(CO)=O)C(C(C)=O)O)=O,4,2,15,17,11,9.6e-05
G4,C(C)(C(CCC(C=O)=O)O)=O,2,6,17,23,7,0.000285
G4,C(CO)(CCCC(CO)=O)=O,1,7,9,16,7,0.000344
G4,C(C)(C(CCC(CO)=O)O)=O,2,6,16,22,7,0.000297
G4,C(C(CCC(C=O)=O)(CC=O)O)=O,2,2,14,16,7,9.7e-05
G4,C(C(CCC(C=O)=O)C(C=O)O)=O,4,4,14,18,7,0.00019099999999999998
G4,C(CO)(CCC(C=O)C(C=O)O)=O,4,8,16,24,7,0.000404
G4,C(CC(C=O)(C(C=O)CC=O)O)=O,4,3,13,16,43,0.000144
G4,C(CC(C=O)C(C=O)C(C=O)O)=O,8,4,14,18,43,0.000192
G4,C(CC1C(C(C(C1CO)=O)O)O)=O,16,4,19,23,43,0.00019099999999999998
G4,C1(CC(C(C(CO)O)O1)CC=O)=O,8,3,9,12,4,0.000144
G4,C1(CC(C(C(CO)O1)O)CC=O)=O,8,2,9,11,4,9.6e-05
G4,C1(CC(C(C(CO1)O)O)CC=O)=O,8,1,12,13,4,4.9e-05
G4,C(CO)(C(C(CO)O)CC=O)=O,4,6,16,22,46,0.000308
G4,C(CO)(CCC(CO)O)=O,2,5,18,23,46,0.000271
G4,C(CC(C(C=O)=O)C(CO)O)(C)=O,4,3,13,16,46,0.000165
G4,C(C)(C(C(CO)O)CC(C=O)=O)=O,4,4,13,17,46,0.000223
G4,C(C(C(CO)O)CC(C(C)=O)=O)=O,4,5,12,17,46,0.000272
G4,C(CC(C(C(C)=O)=O)C(CO)O)=O,4,4,12,16,46,0.000213
G4,C(C(C(CO)O)CC(CC=O)=O)=O,4,5,14,19,46,0.000272
G4,C(C(C(CO)O)CC=O)(CC=O)=O,4,6,15,21,46,0.00033
G4,C(CCC(CO)O)(CC(C=O)=O)=O,2,3,9,12,46,0.000165
G4,C(CC(C(CCC(CO)O)=O)=O)=O,2,3,10,13,46,0.000165
G4,C(C(C(C=O)CC(CO)=O)O)(O)=O,4,5,13,18,33,0.000271
G4,C(C(C(C(CO)=O)CC=O)O)(O)=O,4,3,13,16,33,0.000154
G4,C(C(CC(CO)C(CO)O)=O)=O,4,10,17,27,55,0.000542
G4,C(C(CC(C(CO)O)C(C)O)=O)=O,8,6,14,20,46,0.00031800000000000003
G4,C(C(C(C=O)O)O)(CCCO)=O,4,11,15,26,55,0.00057
G4,C(C(C(C=O)O)O)(CCC(C)O)=O,8,9,14,23,46,0.000453
G4,C(C(C(CO)CC(CO)=O)O)=O,4,11,15,26,55,0.0005679999999999999
G4,C(C(C(C(C)O)CC(CO)=O)O)=O,8,6,14,20,46,0.000296
G4,C(CC(CO)C(C(C=O)O)O)=O,8,11,21,32,55,0.00058
G4,C(CC(C(C(C=O)O)O)C(C)O)=O,16,7,19,26,46,0.000356
G4,C(C(C(C=C)=O)(CO)O)=O,2,6,15,21,2,0.00028900000000000003
G4,C1(C=CC(C1O)=O)=O,1,1,133,134,47,4.7e-05
G4,C(C(O)OCC(C=C)=O)=O,2,2,21,23,4,9.499999999999999e-05
G4,C(C(C(C=C)=O)OCO)=O,2,1,17,18,37,4.7e-05
G4,C(C(C(CC=CC=O)=O)O)=O,4,2,15,17,55,9.499999999999999e-05
G4,C(CC=CC(C(C=O)O)=O)=O,4,3,16,19,55,0.00014199999999999998
G4,C(CC=CC=O)=O,2,10,338,348,28,0.000475
G5,C1(C(C2(C(C1C(C2)O)O)O)O)=O,32,6,0,6,20,0.000285
G5,C1(C(C2C(C1C(C2O)O)O)O)=O,64,4,0,4,20,0.00018999999999999998
G5,C1(C(C2(C(C(CC2O)O)C1)O)O)=O,32,2,0,2,7,9.499999999999999e-05
G5,C1(C(C2(CC1C(CC2O)O)O)O)=O,32,3,0,3,7,0.00014199999999999998
G5,C(C1C(C2(CCC1(C2O)O)O)O)=O,32,4,0,4,7,0.00018999999999999998
G5,C1(C(C2C(C1CC2(CO)O)O)O)=O,32,1,0,1,7,4.7e-05
G5,C1(C(C(C2(CC1C(C2)O)O)O)O)=O,32,3,0,3,29,0.00014199999999999998
G5,C(C1C2(CCC1(C(C2O)O)O)O)=O,10,2,0,2,29,9.499999999999999e-05
G5,C1(C(C2C(C(CC2O)O)(C1)O)O)=O,32,1,0,1,45,4.7e-05
G5,C1(C(CC2(C(CC(C12)O)O)O)O)=O,32,4,0,4,22,0.00018999999999999998
G5,C(C1C(C2(CC1(C(C2)O)O)O)O)=O,32,4,0,4,22,0.00018999999999999998
G5,C1(C(C2C(C1C(C2(C)O)O)O)O)=O,64,2,0,2,22,9.499999999999999e-05
G5,C1(C(CC2(C(C1C(C2)O)O)O)O)=O,32,4,0,4,22,0.00018999999999999998
G5,C(C1C2(CC(C1(CC2O)O)O)O)=O,10,2,0,2,22,9.499999999999999e-05
G5,C1(C(C2C(C1C(CC2O)O)O)O)=O,64,4,0,4,4,0.00018999999999999998
G5,C(C1C(C2C(C1(CC2O)O)O)O)=O,64,4,0,4,4,0.00018999999999999998
G5,C1(C(C2(CC(C1C(C2)O)O)O)O)=O,6,2,0,2,49,9.499999999999999e-05
G5,C1(CC2(CC(C1C(C2O)O)O)O)=O,32,4,0,4,27,0.00018999999999999998
G5,C1(C(C(C2C(C1CC2O)O)O)O)=O,64,1,0,1,44,4.7e-05
G5,C(C1C(C2CC1(C(C2O)O)O)O)=O,64,4,0,4,44,0.00018999999999999998
G5,C1(CC(C2C(C(CC12O)O)O)O)=O,32,1,0,1,21,4.7e-05
G5,C1(C(C)(C2C(C1C(C2O)O)O)O)=O,64,2,0,2,21,9.499999999999999e-05
G5,C1(C2(CC(C1C(C(C2)O)O)O)O)=O,32,4,0,4,21,0.00018999999999999998
G5,C1(CC(C2C(C1C(C2O)O)O)O)=O,64,2,0,2,6,9.499999999999999e-05
G5,C1(C2C(C(C1C(CC2O)O)O)O)=O,36,4,0,4,26,0.00018999999999999998
G5,C1(CC2(C(C1(C(C2)O)O)O)O)=O,16,5,0,5,51,0.00023700000000000001
G5,C1(C(C2(C(C1C(C2O)O)O)O)O)=O,64,4,0,4,0,0.00018999999999999998
G5,C1(C2(C(C(C1C(C2O)O)O)O)O)=O,10,4,0,4,0,0.00018999999999999998
G5,C(CC1(C(CC(C1O)=O)O)O)(O)=O,8,4,0,4,29,0.00020099999999999998
G5,C(C1C(C(CC1(CO)O)O)=O)(O)=O,8,5,0,5,3,0.00025
G5,C(C1C(C(C(C)(C1O)O)O)=O)(O)=O,16,7,0,7,45,0.00034500000000000004
G5,C(C1C(CO)(CC(C1O)=O)O)(O)=O,8,3,0,3,29,0.000154
G5,C1(C(CC(C(C(O)=O)O)(C1)O)O)=O,8,3,0,3,45,0.000154
G5,C(C1C(C(C(C1(C)O)O)O)=O)(O)=O,16,7,0,7,16,0.00034500000000000004
G5,C(CC1(C(C(C(C1)=O)O)O)O)(O)=O,8,2,0,2,51,0.000106
G5,C1(C(C(CO)C(C1C(C)O)O)O)=O,32,5,0,5,4,0.000251
G5,C1(C(CC(C1C(CCO)O)O)O)=O,16,5,0,5,4,0.00024900000000000004
G5,C1(C(C(C(C1)O)C(CCO)O)O)=O,16,2,0,2,45,0.000106
G5,C(C1C(C(C)(C(CO)C1O)O)O)=O,32,2,0,2,45,9.499999999999999e-05
G5,C1(C(CC(C(C(C1)O)CO)O)O)=O,16,2,0,2,45,0.000106
G5,C(C1C(C(C=O)C(C)(C1O)O)O)=O,32,8,0,8,45,0.00037999999999999997
G5,C1(C(C(CC1O)O)C(C(O)=O)O)=O,16,4,0,4,33,0.00018999999999999998
G5,C1(C(C(C(C1)O)C(C(O)=O)O)O)=O,16,2,0,2,20,0.000106
G5,C1(C(CC(C1C(C(C)O)O)O)O)=O,32,4,0,4,11,0.00019099999999999998
G5,C1(C(C(C(C1)O)C(C(C)O)O)O)=O,32,1,0,1,45,4.7e-05
G5,C(C1C(C(CO)C(C1(C)O)O)O)=O,32,2,0,2,45,9.499999999999999e-05
G5,C(C1C(C(C(CC1O)O)O)=O)(O)=O,16,6,0,6,17,0.000286
G5,C(C1C(CC(C(C1O)O)=O)O)(O)=O,16,3,0,3,49,0.00014199999999999998
G5,C1(CC(C(CO)C1(CO)O)O)=O,8,3,0,3,2,0.000156
G5,C1(C(C(C(CO)C1(C)O)O)O)=O,16,2,0,2,25,9.499999999999999e-05
G5,C1(C(C(CO)C(C1C(C)=O)O)O)=O,16,2,0,2,26,9.499999999999999e-05
G5,C1(CC(C(CO)C(C(C1)=O)O)O)=O,8,1,0,1,26,4.7e-05
G5,C(C1(C(C(CC(C1)=O)O)CO)O)=O,8,2,0,2,23,9.499999999999999e-05
G5,C(C(CO)C1(C(CC(C1)=O)O)O)=O,8,3,0,3,26,0.000143
G5,C1(CC(C(C1C(CCO)O)=O)O)=O,8,3,0,3,26,0.000143
G5,C1(C(C(CCO)O)C(C(C1)=O)O)=O,8,4,0,4,18,0.00019099999999999998
G5,C1(C(CC(C(CO)C(C1)O)O)=O)=O,3,1,0,1,14,4.7e-05
G5,C(C(CO)C1(C(CC(C1)O)=O)O)=O,8,3,0,3,45,0.000143
G5,C(C1C(C(C)(C(CO)C1O)O)=O)=O,16,2,0,2,14,9.499999999999999e-05
G5,C1(C(CC(C1C(CCO)O)O)=O)=O,8,5,0,5,18,0.00023799999999999998
G5,C1(CC(C(CO)C1(C)O)O)=O,8,1,0,1,14,4.7e-05
G5,C1(CC(C(CO)C(C1)O)O)=O,3,1,0,1,18,4.7e-05
G5,C1C(C(C(C(C(C=1)=O)O)O)CO)O,16,2,0,2,21,9.499999999999999e-05
G5,C(C1C(C(C(C1O)=O)CO)O)(O)=O,16,7,0,7,29,0.00034700000000000003
G5,C1(C(C(CC(C1C(C)O)O)O)O)=O,32,6,0,6,4,0.00028700000000000004
G5,C(C1C(C(C=O)C(C1O)O)O)(O)=O,32,5,0,5,43,0.00023700000000000001
G5,C1(C(C(C(C1O)O)C(C)O)O)=O,32,3,0,3,28,0.00014199999999999998
G5,C1(CC(C(C(C)O)C1(CO)O)O)=O,16,1,0,1,25,4.7e-05
G5,C1(C(C(C(C(C)O)C1(C)O)O)O)=O,32,2,0,2,25,9.499999999999999e-05
G5,C1(CC(C(C(C)O)C1(C)O)O)=O,16,1,0,1,14,4.7e-05
G5,C1(CC(C(C(C1)O)C(C)O)O)=O,6,1,0,1,6,4.7e-05
G5,C1(C(C(C(C1O)O)C(CO)O)O)=O,32,3,0,3,0,0.00014199999999999998
G5,C1(CC(C(C(CO)O)C1(C)O)O)=O,16,1,0,1,14,4.7e-05
G5,C1(CC(C(C(C1)O)C(CO)O)O)=O,6,1,0,1,6,4.7e-05
G5,C(C1(C(C(C(C1O)=O)O)O)O)=O,16,8,0,8,5,0.00037999999999999997
G5,C1(C(C(C(C(C1O)O)=O)O)O)=O,7,2,0,2,5,9.499999999999999e-05
G5,C(C1(C(C(C(C1)=O)(CO)O)O)O)=O,8,4,0,4,1,0.000194
G5,C1(CC(C(C(C1(CO)O)O)=O)O)=O,8,7,0,7,1,0.000336
G5,C(C1(C(C(C(C1O)=O)(C)O)O)O)=O,16,5,0,5,0,0.00023700000000000001
G5,C1(C(C(C(C(C1(C)O)O)=O)O)O)=O,16,7,0,7,5,0.000332
G5,C1(C(C(C(C(C1)O)(CO)O)O)=O)=O,8,3,0,3,1,0.00014199999999999998
G5,C1(C(C(C(C(CO)(C1)O)O)O)=O)=O,8,3,0,3,5,0.00014199999999999998
G5,C(C)(C1(C(C(C(C1O)=O)O)O)O)=O,16,8,0,8,5,0.00037999999999999997
G5,C(CO)(C1(CC(C(C1O)=O)O)O)=O,8,2,0,2,1,9.499999999999999e-05
G5,C1(C(C(C(C1O)O)(C(C)O)O)O)=O,32,4,0,4,5,0.00018999999999999998
G5,C(C1(CC(C(C1O)=O)O)O)(O)=O,8,2,0,2,5,9.499999999999999e-05
G5,C1(C(C(C(C=O)(C1C=O)O)O)O)=O,16,2,0,2,1,9.499999999999999e-05
G5,C(C1C(C(C(C(C1O)=O)O)O)=O)=O,16,4,0,4,23,0.00018999999999999998
G5,C(C1(C(C(C(C1C=O)O)=O)O)O)=O,16,4,0,4,23,0.00018999999999999998
G5,C1(C(C(C(C=O)=O)C(C1O)O)O)=O,16,4,0,4,23,0.00018999999999999998
G5,C(C1(C(C(C(C1)=O)(C)O)O)O)=O,8,2,0,2,16,9.499999999999999e-05
G5,C1(CC(C(C(C1(C)O)O)=O)O)=O,8,4,0,4,5,0.00018999999999999998
G5,C(C)(C1(CC(C(C1O)=O)O)O)=O,8,5,0,5,5,0.00023700000000000001
G5,C(C1C(C)(C(C(C1O)=O)O)O)=O,16,8,0,8,5,0.00037999999999999997
G5,C(C1(C(C(CC(C1)=O)O)O)O)=O,8,2,0,2,0,9.499999999999999e-05
G5,C1(CC(C(C(C(C1)O)O)=O)O)=O,8,4,0,4,51,0.00018999999999999998
G5,C(C)(C1C(C(C(C1O)=O)O)O)=O,16,4,0,4,5,0.00018999999999999998
G5,C(C1C(CC(C1(CO)O)O)=O)=O,8,5,0,5,51,0.00023700000000000001
G5,C(CC1(CC(C(C1O)=O)O)O)=O,8,4,0,4,51,0.00018999999999999998
G5,C1(C2C(C(CO)(C1C(O2)O)O)O)=O,32,4,0,4,5,0.00018999999999999998
G5,C1(C2C(CO)(C(C1C(O2)O)O)O)=O,32,4,0,4,5,0.00018999999999999998
G5,C1(C(C2(COC(C2C1O)O)O)O)=O,32,2,0,2,5,9.499999999999999e-05
G5,C1(C(C2(C(C1O)OC(C2)O)O)O)=O,32,2,0,2,5,9.499999999999999e-05
G5,C1(C(C(C=C)(C(C1O)O)O)O)=O,16,5,0,5,7,0.00023700000000000001
G5,C1(C(C2(C(C1O)OCC2O)O)O)=O,32,2,0,2,10,9.499999999999999e-05
G5,C1(C(C2(C(O)OCC2C1O)O)O)=O,32,2,0,2,34,9.499999999999999e-05
G5,C(C1C(C(C(C1O)=O)O)O)(O)=O,16,5,0,5,28,0.00024900000000000004
G5,C(C1C(C(C(C1(C)O)=O)O)O)=O,16,4,0,4,25,0.00018999999999999998
G5,C1(C(C(C(CC(C1)O)O)O)=O)=O,8,4,0,4,25,0.00018999999999999998
G5,C(C1(CC(C(C1)=O)(CO)O)O)(O)=O,4,3,0,3,29,0.000156
G5,C(C1(CC(C(C1O)=O)(C)O)O)(O)=O,8,2,0,2,0,9.499999999999999e-05
G5,C(C)(C1(C(C(C(C1)=O)(C)O)O)O)=O,8,1,0,1,14,4.7e-05
G5,C1(CC(C(C(C1(C)O)O)=O)(C)O)=O,8,3,0,3,14,0.00014199999999999998
G5,C1(C(C(C(C)(C(C)(C1)O)O)O)=O)=O,8,3,0,3,14,0.00014199999999999998
G5,C1(CC(C(CC1(CO)O)=O)(C)O)=O,4,2,0,2,14,9.499999999999999e-05
G5,C(CO)(C1(CC(C(C1)=O)(C)O)O)=O,4,1,0,1,14,4.7e-05
G5,C1(C(CC(CO)(C(C)(C1)O)O)=O)=O,4,2,0,2,14,9.499999999999999e-05
G5,C(C)(C1(CC(C(C1)=O)(CO)O)O)=O,4,1,0,1,14,4.7e-05
G5,C(C)(C1(CC(C(C1O)=O)(C)O)O)=O,8,2,0,2,14,9.499999999999999e-05
G5,C(C1C(C)(C(C(C1(C)O)=O)O)O)=O,16,4,0,4,25,0.00018999999999999998
G5,C1(C(C(C(C)(CC(C1)O)O)O)=O)=O,8,3,0,3,25,0.00014199999999999998
G5,C(C1C(C)(CC(C1(CO)O)=O)O)=O,8,5,0,5,26,0.00023700000000000001
G5,C1(C(C(C(CC(C)(C1)O)O)O)=O)=O,8,3,0,3,26,0.00014199999999999998
G5,C(C)(C1(C(C(CC(C1)=O)O)O)O)=O,8,1,0,1,25,4.7e-05
G5,C1(C(C)(CC(CC(C1O)O)=O)O)=O,8,3,0,3,25,0.00014199999999999998
G5,C1(C(C)(C(C(C)=O)C(C1O)O)O)=O,16,4,0,4,25,0.00018999999999999998
G5,C1(C(CO)(CC(CC(C1)O)=O)O)=O,4,2,0,2,25,9.499999999999999e-05
G5,C1(C(CO)(C(C(C)=O)C(C1)O)O)=O,8,3,0,3,25,0.00014199999999999998
G5,C(CO)(C1(CC(CC(C1)=O)O)O)=O,4,3,0,3,27,0.00014199999999999998
G5,C(C1C(CC(CO)(C1(C)O)O)=O)=O,8,3,0,3,25,0.00014199999999999998
G5,C(C1C(CC(C)(C1(CO)O)O)=O)=O,8,3,0,3,25,0.00014199999999999998
G5,C(CC1(CC(C(C1O)=O)(C)O)O)=O,8,3,0,3,25,0.000144
G5,C(C1(C(C(C(C(C1)=O)=O)O)O)O)=C,8,3,0,3,25,0.00014199999999999998
G5,C(C1(C(CC(C(C1O)=O)=O)O)O)=C,8,3,0,3,25,0.00014199999999999998
G5,C1(CC(C=C)(C(C1(CO)O)O)O)=O,8,3,0,3,7,0.00014199999999999998
G5,C1(C(C(C=C)(C(C1(C)O)O)O)O)=O,16,3,0,3,25,0.00014199999999999998
G5,C1C(C(C(C(CC(C=1)O)=O)=O)O)O,8,3,0,3,25,0.00014199999999999998
G5,C1C(C(C(C(CO)=O)=O)C(C=1)O)O,3,2,0,2,25,9.499999999999999e-05
G5,C(C1C(CC(C1(C(C)O)O)O)=O)=O,16,3,0,3,9,0.00014199999999999998
G5,C1(CC(C(C1(C)O)O)(C(C)O)O)=O,16,1,0,1,25,4.7e-05
G5,C1(CC(C(C(C1)O)O)(C(C)O)O)=O,16,1,0,1,25,4.7e-05
G5,C(C1C(C(C(C(C1O)O)=O)O)O)=O,10,4,0,4,5,0.00018999999999999998
G5,C(C1C(C(C(C)=O)C(C1O)=O)O)=O,16,4,0,4,26,0.00018999999999999998
G5,C(C1C(CC(CC(C1O)=O)=O)O)=O,8,3,0,3,26,0.00014199999999999998
G5,C1(CC(C=O)(C(C=O)C(C1)O)O)=O,8,6,0,6,26,0.000285
G5,C(C(C=O)C1(C(CC(C1)=O)O)O)=O,4,3,0,3,26,0.000143
G5,C1(CC(CC(C1C(C=O)=O)O)O)=O,8,3,0,3,26,0.00014199999999999998
G5,C(CC(C1C(CC(C1=O)O)=O)O)=O,8,3,0,3,26,0.000143
G5,C(CC(C1C(CC(C1O)=O)=O)O)=O,8,4,0,4,26,0.00019099999999999998
G5,C(C1C(C(C=O)C(C1O)=O)O)=O,16,7,0,7,23,0.000332
G5,C(C1C(CC(C(CC1O)=O)=O)O)=O,3,3,0,3,14,0.00014199999999999998
G5,C(CC1(C(CC(C1C=O)O)=O)O)=O,8,3,0,3,14,0.00014199999999999998
G5,C(C(C=O)C1(C(CC(C1)O)=O)O)=O,4,3,0,3,45,0.000143
G5,C(C1C(C(C=O)C(C1(C)O)=O)O)=O,16,4,0,4,14,0.00018999999999999998
G5,C(C1C(C(CC(CC1O)O)=O)=O)=O,8,3,0,3,14,0.00014199999999999998
G5,C(CC(C1C(C(CC1O)=O)=O)O)=O,8,5,0,5,14,0.00023799999999999998
G5,C(C1C(CC(C1(C)O)=O)O)=O,8,6,0,6,14,0.000285
G5,C1(C(CC(CC(C1)O)O)=O)=O,3,4,0,4,53,0.00018999999999999998
G5,C(C1C(CC(CC1O)=O)O)=O,3,3,0,3,45,0.00014199999999999998
G5,C(C1C(CC(CC1O)O)=O)=O,8,3,0,3,45,0.00014199999999999998
G5,C1(C2C(CC(C1C(O2)O)O)O)=O,32,4,0,4,35,0.00018999999999999998
G5,C(C1C(C(C(C=CC1O)=O)O)O)=O,16,4,0,4,11,0.00018999999999999998
G5,C(C1C(CC(C=CC(C1O)=O)=O)O)=O,8,3,0,3,45,0.00014199999999999998
G5,C(C(C=O)C(C1(C=CC(C1)=O)O)O)=O,4,3,0,3,45,0.000143
G5,C(C1(C=CC(CC(C1C=O)O)=O)O)=O,8,3,0,3,45,0.00014199999999999998
G5,C(C(C=O)C1(C=CC(CC1O)=O)O)=O,4,3,0,3,45,0.000143
G5,C(CC(C1C(C=CC(C1O)=O)=O)O)=O,8,4,0,4,45,0.00019099999999999998
G5,C(CC(C1C(C=CC1(C=O)O)=O)O)=O,8,4,0,4,45,0.00019099999999999998
G5,C(C1C(C(C=O)C=CC(C1O)=O)O)=O,16,3,0,3,45,0.00014199999999999998
G5,C(C1C=CC(C=O)(C(C=O)C1O)O)=O,16,3,0,3,45,0.00014199999999999998
G5,C(C1C=CC(C1O)(C(C=O)C=O)O)=O,8,3,0,3,45,0.000143
G5,C(C1C(CC(C(C=CC1O)=O)=O)O)=O,8,3,0,3,45,0.00014199999999999998
G5,C1(CC(C(C=O)C1(C=CC=O)O)O)=O,16,3,0,3,45,0.00014199999999999998
G5,C(C(C=O)C1(C(CC(C=C1)O)=O)O)=O,4,3,0,3,27,0.000143
G5,C(CC(C1C(C(C=CC1O)=O)=O)O)=O,8,4,0,4,45,0.00019099999999999998
G5,C(C1C(C(C=O)C(C=CC1O)=O)O)=O,16,4,0,4,45,0.00018999999999999998
G5,C(C(C=O)C1(C=CC(C1C=O)O)O)=O,8,4,0,4,45,0.00019099999999999998
G5,C(C(C=O)C(C1C(C=CC1O)=O)O)=O,8,4,0,4,45,0.00019099999999999998
G5,C(C1C(C(C(C1O)=O)C(C=C)=O)O)=O,16,4,0,4,45,0.00018999999999999998
G5,C(C1C(C(C=C)(C(C=O)C1O)O)=O)=O,16,4,0,4,45,0.00018999999999999998
G5,C(C1C(C(C(C1O)=O)C=CC=O)O)=O,32,3,0,3,27,0.00014199999999999998
G5,C(C1C(C(C=CC1O)C(C=O)=O)O)=O,16,3,0,3,27,0.00014199999999999998
G5,C1(C(CC(C(O)=O)(C1C=O)O)O)=O,8,2,0,2,23,9.499999999999999e-05
G5,C1(C(C(C(C(O)=O)=O)C(C1)O)O)=O,8,4,0,4,23,0.00018999999999999998
G5,C(C1(CC(C(C1)=O)(C)O)O)(O)=O,4,1,0,1,14,4.7e-05
G5,C(C1(CC(CC(C1)=O)O)O)(O)=O,4,1,0,1,28,4.7e-05
G5,C1C(C(C(C(O)=O)=O)C(C=1)O)O,3,2,0,2,29,9.499999999999999e-05
G5,C(C1C(CC(C1=O)O)=O)(O)=O,4,11,0,11,17,0.000524
G5,C(C1C(CC(C1O)=O)=O)(O)=O,4,11,0,11,30,0.000524
G5,C(C1C(C(CC1O)=O)=O)(O)=O,4,10,0,10,17,0.00047599999999999997
G5,C(C1C(CC(C(C1O)=O)=O)O)(O)=O,8,2,0,2,17,9.499999999999999e-05
G5,C(C1C(C(C(CC1O)O)=O)=O)(O)=O,8,5,0,5,17,0.000239
G5,C(C(C1(C(CC(C1)=O)=O)O)O)(O)=O,4,2,0,2,26,9.499999999999999e-05
G5,C(C1C(C(C(C1(C)O)O)=O)=O)(O)=O,8,4,0,4,26,0.00019099999999999998
G5,C(CC1(C(C(C(C1)=O)=O)O)O)(O)=O,4,2,0,2,17,9.499999999999999e-05
G5,C(C1C(CC(C(C1O)=O)O)=O)(O)=O,8,7,0,7,17,0.000334
G5,C(C1C(C(C(C(C1)O)O)=O)=O)(O)=O,8,3,0,3,17,0.000143
G5,C(C1C(C(C(C(C1)=O)=O)O)O)(O)=O,8,2,0,2,17,9.499999999999999e-05
G5,C(C(C1(CC(C(C1)=O)=O)O)O)(O)=O,2,1,0,1,24,4.7e-05
G5,C(C1C(C(CC1(CO)O)=O)=O)(O)=O,4,5,0,5,2,0.000239
G5,C1(C(C)(C(C(C1C(O)=O)=O)O)O)=O,8,5,0,5,24,0.000239
G5,C(CC1(C(CC(C1O)=O)=O)O)(O)=O,4,2,0,2,17,9.499999999999999e-05
G5,C(C(C1(C=CC(C1O)=O)O)O)(O)=O,8,3,0,3,32,0.000143
G5,C1(C(C(CC1)(C(C(O)=O)O)O)O)=O,8,4,0,4,29,0.00018999999999999998
G5,C(C1C(CO)(C(C(C1)=O)O)O)(O)=O,8,2,0,2,29,9.499999999999999e-05
G5,C(C1C(C(C(CO)(C1)O)O)=O)(O)=O,8,4,0,4,29,0.000202
G5,C(C1C(C(CO)C(C1O)O)=O)(O)=O,16,10,0,10,17,0.000503
G5,C1(C2C(C(C(C(O)=O)O2)(C1)O)O)=O,16,1,0,1,17,4.7e-05
G5,C(C1C(C2C(C1(CO2)O)O)=O)(O)=O,16,4,0,4,17,0.00019099999999999998
G5,C(C1C2C(C(C(C1O)O2)=O)O)(O)=O,32,2,0,2,9,9.499999999999999e-05
G5,C(C1C2(C(OC1C(C2)=O)O)O)(O)=O,16,1,0,1,22,4.7e-05
G5,C(C1C(C2CC1(C(O2)O)O)=O)(O)=O,16,6,0,6,17,0.000286
G5,C(C1C(C2C(C1OC2O)=O)O)(O)=O,32,2,0,2,17,9.499999999999999e-05
G5,C(C1C(C=CC(C1O)=O)=O)(O)=O,4,5,0,5,17,0.000239
G5,C(C1C(C=CC1(C=O)O)=O)(O)=O,4,6,0,6,17,0.000286
G5,C(C1C(C(C=CC1O)=O)=O)(O)=O,4,5,0,5,17,0.000239
G5,C(C1C(C2C(C1(O)OC2)=O)O)(O)=O,16,4,0,4,17,0.00018999999999999998
G5,C(C1C(C2C(CC1(O2)O)=O)O)(O)=O,16,3,0,3,48,0.00014199999999999998
G5,C(C1C(C2C(CC1(O2)O)O)=O)(O)=O,16,5,0,5,48,0.000239
G5,C(C1C(C2COC1(C2O)O)=O)(O)=O,16,6,0,6,30,0.000286
G5,C(C1C(C2C(O)OC1C2O)=O)(O)=O,32,6,0,6,37,0.000286
G5,C(C(C1C(CC(C1=O)O)=O)O)(O)=O,8,3,0,3,26,0.000143
G5,C(C(C1C(CC(C1O)=O)=O)O)(O)=O,8,4,0,4,33,0.00018999999999999998
G5,C(C(C1C(C(CC1O)=O)=O)O)(O)=O,8,5,0,5,33,0.00023799999999999998
G5,C1(CC(C(C1C(C(C=C)=O)O)=O)O)=O,8,3,0,3,26,0.000143
G5,C1(CC(C=C)(C(C1C(C=O)=O)O)O)=O,8,3,0,3,7,0.00014199999999999998
G5,C1(C(C(C(C1)=O)C(C(C=C)=O)O)O)=O,8,4,0,4,7,0.00019099999999999998
G5,C1(CC(C(C=C)(C1C(C=O)=O)O)O)=O,8,3,0,3,7,0.00014199999999999998
G5,C(C(C=C)(C1C(C(CC1=O)O)=O)O)=O,8,3,0,3,26,0.000143
G5,C(C(C=C)(C1C(CC(C1O)=O)=O)O)=O,8,4,0,4,7,0.00019099999999999998
G5,C1(CC(C(C1C(C=CC=O)O)=O)O)=O,16,3,0,3,26,0.000143
G5,C1(CC(C=CC(C1C(C=O)=O)O)O)=O,8,3,0,3,43,0.00014199999999999998
G5,C1(C(C(C(C1)=O)C(C=CC=O)O)O)=O,16,4,0,4,43,0.00018999999999999998
G5,C(C1C(C=CC1O)O)(CC(C=O)=O)=O,3,2,0,2,43,9.499999999999999e-05
G5,C1(CC(C(C1C(C(C)O)O)=O)O)=O,16,3,0,3,26,0.000143
G5,C1(C(C(C(C)O)O)C(C(C1)=O)O)=O,16,4,0,4,11,0.00019099999999999998
G5,C1(CC(C(C(C=O)C1(C)O)=O)O)=O,8,3,0,3,14,0.00014199999999999998
G5,C1(CC(C=O)(C(C=O)C1(C)O)O)=O,8,3,0,3,14,0.00014199999999999998
G5,C1(C(C)(C(C(C=O)=O)C(C1)O)O)=O,8,5,0,5,14,0.00023700000000000001
G5,C(CC1(C(CC(C(C1)=O)=O)O)O)=O,4,2,0,2,14,9.499999999999999e-05
G5,C1(C(C(C(C(C)=O)=O)C(C1)O)O)=O,8,5,0,5,14,0.00023700000000000001
G5,C1(C(CC(C(CC(C1)O)=O)=O)O)=O,4,3,0,3,45,0.00014199999999999998
G5,C1(C(CC(C(C)=O)(C1C=O)O)O)=O,8,2,0,2,14,9.499999999999999e-05
G5,C(C1(CC(CC(C(C1)=O)=O)O)O)=O,4,2,0,2,14,9.499999999999999e-05
G5,C(C1C(C)(C(C=O)C(C1O)=O)O)=O,16,4,0,4,23,0.00018999999999999998
G5,C1(CC(C(C(C=O)C(C1)O)=O)O)=O,8,3,0,3,23,0.00014199999999999998
G5,C(C)(C1C(C(C=O)C(C1O)=O)O)=O,16,4,0,4,23,0.00018999999999999998
G5,C1(CC(C(C(C=O)=O)C(C1)O)O)=O,3,3,0,3,23,0.00014199999999999998
G5,C(C1C(CC(C1(CC=O)O)O)=O)=O,8,3,0,3,23,0.00014199999999999998
G5,C(C1C(CC(C1O)=O)O)(CC=O)=O,8,4,0,4,23,0.00018999999999999998
G5,C1(CC(C(CC(C1C=O)O)=O)O)=O,8,3,0,3,23,0.00014199999999999998
G5,C(CC1(CC(C(C1C=O)=O)O)O)=O,8,2,0,2,23,9.499999999999999e-05
G5,C(C1C(CC(C1O)(CC=O)O)=O)=O,8,3,0,3,26,0.00014199999999999998
G5,C(C1(CC(C(C=O)C(C1)=O)O)O)=O,8,3,0,3,26,0.00014199999999999998
G5,C1(CC(CC(C(C1C=O)O)=O)O)=O,8,3,0,3,23,0.00014199999999999998
G5,C1(CC(CC(C=O)(C1C=O)O)O)=O,8,3,0,3,23,0.00014199999999999998
G5,C1(C(C(C(C=C)(C1C=O)O)O)O)=O,16,4,0,4,7,0.00018999999999999998
G5,C=CC(C(C1C(C(CC1O)=O)=O)O)=O,8,5,0,5,14,0.00023799999999999998
G5,C(C1C(C(CC(C=C)(C1O)O)=O)=O)=O,8,3,0,3,14,0.00014199999999999998
G5,C(C1C(C(CC(C1(C=C)O)O)=O)=O)=O,8,3,0,3,14,0.00014199999999999998
G5,C(C(C=C)(C1C(C(CC1O)=O)=O)O)=O,8,5,0,5,14,0.00023799999999999998
G5,C(C(C1C(C(CC1O)=O)=O)O)=CC=O,16,5,0,5,14,0.00023799999999999998
G5,C(C1C(C(CC(C=CC1O)O)=O)=O)=O,8,3,0,3,14,0.00014199999999999998
G5,C(CC(C(C1C(C=CC1O)O)=O)=O)=O,3,2,0,2,14,9.499999999999999e-05
G5,C1(C(CC(C1C(C(C)O)O)O)=O)=O,16,5,0,5,11,0.00023799999999999998
G5,C(C)(C1(CC(C(C1)=O)(C)O)O)=O,4,1,0,1,14,4.7e-05
G5,C1(CC(C(CC1(C)O)=O)(C)O)=O,3,1,0,1,14,4.7e-05
G5,C1(C(CC(C)(C(C)(C1)O)O)=O)=O,3,1,0,1,14,4.7e-05
G5,C(C1C(C)(CC(C1(C)O)=O)O)=O,8,3,0,3,14,0.00014199999999999998
G5,C1(C(CC(CC(C)(C1)O)O)=O)=O,4,2,0,2,14,9.499999999999999e-05
G5,C(C)(C1(CC(CC(C1)=O)O)O)=O,4,1,0,1,14,4.7e-05
G5,C1(C(C)(CC(CC(C1)O)=O)O)=O,4,2,0,2,14,9.499999999999999e-05
G5,C1(C(C)(C(C(C)=O)C(C1)O)O)=O,8,3,0,3,14,0.00014199999999999998
G5,C(C1C(CC(C)(C1(C)O)O)=O)=O,8,3,0,3,14,0.00014199999999999998
G5,C1(CC(CC1(C)O)(CC=O)O)=O,4,1,0,1,14,4.7e-05
G5,C1(C2C(C)(C(C)(C1C(O2)O)O)O)=O,32,4,0,4,14,0.00018999999999999998
G5,C1(CC2(COC(C2C1(C)O)O)O)=O,16,1,0,1,14,4.7e-05
G5,C1(CC2(C(C1(C)O)OC(C2)O)O)=O,16,1,0,1,14,4.7e-05
G5,C(C1(C(CC(C(C1)=O)=O)O)O)=C,4,3,0,3,14,0.00014199999999999998
G5,C1(CC(C=C)(C(C1(C)O)O)O)=O,8,1,0,1,14,4.7e-05
G5,C1C(C(C(C(C)=O)=O)C(C=1)O)O,3,3,0,3,21,0.00014199999999999998
G5,C1C(CC(C(CC(C=1)O)=O)=O)O,3,2,0,2,21,9.499999999999999e-05
G5,C1(CC2(C(C1(C)O)OCC2O)O)=O,16,1,0,1,10,4.7e-05
G5,C1(CC2(C(O)OCC2C1(C)O)O)=O,16,1,0,1,34,4.7e-05
G5,C(C1C(CC(CC1(C)O)=O)O)=O,8,3,0,3,6,0.00014199999999999998
G5,C(C1C(CC(C)(CC1O)O)=O)=O,8,3,0,3,6,0.00014199999999999998
G5,C(C1C(CC(CC1(C)O)O)=O)=O,8,3,0,3,6,0.00014199999999999998
G5,C(CC1(CC(CC(C1)=O)O)O)=O,4,1,0,1,6,4.7e-05
G5,C1(CC(CC(CC(C1)O)=O)O)=O,1,1,0,1,6,4.7e-05
G5,C1(CC(C(C(C)=O)C(C1)O)O)=O,3,3,0,3,6,0.00014199999999999998
G5,C1(C2C(CC(C)(C1C(O2)O)O)O)=O,32,4,0,4,35,0.00018999999999999998
G5,C1(C2C(C)(CC(C1C(O2)O)O)O)=O,32,6,0,6,6,0.000285
G5,C1(CC(C2C(O)OCC2(C1)O)O)=O,16,2,0,2,26,9.499999999999999e-05
G5,C1(CC(C2C(CC(O)O2)(C1)O)O)=O,16,3,0,3,35,0.00014199999999999998
G5,C1(CC(C(C=C)(C1C=O)O)O)=O,8,4,0,4,7,0.00018999999999999998
G5,C(C1C(CC(C=C)(C1O)O)=O)=O,8,5,0,5,29,0.00023700000000000001
G5,C1(CC(C=C)(C(C(C1)O)O)O)=O,8,1,0,1,7,4.7e-05
G5,C(CC(C1C(C=CC1O)O)=O)=O,3,4,0,4,29,0.00018999999999999998
G5,C(C1C(CC(C=CC1O)O)=O)=O,8,6,0,6,29,0.000285
G5,C1(CC2(C(C(C1)O)OCC2O)O)=O,16,1,0,1,10,4.7e-05
G5,C1(CC(C2COC(C2(C1)O)O)O)=O,16,1,0,1,34,4.7e-05
G5,C1(C2C(C=C)(C(C1C(O2)O)O)O)=O,32,4,0,4,7,0.00018999999999999998
G5,C1(C2C(C(C=C)(C1C(O2)O)O)O)=O,32,4,0,4,7,0.00018999999999999998
G5,C1(C2C(C=CC(C1C(O2)O)O)O)=O,32,4,0,4,35,0.00018999999999999998
G5,C(C1C(C(C)(C(C1O)O)O)O)=O,32,4,0,4,45,0.00018999999999999998
G5,C1(C(CC(C(C(C1)O)O)O)O)=O,16,1,0,1,0,4.7e-05
G5,C1(C(CC(C1C(CO)O)O)O)=O,16,4,0,4,0,0.000192
G5,C1(C(C(C(C1)O)C(CO)O)O)=O,16,2,0,2,45,0.000106
G5,C(C1C(C(C(C(C1O)O)O)O)O)=O,10,4,0,4,0,0.000212
G5,C1(C(C(C(C(CC1O)O)O)O)O)=O,32,4,0,4,0,0.00018999999999999998
G5,C1(C(C(C(C1C(C)=O)O)O)O)=O,16,6,0,6,26,0.000285
G5,C1(CC(C(C(C(C1)=O)O)O)O)=O,8,5,0,5,51,0.00023700000000000001
G5,C1(CC(C(C(C=O)O)(C1)O)O)=O,8,4,0,4,26,0.000192
G5,C1(CC(C(C1C(CO)O)=O)O)=O,8,5,0,5,26,0.000239
G5,C1(C(C(CO)O)C(C(C1)=O)O)=O,8,6,0,6,0,0.00028700000000000004
G5,C1(C(CC(C(C(C1)O)O)O)=O)=O,3,2,0,2,20,9.499999999999999e-05
G5,C1(C(C(C(C1)O)O)(CC=O)O)=O,8,3,0,3,0,0.00014199999999999998
G5,C1(C(CC(C1)O)(C(C=O)O)O)=O,8,5,0,5,45,0.00023999999999999998
G5,C(C1C(C(C)(C(C1O)O)O)=O)=O,16,5,0,5,0,0.00023700000000000001
G5,C1(C(CC(C1C(CO)O)O)=O)=O,8,7,0,7,0,0.000334
G5,C1(CC(C(C1(C)O)O)O)=O,8,1,0,1,14,4.7e-05
G5,C1(CC(C(C(C1)O)O)O)=O,3,1,0,1,0,4.7e-05
G5,C1C(C(C(C(C(C=1)=O)O)O)O)O,16,3,0,3,11,0.00014199999999999998
G5,C1(C=CC(C(C(C(C1)O)O)O)=O)=O,8,1,0,1,45,4.7e-05
G5,C(C(C(C1(C=CC(C1)=O)O)O)O)=O,8,3,0,3,45,0.000144
G5,C(C1(C=CC(CC(C1O)O)=O)O)=O,8,1,0,1,45,4.7e-05
G5,C(C(C1(C=CC(CC1O)=O)O)O)=O,8,3,0,3,45,0.000144
G5,C1(C=CC(C(C1C(CO)O)O)=O)=O,8,4,0,4,0,0.000192
G5,C(C1(C=CC(C1C(CO)O)=O)O)=O,8,4,0,4,0,0.000192
G5,C(C1C=CC(C(C(C1O)O)O)=O)=O,16,1,0,1,29,4.7e-05
G5,C(C1C=CC(C=O)(C(C1O)O)O)=O,16,1,0,1,45,4.7e-05
G5,C(C1C=CC(C1O)(C(C=O)O)O)=O,16,3,0,3,45,0.000144
G5,C1C(C(C(CC(C(C=1)=O)=O)O)O)O,8,1,0,1,45,4.7e-05
G5,C1(CC(C(C1(C=CC=O)O)O)O)=O,16,1,0,1,45,4.7e-05
G5,C(C(C1(C(CC(C=C1)O)=O)O)O)=O,8,3,0,3,27,0.000144
G5,C1C(C(C(C(C=1)=O)=O)C(CO)O)O,8,4,0,4,0,0.000192
G5,C(C1C(C=CC(C(C1O)O)O)=O)=O,16,2,0,2,45,9.499999999999999e-05
G5,C(C(C1(C=CC(C1C=O)O)O)O)=O,16,4,0,4,45,0.000192
G5,C(C(C(C1C(C=CC1O)=O)O)O)=O,16,4,0,4,45,0.000192
G5,C1(C(C(C(C1C(C=C)=O)O)O)O)=O,16,2,0,2,27,9.499999999999999e-05
G5,C(C1C(C(C=C)(C(C1O)O)O)=O)=O,16,2,0,2,0,9.499999999999999e-05
G5,C1(C(C(C(C1C=CC=O)O)O)O)=O,32,1,0,1,27,4.7e-05
G5,C1C(C(C=O)=O)C(C(C(C=1)O)O)O,16,1,0,1,27,4.7e-05
G5,C1(C(C(C(CO)(C1O)O)O)O)=O,16,8,0,8,5,0.000413
G5,C(C1C(C(C(C1(CO)O)O)O)=O)=O,16,4,0,4,5,0.00018999999999999998
G5,C(CC1(C(C(C(C1O)=O)O)O)O)=O,16,4,0,4,5,0.00018999999999999998
G5,C1(C(C(C(C(C(C1)O)O)=O)O)O)=O,16,7,0,7,5,0.000332
G5,C(C1(CC(C(C(C1O)=O)O)O)O)=O,16,5,0,5,5,0.00023700000000000001
G5,C1(CC(CO)(C(C1(C)O)O)O)=O,8,1,0,1,5,4.7e-05
G5,C1(C(C(C)(C(C)(C1O)O)O)O)=O,10,2,0,2,5,9.499999999999999e-05
G5,C1(C(C(C)(CC(C1O)O)O)O)=O,16,4,0,4,5,0.00018999999999999998
G5,C1(CC(CO)(C(C(C1)O)O)O)=O,8,1,0,1,5,4.7e-05
G5,C1(C(C(C=CC(C1O)O)O)O)=O,10,3,0,3,51,0.00014199999999999998
G5,C(C1C(C(C)(CC(C1O)=O)O)O)=O,16,5,0,5,4,0.00023700000000000001
G5,C(C1C(C(C)(CC1(C=O)O)O)O)=O,16,4,0,4,4,0.00018999999999999998
G5,C(C(C1C(CC(C1(C)O)O)O)=O)=O,16,4,0,4,22,0.00018999999999999998
G5,C(C1(CC(CC(C(C1)=O)O)O)O)=O,8,2,0,2,22,9.499999999999999e-05
G5,C1(C(C(CC1O)O)C(C=O)(C)O)=O,16,4,0,4,4,0.00019099999999999998
G5,C1(C(C(C(C1)O)C(C(C)=O)O)O)=O,16,2,0,2,45,9.499999999999999e-05
G5,C(C(C)(C1C(CC(C1O)=O)O)O)=O,16,1,0,1,45,4.7e-05
G5,C1(C(C(C)(C(C1C(C)O)O)O)O)=O,32,6,0,6,45,0.00028700000000000004
G5,C1(C(C(C(CO)(C1)O)C(C)O)O)=O,16,2,0,2,22,0.000106
G5,C1(C(C(C(C)(C1C(C)O)O)O)O)=O,32,6,0,6,4,0.00028700000000000004
G5,C1(C(C(C(CC(C)O)(C1)O)O)O)=O,16,3,0,3,49,0.00014199999999999998
G5,C1(C(CC(C(C(C)O)O)(C1)O)O)=O,16,1,0,1,45,4.7e-05
G5,C1(C(C(C(C1)O)C(CO)(C)O)O)=O,16,1,0,1,49,4.7e-05
G5,C1(C(C(C(C1)O)C(C)O)O)=O,16,1,0,1,45,4.7e-05
G5,C(C1(CC(C(C1O)=O)O)O)=O,8,4,0,4,5,0.00018999999999999998
G5,C1(C(C(C(C(C)(C1)O)=O)O)O)=O,8,3,0,3,26,0.00014199999999999998
G5,C(C1(CC(C(C1O)=O)(C)O)O)=O,8,2,0,2,26,9.499999999999999e-05
G5,C1(C(C(C(C(C)(C1)O)O)O)=O)=O,8,3,0,3,25,0.00014199999999999998
G5,C1(C(C(C(C(C1)O)(C)O)O)=O)=O,8,4,0,4,5,0.00018999999999999998
G5,C(CO)(C1(CC(C(C1)=O)O)O)=O,4,2,0,2,26,9.499999999999999e-05
G5,C(C)(C1C(C(CC(C1O)=O)O)=O)=O,8,3,0,3,26,0.00014199999999999998
G5,C1(CC(C(CC(C(C1)=O)O)=O)O)=O,4,2,0,2,26,9.499999999999999e-05
G5,C(C1(CC(C(C1C(C)=O)=O)O)O)=O,8,2,0,2,26,9.499999999999999e-05
G5,C(C1(CC(C(CC(C1)=O)=O)O)O)=O,4,1,0,1,26,4.7e-05
G5,C1(C(C(C(C=O)=O)C(C)(C1)O)O)=O,8,5,0,5,26,0.00023700000000000001
G5,C(C1(CC(C(C1C(C)=O)O)=O)O)=O,8,3,0,3,45,0.00014199999999999998
G5,C(C1(CC(CC(C(C1)=O)O)=O)O)=O,4,2,0,2,45,9.499999999999999e-05
G5,C(C1(CC(C=O)(CC(C1)=O)O)O)=O,3,1,0,1,45,4.7e-05
G5,C1(CC(C(CC(C=O)=O)(C1)O)O)=O,4,2,0,2,45,9.499999999999999e-05
G5,C1(CC(C)(C(C1C(C=O)=O)O)O)=O,8,3,0,3,45,0.00014199999999999998
G5,C1(C(CC(C1C(C(C)=O)O)=O)O)=O,8,3,0,3,26,0.000144
G5,C1(CC(C(C)(C1C(C=O)=O)O)O)=O,8,3,0,3,45,0.00014199999999999998
G5,C(C(C)(C1C(CC(C1=O)O)=O)O)=O,8,3,0,3,26,0.000144
G5,C1(C(C(C(C1)=O)C(C(C)=O)O)O)=O,8,4,0,4,45,0.00019099999999999998
G5,C1(C(CC(CC(C=O)=O)(C1)O)O)=O,4,2,0,2,45,9.499999999999999e-05
G5,C(C(C)(C1C(CC(C1O)=O)=O)O)=O,8,4,0,4,45,0.00019099999999999998
G5,C(C1C(C(CC(C1O)=O)O)=O)=O,8,5,0,5,29,0.00023700000000000001
G5,C1(C(CC(C=O)(C1C=O)O)O)=O,8,3,0,3,29,0.00014199999999999998
G5,C1(C(C(C(C=O)=O)C(C1)O)O)=O,8,7,0,7,29,0.000332
G5,C(C1(CC(C(C1C=O)O)=O)O)=O,8,4,0,4,29,0.00018999999999999998
G5,C(C1C(C(CC1(C(C)=O)O)=O)O)=O,8,3,0,3,45,0.00014199999999999998
G5,C(CC1(C(CC(C(C1)=O)O)=O)O)=O,4,2,0,2,45,9.499999999999999e-05
G5,C(C1(CC(C(C1)=O)(CC=O)O)O)=O,4,1,0,1,45,4.7e-05
G5,C1(C(CC(C1)O)(CC(C=O)=O)O)=O,4,2,0,2,45,9.499999999999999e-05
G5,C1(C(C)(CC(C(C1C=O)O)=O)O)=O,8,3,0,3,45,0.00014199999999999998
G5,C1(C(C)(CC(C=O)(C1C=O)O)O)=O,8,2,0,2,45,9.499999999999999e-05
G5,C(C1C(C(CC(C)(C1O)O)=O)=O)=O,8,3,0,3,45,0.00014199999999999998
G5,C(C(C1C(C(CC1O)=O)=O)O)(C)=O,8,5,0,5,45,0.00023799999999999998
G5,C(C1C(C(CC(C1(C)O)O)=O)=O)=O,8,3,0,3,45,0.00014199999999999998
G5,C(C(C)(C1C(C(CC1O)=O)=O)O)=O,8,5,0,5,45,0.00023799999999999998
G5,C(C1(CC(C(C1)=O)O)O)(CC=O)=O,4,1,0,1,45,4.7e-05
G5,C1(CC(C(CC1(C)O)=O)O)=O,4,3,0,3,14,0.00014199999999999998
G5,C(C1(CC(C(C1)=O)(C)O)O)=O,4,1,0,1,29,4.7e-05
G5,C1(C(CC(C)(C(C1)O)O)=O)=O,4,3,0,3,45,0.00014199999999999998
G5,C(C)(C1(CC(C(C1)=O)O)O)=O,4,2,0,2,45,9.499999999999999e-05
G5,C(C1C(C)(CC(C1O)=O)O)=O,8,7,0,7,26,0.000332
G5,C1(CC(C(CC(C1)O)=O)O)=O,4,3,0,3,45,0.00014199999999999998
G5,C(C)(C1C(CC(C1O)=O)O)=O,8,4,0,4,23,0.00018999999999999998
G5,C(C1(CC(CC(C1)=O)O)O)=O,4,4,0,4,23,0.00018999999999999998
G5,C(C1C(CC(C1(C)O)O)=O)=O,8,5,0,5,45,0.00023700000000000001
G5,C(CC1(CC(C(C1)=O)O)O)=O,4,8,0,8,2,0.000381
G5,C(C1C(CC(C)(C1O)O)=O)=O,8,5,0,5,45,0.00023700000000000001
G5,C1(C2C(C)(C(C1C(O2)O)O)O)=O,32,6,0,6,35,0.000285
G5,C1(C(C2C(O)OCC2(C1)O)O)=O,16,2,0,2,35,9.499999999999999e-05
G5,C1(C2C(C(C)(C1C(O2)O)O)O)=O,32,6,0,6,35,0.000285
G5,C1(C(C2C(CC(O)O2)(C1)O)O)=O,16,2,0,2,35,9.499999999999999e-05
G5,C1(CC(C=CC(C(C1O)O)=O)O)=O,8,3,0,3,45,0.00014199999999999998
G5,C(C1(CC(C=CC(C1O)=O)O)O)=O,8,2,0,2,45,9.499999999999999e-05
G5,C1C(C(C(C=O)=O)C(C=1)(CO)O)O,8,4,0,4,45,0.00018999999999999998
G5,C1(CC(C=CC=O)(C(C1O)O)O)=O,16,1,0,1,45,4.7e-05
G5,C1(CC(C=C)(C(C1O)O)O)=O,8,5,0,5,7,0.00023700000000000001
G5,C1C(C(C(C=O)=O)C(C=1)O)O,3,3,0,3,20,0.00014199999999999998
G5,C(C1(C(CO)C(C(C1)=O)O)O)(O)=O,8,2,0,2,45,0.000106
G5,C1(CC(C(C=CC(CC1O)=O)=O)O)=O,4,2,0,2,45,9.499999999999999e-05
G5,C(C1(CC(C(C=CC(C1)=O)=O)O)O)=O,4,1,0,1,45,4.7e-05
G5,C1C(C(CC(C=O)=O)O)(CC(C=1)=O)O,4,2,0,2,45,9.499999999999999e-05
G5,C1C(C)(C(C(C=O)=O)C(C(C=1)=O)O)O,8,4,0,4,45,0.00018999999999999998
G5,C(C1(C=CC(CC(C(C1)=O)O)=O)O)=O,4,2,0,2,45,9.499999999999999e-05
G5,C(C1(CC(C=O)(C=CC(C1)=O)O)O)=O,4,1,0,1,45,4.7e-05
G5,C1C(C(CC(C=1)=O)O)(CC(C=O)=O)O,4,2,0,2,45,9.499999999999999e-05
G5,C(C1(C=CC(C)(C1C(C=O)=O)O)O)=O,8,4,0,4,45,0.00018999999999999998
G5,C(C)(C(C1C(C=CC(C1O)=O)=O)O)=O,8,4,0,4,45,0.00019099999999999998
G5,C(C1(C=CC(C1C(C(C)=O)O)=O)O)=O,8,4,0,4,45,0.00019099999999999998
G5,C1(CC(C=CC(C=O)=O)(CC1O)O)=O,8,1,0,1,45,4.7e-05
G5,C(C(C)(C1C(C=CC(C1O)=O)=O)O)=O,8,4,0,4,45,0.00019099999999999998
G5,C(C(C)(C1C(C=CC1(C=O)O)=O)O)=O,8,4,0,4,45,0.00019099999999999998
G5,C(C1C=CC(C(CC(C1O)=O)O)=O)=O,8,2,0,2,45,9.499999999999999e-05
G5,C(C1C=CC(C(CC1(C=O)O)O)=O)=O,8,1,0,1,45,4.7e-05
G5,C1CC(C(C(C=O)=O)C(C(C=1)=O)O)O,8,4,0,4,45,0.00018999999999999998
G5,C(C1C=CC(C=O)(CC(C1O)=O)O)=O,8,2,0,2,45,9.499999999999999e-05
G5,C(C1(C=CC(C=O)C(C=O)(C1)O)O)=O,8,1,0,1,45,4.7e-05
G5,C(C1C=CC(C1O)(CC(C=O)=O)O)=O,8,2,0,2,45,9.499999999999999e-05
G5,C(C1(C=CCC(C1C(C=O)=O)O)O)=O,8,4,0,4,45,0.00018999999999999998
G5,C1(C(C(C=CC(C=O)=O)C(C1)O)O)=O,16,1,0,1,45,4.7e-05
G5,C1(CC(C=CC(C(CC1O)=O)=O)O)=O,4,2,0,2,45,9.499999999999999e-05
G5,C(C1(CC(C=CC(C(C1)=O)=O)O)O)=O,4,1,0,1,45,4.7e-05
G5,C(C)(C1(C=CC(C1C(C=O)=O)O)O)=O,8,4,0,4,45,0.00018999999999999998
G5,C1C(C(C(C=O)=O)C(C(C=1)=O)(C)O)O,8,4,0,4,45,0.00018999999999999998
G5,C1(CC(C(CC1(C=CC=O)O)=O)O)=O,8,2,0,2,45,9.499999999999999e-05
G5,C(C1(CC(C(C1)=O)(C=CC=O)O)O)=O,8,1,0,1,45,4.7e-05
G5,C1(CC(C=CC1(CC(C=O)=O)O)O)=O,4,2,0,2,45,9.499999999999999e-05
G5,C(C)(C(C1C(C(C=CC1O)=O)=O)O)=O,8,4,0,4,45,0.00019099999999999998
G5,C1(CC(C(C=CC=O)=O)(CC1O)O)=O,8,1,0,1,45,4.7e-05
G5,C(C(C)(C1C(C(C=CC1O)=O)=O)O)=O,8,4,0,4,45,0.00019099999999999998
G5,C(C1C(C=CC(CC(C1O)=O)O)=O)=O,8,3,0,3,45,0.00014199999999999998
G5,C(C1C(C=CC(CC1(C=O)O)O)=O)=O,8,2,0,2,45,9.499999999999999e-05
G5,C(CC1(C=CC(C1C(C=O)=O)O)O)=O,8,4,0,4,45,0.00018999999999999998
G5,C1C(C(C(C=O)=O)C(CC(C=1)=O)O)O,8,4,0,4,45,0.00018999999999999998
G5,C(C1C(C(CC1(C=CC=O)O)=O)O)=O,16,3,0,3,45,0.00014199999999999998
G5,C(C1C(C=CC1(CC(C=O)=O)O)O)=O,8,3,0,3,45,0.000143
G5,C1(C(C(C(C=CC=O)=O)C(C1)O)O)=O,16,3,0,3,45,0.00014199999999999998
G5,C1C(C(C(C=1)=O)C(CC(C=O)=O)O)O,8,3,0,3,45,0.000143
G5,C1(C(CC(C(C1C(C=C)=O)O)=O)O)=O,8,3,0,3,45,0.00014199999999999998
G5,C1(C(CC(C=O)(C1C(C=C)=O)O)O)=O,8,2,0,2,45,9.499999999999999e-05
G5,C1(CC(C=C)(C(C(C=O)=O)C1O)O)=O,8,5,0,5,45,0.00023700000000000001
G5,C(C1(CC(C(C1C(C=C)=O)O)=O)O)=O,8,3,0,3,45,0.00014199999999999998
G5,C1(C(C(C(C(C=C)=O)=O)C(C1)O)O)=O,8,3,0,3,45,0.00014199999999999998
G5,C1(CC(C(C(C=O)=O)C1(C=C)O)O)=O,8,4,0,4,45,0.00018999999999999998
G5,C(C1C(C(CC1(C(C=C)=O)O)=O)O)=O,8,3,0,3,45,0.00014199999999999998
G5,C(C1C(C(C=C)(CC(C1O)=O)O)=O)=O,8,3,0,3,45,0.00014199999999999998
G5,C1(C(C=O)C(C=O)(CC1(C=C)O)O)=O,8,2,0,2,45,9.499999999999999e-05
G5,C1(C(CC(C(C1C=CC=O)O)=O)O)=O,16,2,0,2,45,9.499999999999999e-05
G5,C1(C(CC(C=O)(C1C=CC=O)O)O)=O,16,1,0,1,45,4.7e-05
G5,C1(C(C(C(C=O)=O)C(C=CC1)O)O)=O,8,4,0,4,45,0.00018999999999999998
G5,C(C1(CC=CC(C1C(C=O)=O)O)O)=O,8,4,0,4,45,0.00018999999999999998
G5,C1(C(C(C=CC(C1)O)C(C=O)=O)O)=O,8,2,0,2,45,9.499999999999999e-05
G5,C(C1(CC(C=CC1C(C=O)=O)O)O)=O,8,1,0,1,45,4.7e-05
G5,C(C1(CC(C(C1C=CC=O)O)=O)O)=O,16,1,0,1,45,4.7e-05
G5,C1(C(C2C(C(CO2)O)(C1)O)O)=O,16,1,0,1,10,4.7e-05
G5,C1(C(C2COC(C2(C1)O)O)O)=O,16,2,0,2,45,9.499999999999999e-05
G5,C1(C(C(C(C(C1)O)CO)O)O)=O,16,3,0,3,2,0.00014199999999999998
G5,C1(C(C(C(C(C1)O)C(C)O)O)O)=O,32,3,0,3,49,0.00014199999999999998
G5,C(C1C(C(C(CO)(C1O)O)O)=O)=O,16,4,0,4,49,0.00018999999999999998
G5,C(CO)(C1C(C(C(C1O)=O)O)O)=O,16,4,0,4,49,0.00018999999999999998
G5,C(C1C(CO)(C(C(C1O)=O)O)O)=O,16,4,0,4,49,0.00018999999999999998
G5,C(C1C(C(C(CC1O)O)O)=O)=O,16,5,0,5,49,0.00023700000000000001
G5,C(C1C(CC(C(C1O)O)=O)O)=O,16,8,0,8,55,0.00037999999999999997
G5,C(C1(CC(CC(C1O)=O)O)O)(O)=O,8,5,0,5,49,0.00024900000000000004
G5,C1(C(C)(C(C(CO)=O)C(C1)O)O)=O,8,5,0,5,14,0.00023700000000000001
G5,C(C1C(CO)(CC(C1(C)O)=O)O)=O,8,5,0,5,21,0.00023700000000000001
G5,C(C1C(C(C(C)(C1(C)O)O)O)=O)=O,16,4,0,4,14,0.00018999999999999998
G5,C1(C(C)(C(C(CC(C1)O)=O)O)O)=O,8,4,0,4,14,0.00018999999999999998
G5,C1(CC(C(C1(C)O)O)(CC=O)O)=O,8,3,0,3,14,0.000144
G5,C1(C(CC(CO)(CC(C1)O)O)=O)=O,4,2,0,2,14,9.499999999999999e-05
G5,C(C)(C1(CC(CC(C1O)=O)O)O)=O,8,4,0,4,14,0.00018999999999999998
G5,C(C1C(C(C(CC1(C)O)O)O)=O)=O,16,4,0,4,49,0.00018999999999999998
G5,C1(CC(C(C(CO)=O)C(C1)O)O)=O,3,3,0,3,49,0.00014199999999999998
G5,C1(CC(CC(C(C(C1)O)O)=O)O)=O,8,5,0,5,49,0.00023700000000000001
G5,C1(C(C(C(C(C)=O)C(C1)O)O)O)=O,16,7,0,7,6,0.000332
G5,C(C1C(CC(CC1(CO)O)O)=O)=O,8,3,0,3,49,0.00014199999999999998
G5,C(C1C(C(C(C=C)(C1O)O)O)=O)=O,16,4,0,4,7,0.00018999999999999998
G5,C1(C(C(C=C)(C(C(C1)O)O)O)O)=O,16,2,0,2,49,9.499999999999999e-05
G5,C(C1C(C(C(C=CC1O)O)O)=O)=O,16,4,0,4,43,0.00018999999999999998
G5,C1(CC(C(C(C(C1O)O)O)=O)O)=O,16,3,0,3,1,0.00014199999999999998
G5,C(C(C1(CC(C(C1O)=O)O)O)O)=O,16,3,0,3,1,0.00014199999999999998
G5,C(C1(CC(C(C(C1)=O)O)O)O)(O)=O,8,2,0,2,51,0.000106
G5,C1(C(C)(CC(C(C(C1)O)O)=O)O)=O,8,4,0,4,14,0.00018999999999999998
G5,C1(CC(CC1(C)O)(C(C=O)O)O)=O,8,1,0,1,14,4.7e-05
G5,C1(C(CC(C(C(C)(C1)O)O)O)=O)=O,8,2,0,2,14,9.499999999999999e-05
G5,C(C)(C1(CC(C(C(C1)=O)O)O)O)=O,8,3,0,3,24,0.00014199999999999998
G5,C(C1C(CC(C(C1(C)O)O)O)=O)=O,16,3,0,3,9,0.00014199999999999998
G5,C(C1C(CC(C)(C(C1O)O)O)=O)=O,16,3,0,3,27,0.00014199999999999998
G5,C1(CC(C=C)(C(C(C1O)O)O)O)=O,16,1,0,1,1,4.7e-05
G5,C(C(C(C1C(C=CC1O)O)=O)O)=O,6,2,0,2,1,9.499999999999999e-05
G5,C1(C(C(CC1O)O)C(C=O)O)=O,16,5,0,5,20,0.000239
G5,C(C1C(C(C(C(C1O)=O)O)O)O)=O,32,7,0,7,43,0.000332
G5,C(C(C1C(C(C(C1O)=O)O)O)O)=O,32,3,0,3,43,0.00014199999999999998
G5,C1(C(C(C(C(C1)O)O)O)=O)=O,8,5,0,5,5,0.00023700000000000001
G5,C1(C(C(C(C1C(CO)=O)O)O)O)=O,16,5,0,5,0,0.00023700000000000001
G5,C1(C(C(C(C(C(C1)=O)O)O)O)O)=O,10,2,0,2,0,9.499999999999999e-05
G5,C1(CC(C(C(C(C1O)=O)O)O)O)=O,16,3,0,3,0,0.00014199999999999998
G5,C1(CC(C(C1C(C=O)=O)O)O)=O,8,5,0,5,0,0.00023700000000000001
G5,C(C(C1C(CC(C1=O)O)=O)O)=O,8,5,0,5,0,0.000239
G5,C(C(C1C(CC(C1O)=O)=O)O)=O,8,6,0,6,0,0.000286
G5,C(C1C(C(CC(C1O)O)=O)=O)=O,8,5,0,5,0,0.00023700000000000001
G5,C(C(C1C(C(CC1O)=O)=O)O)=O,8,7,0,7,0,0.000333
G5,C1(C2C(C(C1C(O2)O)O)O)=O,32,6,0,6,0,0.000285
G5,C1(C2C(C(C1C(C(O2)O)O)O)O)=O,64,6,0,6,0,0.000285
G5,C(C(C1C(C=CC(C1O)=O)=O)O)=O,8,4,0,4,0,0.00019099999999999998
G5,C(C1(C=CC(C1C(C=O)O)=O)O)=O,8,4,0,4,0,0.00019099999999999998
G5,C(C(C1C(C(C=CC1O)=O)=O)O)=O,8,4,0,4,0,0.00019099999999999998
G5,C1(CC(CC1(C)O)(C(CO)O)O)=O,8,1,0,1,14,4.7e-05
G5,C1(CC(CC(C1)O)(C(CO)O)O)=O,8,3,0,3,6,0.000154
G5,C(C1C(C=CC1O)O)(C(CO)O)=O,6,2,0,2,43,9.499999999999999e-05
G5,C1(C(C(CC(C1CO)O)O)O)=O,16,6,0,6,2,0.00028900000000000003
G5,C1(C(C(CO)C(C1CO)O)O)=O,16,6,0,6,2,0.00031099999999999997
G5,C(C1C(C(CO)C(C1O)O)O)=O,32,4,0,4,43,0.00018999999999999998
G5,C1(C(C(C(C(C1CO)O)=O)O)O)=O,16,8,0,8,5,0.000384
G5,C1(C(CO)C(C=O)(C(C1O)O)O)=O,16,5,0,5,1,0.000241
G5,C(C1C(C(CO1)O)O)(C(CO)O)=O,16,4,0,4,36,0.000194
G5,C(C1C(CO)(C(CO)C(O1)O)O)=O,16,3,0,3,38,0.00014199999999999998
G5,C(C1C(CC(O1)O)(C(CO)O)O)=O,16,3,0,3,38,0.00014199999999999998
G5,C(C(CO)O)(C1C(O)OCC1O)=O,16,5,0,5,38,0.000241
G5,C(C1C(C(C(O1)O)O)(CCO)O)=O,16,3,0,3,19,0.00014199999999999998
G5,C1(C(C(C(C(C1)O)CO)O)=O)=O,8,3,0,3,5,0.00014199999999999998
G5,C1(C(C(CC(C1CO)O)O)=O)=O,8,5,0,5,9,0.000241
G5,C1(C(C(CO)O)(CC(C1)=O)O)=O,4,4,0,4,26,0.00019099999999999998
G5,C1(C(C(C(C)(C1CO)O)O)=O)=O,8,5,0,5,26,0.000241
G5,C1(C(C(C(CCO)(C1)O)O)=O)=O,4,4,0,4,2,0.00018999999999999998
G5,C1(CC(C(C(C1CO)O)=O)O)=O,8,8,0,8,17,0.000384
G5,C1(C(C(C(CC1CO)O)O)=O)=O,8,4,0,4,5,0.000192
G5,C1(C(C(C(C(CO)C1)O)O)=O)=O,8,4,0,4,5,0.00018999999999999998
G5,C1(C(CC(C(CO)O)(C1)O)=O)=O,2,2,0,2,51,9.499999999999999e-05
G5,C1(C(CC(CO)(C1CO)O)=O)=O,4,7,0,7,24,0.000336
G5,C1(C(C)(C(C(C1CO)=O)O)O)=O,8,7,0,7,24,0.000336
G5,C1(C(CCO)(C(C(C1)=O)O)O)=O,4,4,0,4,24,0.00018999999999999998
G5,C1C(C(CO)O)(C(C(C=1)=O)O)O,8,4,0,4,32,0.00018999999999999998
G5,C1(C(C(CC1)(C(CO)O)O)O)=O,8,3,0,3,29,0.00014199999999999998
G5,C1(C(C(CO)(C(CO)C1)O)O)=O,8,4,0,4,29,0.00020099999999999998
G5,C1(C(C(CO)(CC1CO)O)O)=O,8,5,0,5,29,0.000251
G5,C1(C(CO)C(C(C1CO)O)O)=O,10,5,0,5,29,0.00025299999999999997
G5,C(C1(C(CO)CC(C1O)=O)O)(O)=O,8,3,0,3,29,0.000154
G5,C(C1(CC(C(C1O)=O)CO)O)(O)=O,8,4,0,4,29,0.00020299999999999997
G5,C1(C(CO)C(C(O)=O)(CC1O)O)=O,8,5,0,5,29,0.00025299999999999997
G5,C(C1C(C(C(CO)C1O)O)=O)(O)=O,16,6,0,6,17,0.000309
G5,C(C1(C(C(CO)C(C1O)O)=O)O)=O,16,6,0,6,27,0.00028900000000000003
G5,C1(C2C(C(C(CO)O2)(C1)O)O)=O,16,1,0,1,2,4.7e-05
G5,C1(C2C(C(CO2)(C1CO)O)O)=O,16,4,0,4,2,0.000194
G5,C1(C2C(C(C(C1O)O2)CO)O)=O,32,2,0,2,9,9.499999999999999e-05
G5,C1(C2C(CO)C(C(O2)O)(C1)O)=O,16,3,0,3,45,0.00014199999999999998
G5,C1(C2CC(C(O2)O)(C1CO)O)=O,16,6,0,6,2,0.00028900000000000003
G5,C1(C2C(CO)C(C1C(O2)O)O)=O,32,4,0,4,23,0.00018999999999999998
G5,C1(C=CC(C(C1CO)O)=O)=O,4,5,0,5,2,0.000241
G5,C(C1(C=CC(C1CO)=O)O)=O,4,6,0,6,2,0.00028900000000000003
G5,C1C(C(C(C(C=1)=O)=O)CO)O,4,5,0,5,14,0.000241
G5,C1(C2(C(CO)C(C1CO2)O)O)=O,16,4,0,4,2,0.00018999999999999998
G5,C1(C2C(C(CO)C(C1)(O2)O)O)=O,16,4,0,4,48,0.00018999999999999998
G5,C1(C2C(CC(C1CO)(O2)O)O)=O,16,6,0,6,2,0.00028900000000000003
G5,C1(C2COC(C2O)(C1CO)O)=O,16,6,0,6,2,0.00028900000000000003
G5,C1(C2C(O)OC(C2O)C1CO)=O,32,6,0,6,2,0.00028900000000000003
G5,C1(C(C(C(C1CO)O)C(C)O)O)=O,32,3,0,3,4,0.000154
G5,C(C1(C(CO)C(C(C1O)=O)O)O)=O,16,2,0,2,5,9.499999999999999e-05
G5,C1(CC(C(C(CO)C1(C)O)=O)O)=O,8,3,0,3,14,0.00014199999999999998
G5,C(C1(C(CO)C(C(C1)=O)(C)O)O)=O,8,1,0,1,14,4.7e-05
G5,C1(C(CC(C(C1)O)(CCO)O)=O)=O,4,2,0,2,14,9.499999999999999e-05
G5,C1(C(CO)C(C(C)=O)(CC1O)O)=O,8,2,0,2,14,9.499999999999999e-05
G5,C(C1C(C)(C(C(C1O)=O)CO)O)=O,16,4,0,4,3,0.00018999999999999998
G5,C1(CC(C(C(CO)C(C1)O)=O)O)=O,8,3,0,3,30,0.00014199999999999998
G5,C(C)(C1C(C(C(C1O)=O)CO)O)=O,16,4,0,4,23,0.00018999999999999998
G5,C(C1C(CC(C1(CCO)O)O)=O)=O,8,3,0,3,30,0.00014199999999999998
G5,C(C1C(CC(C1O)(CCO)O)=O)=O,8,3,0,3,34,0.00014199999999999998
G5,C1(C(CO)C(C=C)(C(C1O)O)O)=O,16,4,0,4,7,0.00018999999999999998
G5,C1(CC(C(C1(C)O)O)(CCO)O)=O,8,1,0,1,14,4.7e-05
G5,C1(C(C(C)(C(C)(C1CO)O)O)O)=O,16,4,0,4,14,0.00018999999999999998
G5,C1(CC(CO)(C(CO)C1(C)O)O)=O,8,1,0,1,14,4.7e-05
G5,C1(C(C(C)(CC(C1CO)O)O)O)=O,16,5,0,5,3,0.00024900000000000004
G5,C1(C(C(CC(C)(C1CO)O)O)O)=O,16,4,0,4,3,0.00018999999999999998
G5,C1(CC(CCO)(C(C(C1)O)O)O)=O,8,3,0,3,27,0.000154
G5,C1(CC(C(CO)C(CO)(C1)O)O)=O,8,2,0,2,26,0.000106
G5,C1(C(C(C=C)(C(C1CO)O)O)O)=O,16,4,0,4,7,0.00018999999999999998
G5,C1(C(C(C=CC(C1CO)O)O)O)=O,16,4,0,4,43,0.00018999999999999998
G5,C1(C(C(C(C(C(C1)O)O)O)O)=O)=O,16,3,0,3,1,0.00014199999999999998
G5,C1(C2C(C(C(C1C(O2)O)O)O)O)=O,64,6,0,6,35,0.000285
G5,C1(C(CC(CO)(C1C(C)O)O)O)=O,16,5,0,5,4,0.000251
G5,C1(C(C(C(C1)O)(CC(C)O)O)O)=O,16,3,0,3,4,0.00014199999999999998
G5,C(C1C(C(C)(CC1(CO)O)O)O)=O,16,4,0,4,4,0.00018999999999999998
G5,C(CO)(C1C(CC(C1(C)O)O)O)=O,16,4,0,4,49,0.00018999999999999998
G5,C1(C(C(CC(C(C)(C1)O)O)O)O)=O,16,3,0,3,4,0.00014199999999999998
G5,C(C1C(C(C)(C(C1(C)O)O)O)O)=O,32,4,0,4,45,0.00018999999999999998
G5,C1(C(C(C)(C(CC(C1)O)O)O)O)=O,16,3,0,3,49,0.00014199999999999998
G5,C1(C(CC(CC(CO)(C1)O)O)O)=O,8,1,0,1,49,4.7e-05
G5,C1(C(CC(C(C(C)(C1)O)O)O)O)=O,16,1,0,1,45,4.7e-05
G5,C1(C(CC(C1C(CO)(C)O)O)O)=O,16,4,0,4,49,0.00019099999999999998
G5,C(C1C(CO)(CC(C1(C)O)O)O)=O,16,5,0,5,29,0.00024900000000000004
G5,C(CO)(C1C(C(C)(CC1O)O)O)=O,16,5,0,5,29,0.00024900000000000004
G5,C1(C(C(CC(C(C1)O)(C)O)O)O)=O,16,3,0,3,29,0.00014199999999999998
G5,C(C1C(C)(C(C(C1(C)O)O)O)O)=O,10,2,0,2,45,9.499999999999999e-05
G5,C1(C(C(C(C)(CC(C1)O)O)O)O)=O,16,3,0,3,49,0.00014199999999999998
G5,C1(CC(CO)(CC1(CO)O)O)=O,4,3,0,3,22,0.000156
G5,C1(C(C(C)(C(CO)(C1)O)O)O)=O,8,3,0,3,45,0.00014199999999999998
G5,C1(C(C(CO)(CC1(C)O)O)O)=O,8,2,0,2,25,9.499999999999999e-05
G5,C1(C(C(C)(C(C1(C)O)O)O)O)=O,16,3,0,3,25,0.00014199999999999998
G5,C1(C(CC(CO)(C1C(C)=O)O)O)=O,8,2,0,2,26,9.499999999999999e-05
G5,C1(CC(CO)(CC(C(C1)=O)O)O)=O,4,1,0,1,26,4.7e-05
G5,C1(C(C(C(C1)O)(CC(C)=O)O)O)=O,8,3,0,3,26,0.00014199999999999998
G5,C(CO)(C1C(C)(CC(C1O)=O)O)=O,8,4,0,4,26,0.00018999999999999998
G5,C1(CC(C(CC(C)(C1O)O)=O)O)=O,8,3,0,3,26,0.00014199999999999998
G5,C1(C(C(C(C)(C1C(C)=O)O)O)O)=O,16,2,0,2,26,9.499999999999999e-05
G5,C1(CC(C)(C(C(C(C1)=O)O)O)O)=O,8,1,0,1,26,4.7e-05
G5,C1(C(C(C(C1)(CC(C)=O)O)O)O)=O,8,3,0,3,27,0.00014199999999999998
G5,C1(C(C(C(CC(C)(C1)O)=O)O)O)=O,3,3,0,3,26,0.00014199999999999998
G5,C(C1(CC(CO)(CC(C1)=O)O)O)=O,4,1,0,1,27,4.7e-05
G5,C1(CC(C(C1)(CC(CO)=O)O)O)=O,4,2,0,2,27,9.499999999999999e-05
G5,C(C1(CC(C)(C(C(C1)=O)O)O)O)=O,8,3,0,3,27,0.00014199999999999998
G5,C(C1(C(C(C)(CC(C1)=O)O)O)O)=O,8,1,0,1,26,4.7e-05
G5,C1(CC(C(C(C(C)=O)O)(C1)O)O)=O,8,3,0,3,26,0.000143
G5,C(C1(CC(C)(CC(C1O)=O)O)O)=O,8,3,0,3,26,0.00014199999999999998
G5,C1(CC(C(C1C(CO)(C)O)=O)O)=O,8,3,0,3,26,0.000143
G5,C1(C(C(CO)(C)O)C(C(C1)=O)O)=O,8,4,0,4,49,0.00019099999999999998
G5,C(C1C(C(CC1(CO)O)O)=O)=O,8,5,0,5,20,0.00023700000000000001
G5,C1(C(CC(CO)(C1)O)(CC=O)O)=O,4,2,0,2,2,9.6e-05
G5,C1(C(CC(C1)O)(CC(CO)=O)O)=O,4,3,0,3,21,0.000143
G5,C(CC1(C(C)(C(C(C1)=O)O)O)O)=O,8,4,0,4,24,0.00019099999999999998
G5,C1(C(C(C(C)(C1)O)O)(CC=O)O)=O,8,3,0,3,14,0.000144
G5,C1(C(CC(C1)O)(C(C(C)=O)O)O)=O,8,4,0,4,45,0.00019099999999999998
G5,C(CC1(C(C)(CC(C1O)=O)O)O)=O,8,4,0,4,14,0.00019099999999999998
G5,C(C1C(C(C)(CC1(CO)O)O)=O)=O,8,2,0,2,14,9.499999999999999e-05
G5,C(C1C(C(C)(C(C1(C)O)O)O)=O)=O,16,2,0,2,14,9.499999999999999e-05
G5,C1(C(CC(C1C(C)(CO)O)O)=O)=O,8,5,0,5,49,0.00023799999999999998
G5,C1(CC(CO)(CC1(C)O)O)=O,4,1,0,1,14,4.7e-05
G5,C1(C(C(C)(C(C)(C1)O)O)O)=O,8,3,0,3,14,0.00014199999999999998
G5,C1(CC(C)(C(C1(C)O)O)O)=O,8,1,0,1,14,4.7e-05
G5,C1(C(C(CC(C)(C1)O)O)O)=O,8,3,0,3,6,0.00014199999999999998
G5,C1(C(C(C)(CC(C1)O)O)O)=O,8,3,0,3,6,0.00014199999999999998
G5,C1(CC(CC(CO)(C1)O)O)=O,4,1,0,1,6,4.7e-05
G5,C1(CC(C)(C(C(C1)O)O)O)=O,8,1,0,1,49,4.7e-05
G5,C1C(CC(CO)(C(C(C=1)=O)O)O)O,8,2,0,2,49,9.499999999999999e-05
G5,C(C1C(C=CC1(CO)O)O)(CO)=O,8,4,0,4,49,0.00018999999999999998
G5,C1(C(C(C=CC(C1)O)(CO)O)O)=O,8,3,0,3,49,0.00014199999999999998
G5,C1C(C(C(C)(C(C(C=1)=O)O)O)O)O,16,2,0,2,49,9.499999999999999e-05
G5,C1(C(C(C=CC(CO)(C1)O)O)O)=O,8,3,0,3,49,0.00014199999999999998
G5,C1(C(C(C=C)(C(C1)O)O)O)=O,8,5,0,5,7,0.00023700000000000001
G5,C(CO)(C1C(C=CC1O)O)=O,3,3,0,3,43,0.00014199999999999998
G5,C1(CC(C=CC(C1O)O)O)=O,8,5,0,5,43,0.00023700000000000001
G5,C(C1C(C(C(C1O)O)C(C)O)O)=O,64,4,0,4,4,0.00018999999999999998
G5,C(C1C(C(C=O)C(C1O)O)O)=O,10,5,0,5,43,0.00023700000000000001
G5,C(C(C1C(C(CC1O)O)O)=O)(O)=O,16,5,0,5,29,0.00024900000000000004
G5,C(C1C(C(CC1(C(O)=O)O)O)O)=O,16,3,0,3,29,0.000154
G5,C1(CC(C(C(C=O)O)C1(C)O)O)=O,16,1,0,1,14,4.7e-05
G5,C(C1C(C(C(C=O)C1(C)O)O)O)=O,10,4,0,4,6,0.00018999999999999998
G5,C(C1C(C(C(C)=O)C(C1O)O)O)=O,32,4,0,4,6,0.00018999999999999998
G5,C1(CC(C(C(C1)O)C(C=O)O)O)=O,6,1,0,1,6,4.7e-05
G5,C(C1C(CC(CC(C1O)O)O)=O)=O,16,3,0,3,6,0.00014199999999999998
G5,C1(C2(CC(C1C(C2CO)O)O)O)=O,32,2,0,2,4,9.499999999999999e-05
G5,C1(C(C(C2C(CC(C12)O)O)O)O)=O,64,1,0,1,18,4.7e-05
G5,C1(C(CC(CO)(CC(C1)O)O)O)=O,8,2,0,2,22,0.000106
G5,C1(C(CC(C1C(C)O)O)O)=O,16,4,0,4,4,0.000192
G5,C(C1C(C(C)(CC1O)O)O)=O,16,4,0,4,18,0.00018999999999999998
G5,C(C1C(CC(C1(C)O)O)O)=O,16,4,0,4,45,0.00018999999999999998
G5,C1(C(CC(CC(C1)O)O)O)=O,8,1,0,1,45,4.7e-05
G5,C(C1C(CC(CO)(CC1O)O)O)=O,3,3,0,3,4,0.000154
G5,C(C1C(CC(CC1(CO)O)O)O)=O,16,5,0,5,29,0.00024900000000000004
G5,C(CO)(C1C(CC(CC1O)O)O)=O,3,3,0,3,29,0.000154
G5,C1(C(C(CC(CC(C1)O)O)O)O)=O,16,3,0,3,29,0.00014199999999999998
G5,C(C1C(C(C(C)(CC1O)O)O)O)=O,32,4,0,4,4,0.00018999999999999998
G5,C(C1C(CC(C(C1(C)O)O)O)O)=O,32,4,0,4,4,0.00018999999999999998
G5,C(C1C(C(CC1O)(CCO)O)O)=O,16,5,0,5,4,0.00024900000000000004
G5,C(C1C(CC(C1(CCO)O)O)O)=O,16,5,0,5,4,0.00024900000000000004
G5,C1(C(CC(CC(C1CO)O)O)O)=O,16,3,0,3,4,0.000154
G5,C(C1C(C(C(CC1O)O)O)O)=O,32,4,0,4,4,0.00018999999999999998
G5,C(C1C(C(CC(CC1O)O)O)O)=O,32,4,0,4,4,0.00018999999999999998
G5,C(C1C(CC(C(CC1O)O)O)O)=O,10,2,0,2,4,9.499999999999999e-05
G5,C1(C(C(CC(CC1O)O)O)O)=O,16,3,0,3,41,0.00014199999999999998
G5,C(C1C(CC(C1(CO)O)O)O)=O,16,4,0,4,41,0.00018999999999999998
G5,C(C1C(C(CO)(CC1O)O)O)=O,16,4,0,4,43,0.00018999999999999998
G5,C1(CC(CC1(CO)O)O)=O,4,4,0,4,29,0.00020299999999999997
G5,C1(C(C(CC1(C)O)O)O)=O,8,2,0,2,25,9.499999999999999e-05
G5,C1(C(CC(C1C(C)=O)O)O)=O,8,4,0,4,26,0.00018999999999999998
G5,C1(CC(CC(C(C1)=O)O)O)=O,4,4,0,4,30,0.00018999999999999998
G5,C(CC1(C(CC(C1)=O)O)O)=O,4,7,0,7,2,0.000333
G5,C1(CC(C(C1C(C)O)=O)O)=O,8,11,0,11,4,0.000525
G5,C1(C(C(C)O)C(C(C1)=O)O)=O,8,12,0,12,2,0.000572
G5,C1(C(CC(C1)O)(CC=O)O)=O,4,5,0,5,4,0.000239
G5,C(C1C(C(C)(CC1O)O)=O)=O,8,3,0,3,14,0.00014199999999999998
G5,C1(C(CC(C1C(C)O)O)=O)=O,8,11,0,11,4,0.000525
G5,C1(CC(CC1(C)O)O)=O,4,3,0,3,21,0.00014199999999999998
G5,C1(CC(CC(C1)O)O)=O,3,3,0,3,26,0.00014199999999999998
G5,C1C(CC(C(C(C=1)=O)O)O)O,8,6,0,6,21,0.000285
G5,C(C1C(C=CC1(CO)O)O)=O,8,5,0,5,11,0.00023700000000000001
G5,C(C1C(C=CC1O)O)=O,3,4,0,4,43,0.00018999999999999998
G5,C(C1C(C(CC(C1O)O)O)O)=O,10,2,0,2,4,9.499999999999999e-05
G5,C1(C(CC(C1CC(C=O)O)O)O)=O,16,2,0,2,7,9.499999999999999e-05
G5,C(C1C(C(CCC(C1O)=O)O)O)=O,16,5,0,5,7,0.00023700000000000001
G5,C(C1C(C(CCC1(C=O)O)O)O)=O,16,4,0,4,29,0.00018999999999999998
G5,C(C(C1CC(C(CC1O)O)O)=O)=O,16,1,0,1,7,4.7e-05
G5,C1(C(CC(C1C(C(C)O)=O)O)O)=O,16,3,0,3,45,0.00014199999999999998
G5,C(C1C(C(C)O)(CC(C1O)=O)O)=O,16,4,0,4,45,0.00018999999999999998
G5,C1(C(C(CC(CC(C1)O)O)O)=O)=O,8,2,0,2,9,9.499999999999999e-05
G5,C(C1C(CC(C1(C(C)=O)O)O)O)=O,16,5,0,5,9,0.00023700000000000001
G5,C(C1C(CC(C(C1(C)O)=O)O)O)=O,16,5,0,5,6,0.00023700000000000001
G5,C(C1C(C(C(C)=O)(CC1O)O)O)=O,16,3,0,3,45,0.00014199999999999998
G5,C1(CC(CC1(C(CC=O)O)O)O)=O,8,3,0,3,43,0.000144
G5,C(C1C(CC(C(C1O)=O)(C)O)O)=O,16,3,0,3,6,0.00014199999999999998
G5,C1(C(C(C(C(C1)O)C(C)O)O)=O)=O,16,2,0,2,25,9.499999999999999e-05
G5,C1(C(C(CC(C1C(C)O)O)O)=O)=O,16,5,0,5,4,0.00023999999999999998
G5,C1(C(CO)(CC(C1C(C)=O)O)O)=O,8,2,0,2,26,9.499999999999999e-05
G5,C1(C(CO)(CC(CC(C1)=O)O)O)=O,4,1,0,1,26,4.7e-05
G5,C1(C(CC(C1O)O)(CC(C)=O)O)=O,8,2,0,2,26,9.499999999999999e-05
G5,C1(C(CC(C)(C1O)O)(CC=O)O)=O,8,3,0,3,26,0.000144
G5,C1(C(C(C(C)O)O)(CC(C1)=O)O)=O,8,2,0,2,26,9.499999999999999e-05
G5,C1(C(C(C(C)(C1C(C)O)O)O)=O)=O,16,4,0,4,26,0.000192
G5,C1(C(C(C(CC(C)O)(C1)O)O)=O)=O,8,2,0,2,4,9.499999999999999e-05
G5,C(C)(C1C(CC(C(C1O)=O)O)O)=O,16,3,0,3,26,0.00014199999999999998
G5,C1(CC(C(C(CC(C1)O)O)=O)O)=O,8,2,0,2,26,9.499999999999999e-05
G5,C(C1C(CC(C(C1O)=O)O)(C)O)=O,16,5,0,5,6,0.00023700000000000001
G5,C(C1(C(C(C(C)=O)C(C1)O)O)O)=O,16,3,0,3,6,0.00014199999999999998
G5,C(C1(C(CC(CC(C1)O)=O)O)O)=O,8,2,0,2,6,9.499999999999999e-05
G5,C(CC1(C(CC(CC1O)=O)O)O)=O,3,2,0,2,17,9.6e-05
G5,C(C1C(C)(CC(C1(C=O)O)O)O)=O,16,5,0,5,6,0.00023700000000000001
G5,C1(CC(C(C(C1C(C)O)O)=O)O)=O,16,7,0,7,4,0.000335
G5,C1(C(C(CC1(CO)O)O)CC=O)=O,8,1,0,1,4,4.7e-05
G5,C(C1C(CC(C(C1)=O)(CO)O)O)=O,8,1,0,1,4,4.7e-05
G5,C(C1C(CCC(C1(CO)O)=O)O)=O,8,4,0,4,44,0.00018999999999999998
G5,C(CCC1(C(C(C(C1)O)O)=O)O)=O,8,3,0,3,27,0.000143
G5,C(C1CC(C(CO)=O)(CC1O)O)=O,8,2,0,2,27,9.499999999999999e-05
G5,C(C1C(CCC1(C(CO)=O)O)O)=O,8,5,0,5,44,0.00023700000000000001
G5,C1(C(CCC(C1O)O)(CC=O)O)=O,8,3,0,3,27,0.000144
G5,C1(C(C(C(CC(CC1)O)O)O)=O)=O,8,2,0,2,44,9.499999999999999e-05
G5,C(C(CO)=O)(C1C(CC(C1)O)O)=O,8,2,0,2,44,9.499999999999999e-05
G5,C1(C(C(C(CC1C(C)O)O)O)=O)=O,16,3,0,3,4,0.000144
G5,C1(C(C(C(C(C(C)O)C1)O)O)=O)=O,16,2,0,2,46,9.499999999999999e-05
G5,C(C1CC(C(C(CC1O)O)=O)O)=O,16,2,0,2,27,9.499999999999999e-05
G5,C(C1C(CCC(C(C1O)=O)O)O)=O,16,5,0,5,27,0.00023700000000000001
G5,C(C1C(CC(C=O)(C(C1)O)O)O)=O,16,2,0,2,27,9.499999999999999e-05
G5,C(C1CC(C(C1O)(CC=O)O)O)=O,16,2,0,2,27,9.6e-05
G5,C(C1C(CCC(C1(C=O)O)O)O)=O,16,4,0,4,27,0.00018999999999999998
G5,C1(C(C)(CC(C(C(C1)=O)O)O)O)=O,8,2,0,2,21,9.499999999999999e-05
G5,C1(C(C)(CC(C1C(CO)=O)O)O)=O,8,3,0,3,21,0.00014199999999999998
G5,C1(C(CC(C(C(C)O)O)(C1)O)=O)=O,4,1,0,1,24,4.7e-05
G5,C1(C(CC(CO)(C1C(C)O)O)=O)=O,8,5,0,5,4,0.00023999999999999998
G5,C1(C(C)(C(C(C1C(C)O)=O)O)O)=O,16,5,0,5,24,0.00023999999999999998
G5,C1(C(CC(C)O)(C(C(C1)=O)O)O)=O,8,3,0,3,4,0.00014199999999999998
G5,C1(C(C(CC1(C=CCO)O)O)O)=O,16,2,0,2,0,9.499999999999999e-05
G5,C1(C(C(CC(C=CC1O)O)O)O)=O,16,2,0,2,32,9.499999999999999e-05
G5,C(C1C(CO)(C(C=CC1O)O)O)=O,16,4,0,4,32,0.00018999999999999998
G5,C1(C(C(C=C)(CC(C1O)O)O)O)=O,16,2,0,2,7,9.499999999999999e-05
G5,C1C(CO)(CC(C(C(C=1)=O)O)O)O,8,2,0,2,32,9.499999999999999e-05
G5,C(C1C(C=CC1(CO)O)(CO)O)=O,3,2,0,2,32,9.499999999999999e-05
G5,C1C(C(C(C)O)O)(C(C(C=1)=O)O)O,16,2,0,2,32,9.499999999999999e-05
G5,C(C1C(C(C=CC(C1O)O)O)O)=O,10,2,0,2,32,9.499999999999999e-05
G5,C1(CC(CO)(CC(C1CO)O)O)=O,8,4,0,4,29,0.000212
G5,C1(C(C(CC(CCO)(C1)O)O)O)=O,8,3,0,3,29,0.000154
G5,C(CO)(C1CC(CO)(CC1O)O)=O,8,3,0,3,29,0.000165
G5,C1(C(C(CC(CC1)(CO)O)O)O)=O,8,4,0,4,29,0.00020099999999999998
G5,C(C1C(CO)(CCC1(CO)O)O)=O,3,3,0,3,29,0.000154
G5,C1(C(C(CC1)(C(C(C)O)O)O)O)=O,16,3,0,3,29,0.00014199999999999998
G5,C1(C(C(CO)(C(C(C)O)C1)O)O)=O,16,4,0,4,29,0.00020099999999999998
G5,C1(C(C(CO)(CC1C(C)O)O)O)=O,16,4,0,4,29,0.000202
G5,C1(C(CC(C1CO)O)(CCO)O)=O,8,4,0,4,29,0.000212
G5,C1(C(C(CCO)(CC(C1)O)O)O)=O,8,2,0,2,49,0.000106
G5,C(C1CC(CC1O)(C(CO)O)O)=O,16,2,0,2,29,0.000106
G5,C(C1C(CCC1(C(CO)O)O)O)=O,16,5,0,5,29,0.00024900000000000004
G5,C(C(CO)O)(C1C(CC(C1)O)O)=O,16,2,0,2,44,0.000106
G5,C1(C(C(CC(C1CCO)O)O)O)=O,16,2,0,2,18,0.000106
G5,C1(CC(CC1(CC(CO)O)O)O)=O,8,2,0,2,29,0.000106
G5,C1(C(C)(CC(C1C(CO)O)O)O)=O,16,3,0,3,29,0.000154
G5,C1(CC(CC(C1C(CO)O)O)O)=O,16,3,0,3,29,0.000154
G5,C(CCO)(C1C(C(CC1O)O)O)=O,16,3,0,3,29,0.000154
G5,C1(CC(C(CC(C1CO)O)O)O)=O,16,3,0,3,29,0.000154
G5,C(C1C(C(CC1(CCO)O)O)O)=O,16,5,0,5,29,0.00024900000000000004
G5,C1(C(C(C(C1CO)O)O)C(C)O)=O,32,5,0,5,4,0.000251
G5,C1(C2(C(CC1C(CC2O)O)O)O)=O,32,3,0,3,18,0.00014199999999999998
G5,C1(CC(CC(C1(CO)O)O)O)=O,8,5,0,5,2,0.000241
G5,C1(CC(CC(C1(C(C)O)O)O)O)=O,16,5,0,5,4,0.00023999999999999998
G5,C1(CC(C2(C(CC(C12)O)O)O)O)=O,32,2,0,2,26,9.499999999999999e-05
G5,C1(CC2(C(C1C(CC2O)O)O)O)=O,32,4,0,4,26,0.00018999999999999998
G5,C(C1C(C2(CC1(CC2O)O)O)O)=O,32,4,0,4,26,0.00018999999999999998
G5,C(C1C(CC(C1(C(C)O)O)O)O)=O,32,2,0,2,4,9.499999999999999e-05
G5,C(C1C(C(CC1O)(C(C)O)O)O)=O,32,4,0,4,4,0.00018999999999999998
G5,C1(C2C(C(CC2O)(C1CO)O)O)=O,32,2,0,2,30,9.499999999999999e-05
G5,C1(C(C2(CC(C1C2CO)O)O)O)=O,32,1,0,1,47,4.7e-05
G5,C1(C(CO)(C2(CC1C(C2)O)O)O)=O,16,1,0,1,21,4.7e-05
G5,C1(CC2(CC(C1C2(CO)O)O)O)=O,16,2,0,2,4,9.499999999999999e-05
G5,C1(C2C(C(CO2)(CC(C1)O)O)O)=O,16,1,0,1,17,4.7e-05
G5,C(C1C2(COC(C2O)C1(C)O)O)=O,32,4,0,4,17,0.00018999999999999998
G5,C1(C2C(CC(C(C1O)O2)(C)O)O)=O,32,2,0,2,17,9.499999999999999e-05
G5,C1(C2C(C(C(C(C)O)O2)(C1)O)O)=O,32,1,0,1,4,4.7e-05
G5,C1(C2C(C(CO2)(C1C(C)O)O)O)=O,32,4,0,4,4,0.000192
G5,C(C1C2C(C(CO2)(CC1O)O)O)=O,32,2,0,2,4,9.499999999999999e-05
G5,C(C1C(CC2C(C1(CO2)O)O)O)=O,32,4,0,4,9,0.00018999999999999998
G5,C1(C2C(CC(CC(C1O)O2)O)O)=O,32,2,0,2,9,9.499999999999999e-05
G5,C1(C2C(C(C(C1O)O2)C(C)O)O)=O,64,2,0,2,9,9.499999999999999e-05
G5,C1(C2CC(C(O2)O)(CC(C1)O)O)=O,16,2,0,2,22,9.499999999999999e-05
G5,C(C1C2(C(O)OC(C2)C1(C)O)O)=O,32,6,0,6,22,0.000285
G5,C1(C(O)OC2C(C)(CC(C12)O)O)=O,32,3,0,3,22,0.00014199999999999998
G5,C1(C2C(C(C(O2)O)(C1)O)C(C)O)=O,32,3,0,3,22,0.00014199999999999998
G5,C1(C2CC(C(O2)O)(C1C(C)O)O)=O,32,6,0,6,22,0.00028700000000000004
G5,C(C1C2CC(C(O)O2)(CC1O)O)=O,32,4,0,4,13,0.00018999999999999998
G5,C(C1C(CC2CC1(C(O)O2)O)O)=O,32,6,0,6,13,0.000285
G5,C1(C(O)OC2CC(CC(C12)O)O)=O,32,3,0,3,13,0.00014199999999999998
G5,C1(C2C(CC(O2)O)(CC(C1)O)O)=O,16,2,0,2,49,9.499999999999999e-05
G5,C(C1C2C(CC(O)O2)(CC1O)O)=O,32,3,0,3,13,0.00014199999999999998
G5,C(C1C(CC2C1(CC(O)O2)O)O)=O,32,5,0,5,13,0.00023700000000000001
G5,C1(C2CC(CC(C1C(O2)O)O)O)=O,32,3,0,3,13,0.00014199999999999998
G5,C1(C2C(C(C1C(O2)O)O)C(C)O)=O,64,4,0,4,4,0.00018999999999999998
G5,C1(C2(COC(CO)C1C(C2)O)O)=O,16,2,0,2,54,9.499999999999999e-05
G5,C1(C2C(CC1(CC(CO)O2)O)O)=O,16,2,0,2,54,9.499999999999999e-05
G5,C1(C2C(CC(C(CO)O2)(C1)O)O)=O,16,2,0,2,54,9.499999999999999e-05
G5,C1(C2(COCC(C1C(C2)O)O)O)=O,16,2,0,2,4,9.499999999999999e-05
G5,C1(C2C(CC1(CC(CO2)O)O)O)=O,16,2,0,2,36,9.499999999999999e-05
G5,C1(C2C(CC(C(CO2)O)(C1)O)O)=O,16,2,0,2,36,9.499999999999999e-05
G5,C1(C(C2(COCC1C(C2)O)O)O)=O,16,2,0,2,36,9.499999999999999e-05
G5,C1(C2C(CC(CCO2)(C1O)O)O)=O,16,2,0,2,36,9.499999999999999e-05
G5,C1(COCC2(C(C1C(C2)O)O)O)=O,16,2,0,2,36,9.499999999999999e-05
G5,C1(C2C(CC(C(C1)O)(CO2)O)O)=O,16,2,0,2,36,9.499999999999999e-05
G5,C(C1C2(COCC1(CC2O)O)O)=O,16,4,0,4,36,0.00018999999999999998
G5,C1(C2C(CC(CC1O)(CO2)O)O)=O,16,2,0,2,36,9.499999999999999e-05
G5,C1(CC2(C(O)OCC1C(C2)O)O)=O,16,3,0,3,23,0.00014199999999999998
G5,C1(COC(C2(CC1C(C2)O)O)O)=O,16,2,0,2,29,9.499999999999999e-05
G5,C1(C2C(CC(CC1)(C(O2)O)O)O)=O,16,4,0,4,29,0.00018999999999999998
G5,C(C1C2(C(O)OCC1(CC2)O)O)=O,16,6,0,6,29,0.000285
G5,C1(C(O)OCC2(CC1C(C2)O)O)=O,16,2,0,2,29,9.499999999999999e-05
G5,C1(C2(CC(C1COC(C2)O)O)O)=O,16,3,0,3,4,0.00014199999999999998
G5,C1(C2(CC(C1C(O)OCC2)O)O)=O,16,3,0,3,53,0.00014199999999999998
G5,C1(C2C(CC(CC(O2)O)(C1)O)O)=O,16,3,0,3,32,0.00014199999999999998
G5,C1(CC2(COC(C1C(C2)O)O)O)=O,16,3,0,3,26,0.00014199999999999998
G5,C1(C=CC(C(CC(C1)O)O)=O)=O,4,2,0,2,29,9.499999999999999e-05
G5,C(CC(C1(C=CC(C1)=O)O)O)=O,4,5,0,5,29,0.000239
G5,C(C1C(C(C=CC1(C)O)=O)O)=O,8,5,0,5,29,0.00023700000000000001
G5,C(C1(C=CC(CC(C1)O)=O)O)=O,4,2,0,2,22,9.499999999999999e-05
G5,C(CC1(C=CC(CC1O)=O)O)=O,4,4,0,4,32,0.00019099999999999998
G5,C(C1(C=CC(C)(C1C=O)O)O)=O,8,5,0,5,29,0.00023700000000000001
G5,C1(C=CC(C(C1C(C)O)O)=O)=O,8,5,0,5,4,0.00023999999999999998
G5,C(C1(C=CC(C1C(C)O)=O)O)=O,8,6,0,6,4,0.00028700000000000004
G5,C(C1C=CC(C(CC1O)O)=O)=O,8,2,0,2,13,9.499999999999999e-05
G5,C(C1C(CC=CC(C1O)=O)O)=O,8,5,0,5,29,0.00023700000000000001
G5,C(C1C=CC(C=O)(CC1O)O)=O,8,2,0,2,13,9.499999999999999e-05
G5,C(C1C=CC(C1O)(CC=O)O)=O,8,3,0,3,29,0.000144
G5,C(C1(C=CCC(C1C=O)O)O)=O,8,5,0,5,29,0.00023700000000000001
G5,C1C(CC(CC(C(C=1)=O)=O)O)O,4,2,0,2,21,9.499999999999999e-05
G5,C(C1C(C=CC1(C(C)=O)O)O)=O,8,6,0,6,21,0.000285
G5,C(C1C(C=CC(C1(C)O)=O)O)=O,8,5,0,5,21,0.00023700000000000001
G5,C1(CC(CC1(C=CC=O)O)O)=O,8,2,0,2,21,9.499999999999999e-05
G5,C(CC1(C(CC(C=C1)O)=O)O)=O,4,5,0,5,21,0.000239
G5,C1C(C(C(C(C=1)=O)=O)C(C)O)O,8,5,0,5,4,0.00023999999999999998
G5,C(C1C(C=CC(CC1O)O)=O)=O,8,6,0,6,29,0.000285
G5,C(CC1(C=CC(C1C=O)O)O)=O,8,9,0,9,4,0.00042800000000000005
G5,C(C1C(CC(C=CC1O)=O)O)=O,8,7,0,7,29,0.000332
G5,C(CC(C1C(C=CC1O)=O)O)=O,8,6,0,6,29,0.000286
G5,C1(C(CC(C1C(C=C)=O)O)O)=O,8,4,0,4,7,0.00018999999999999998
G5,C(C1C(C(CC1(C=C)O)=O)O)=O,8,6,0,6,7,0.000285
G5,C1(CC(C(C=O)C1(C=C)O)O)=O,8,7,0,7,29,0.000332
G5,C(C1C(C(C=C)(CC1O)O)=O)=O,8,5,0,5,29,0.00023700000000000001
G5,C1(C(CC(C1C=CC=O)O)O)=O,16,2,0,2,29,9.499999999999999e-05
G5,C(C1C(C(CC=CC1O)=O)O)=O,8,6,0,6,29,0.000285
G5,C(C1(CC=CC(C1C=O)O)O)=O,8,5,0,5,29,0.00023700000000000001
G5,C1C(C(C=O)=O)C(CC(C=1)O)O,8,2,0,2,29,9.499999999999999e-05
G5,C(C1C(CC2C1(C(CO2)O)O)O)=O,32,4,0,4,9,0.00018999999999999998
G5,C(C1C2C(CC1O)(C(CO2)O)O)=O,32,2,0,2,9,9.499999999999999e-05
G5,C1(C2(CC(CC(C1CO2)O)O)O)=O,16,3,0,3,53,0.00014199999999999998
G5,C(C1C(CC2(C1(CCO2)O)O)O)=O,16,5,0,5,53,0.00023700000000000001
G5,C(C1C2(C(CC1O)(CCO2)O)O)=O,16,3,0,3,53,0.00014199999999999998
G5,C1(C2(C(C(C1CO2)O)C(C)O)O)=O,32,4,0,4,4,0.00018999999999999998
G5,C1(COC2(CC(CC(C12)O)O)O)=O,16,3,0,3,26,0.00014199999999999998
G5,C1(C2C(CC(CC(C1)(O2)O)O)O)=O,16,4,0,4,26,0.00018999999999999998
G5,C(C1C(CC2(CC1(CO2)O)O)O)=O,16,6,0,6,26,0.000285
G5,C(C1C2(CC(CO2)(CC1O)O)O)=O,16,4,0,4,26,0.00018999999999999998
G5,C1(C2C(C(C(C1)(O2)O)C(C)O)O)=O,32,3,0,3,4,0.00014199999999999998
G5,C1(C2C(CC(C1C(C)O)(O2)O)O)=O,32,5,0,5,4,0.00023999999999999998
G5,C(C1C(C2CC(C(C1O)O2)O)O)=O,64,4,0,4,40,0.00018999999999999998
G5,C1(C2C(CC(C1C(C)(O2)O)O)O)=O,32,4,0,4,26,0.00018999999999999998
G5,C1(C(C)(O)OC2C(CC(C12)O)O)=O,32,3,0,3,21,0.00014199999999999998
G5,C(C1C(C2CC1(C(C)(O)O2)O)O)=O,32,6,0,6,21,0.000285
G5,C(C1C(C2C(C1(C(C)O2)O)O)O)=O,64,4,0,4,29,0.00018999999999999998
G5,C1(CCOC2(C(CC(C12)O)O)O)=O,16,3,0,3,30,0.00014199999999999998
G5,C1(CC2(C(CC(C1CO2)O)O)O)=O,16,4,0,4,30,0.00018999999999999998
G5,C(C1C(C2(CC1(CCO2)O)O)O)=O,16,6,0,6,30,0.000285
G5,C1(C(C2(C(C1CO2)O)O)C(C)O)=O,32,6,0,6,30,0.00028700000000000004
G5,C1(COC2(CC1C(CC2O)O)O)=O,16,2,0,2,7,9.499999999999999e-05
G5,C1(C2C(CC(C(CC1)(O2)O)O)O)=O,16,3,0,3,7,0.00014199999999999998
G5,C(C1C(C2(CCC1(CO2)O)O)O)=O,16,5,0,5,29,0.00023700000000000001
G5,C1(C2C(CC(C1CC(O2)O)O)O)=O,32,2,0,2,37,9.499999999999999e-05
G5,C1(CC(O)OC2C(CC(C12)O)O)=O,32,3,0,3,6,0.00014199999999999998
G5,C1(CC2C(CC(C1C(O)O2)O)O)=O,32,4,0,4,6,0.00018999999999999998
G5,C(C1C(C2CC1(CC(O)O2)O)O)=O,32,6,0,6,6,0.000285
G5,C1(C(C2C(C1C(O)O2)O)C(C)O)=O,64,6,0,6,37,0.00028700000000000004
G5,C(C1CC(C(C1(C=O)O)O)=O)(O)=O,8,2,0,2,12,9.499999999999999e-05
G5,C(C1C(C(CC1(C=O)O)=O)O)(O)=O,8,2,0,2,17,9.499999999999999e-05
G5,C(C1C(C(C=O)C(C1O)=O)O)(O)=O,16,3,0,3,17,0.00014199999999999998
G5,C1(C(C(C(C1)=O)O)O)=O,3,9,0,9,2,0.00042699999999999997
G5,C1(C(CC(C1O)=O)O)=O,4,8,0,8,2,0.000391
G5,C(C1(C(CC(C1)=O)=O)O)=O,2,3,0,3,15,0.00014199999999999998
G5,C1(CC(C(C(C1)=O)=O)O)=O,2,4,0,4,29,0.00018999999999999998
G5,C(C1CC(C(C1O)=O)=O)=O,4,2,0,2,5,9.499999999999999e-05
G5,C(C1(CC(C(C1)=O)=O)O)=O,1,2,0,2,1,9.499999999999999e-05
G5,C1(C(CC(C(C1)=O)=O)O)=O,2,3,0,3,29,0.00014199999999999998
G5,C(C1C(CC(C1O)=O)=O)=O,4,6,0,6,27,0.000285
G5,C(C1(C=CC(C1O)=O)O)=O,4,6,0,6,12,0.000285
G5,C1(C=CC(C(C1O)O)=O)=O,3,5,0,5,12,0.00023700000000000001
G5,C1(CC(CC(C1)=O)O)=O,1,4,0,4,27,0.00018999999999999998
G5,C1(C(C(CC1)O)O)=O,4,13,0,13,7,0.000617
G5,C(C1C(CC(C1)=O)O)=O,4,6,0,6,44,0.000285
G5,C(C1C(CCC1O)=O)=O,4,6,0,6,44,0.000285
G5,C1(CC(C(C1)O)O)=O,3,7,0,7,26,0.000332
G5,C(C1C(CO)(C(CO1)O)O)=O,8,3,0,3,36,0.00014199999999999998
G5,C(C1C(O)OCC1(CO)O)=O,8,4,0,4,38,0.00018999999999999998
G5,C1(C(C(C(C1)O)O)=O)=O,4,6,0,6,0,0.000285
G5,C1(C(C=O)C(C)(CO1)O)=O,4,4,0,4,48,0.00018999999999999998
G5,C(C1(COCC(C1)=O)O)=O,2,3,0,3,17,0.00014199999999999998
G5,C(OC1C(CC(C1)O)=O)=O,4,3,0,3,4,0.00014199999999999998
G5,C1(CC(C)(C(C=O)O1)O)=O,4,4,0,4,19,0.00018999999999999998
G5,C1(C(C(C)=O)C(CO1)O)=O,4,7,0,7,19,0.000332
G5,C1(COC(C=O)C1(C)O)=O,4,3,0,3,36,0.00014199999999999998
G5,C(C1C(COC1C=O)O)=O,8,3,0,3,40,0.00014199999999999998
G5,C(C)(C1COC(C1O)=O)=O,4,3,0,3,30,0.00014199999999999998
G5,C(OC1C(CC(C1)=O)O)=O,4,3,0,3,37,0.00014199999999999998
G5,C1(CC(CO)(C(C=O)O1)O)=O,4,3,0,3,2,0.00014199999999999998
G5,C1(C(C(CO)=O)C(CO1)O)=O,4,5,0,5,2,0.00023700000000000001
G5,C(CO)(C1COC(C1O)=O)=O,4,4,0,4,2,0.00018999999999999998
G5,C(C1C(C=CO1)(CO)O)=O,4,3,0,3,38,0.00014199999999999998
G5,C(C1CC(C(C(C1)=O)O)O)=O,8,8,0,8,43,0.00037999999999999997
G5,C(CC1C(C(C(C1)=O)O)O)=O,8,8,0,8,2,0.000381
G5,C1(C(CC(C1O)O)CC=O)=O,8,7,0,7,46,0.000332
G5,C(C1CCC(C1O)=O)=O,4,4,0,4,29,0.00018999999999999998
G5,C1(C(C(CCC1)O)O)=O,4,6,0,6,7,0.000285
G5,C1(CC(CC(C(C1O)=O)O)O)=O,8,2,0,2,0,9.499999999999999e-05
G5,C(C1C(C(C(C1O)=O)(C)O)O)=O,16,7,0,7,9,0.000332
G5,C1(CC(C(C(CC1O)O)=O)O)=O,8,2,0,2,20,9.499999999999999e-05
G5,C(C1(C(CC(C(C1)=O)O)O)O)=O,8,2,0,2,45,9.499999999999999e-05
G5,C1(C(C(C)(C(CC1O)O)O)O)=O,16,2,0,2,49,9.499999999999999e-05
G5,C1(C(CC(C(CO)(C1)O)O)O)=O,8,1,0,1,49,4.7e-05
G5,C1(C(C(C(C)(CC1O)O)O)O)=O,16,3,0,3,16,0.00014199999999999998
G5,C1(C(C(CO)C(C(C1)O)O)O)=O,16,2,0,2,29,0.000106
G5,C1(C(CC(C(C1)O)O)O)=O,8,1,0,1,29,4.7e-05
G5,C1(C(C(C(C)(C(C1O)O)O)O)O)=O,10,3,0,3,5,0.00014199999999999998
G5,C1(CC(C(C(C1O)=O)O)O)=O,8,6,0,6,2,0.000285
G5,C1(C(C(C(C(C1)=O)O)O)O)=O,3,4,0,4,15,0.00018999999999999998
G5,C1(C(C(C(C1CO)=O)O)O)=O,3,4,0,4,51,0.00018999999999999998
G5,C1(C(C(CO)(C(CC1O)O)O)O)=O,16,4,0,4,2,0.00018999999999999998
G5,C1(C(C(C(C(CC1)O)=O)O)O)=O,8,5,0,5,20,0.00023700000000000001
G5,C(C1(CCC(C(C1O)=O)O)O)=O,8,2,0,2,20,9.499999999999999e-05
G5,C(C1C(CO)C(C(C1O)=O)O)=O,16,4,0,4,5,0.00018999999999999998
G5,C1(C(C(C(C=CC1O)O)O)O)=O,16,3,0,3,51,0.00014199999999999998
G5,C1(C(CC(C(C1CO)O)O)O)=O,16,2,0,2,3,9.499999999999999e-05
G5,C(C1C(CC(C1O)=O)O)(CCO)=O,8,3,0,3,30,0.00014199999999999998
G5,C1(CC(C(CC(C1CO)O)=O)O)=O,8,3,0,3,30,0.00014199999999999998
G5,C(C1C(C(CC1(CCO)O)O)=O)=O,8,3,0,3,30,0.00014199999999999998
G5,C1(C(CC(C(CO)=O)C(C1)O)O)=O,8,2,0,2,7,9.499999999999999e-05
G5,C1(C(C(CC(C(CC1)O)=O)O)O)=O,8,4,0,4,7,0.00018999999999999998
G5,C(CC1(C(CCC(C1O)=O)O)O)=O,8,4,0,4,7,0.00019099999999999998
G5,C(C1C(C(CCC1(CO)O)O)=O)=O,8,3,0,3,7,0.00014199999999999998
G5,C1(C(CC(C(CC(C1)O)=O)O)O)=O,3,2,0,2,45,9.499999999999999e-05
G5,C(CC1(C(CC(C(C1)=O)O)O)O)=O,8,3,0,3,45,0.000144
G5,C(C1C(C(CC(C1(C)O)O)O)=O)=O,16,3,0,3,45,0.00014199999999999998
G5,C(C1C(C(C)O)C(C(C1O)=O)O)=O,32,2,0,2,46,9.499999999999999e-05
G5,C1(C(C(C(C(C1(C)O)O)O)O)O)=O,32,5,0,5,26,0.000248
G5,C1(C(C(C(C1CO)O)O)=O)=O,8,3,0,3,2,0.00014199999999999998
G5,C1(C(O)OCC(C)(C1O)O)=O,8,3,0,3,2,0.00014199999999999998
G5,C1(COCC(CO)(C1O)O)=O,4,2,0,2,36,9.499999999999999e-05
G5,C1(C(CC(C)(C1O)O)O)=O,8,3,0,3,5,0.00014199999999999998
G5,C1(C(C(CCC1O)O)O)=O,8,3,0,3,27,0.00014199999999999998
G5,C1(C(C(C(CO)(C1(C)O)O)O)O)=O,16,4,0,4,25,0.00018999999999999998
G5,C(C1(C(C(C(C)(C1O)O)O)=O)O)=O,16,4,0,4,5,0.00018999999999999998
G5,C(CO)(C1(C(CC(C1O)=O)O)O)=O,8,6,0,6,5,0.000285
G5,C(C1(C(CO)(CC(C1O)=O)O)O)=O,8,7,0,7,49,0.000332
G5,C(C1(C(C(C(C1(C)O)O)O)=O)O)=O,16,4,0,4,45,0.00018999999999999998
G5,C1(C(C)(C(C=O)(C(C1O)O)O)O)=O,16,7,0,7,25,0.000332
G5,C(C1(C(C)(C(C(C1O)=O)O)O)O)=O,16,8,0,8,0,0.00037999999999999997
G5,C(C1(C(CC(CO)(C1O)O)=O)O)=O,8,3,0,3,2,0.00014199999999999998
G5,C1(C(C(C(C1(C(C)=O)O)O)O)O)=O,16,4,0,4,0,0.00018999999999999998
G5,C1(CC(C(C1(C(CO)=O)O)O)O)=O,8,4,0,4,0,0.00018999999999999998
G5,C(C1(C(C(C(C1O)O)O)=O)O)=O,16,4,0,4,0,0.00018999999999999998
G5,C(C1(C(CO)(C(C(C1)=O)O)O)O)=O,8,4,0,4,51,0.00018999999999999998
G5,C(CO)(C1(C(C(C(C1)=O)O)O)O)=O,8,4,0,4,51,0.00018999999999999998
G5,C(C1(C(C(C(CO)(C1)O)O)=O)O)=O,8,2,0,2,51,9.499999999999999e-05
G5,C(C1(C(C(C(C1)O)O)=O)O)=O,8,2,0,2,0,9.499999999999999e-05
G5,C1(C(C(C(CC(CO)C1)O)O)=O)=O,8,3,0,3,55,0.00014199999999999998
G5,C(C1C(CO)CC(C1(CO)O)=O)=O,8,2,0,2,4,9.499999999999999e-05
G5,C(C1C(CC(C(C1O)=O)O)CO)=O,16,2,0,2,11,9.499999999999999e-05
G5,C(C1C(CO)CC(C1(C=O)O)O)=O,16,1,0,1,55,4.7e-05
G5,C(C1CC(C(C(C(C1)O)O)=O)O)=O,16,2,0,2,25,9.499999999999999e-05
G5,C(CC1C(C(C(C(C1)O)=O)O)O)=O,16,4,0,4,25,0.00018999999999999998
G5,C(C1CC(C(CO)(C1C=O)O)O)=O,16,1,0,1,25,4.7e-05
G5,C(CC1CC(C(C(C1O)=O)O)O)=O,16,3,0,3,46,0.00014199999999999998
G5,C1(CCCC(C(C(C1O)=O)O)O)=O,8,3,0,3,32,0.00014199999999999998
G5,C(C1CCC(C(C1(CO)O)O)=O)=O,8,4,0,4,7,0.00018999999999999998
G5,C(C1C(C(C(C(CC1)O)=O)O)O)=O,16,2,0,2,27,9.499999999999999e-05
G5,C(C1CCC(C1(C(C=O)O)O)O)=O,16,1,0,1,27,4.7e-05
G5,C1(C(CC(C1O)O)CC(CO)=O)=O,8,3,0,3,32,0.00014199999999999998
G5,C(CO)(C1CC(C(C(C1)=O)O)O)=O,8,4,0,4,32,0.00018999999999999998
G5,C(CC1C(CO)(C(C(C1)=O)O)O)=O,8,4,0,4,32,0.00019099999999999998
G5,C1(C(CC(CO)(C1O)O)CC=O)=O,8,3,0,3,32,0.00014199999999999998
G5,C(C1C(C(CC1C(C=O)O)O)O)=O,32,1,0,1,27,4.7e-05
G5,C1(CC(C(C1CO)O)(CCO)O)=O,8,3,0,3,29,0.000154
G5,C1(C(C(CC1)(C(CCO)O)O)O)=O,8,4,0,4,7,0.00020099999999999998
G5,C1(C(C(C(CC1)(CCO)O)O)O)=O,8,4,0,4,29,0.00020099999999999998
G5,C1(C(CC(C(CCO)O)(C1)O)O)=O,8,2,0,2,22,0.000106
G5,C1(C(CC(C(C1)O)(CCO)O)O)=O,8,2,0,2,29,0.000106
G5,C(C1CC(CCO)(C(C1O)O)O)=O,16,2,0,2,44,0.000106
G5,C1(CC(C(CC1(CCO)O)O)O)=O,8,2,0,2,29,0.000106
G5,C1(CC(C(C1C(CCO)O)O)O)=O,16,3,0,3,27,0.000154
G5,C1(C(CO)(CC(C1CO)O)O)=O,8,4,0,4,2,0.00020299999999999997
G5,C1(CC(CO)(C(C1CO)O)O)=O,8,6,0,6,2,0.00031099999999999997
G5,C1(CC(CO)(CC1(C(C)O)O)O)=O,8,3,0,3,4,0.000155
G5,C1(C(C(C)(C(C(C)O)(C1)O)O)O)=O,16,2,0,2,45,9.499999999999999e-05
G5,C1(C(C(C)O)(CC(C1CO)O)O)=O,16,4,0,4,4,0.000202
G5,C1(CC(C(C1CO)O)(C(C)O)O)=O,16,3,0,3,25,0.000154
G5,C1C(CO)(CC(C=1)=O)O,2,5,0,5,29,0.00024900000000000004
G5,C1C(C)(C(C(C=1)=O)O)O,4,4,0,4,45,0.00018999999999999998
G5,C1CC(C(C(C=1)=O)O)O,4,4,0,4,29,0.00018999999999999998
G5,C1C(C(C(C=1)=O)CO)O,4,6,0,6,29,0.000296
G5,C1(C(C(C=CC1)O)O)=O,4,4,0,4,27,0.00018999999999999998
G5,C1(C(C(CC(C(CO)O)C1)O)O)=O,16,4,0,4,46,0.00020099999999999998
G5,C(C1C(C(CC(C1O)=O)O)O)(O)=O,16,3,0,3,45,0.000154
G5,C(C1(C(CC(C1O)=O)O)O)(O)=O,8,9,0,9,29,0.00043799999999999997
G5,C(C1(C(C(C(C1)=O)O)O)O)(O)=O,8,6,0,6,17,0.000296
G5,C(C1(C(CC(C)(C1O)O)=O)O)(O)=O,8,6,0,6,16,0.000298
G5,C(C1(C(C)(CC(C1O)=O)O)O)(O)=O,8,6,0,6,26,0.000296
G5,C(C1(C(CC(C1(C)O)O)=O)O)(O)=O,8,6,0,6,45,0.000298
G5,C(C1C(C(CO)(CC1O)O)=O)(O)=O,8,4,0,4,45,0.00020299999999999997
G5,C(C1C(CC(CO)(C1O)O)=O)(O)=O,8,6,0,6,17,0.000309
G5,C(C1(C=CC(C1)=O)O)(O)=O,2,5,0,5,29,0.00024900000000000004
G5,C(C1C(C=CC1O)=O)(O)=O,4,6,0,6,29,0.000296
G5,C1(C(C2(C(C1CCC2O)O)O)O)=O,32,1,0,1,7,4.7e-05
G5,C1(C2(C(C(C1CCC2O)O)O)O)=O,32,4,0,4,4,0.00018999999999999998
G5,C(C1C(C2(C(CC1C2O)O)O)O)=O,64,1,0,1,43,4.7e-05
G5,C(C1(C(C(C(C1O)O)O)=O)O)(O)=O,16,6,0,6,5,0.000286
G5,C(C1(C(C(C(C1O)=O)O)O)O)(O)=O,16,6,0,6,5,0.000285
G5,C(C1(C(CC(CC1O)O)=O)O)(O)=O,8,5,0,5,17,0.000239
G5,C1(CC(C(C(C)O)(C1(C)O)O)O)=O,16,1,0,1,14,4.7e-05
G5,C1(CC(C(C(C1)O)(C(C)O)O)O)=O,6,1,0,1,6,4.7e-05
G5,C(C1C(C(C(C1O)=O)(CO)O)O)=O,16,6,0,6,5,0.00028900000000000003
G5,C1(C2C(C(CO)(C1(CO2)O)O)O)=O,16,4,0,4,10,0.00018999999999999998
G5,C1(C2C(CO)(C(C1(CO2)O)O)O)=O,16,4,0,4,10,0.00018999999999999998
G5,C1(C(C2(COCC2(C1O)O)O)O)=O,10,2,0,2,10,9.499999999999999e-05
G5,C(C1(C(C(C(CC1O)O)O)=O)O)=O,16,4,0,4,5,0.00018999999999999998
G5,C1(C2C(CC(C1(CO2)O)O)O)=O,16,4,0,4,10,0.00018999999999999998
G5,C(C1(C2(COC1C(C2)=O)O)O)(O)=O,8,1,0,1,17,4.7e-05
G5,C(C12C(CC(C1O)(CO2)O)=O)(O)=O,8,3,0,3,17,0.000144
G5,C(C1(C(C2C(CC1O2)O)=O)O)(O)=O,16,4,0,4,9,0.00019099999999999998
G5,C1(C(C)(C(C(O)=O)(C(C1)O)O)O)=O,8,5,0,5,14,0.00023700000000000001
G5,C(C1(C(CC(CC1O)=O)O)O)(O)=O,3,3,0,3,9,0.00014199999999999998
G5,C1(C2C(C)(C(C)(C1(CO2)O)O)O)=O,16,4,0,4,10,0.00018999999999999998
G5,C1(CC2(COCC2(C1(C)O)O)O)=O,8,1,0,1,10,4.7e-05
G5,C1(C2C(CC(C)(C1(CO2)O)O)O)=O,16,4,0,4,10,0.00018999999999999998
G5,C1(C2C(C)(CC(C1(CO2)O)O)O)=O,16,4,0,4,10,0.00018999999999999998
G5,C1(CC(C2(COCC2(C1)O)O)O)=O,8,1,0,1,10,4.7e-05
G5,C1(C2C(C=C)(C(C1(CO2)O)O)O)=O,16,4,0,4,10,0.00018999999999999998
G5,C1(C2(COC1C(C2(C=C)O)O)O)=O,16,4,0,4,10,0.00018999999999999998
G5,C1(C2C(C=CC(C1(CO2)O)O)O)=O,16,4,0,4,10,0.00018999999999999998
G5,C1(CC(C(CO)(C1(C)O)O)O)=O,8,1,0,1,14,4.7e-05
G5,C1(CC(C(CO)(C(C1)O)O)O)=O,3,1,0,1,41,4.7e-05
G5,C1(CC(C)(C(C1(C(C)O)O)O)O)=O,16,5,0,5,4,0.00023999999999999998
G5,C1(C(C(C(C)(C1)O)(C(C)O)O)O)=O,16,1,0,1,45,4.7e-05
G5,C1(CC(C(C)(C1(C(C)O)O)O)O)=O,16,5,0,5,45,0.00023999999999999998
G5,C1(C(C(C(C(C1)O)=O)(CO)O)O)=O,8,5,0,5,5,0.000241
G5,C1(C2C(C)(C(C1(CO2)O)O)O)=O,16,4,0,4,10,0.00018999999999999998
G5,C1(C(C2(COCC2(C1)O)O)O)=O,8,1,0,1,10,4.7e-05
G5,C1(C2C(C(C)(C1(CO2)O)O)O)=O,16,4,0,4,10,0.00018999999999999998
G5,C(C1(C(CC(C1(CO)O)O)=O)O)=O,8,3,0,3,1,0.00014199999999999998
G5,C(C1(C(CC(CC1O)O)=O)O)=O,8,3,0,3,55,0.00014199999999999998
G5,C1(C(C)(C(C(C)=O)(C(C1)O)O)O)=O,8,5,0,5,14,0.00023700000000000001
G5,C1(C(C)(C(C=O)(C(C)(C1)O)O)O)=O,8,3,0,3,14,0.00014199999999999998
G5,C(C1(C(CC(C)(C1(C)O)O)=O)O)=O,8,3,0,3,14,0.00014199999999999998
G5,C(C1(C(CC(CC1(C)O)O)=O)O)=O,8,3,0,3,6,0.00014199999999999998
G5,C1(CC(C(C(C)=O)(C(C1)O)O)O)=O,3,3,0,3,9,0.00014199999999999998
G5,C(C1(C(CC(CC1(C)O)=O)O)O)=O,8,3,0,3,27,0.00014199999999999998
G5,C(C1(C(CC(C=C)(C1O)O)=O)O)=O,8,3,0,3,25,0.00014199999999999998
G5,C1(CC(C(C=C)(C1(C=O)O)O)O)=O,8,3,0,3,1,0.00014199999999999998
G5,C(C1(C(CC(C=CC1O)O)=O)O)=O,8,3,0,3,1,0.00014199999999999998
G5,C1(C(C(C(C1(C(C)O)O)O)O)O)=O,32,6,0,6,5,0.00028700000000000004
G5,C(C1(C(C(C(C1O)O)O)=O)CO)=O,16,4,0,4,2,0.000192
G5,C(C1C(C(CO)(C(C1O)O)O)=O)=O,16,6,0,6,2,0.00028900000000000003
G5,C1(C2C(C(C1(CO2)O)O)O)=O,16,4,0,4,10,0.00018999999999999998
G5,C1(CC(C)(C(CO)(C1(C)O)O)O)=O,8,1,0,1,14,4.7e-05
G5,C1(CC(C)(C(C)(C1(CO)O)O)O)=O,8,3,0,3,14,0.00014199999999999998
G5,C1(CC(CC(C)(C1(CO)O)O)O)=O,8,3,0,3,6,0.00014199999999999998
G5,C1(CC(C(CO)(C(C)(C1)O)O)O)=O,8,1,0,1,6,4.7e-05
G5,C1(CC(C)(CC(C1(CO)O)O)O)=O,8,4,0,4,6,0.00020099999999999998
G5,C1(C(CO)(C(C=C)(C(C1)O)O)O)=O,8,3,0,3,7,0.00014199999999999998
G5,C1(CC(C=CC(C1(CO)O)O)O)=O,8,3,0,3,43,0.00014199999999999998
G5,C1(C(CO)C(C(C1(CO)O)=O)O)=O,8,4,0,4,2,0.000194
G5,C1(COC(CO)(CO)C(C1O)O)=O,4,3,0,3,2,0.000153
G5,C1(C(O)OC(CO)(CO)C(C1)O)=O,4,2,0,2,2,9.499999999999999e-05
G5,C(CO)(C1C(C(CO)(CO1)O)O)=O,8,2,0,2,36,9.499999999999999e-05
G5,C1(COCC(CO)(C(C1O)O)O)=O,8,4,0,4,36,0.000212
G5,C1(C(O)OCC(CO)(C(C1)O)O)=O,8,4,0,4,30,0.000212
G5,C1(C(CO)(C(C=O)(C(C1)O)O)O)=O,8,9,0,9,1,0.00043099999999999996
G5,C1(C2C(CO)(C(CO2)(C1)O)O)=O,8,1,0,1,17,4.7e-05
G5,C1(CC2(C(C1(CO)OC2)O)O)=O,8,3,0,3,17,0.000146
G5,C1(C2C(CC(C1(CO)O)O2)O)=O,16,4,0,4,9,0.000194
G5,C(C1(C(C(C=O)C(C1O)=O)O)O)=O,16,4,0,4,23,0.00018999999999999998
G5,C1(C(C)(C(C=O)(C(C1)O)O)O)=O,8,6,0,6,14,0.000285
G5,C(C1(C(CC(CC1O)=O)O)O)=O,3,3,0,3,0,0.00014199999999999998
G5,C1(C2C(C(C(C1(CO2)O)O)O)O)=O,32,4,0,4,10,0.00018999999999999998
G5,C1(C2C(C(CO2)(C1)O)(C(C)O)O)=O,16,1,0,1,17,4.7e-05
G5,C1(CC2(C(C1(C(C)O)OC2)O)O)=O,16,3,0,3,17,0.000145
G5,C1(C2C(CC(C1(C(C)O)O)O2)O)=O,32,4,0,4,9,0.000192
G5,C1(CC2(CC1(C(C2O)O)O)O)=O,16,2,0,2,26,9.499999999999999e-05
G5,C1(C2(CC(C1CC2(CO)O)O)O)=O,16,2,0,2,7,9.499999999999999e-05
G5,C1(C2(CC(C1C(C2(C)O)O)O)O)=O,32,3,0,3,45,0.00014199999999999998
G5,C1(CC2(CC1(C(CC2O)O)O)O)=O,16,2,0,2,45,9.499999999999999e-05
G5,C1(CC(C2(CC1(C(C2)O)O)O)O)=O,16,2,0,2,22,9.499999999999999e-05
G5,C1(C2(CC(C1C(CC2O)O)O)O)=O,32,3,0,3,13,0.00014199999999999998
G5,C1(CC(C2(CC1(CC2O)O)O)O)=O,16,1,0,1,21,4.7e-05
G5,C(C1(C(C)(C(C(C1)=O)O)O)O)(O)=O,8,2,0,2,17,9.499999999999999e-05
G5,C(C1(C(CC(CO)(C1)O)=O)O)(O)=O,4,3,0,3,17,0.000154
G5,C1(CC(CC1(C(CCO)O)O)O)=O,8,2,0,2,45,9.499999999999999e-05
G5,C(C1(C(CC(C1)O)=O)O)(O)=O,4,4,0,4,29,0.000202
G5,C1(C(CC(C1)O)(C(C(O)=O)O)O)=O,8,3,0,3,45,0.000143
G5,C(C1C(C(C)(C(C)(C1O)O)O)O)=O,10,2,0,2,11,9.499999999999999e-05
G5,C1(C(CC(C(C(C1)O)(C)O)O)O)=O,16,1,0,1,11,4.7e-05
G5,C1(CC(CC1(C(C(C)O)O)O)O)=O,16,2,0,2,45,9.499999999999999e-05
G5,C(C1(C(C(CO)C(C1)O)=O)O)(O)=O,8,4,0,4,4,0.000202
G5,C(C1C(C(C(O)=O)(CC1O)O)O)=O,16,5,0,5,33,0.00023700000000000001
G5,C1(C2(C(CO)(C(C1CO2)O)O)O)=O,16,3,0,3,34,0.00014199999999999998
G5,C1(C2(C(C(CO)(C1CO2)O)O)O)=O,16,3,0,3,5,0.00014199999999999998
G5,C1(C(C2(C(C1O)(O)OCC2)O)O)=O,16,2,0,2,5,9.499999999999999e-05
G5,C(C1(C(C(C(C1)O)O)=O)O)(O)=O,8,3,0,3,17,0.000143
G5,C1(C(C(C(C)(C1(C)O)O)O)O)=O,16,3,0,3,25,0.00014199999999999998
G5,C1(CC(C(C(C)(C1(C)O)O)=O)O)=O,8,2,0,2,14,9.499999999999999e-05
G5,C(C1(C(C)(C(C(C1)=O)(C)O)O)O)=O,8,1,0,1,25,4.7e-05
G5,C(C1C(C)(C(C(C1O)=O)(C)O)O)=O,16,3,0,3,25,0.00014199999999999998
G5,C1(CC(C(C(C)(C(C1)O)O)=O)O)=O,8,2,0,2,25,9.499999999999999e-05
G5,C(C)(C1C(C(C(C1O)=O)(C)O)O)=O,16,3,0,3,25,0.00014199999999999998
G5,C(C1(C(C(CC(C1)=O)O)(C)O)O)=O,8,2,0,2,25,9.499999999999999e-05
G5,C1(C(C(CC(C1(C)O)O)O)O)=O,16,3,0,3,25,0.00014199999999999998
G5,C1(CC(CO)(C(C)(C1(C)O)O)O)=O,8,1,0,1,25,4.7e-05
G5,C1(C(C(C)(C(C)(C1(C)O)O)O)O)=O,16,3,0,3,25,0.00014199999999999998
G5,C1(C(C(CC(C)(C1(C)O)O)O)O)=O,16,3,0,3,25,0.00014199999999999998
G5,C1(CC(C(C)(C(CO)(C1)O)O)O)=O,8,1,0,1,25,4.7e-05
G5,C1(C(C(C)(CC(C1(C)O)O)O)O)=O,16,3,0,3,25,0.00014199999999999998
G5,C1(C(C)(C(C=C)(C(C1O)O)O)O)=O,16,3,0,3,25,0.00014199999999999998
G5,C1(C(C(C=CC(C1(C)O)O)O)O)=O,16,3,0,3,25,0.00014199999999999998
G5,C(C1C(CC(C1(C(O)=O)O)O)O)=O,16,3,0,3,33,0.00014199999999999998
G5,C1(C2(C(CC(C1CO2)O)O)O)=O,16,3,0,3,34,0.00014199999999999998
G5,C1(CC(C(CCO)(C1(C)O)O)O)=O,8,1,0,1,14,4.7e-05
G5,C1(CC(C(C(C1)O)(CCO)O)O)=O,3,1,0,1,29,4.7e-05
G5,C(C1(C(C(CC(C1)O)=O)=O)O)(O)=O,4,2,0,2,17,9.6e-05
G5,C(C1(C(C(CC(C1)=O)O)=O)O)(O)=O,4,2,0,2,17,9.6e-05
G5,C(C1(CC(CC1(C=O)O)=O)O)(O)=O,4,2,0,2,17,9.499999999999999e-05
G5,C(C1CC(C(O)=O)(C(C1O)=O)O)=O,8,2,0,2,17,9.6e-05
G5,C(C1(C(C(C(C=C1)O)O)=O)O)(O)=O,8,3,0,3,32,0.000143
G5,C(C1(C(C(C(C1)=O)CO)O)O)(O)=O,8,6,0,6,29,0.0003
G5,C1(C2CC(C(C(O)=O)(O2)O)(C1)O)=O,8,1,0,1,22,4.7e-05
G5,C(C12C(CC(C1)(C(O2)O)O)=O)(O)=O,8,4,0,4,17,0.00019099999999999998
G5,C(C12C(C(C(O1)O)C(C2)O)=O)(O)=O,16,5,0,5,17,0.00023799999999999998
G5,C(C12C(C(C(C1)=O)C(O2)O)O)(O)=O,16,2,0,2,37,9.499999999999999e-05
G5,C1(C(C(C)(C(C1C(C)=O)O)O)O)=O,16,2,0,2,26,9.499999999999999e-05
G5,C1(CC(C(C)(C(C(C1)=O)O)O)O)=O,8,1,0,1,26,4.7e-05
G5,C(C(C)(C1(C(CC(C1)=O)O)O)O)=O,8,2,0,2,27,9.499999999999999e-05
G5,C1(C(CC(C(C)(C(C1)O)O)O)=O)=O,3,1,0,1,14,4.7e-05
G5,C1(C(CC(C1)O)(C(C=O)(C)O)O)=O,8,3,0,3,45,0.000143
G5,C(C1C(C(C)(C(C)(C1O)O)O)=O)=O,16,2,0,2,45,9.499999999999999e-05
G5,C1(CC(C(C)(C1(C)O)O)O)=O,8,1,0,1,11,4.7e-05
G5,C1(C2(C(C)(C(C)(C1CO2)O)O)O)=O,16,3,0,3,14,0.00014199999999999998
G5,C1(CC2(C(C1(C)O)(O)OCC2)O)=O,8,1,0,1,14,4.7e-05
G5,C1(CC(C(C)(C(C1)O)O)O)=O,3,1,0,1,11,4.7e-05
G5,C1(C2(C(C)(CC(C1CO2)O)O)O)=O,16,3,0,3,34,0.00014199999999999998
G5,C1(C2(C(CC(C)(C1CO2)O)O)O)=O,16,3,0,3,34,0.00014199999999999998
G5,C1(CC2(CCOC2(C(C1)O)O)O)=O,8,1,0,1,34,4.7e-05
G5,C1C(C(C(C(C(C=1)=O)O)O)(C)O)O,16,2,0,2,11,9.499999999999999e-05
G5,C1(C2(C(C(C=C)(C1CO2)O)O)O)=O,16,3,0,3,7,0.00014199999999999998
G5,C1(C2(C(C=C)(C(C1CO2)O)O)O)=O,16,3,0,3,7,0.00014199999999999998
G5,C1(C2(C(C=CC(C1CO2)O)O)O)=O,16,3,0,3,34,0.00014199999999999998
G5,C1(CC(CC1(C(CO)O)O)O)=O,8,2,0,2,0,9.6e-05
G5,C1(C(C(CC1(C(CO)O)O)O)O)=O,16,4,0,4,0,0.00019099999999999998
G5,C1(C(C(C(C(C1)O)=O)(C)O)O)=O,8,4,0,4,49,0.00018999999999999998
G5,C(C1(C(C)(C(C(C1)=O)O)O)O)=O,8,5,0,5,25,0.00023700000000000001
G5,C1(C2(C(C(C)(C1CO2)O)O)O)=O,16,3,0,3,34,0.00014199999999999998
G5,C1(C(C2(C(CCO2)(C1)O)O)O)=O,8,1,0,1,34,4.7e-05
G5,C1(C2(C(C)(C(C1CO2)O)O)O)=O,16,3,0,3,45,0.00014199999999999998
G5,C1(C(C(C(C(C1)O)(C)O)O)O)=O,16,3,0,3,11,0.00014199999999999998
G5,C1(C(C(C(C1O)O)O)(CC=O)O)=O,16,3,0,3,0,0.00014199999999999998
G5,C1(C(CC(C1O)O)(C(C=O)O)O)=O,16,3,0,3,0,0.000143
G5,C1(C2(C(C(C1CO2)O)O)O)=O,16,3,0,3,34,0.00014199999999999998
G5,C1(C(C(C(C(CO)(C1)O)=O)O)O)=O,8,3,0,3,49,0.000144
G5,C(C1C(C(CO)(CC(O1)O)O)O)=O,16,5,0,5,37,0.00026000000000000003
G5,C1(C(CC(CC1(CO)O)O)=O)=O,4,3,0,3,2,0.000144
G5,C1(CC(C(C(C1)O)=O)(CO)O)=O,4,4,0,4,17,0.000192
G5,C(C1(C(CO)(CC(C1)=O)O)O)=O,4,4,0,4,51,0.00018999999999999998
G5,C(C1CC(C(C1O)=O)(CO)O)=O,8,4,0,4,2,0.000192
G5,C1(C(C(C=CC1(CO)O)O)O)=O,8,5,0,5,2,0.000239
G5,C1(C2CC(C(CO)(O2)O)(C1)O)=O,8,1,0,1,2,4.7e-05
G5,C1(CC2(CC1(CO)OC2O)O)=O,8,4,0,4,22,0.000192
G5,C1(C2(CO)CC(C1C(O2)O)O)=O,16,5,0,5,2,0.000239
G5,C1(CC2(CO)C(C1C(O)O2)O)=O,16,4,0,4,37,0.00018999999999999998
G5,C1(C2(C(C(C(C1CO2)O)O)O)O)=O,32,3,0,3,34,0.00014199999999999998
G5,C1(CC(CC1(C(CO)(C)O)O)O)=O,8,2,0,2,45,9.499999999999999e-05
G5,C(C1C(C(C=O)(CC1O)O)O)=O,16,4,0,4,43,0.00018999999999999998
G5,C(C1C(CC(C1(C=O)O)O)O)=O,16,3,0,3,43,0.00014199999999999998
G5,C1(CC(C(CC=O)(C1(C)O)O)O)=O,8,2,0,2,14,9.6e-05
G5,C1(C(C)(C(C=O)(CC(C1)O)O)O)=O,8,2,0,2,21,9.499999999999999e-05
G5,C(C1C(CC(C=O)(C1(C)O)O)O)=O,16,3,0,3,6,0.00014199999999999998
G5,C(C1C(CC(C)(C1(C=O)O)O)O)=O,16,3,0,3,6,0.00014199999999999998
G5,C(C1(C(C=CC(C1C=O)O)O)O)=O,16,3,0,3,43,0.00014199999999999998
G5,C1(CC(CC1(C(C)O)O)O)=O,8,2,0,2,4,9.6e-05
G5,C1(C(C(CC1(C(C)O)O)O)O)=O,16,3,0,3,4,0.000144
G5,C1(C(CC(CC1(C(C)O)O)O)=O)=O,8,2,0,2,25,9.6e-05
G5,C1(CC(C(C(C1)O)=O)(C(C)O)O)=O,8,2,0,2,17,9.6e-05
G5,C(C1(C(C(C)O)(CC(C1)=O)O)O)=O,8,1,0,1,17,4.7e-05
G5,C(C1CC(C(C1O)=O)(C(C)O)O)=O,16,2,0,2,27,9.6e-05
G5,C1(C(C(C=CC1(C(C)O)O)O)O)=O,16,3,0,3,32,0.000144
G5,C1(C2CC(C(C(C)O)(O2)O)(C1)O)=O,16,1,0,1,22,4.7e-05
G5,C1(CC2(CC1(C(C)O)OC2O)O)=O,16,4,0,4,4,0.00019099999999999998
G5,C1(C2(C(C)O)CC(C1C(O2)O)O)=O,32,5,0,5,4,0.000239
G5,C1(CC2(C(C1C(O)O2)O)C(C)O)=O,32,4,0,4,25,0.00018999999999999998
G5,C1(CC(C(C(C(O)=O)O)(C1)O)O)=O,8,2,0,2,27,9.499999999999999e-05
G5,C(C1(C(CC(C(C1)=O)=O)O)O)(O)=O,4,2,0,2,33,9.499999999999999e-05
G5,C(C1(C(C(C=O)C(C1)=O)O)O)(O)=O,8,2,0,2,37,9.499999999999999e-05
G5,C(C1(C=CC(C(C1O)O)=O)O)(O)=O,8,2,0,2,32,9.499999999999999e-05
G5,C(CO)(C1(CCC(C1O)=O)O)=O,4,4,0,4,12,0.00018999999999999998
G5,C1(C(C(C(CC1)(CO)O)O)=O)=O,4,3,0,3,12,0.00014199999999999998
G5,C1(CC(CO)(C(C(C1)=O)O)O)=O,4,6,0,6,5,0.000285
G5,C(C1CC(C(C(C1O)=O)O)O)=O,16,4,0,4,5,0.00018999999999999998
G5,C(CC1C(C(C(C1O)=O)O)O)=O,16,4,0,4,5,0.00018999999999999998
G5,C(C1C(C(C(C1CO)O)O)=O)=O,16,3,0,3,55,0.00014199999999999998
G5,C1(CC(CO)(CC(C1O)=O)O)=O,1,2,0,2,5,9.499999999999999e-05
G5,C1(C(C(C)(C(C(C1)=O)O)O)O)=O,3,3,0,3,5,0.00014199999999999998
G5,C1(CC(C)(C(C(C1O)=O)O)O)=O,8,3,0,3,5,0.00014199999999999998
G5,C1(C(C(C(C(C1C)O)O)O)=O)=O,16,3,0,3,42,0.00014199999999999998
G5,C1(C(C(C(C(C1C)O)=O)O)O)=O,16,3,0,3,5,0.00014199999999999998
G5,C(C1(C(C)C(C(C1O)=O)O)O)=O,16,2,0,2,5,9.499999999999999e-05
G5,C1(C(C(CO)(C(C1C)O)O)O)=O,16,2,0,2,5,9.499999999999999e-05
G5,C1(C(C(CO)(C(C)C1O)O)O)=O,16,2,0,2,5,9.499999999999999e-05
G5,C1(C(C(C(C1CCO)O)O)=O)=O,8,3,0,3,5,0.00014199999999999998
G5,C1(C(C(C(C1O)O)CCO)O)=O,16,3,0,3,55,0.00014199999999999998
G5,C1(C(C(C(C)C1O)O)O)=O,16,2,0,2,49,9.499999999999999e-05
G5,C1(C(CC(C1C(CO)=O)O)O)=O,8,4,0,4,51,0.00018999999999999998
G5,C1(C(C(CC(C(C1)=O)O)O)O)=O,8,4,0,4,51,0.00018999999999999998
G5,C(C1C(CO)(C(C(C1)=O)O)O)=O,8,6,0,6,29,0.000285
G5,C1(CCC(C(C(C1O)=O)O)O)=O,8,4,0,4,51,0.00018999999999999998
G5,C1(C(C(C(C(CC1)O)O)O)=O)=O,8,3,0,3,12,0.00014199999999999998
G5,C1(CC(C(C1C(CO)=O)O)O)=O,8,6,0,6,51,0.000285
G5,C(C1C(C(C(CO)(C1)O)O)=O)=O,8,5,0,5,29,0.00023700000000000001
G5,C(CO)(C1C(C(C(C1)=O)O)O)=O,8,7,0,7,29,0.000332
G5,C1(CCC(C(C(C1O)O)O)=O)=O,3,3,0,3,20,0.00014199999999999998
G5,C1(C(C(CC1)(C(C=O)O)O)O)=O,8,6,0,6,20,0.00028700000000000004
G5,C(C1C(C(C(C(C1)=O)O)O)O)=O,16,5,0,5,12,0.00023700000000000001
G5,C(C1CC(C(C1C=O)O)=O)=O,8,3,0,3,43,0.00014199999999999998
G5,C1(C(C=O)C(C(C1)=O)(C)O)=O,4,3,0,3,2,0.00014199999999999998
G5,C1(CC(CC(C(C1)=O)=O)O)=O,2,3,0,3,26,0.00014199999999999998
G5,C(CC1(CC(C(C1)=O)=O)O)=O,1,2,0,2,51,9.499999999999999e-05
G5,C(C1C(C(CC1(C)O)=O)=O)=O,4,5,0,5,26,0.00023700000000000001
G5,C(C)(C1C(C(CC1O)=O)=O)=O,4,4,0,4,26,0.00018999999999999998
G5,C(CC1(C(CC(C1)=O)=O)O)=O,2,2,0,2,51,9.499999999999999e-05
G5,C(C1C(C(C(C)C1O)=O)=O)=O,8,3,0,3,42,0.00014199999999999998
G5,C1(CC(C(C1C(C)=O)O)=O)=O,4,3,0,3,26,0.00014199999999999998
G5,C1(CC(CC(C(C1)=O)O)=O)=O,2,2,0,2,20,9.499999999999999e-05
G5,C(C1(CC(CC(C1)=O)=O)O)=O,1,2,0,2,51,9.499999999999999e-05
G5,C1(CCC(C(CC1O)=O)=O)=O,2,2,0,2,12,9.499999999999999e-05
G5,C(C1(CCC(C(C1)=O)=O)O)=O,2,3,0,3,12,0.00014199999999999998
G5,C1(C(C(C(C(C)C1)=O)O)O)=O,8,5,0,5,52,0.00023700000000000001
G5,C(C1(CC(C(C1O)=O)C)O)=O,8,2,0,2,52,9.499999999999999e-05
G5,C1(C(CO)C(C(C1)=O)(C)O)=O,4,3,0,3,2,0.00014199999999999998
G5,C1(C(CC(CCO)(C1)O)=O)=O,1,2,0,2,2,9.499999999999999e-05
G5,C1(C(CC(C)(C1CO)O)=O)=O,4,5,0,5,2,0.00023700000000000001
G5,C1(C(CCO)(CC(C1)=O)O)=O,2,2,0,2,3,9.499999999999999e-05
G5,C1(C(C(C)C(C1CO)O)=O)=O,8,3,0,3,29,0.00014199999999999998
G5,C1(C(C)(CC(C1)=O)O)=O,2,2,0,2,16,9.499999999999999e-05
G5,C1(C(CC(C)(C1)O)=O)=O,1,2,0,2,16,9.499999999999999e-05
G5,C1(C(CC(C1C)O)=O)=O,4,3,0,3,45,0.00014199999999999998
G5,C(CC1C(CC(C1O)=O)=O)=O,4,2,0,2,20,9.499999999999999e-05
G5,C(C1CC(CC(C1O)=O)=O)=O,4,2,0,2,20,9.499999999999999e-05
G5,C(C1(CC(CC1C=O)=O)O)=O,4,2,0,2,20,9.499999999999999e-05
G5,C1(CCC(C1C(C=O)=O)O)=O,4,5,0,5,20,0.00023700000000000001
G5,C(C1C(CCC(C1O)=O)=O)=O,4,6,0,6,20,0.000285
G5,C1(CCC(C=O)(C1C=O)O)=O,4,5,0,5,20,0.00023700000000000001
G5,C1(CC(C(C=O)=O)C(C1)O)=O,4,3,0,3,2,0.00014199999999999998
G5,C1(CC(C(C=O)=O)C(C1O)O)=O,8,5,0,5,51,0.00023700000000000001
G5,C(C1C(C(CC1O)=O)=O)=O,4,5,0,5,2,0.00023700000000000001
G5,C1(CC(C(C(C1C=O)=O)O)O)=O,8,5,0,5,1,0.00023700000000000001
G5,C(C1(CC(C=O)C(C1O)=O)O)=O,8,2,0,2,29,9.499999999999999e-05
G5,C(C1C(C(C(C(C1)=O)O)O)=O)=O,8,6,0,6,51,0.000285
G5,C(C1C(CC(C(C1O)O)=O)=O)=O,8,6,0,6,1,0.000285
G5,C(C1C(C(C(CC1O)=O)O)=O)=O,8,5,0,5,1,0.00023700000000000001
G5,C(C1C(C(C(C1C)O)O)=O)=O,16,2,0,2,49,9.499999999999999e-05
G5,C(C1C(C(C(C)C1O)O)=O)=O,16,2,0,2,49,9.499999999999999e-05
G5,C1(CC(CO)(CC(C1)=O)O)=O,1,2,0,2,49,9.499999999999999e-05
G5,C1(CC(C)(C(C(C1)=O)O)O)=O,4,5,0,5,49,0.00023700000000000001
G5,C1(C(CC(CC1)(CO)O)=O)=O,2,2,0,2,49,9.499999999999999e-05
G5,C1(CCC(C(C1(C)O)O)=O)=O,4,3,0,3,49,0.00014199999999999998
G5,C(C)(C1(CCC(C1O)=O)O)=O,4,4,0,4,49,0.00018999999999999998
G5,C(C1CC(CC(C1O)=O)O)=O,8,3,0,3,2,0.00014199999999999998
G5,C(CC1C(CC(C1O)=O)O)=O,8,2,0,2,43,9.499999999999999e-05
G5,C1(C(CC(CC1CO)O)=O)=O,4,2,0,2,49,9.499999999999999e-05
G5,C(C1(C(C)CC(C1O)=O)O)=O,8,3,0,3,52,0.00014199999999999998
G5,C1(CC(C)(CC(C1O)=O)O)=O,1,2,0,2,49,9.499999999999999e-05
G5,C1(C(C(C(C(C1)O)=O)C)O)=O,8,2,0,2,49,9.499999999999999e-05
G5,C(C1(C(C)C(C(C1)=O)O)O)=O,8,1,0,1,28,4.7e-05
G5,C1(C(CC(C(C1C)O)O)=O)=O,8,3,0,3,49,0.00014199999999999998
G5,C1(C(CC(CC1)O)=O)=O,2,4,0,4,7,0.00018999999999999998
G5,C1(C(C(CO)(C(C)C1)O)O)=O,8,2,0,2,52,9.499999999999999e-05
G5,C1(C(C(CO)(CC1C)O)O)=O,8,2,0,2,52,9.499999999999999e-05
G5,C1(C(C(C)C(CO)(C1)O)O)=O,8,1,0,1,2,4.7e-05
G5,C1(C(C(C)(C(C1C)O)O)O)=O,16,2,0,2,2,9.499999999999999e-05
G5,C1(C(C(CC1C)O)O)=O,8,2,0,2,0,9.499999999999999e-05
G5,C1(CC(C(C1C(C)=O)O)O)=O,8,5,0,5,49,0.00023700000000000001
G5,C1(CC(C(CC(C1)=O)O)O)=O,3,2,0,2,21,9.499999999999999e-05
G5,C(CC1(CCC(C1O)=O)O)=O,4,9,0,9,21,0.00042800000000000005
G5,C(C1C(CCC1(CO)O)=O)=O,4,3,0,3,21,0.00014199999999999998
G5,C(CO)(C1C(CC(C1)=O)O)=O,4,3,0,3,21,0.00014199999999999998
G5,C1(CCC(C(C(C1)O)O)=O)=O,4,3,0,3,21,0.00014199999999999998
G5,C(C1C(CO)(CC(C1)=O)O)=O,4,2,0,2,21,9.499999999999999e-05
G5,C1(CCC(C1C(CO)=O)O)=O,4,3,0,3,21,0.00014199999999999998
G5,C1(CCC(C(C(C1)=O)O)O)=O,4,3,0,3,21,0.00014199999999999998
G5,C(C1CC(C(C1C=O)O)O)=O,16,2,0,2,21,9.499999999999999e-05
G5,C(C1C(C(CC(C1O)O)O)=O)=O,16,4,0,4,32,0.00018999999999999998
G5,C1(C(C(CC(C(C1)O)O)O)=O)=O,8,1,0,1,32,4.7e-05
G5,C1(C(CO)C(C(C1O)=O)(C)O)=O,8,4,0,4,3,0.000194
G5,C1(C(C(CC(CO)(C1)O)O)=O)=O,4,2,0,2,43,9.499999999999999e-05
G5,C(C1C(CC(CC1O)=O)=O)=O,4,5,0,5,2,0.00023700000000000001
G5,C(C1C(C=CC(C1O)O)=O)=O,8,4,0,4,29,0.00018999999999999998
G5,C1C(C(CC(C(C=1)=O)=O)O)O,4,1,0,1,29,4.7e-05
G5,C1(C(C=O)C(C(C1CO)=O)O)=O,8,3,0,3,2,0.00014199999999999998
G5,C1(C(CC(C1CCO)O)=O)=O,4,5,0,5,29,0.00023799999999999998
G5,C1(C(C(C)C(C1CO)O)O)=O,16,2,0,2,3,9.499999999999999e-05
G5,C1(C(C(C(C)C1CO)O)O)=O,16,2,0,2,55,9.499999999999999e-05
G5,C1(C(C(C(CCO)C1)O)O)=O,8,7,0,7,46,0.000332
G5,C1(C(C(C(C1)O)CCO)O)=O,8,1,0,1,3,4.7e-05
G5,C(C1C(C)(C(C(C1)=O)O)O)=O,8,8,0,8,41,0.00037999999999999997
G5,C1(CC(CCC(C1O)=O)O)=O,4,2,0,2,21,9.499999999999999e-05
G5,C1(C(C)C(C=O)C(C1O)O)=O,16,2,0,2,16,9.499999999999999e-05
G5,C(C1C(C(C=O)C(C1O)O)=O)=O,10,3,0,3,9,0.00014199999999999998
G5,C1(C(C(C(C)C1)O)O)=O,8,3,0,3,28,0.00014199999999999998
G5,C1(C(C(C(C1)O)C)O)=O,8,1,0,1,27,4.7e-05
G5,C1(C(CC(C(CC1)O)O)=O)=O,4,2,0,2,21,9.499999999999999e-05
G5,C1(CC(C(CC(C1O)=O)O)O)=O,3,2,0,2,49,9.499999999999999e-05
G5,C1(C(C(C(C(CO)O)C1)O)O)=O,16,5,0,5,46,0.00024900000000000004
G5,C1(C(C(CC1CO)O)O)=O,8,4,0,4,29,0.00020099999999999998
G5,C(C1CC(C(C=O)=O)C(C1)O)=O,8,2,0,2,29,9.499999999999999e-05
G5,C1(C(C(C=O)C(C=O)CC1)O)=O,8,4,0,4,29,0.00018999999999999998
G5,C(C1CCC(C=O)(C1C=O)O)=O,8,2,0,2,29,9.499999999999999e-05
G5,C1(CC(C(C=O)=O)C(C)(C1)O)=O,4,2,0,2,12,9.499999999999999e-05
G5,C1(CCC(C(CC(C1)=O)O)=O)=O,2,2,0,2,7,9.499999999999999e-05
G5,C(C)(C1C(CCC(C1O)=O)=O)=O,4,3,0,3,12,0.00014199999999999998
G5,C(C1(CCC(CC(C1)=O)=O)O)=O,2,2,0,2,29,9.499999999999999e-05
G5,C(C1(CCC(C1C(C)=O)=O)O)=O,4,4,0,4,12,0.00018999999999999998
G5,C1(C(C(C(C(CC1)=O)=O)C)O)=O,4,1,0,1,29,4.7e-05
G5,C(C1(CCC(C(C1C)=O)=O)O)=O,4,1,0,1,29,4.7e-05
G5,C1(C(C)CC(C1C(C=O)=O)O)=O,8,3,0,3,29,0.00014199999999999998
G5,C1(C(C(C=O)C(C(C1)=O)C)O)=O,8,2,0,2,22,9.499999999999999e-05
G5,C1(CC(C=O)(C(C=O)C1C)O)=O,8,3,0,3,29,0.00014199999999999998
G5,C(C1CC(C(C=O)C(C1)=O)O)=O,8,5,0,5,43,0.00023700000000000001
G5,C1(CC(C=O)C(C=O)C(C1)O)=O,8,4,0,4,23,0.00018999999999999998
G5,C(C1C(CC(C1O)CC=O)=O)=O,8,6,0,6,43,0.000286
G5,C(C1C(CC(CC1(C)O)=O)=O)=O,4,4,0,4,26,0.00018999999999999998
G5,C1(CC(CC(CC(C1)=O)O)=O)=O,1,2,0,2,26,9.499999999999999e-05
G5,C1(CC(CC(C1C(C)=O)O)=O)=O,4,5,0,5,26,0.00023700000000000001
G5,C(CC1(CC(CC(C1)=O)=O)O)=O,1,4,0,4,27,0.00019099999999999998
G5,C1(CC(C(C(C(C1)=O)=O)C)O)=O,4,1,0,1,4,4.7e-05
G5,C(CC1(CC(C(C1C)=O)=O)O)=O,4,1,0,1,4,4.7e-05
G5,C1(C(C=O)C(C(C1)=O)(CC)O)=O,4,2,0,2,4,9.499999999999999e-05
G5,C(CC1C(C(CC(C1)O)=O)=O)=O,4,3,0,3,46,0.00014199999999999998
G5,C(C1C(C(C(C)CC1O)=O)=O)=O,8,3,0,3,29,0.00014199999999999998
G5,C(C1C(CC(C(C1C)=O)=O)O)=O,8,2,0,2,29,9.499999999999999e-05
G5,C1(C(CC(C1C=O)O)CC=O)=O,8,6,0,6,46,0.000285
G5,C(CC1C(CC(C1C=O)O)=O)=O,8,6,0,6,29,0.000286
G5,C(C)(C1C(C(CCC1O)=O)=O)=O,4,3,0,3,26,0.00014199999999999998
G5,C1(CC(CCC(C(C1)=O)=O)O)=O,2,2,0,2,26,9.499999999999999e-05
G5,C(CCC1(C(CC(C1)=O)=O)O)=O,2,2,0,2,26,9.499999999999999e-05
G5,C(C1C(C)(CC(C(C1)=O)=O)O)=O,4,4,0,4,29,0.00018999999999999998
G5,C(CC1C(C(CC1(C)O)=O)=O)=O,4,2,0,2,4,9.499999999999999e-05
G5,C1(CC(C(C=O)=O)CC(C1)O)=O,4,3,0,3,27,0.00014199999999999998
G5,C(CC1C(C(CC(C1)=O)O)=O)=O,4,3,0,3,27,0.000144
G5,C(CC1C(C=O)(CC(C1)=O)O)=O,4,4,0,4,26,0.00019099999999999998
G5,C1(CC(C(C(C1)=O)CC=O)O)=O,4,3,0,3,29,0.00014199999999999998
G5,C(C1C(CC(CC(C1)=O)=O)O)=O,4,4,0,4,29,0.00018999999999999998
G5,C(CC1(C(C=O)CC(C1)=O)O)=O,4,5,0,5,4,0.000239
G5,C(C1C(CC(CCC1O)=O)=O)=O,4,4,0,4,29,0.00018999999999999998
G5,C(CC=O)(C1C(CCC1O)=O)=O,4,4,0,4,29,0.00018999999999999998
G5,C(CC1C(C(CCC1O)=O)=O)=O,4,2,0,2,29,9.499999999999999e-05
G5,C(C1C(CCC(C(C1)=O)=O)O)=O,4,3,0,3,29,0.00014199999999999998
G5,C(C1CC(C(C=O)=O)CC1O)=O,8,2,0,2,44,9.499999999999999e-05
G5,C(C1CC(C(C1O)=O)CC=O)=O,8,2,0,2,44,9.499999999999999e-05
G5,C(C1C(CCC1C(C=O)=O)O)=O,8,2,0,2,44,9.499999999999999e-05
G5,C1(CC(C(C(C)=O)=O)C(C1)O)=O,4,2,0,2,21,9.499999999999999e-05
G5,C1(CCC(C(CC(C1)O)=O)=O)=O,2,2,0,2,21,9.499999999999999e-05
G5,C(CC1(CCC(C(C1)=O)=O)O)=O,2,5,0,5,21,0.000239
G5,C1(CCC(C(C)=O)(C1C=O)O)=O,4,3,0,3,21,0.00014199999999999998
G5,C(C1C(CCC(C1(C)O)=O)=O)=O,4,3,0,3,21,0.00014199999999999998
G5,C1(CCC(C1C(C(C)=O)=O)O)=O,4,3,0,3,21,0.00014199999999999998
G5,C1(CCC(CC(C(C1)=O)=O)O)=O,2,2,0,2,21,9.499999999999999e-05
G5,C(CCC1(CC(C(C1)=O)=O)O)=O,1,2,0,2,21,9.499999999999999e-05
G5,C(C1CC(CC1(C(C)=O)O)=O)=O,4,3,0,3,45,0.00014199999999999998
G5,C1(CC(C=O)C(C(C1)=O)(C)O)=O,4,2,0,2,21,9.499999999999999e-05
G5,C(CC1C(CC(C1(C)O)=O)=O)=O,4,1,0,1,21,4.7e-05
G5,C(C1C(CC(C1)=O)O)(CC=O)=O,4,3,0,3,6,0.00014199999999999998
G5,C(C1C(CCC(CC1O)=O)=O)=O,4,4,0,4,6,0.00018999999999999998
G5,C(C1C(CCC1(CC=O)O)=O)=O,4,6,0,6,6,0.000286
G5,C1(C(C(CC1C=CC=O)O)O)=O,16,2,0,2,29,9.499999999999999e-05
G5,C(C1C(C=CC1C(CO)=O)O)=O,8,2,0,2,29,9.499999999999999e-05
G5,C(CC1C(C(C(C=C1)O)O)=O)=O,8,4,0,4,29,0.00018999999999999998
G5,C(C1CC(C(C1(C=C)O)O)=O)=O,8,2,0,2,7,9.499999999999999e-05
G5,C1(C(C(C(C=O)C1C=C)O)O)=O,16,3,0,3,29,0.00014199999999999998
G5,C1(CC(C(C(C=CC1)=O)O)O)=O,4,3,0,3,32,0.00014199999999999998
G5,C(CC1(C(C(C=CC1)=O)O)O)=O,4,4,0,4,32,0.00019099999999999998
G5,C1(C(C=O)C(C=CC1)(CO)O)=O,4,3,0,3,32,0.00014199999999999998
G5,C1(C=CC(C(C(CC1)O)O)=O)=O,4,3,0,3,32,0.00014199999999999998
G5,C(CCC1(C=CC(C1O)=O)O)=O,4,3,0,3,32,0.000143
G5,C(C1CC(C=CC1(CO)O)=O)=O,4,3,0,3,29,0.00014199999999999998
G5,C(CC1C(C=CC1(CO)O)=O)=O,4,2,0,2,29,9.499999999999999e-05
G5,C(C1C=CC(C(C1C=O)O)O)=O,16,3,0,3,29,0.00014199999999999998
G5,C1(CC(C(C=CC(C1)=O)O)O)=O,4,2,0,2,32,9.499999999999999e-05
G5,C(C)(C1C(C=CC(C1O)O)=O)=O,8,3,0,3,29,0.00014199999999999998
G5,C1C(C(C(C(C(C=1)=O)=O)C)O)O,8,1,0,1,32,4.7e-05
G5,C(C1CC(C(C=CC1O)O)=O)=O,8,3,0,3,29,0.00014199999999999998
G5,C(CC1C(C(C=CC1O)O)=O)=O,8,2,0,2,18,9.499999999999999e-05
G5,C1(C(C(C(C1C)O)O)O)=O,16,2,0,2,28,9.499999999999999e-05
G5,C1(C(CC(C1O)O)C(C=O)O)=O,16,4,0,4,0,0.00018999999999999998
G5,C1(C(C(C(C1O)O)O)CC=O)=O,16,5,0,5,0,0.00023700000000000001
G5,C(C1CC(C(C1O)O)O)=O,16,2,0,2,29,9.499999999999999e-05
G5,C1(CC(C=CC1O)O)=O,4,2,0,2,45,9.499999999999999e-05
G5,C(C1(C(CC(C1CO)O)=O)O)=O,8,1,0,1,25,4.7e-05
G5,C(C1(C(CC(CO)(C1)O)=O)O)=O,4,2,0,2,25,9.499999999999999e-05
G5,C1(C(C(C(CO)(C1C)O)O)O)=O,16,2,0,2,28,9.499999999999999e-05
G5,C1(C(C)(CC(C1C=O)=O)O)=O,4,2,0,2,16,9.499999999999999e-05
G5,C1(C(C)(CC(C1CO)=O)O)=O,4,2,0,2,2,9.499999999999999e-05
G5,C(C1C(CC(C1=O)O)=O)=O,4,3,0,3,15,0.00014199999999999998
G5,C(C1(C(CC(CC1O)=O)=O)O)=O,4,5,0,5,1,0.00023700000000000001
G5,C(C1(C(CC(C(C1)=O)=O)O)O)=O,4,4,0,4,1,0.00018999999999999998
G5,C(C1(C(CC(CC1=O)O)=O)O)=O,1,2,0,2,1,9.499999999999999e-05
G5,C(C1(CC(C=O)(C(C1)=O)O)O)=O,4,1,0,1,25,4.7e-05
G5,C(C1(C(CC(C(C1)=O)O)=O)O)=O,4,3,0,3,25,0.00014199999999999998
G5,C(C1(C(CC(C1C)O)=O)O)=O,8,1,0,1,29,4.7e-05
G5,C1(C(C)C(C=O)(C(C1O)O)O)=O,16,4,0,4,28,0.00018999999999999998
G5,C1(CC(C(C)C1(CO)O)O)=O,8,1,0,1,29,4.7e-05
G5,C(C1C(CC(CC1=O)O)=O)=O,1,3,0,3,1,0.00014199999999999998
G5,C(C1C(C(C=O)C(C1)=O)O)=O,8,6,0,6,2,0.000285
G5,C(C1C(C(C(CO)C1O)=O)=O)=O,8,3,0,3,7,0.00014199999999999998
G5,C(C1C(C(C=O)(C(C1)=O)O)O)=O,8,2,0,2,29,9.499999999999999e-05
G5,C(C1(C(C(C=O)C(C1)=O)O)O)=O,8,5,0,5,1,0.00023700000000000001
G5,C1(C(C(C(C)C1(CO)O)O)O)=O,16,2,0,2,49,9.499999999999999e-05
G5,C1(CC(CC(C1C(C)=O)=O)O)=O,1,3,0,3,29,0.00014199999999999998
G5,C(C1C(CC(C)(CC1=O)O)=O)=O,1,2,0,2,29,9.499999999999999e-05
G5,C(C1C(C)(C(C=O)C(C1)=O)O)=O,8,5,0,5,29,0.00023700000000000001
G5,C(C1C(C(C(C)=O)C(C1)=O)O)=O,8,3,0,3,29,0.00014199999999999998
G5,C(C1C(CCC(CC1=O)O)=O)=O,4,2,0,2,29,9.499999999999999e-05
G5,C1(CC(C=CC(C1CO)=O)O)=O,4,2,0,2,21,9.499999999999999e-05
G5,C1(CC(C(C1C(C=C)=O)O)O)=O,8,2,0,2,7,9.499999999999999e-05
G5,C1(CC(C(C1(C(C)=O)O)O)O)=O,8,5,0,5,49,0.00023700000000000001
G5,C(C1(C(C(CO)C(C1)O)=O)O)=O,8,5,0,5,29,0.000241
G5,C(CC1C(C(CC1O)=O)=O)=O,4,3,0,3,29,0.00014199999999999998
G5,C(C1C(C(CC(C1)O)=O)=O)=O,4,3,0,3,20,0.00014199999999999998
G5,C(C1(C(C(CC1C=O)=O)O)O)=O,8,5,0,5,51,0.00023700000000000001
G5,C(C)(C1C(C(C(C1)=O)O)O)=O,8,4,0,4,41,0.00018999999999999998
G5,C(C1C(CC(C1)(CO)O)=O)=O,4,2,0,2,21,9.499999999999999e-05
G5,C(C1C(C(C(C(C1)O)=O)O)O)=O,16,4,0,4,43,0.00018999999999999998
G5,C(C1C(C(C(C(C1)O)O)O)=O)=O,16,4,0,4,32,0.00018999999999999998
G5,C(C1C(CC(C(C1)=O)O)=O)=O,4,3,0,3,2,0.00014199999999999998
G5,C(C1(CC(C=O)C(C1)=O)O)=O,4,3,0,3,29,0.00014199999999999998
G5,C1(CC(C(C=O)C1C=O)O)=O,8,2,0,2,2,9.499999999999999e-05
G5,C(C1C(C(C=O)C(C1)O)=O)=O,8,3,0,3,2,0.00014199999999999998
G5,C(C1C(CC(C(C1)=O)=O)O)=O,4,3,0,3,14,0.00014199999999999998
G5,C(C1C=CC(C(C1O)O)=O)=O,8,5,0,5,43,0.00023700000000000001
G5,C1(CC(C(C=O)C1(C=O)O)O)=O,8,3,0,3,29,0.00014199999999999998
G5,C(C1C(C(C=O)(CC1O)O)=O)=O,8,3,0,3,29,0.00014199999999999998
G5,C1(C(C(C(C=O)C1C=O)O)O)=O,16,2,0,2,1,9.499999999999999e-05
G5,C(C1C(CC(C1)O)=O)=O,4,2,0,2,43,9.499999999999999e-05
G5,C(C)(C1C(CC(C(C1)=O)O)=O)=O,4,3,0,3,29,0.00014199999999999998
G5,C(C1(CC(C(C)=O)C(C1)=O)O)=O,4,3,0,3,29,0.00014199999999999998
G5,C1(CC(CC(C1CC=O)=O)O)=O,1,2,0,2,13,9.499999999999999e-05
G5,C(C1C(CC(C1C(C)=O)=O)O)=O,8,2,0,2,29,9.499999999999999e-05
G5,C(CC=O)(C1C(CC(C1)O)=O)=O,4,2,0,2,13,9.499999999999999e-05
G5,C(C1C(C(C(C)=O)CC1O)=O)=O,8,3,0,3,29,0.00014199999999999998
G5,C(C)(C1C(CC(C(C1)=O)=O)O)=O,4,2,0,2,14,9.499999999999999e-05
G5,C(C)(C1(CC(C=O)C(C1)=O)O)=O,4,2,0,2,21,9.499999999999999e-05
G5,C(C1C(CC(C(C1)=O)(C)O)=O)=O,4,2,0,2,29,9.499999999999999e-05
G5,C(C)(C1C(C(C=O)C(C1)=O)O)=O,8,3,0,3,29,0.00014199999999999998
G5,C(C1C(CC(C1)(CC=O)O)=O)=O,4,5,0,5,2,0.000239
G5,C1(CC(CC(CC1C=O)=O)O)=O,4,2,0,2,26,9.499999999999999e-05
G5,C(C1C=CC(C(C1(C)O)O)=O)=O,8,4,0,4,32,0.00018999999999999998
G5,C(C)(C1C=CC(C(C1O)O)=O)=O,8,3,0,3,32,0.00014199999999999998
G5,C(C1C(CC(C=C1)(CO)O)=O)=O,4,3,0,3,32,0.00014199999999999998
G5,C1(C(C2C(C1CO2)O)O)=O,16,2,0,2,37,9.499999999999999e-05
G5,C1(C2(CC(C(C2)=O)O1)O)=O,4,3,0,3,29,0.00014199999999999998
G5,C1(C2C(C(CC2O)O1)=O)=O,8,5,0,5,45,0.00023700000000000001
G5,C1(C2C(C(C(O2)O)(C1)O)O)=O,16,3,0,3,1,0.00014199999999999998
G5,C1(C2CC(CO2)(C1O)O)=O,8,3,0,3,32,0.00014199999999999998
G5,C1(C2(CC(CO2)(C1)O)O)=O,4,4,0,4,2,0.00018999999999999998
G5,C1(C2C(C(C1CO2)O)O)=O,16,3,0,3,4,0.00014199999999999998
G5,C1(C2C(C(C(C1)O2)O)O)=O,16,3,0,3,4,0.00014199999999999998
G5,C1(C(C2(C(C1CO2)O)O)O)=O,16,4,0,4,2,0.00018999999999999998
G5,C1(C2C(CC(C2O)O1)=O)=O,8,6,0,6,17,0.000285
G5,C1(C(CC(C1)O)CC(C=O)=O)=O,4,2,0,2,46,9.499999999999999e-05
G5,C(C1C(C(CC1C(C)=O)=O)O)=O,8,3,0,3,29,0.00014199999999999998
G5,C(CC1C(CC(C(C1)=O)O)=O)=O,4,4,0,4,45,0.00019099999999999998
G5,C(C1(CC(C(C1)=O)CC=O)O)=O,4,3,0,3,21,0.00014199999999999998
G5,C(CC1C(C=O)C(C(C1)=O)O)=O,8,7,0,7,4,0.000335
G5,C(C1CC(CC(C(C1)=O)=O)O)=O,4,2,0,2,4,9.499999999999999e-05
G5,C(CC1C(CC(C(C1)=O)=O)O)=O,4,6,0,6,53,0.000286
G5,C1(CC(C=O)C(C=O)C1(C)O)=O,8,2,0,2,29,9.499999999999999e-05
G5,C1(CCCC(C1C(C=O)=O)O)=O,4,4,0,4,27,0.00018999999999999998
G5,C(C1CCC(CC(C1O)=O)=O)=O,4,3,0,3,7,0.00014199999999999998
G5,C(CCC1C(CC(C1O)=O)=O)=O,4,4,0,4,4,0.00019099999999999998
G5,C1(CC(C=O)(C(C=O)CC1)O)=O,4,2,0,2,29,9.499999999999999e-05
G5,C(C1C(C(CCCC1O)=O)=O)=O,4,4,0,4,27,0.00018999999999999998
G5,C(C1CCC(C(CC1O)=O)=O)=O,4,3,0,3,7,0.00014199999999999998
G5,C(CCC1C(C(CC1O)=O)=O)=O,4,4,0,4,27,0.00019099999999999998
G5,C(CC1(C(CCC1C=O)=O)O)=O,4,4,0,4,4,0.00019099999999999998
G5,C1C(C(CO)(C(C(C=1)=O)O)O)O,8,3,0,3,5,0.00014199999999999998
G5,C1(C(C(C=CC1O)(CO)O)O)=O,8,4,0,4,5,0.00018999999999999998
G5,C1(C(C(C=C(CO)C1O)O)O)=O,8,5,0,5,5,0.00023700000000000001
G5,C1(C(C(C(C(C1O)=C)O)O)O)=O,16,5,0,5,5,0.00023700000000000001
G5,C1(C(C(C(C1O)=CCO)O)O)=O,16,3,0,3,5,0.00014199999999999998
G5,C(CO)(C1C=CC(C1O)=O)=O,4,2,0,2,20,9.499999999999999e-05
G5,C1(C(C(C(C=CC1)=O)O)O)=O,4,5,0,5,20,0.00023700000000000001
G5,C(C1(C=CCC(C1O)=O)O)=O,4,5,0,5,20,0.00023700000000000001
G5,C(C1(CC=CC(C1O)=O)O)=O,4,4,0,4,20,0.00018999999999999998
G5,C(C1C(CO)=CC(C1O)=O)=O,4,2,0,2,29,9.499999999999999e-05
G5,C1C(C)(C(C(C=1C=O)=O)O)O,4,3,0,3,55,0.00014199999999999998
G5,C(C1C(CC(C=1)=O)O)(CO)=O,2,2,0,2,55,9.499999999999999e-05
G5,C(C1C(CO)(CC(C=1)=O)O)=O,2,2,0,2,55,9.499999999999999e-05
G5,C(C1C(C(C(C1=C)O)O)=O)=O,8,3,0,3,55,0.00014199999999999998
G5,C1(C)C(C(C(C=1C=O)=O)O)O,4,3,0,3,49,0.00014199999999999998
G5,C(C1C(C(C(C1O)=C)O)=O)=O,8,4,0,4,23,0.00018999999999999998
G5,C1(CC(C(C=CC1O)=O)O)=O,4,2,0,2,49,9.499999999999999e-05
G5,C(C1(C=CC(C(C1)=O)O)O)=O,4,2,0,2,49,9.499999999999999e-05
G5,C1(C=CC(C(C(C1)O)O)=O)=O,4,2,0,2,29,9.499999999999999e-05
G5,C(C(C1(C=CC(C1)=O)O)O)=O,4,2,0,2,26,9.499999999999999e-05
G5,C1C(C(CO)O)(CC(C=1)=O)O,4,2,0,2,45,9.499999999999999e-05
G5,C1(C(CO)=CC(CC1O)=O)=O,2,3,0,3,29,0.00014199999999999998
G5,C(C1(C(CO)=CC(C1)=O)O)=O,2,2,0,2,45,9.499999999999999e-05
G5,C1(CC(C(C(C1O)=C)=O)O)=O,4,3,0,3,9,0.00014199999999999998
G5,C(C1(C(C(C(C1)=O)O)=C)O)=O,4,2,0,2,45,9.499999999999999e-05
G5,C1(C(CO)C(C(C1O)=C)O)=O,8,3,0,3,2,0.00014199999999999998
G5,C1C(C)(C(C(C=1CO)=O)O)O,4,3,0,3,45,0.00014199999999999998
G5,C1(CO)C(CO)(CC(C=1)=O)O,2,2,0,2,45,9.499999999999999e-05
G5,C=C1C(C(C(C)(C1O)O)O)=O,8,3,0,3,45,0.00014199999999999998
G5,C1(CC(C(C1O)=C)(CO)O)=O,4,2,0,2,45,9.499999999999999e-05
G5,C1(C(C(C(C1CO)=C)O)O)=O,8,4,0,4,55,0.00018999999999999998
G5,C1(C)C(C(C(C=1CO)=O)O)O,4,3,0,3,3,0.00014199999999999998
G5,C=C1C(C(C(C1(C)O)O)O)=O,8,3,0,3,3,0.00014199999999999998
G5,C1(C(C(C(C1)=C)O)O)=O,4,5,0,5,16,0.00023700000000000001
G5,C1(C)C(C(C(C=1)=O)O)O,4,3,0,3,16,0.00014199999999999998
G5,C1(CC(C(C1O)=C)O)=O,4,4,0,4,29,0.00018999999999999998
G5,C(C1C(C(C=CC1O)=O)O)=O,8,3,0,3,20,0.00014199999999999998
G5,C(C1(C=CC(C1C=O)O)O)=O,8,3,0,3,20,0.00014199999999999998
G5,C1C(C(C=O)=O)C(C(C=1)O)O,8,2,0,2,20,9.499999999999999e-05
G5,C1(C=C(C=O)C(C(C1)O)O)=O,4,2,0,2,55,9.499999999999999e-05
G5,C(C(C1C(CC(C=1)=O)O)O)=O,4,2,0,2,55,9.499999999999999e-05
G5,C1(CC(C=C(C=O)C1O)O)=O,4,3,0,3,20,0.00014199999999999998
G5,C1(CC(C(C1O)=CC=O)O)=O,8,3,0,3,20,0.00014199999999999998
G5,C1C(CC(C=1)=O)O,2,2,0,2,45,9.499999999999999e-05
G5,C1C(C(C(C=1C=O)=O)O)O,4,3,0,3,55,0.00014199999999999998
G5,C1C(C(C(C(C=1C=O)=O)O)O)O,8,3,0,3,29,0.00014199999999999998
G5,C1(C(C(C=CC1)(CO)O)O)=O,4,3,0,3,49,0.00014199999999999998
G5,C1CC(CO)(C(C(C=1)=O)O)O,4,3,0,3,49,0.00014199999999999998
G5,C1(C(C(C=C(CO)C1)O)O)=O,4,4,0,4,55,0.00018999999999999998
G5,C1(CO)CC(C(C(C=1)=O)O)O,4,3,0,3,49,0.00014199999999999998
G5,C1(CC(C=CC1O)(CO)O)=O,4,2,0,2,49,9.499999999999999e-05
G5,C1C(C(C)(C(C(C=1)=O)O)O)O,8,3,0,3,49,0.00014199999999999998
G5,C1(CC(C=C(CO)C1O)O)=O,4,2,0,2,49,9.499999999999999e-05
G5,C1(C(C(C(C(C1)=C)O)O)O)=O,8,4,0,4,55,0.00018999999999999998
G5,C1(C)C(C(C(C(C=1)=O)O)O)O,8,3,0,3,0,0.00014199999999999998
G5,C1(CC(C(C(C1O)=C)O)O)=O,8,2,0,2,49,9.499999999999999e-05
G5,C(C(C1C(C(C(C=1)O)O)=O)O)=O,8,3,0,3,0,0.00014199999999999998
G5,C(C=C1C(C(C(C1O)O)O)=O)=O,16,3,0,3,0,0.00014199999999999998
G5,C1C(C(C(C=1C(C)O)=O)O)O,8,3,0,3,11,0.00014199999999999998
G5,C(C)=C1C(C(C(C1O)O)O)=O,16,3,0,3,11,0.00014199999999999998
G5,C1(C(C(C(C1C=C)O)O)O)=O,16,5,0,5,11,0.00023700000000000001
G5,C(C1C(CO)=CC(C1O)O)=O,8,3,0,3,21,0.00014199999999999998
G5,C=C1C(C(C(CO)(C1O)O)O)=O,8,4,0,4,5,0.00018999999999999998
G5,C1(C(C(C(C1O)=C)(CO)O)O)=O,8,4,0,4,5,0.00018999999999999998
G5,C1C(CO)(C(C(C=1CO)=O)O)O,4,4,0,4,32,0.00018999999999999998
G5,C1(CO)C(CO)(C(C(C=1)=O)O)O,4,4,0,4,32,0.00018999999999999998
G5,C1(C(C(C(C(C1O)O)=C)O)O)=O,10,3,0,3,5,0.00014199999999999998
G5,C1(C(C(C(CO)=CC1O)O)O)=O,8,4,0,4,43,0.00018999999999999998
G5,C=C1C(C(CO)C(C1=O)O)=O,4,5,0,5,2,0.000241
G5,C1(C(C(C(C(C1)=C)=O)O)O)=O,4,6,0,6,12,0.000285
G5,C(C1(C(CC(C1O)=O)=C)O)=O,4,5,0,5,12,0.00023700000000000001
G5,C(C1(CC(C(C1O)=O)=C)O)=O,4,3,0,3,12,0.00014199999999999998
G5,C(C1C(C(C(C1O)=O)=C)O)=O,8,5,0,5,29,0.00023700000000000001
G5,C(C1C=C(C(C1O)=O)CO)=O,4,2,0,2,29,9.499999999999999e-05
G5,C=C1C(C(C(CO)C1O)=O)=O,4,5,0,5,45,0.000241
G5,C1(C(C(C(C(C1)=O)=C)O)O)=O,4,4,0,4,2,0.00018999999999999998
G5,C=C1C(CC(C(C1=O)O)O)=O,4,5,0,5,2,0.00023700000000000001
G5,C1(CC(C(C(C1O)=O)=C)O)=O,4,3,0,3,9,0.00014199999999999998
G5,C(C1C(C=C(CO)C1O)=O)=O,4,4,0,4,2,0.00018999999999999998
G5,C(C1C(C(C(C1O)O)=O)=C)=O,8,2,0,2,29,9.499999999999999e-05
G5,C=C1C(C(CC(C1O)O)=O)=O,4,3,0,3,14,0.00014199999999999998
G5,C1C(CC(C(C=1CO)=O)=O)O,2,3,0,3,14,0.00014199999999999998
G5,C(C1C(C(C(C1O)O)=C)=O)=O,8,4,0,4,2,0.00018999999999999998
G5,C(C1C(C(CO)=CC1O)=O)=O,4,5,0,5,2,0.00023700000000000001
G5,C1C(CCO)(C(C(C=1)=O)O)O,4,3,0,3,2,0.00014199999999999998
G5,C1C(CO)(C(C(C=1)=O)CO)O,4,3,0,3,2,0.00014199999999999998
G5,C1(C(C(C(C1)=CCO)O)O)=O,8,3,0,3,3,0.00014199999999999998
G5,C1(C(C(C(C=1)=O)O)O)CCO,4,3,0,3,3,0.00014199999999999998
G5,C1(CC(C(C1O)=CCO)O)=O,8,2,0,2,3,9.499999999999999e-05
G5,C(C1C(C(C(C1O)O)O)=C)=O,16,3,0,3,55,0.00014199999999999998
G5,C1CC(C(C(C(C=1)=O)O)O)O,8,3,0,3,21,0.00014199999999999998
G5,C(CO)(C1C=CC(C1O)O)=O,8,2,0,2,21,9.499999999999999e-05
G5,C1(C(C(C(C=CC1)O)O)O)=O,8,3,0,3,21,0.00014199999999999998
G5,C1(CC(C(C=CC1O)O)O)=O,8,2,0,2,49,9.499999999999999e-05
G5,C(C1C=CC(C1O)O)=O,8,3,0,3,29,0.00014199999999999998
G5,C(CCO)(C1C(C=CC1O)=O)=O,4,3,0,3,30,0.00014199999999999998
G5,C1(C(CO)C(C=CC(C1)=O)O)=O,4,3,0,3,30,0.00014199999999999998
G5,C1(C(CO)C(C=C(C=O)C1)O)=O,4,3,0,3,23,0.00014199999999999998
G5,C1(C(CO)C(C(C1)=CC=O)O)=O,8,3,0,3,23,0.00014199999999999998
G5,C1(C=C(C=O)CC(C1CO)O)=O,4,3,0,3,23,0.00014199999999999998
G5,C(CC1C(C(C(C=1)=O)CO)O)=O,4,3,0,3,23,0.00014199999999999998
G5,C(C1C(CCO)=CC(C1O)=O)=O,4,2,0,2,29,9.499999999999999e-05
G5,C(C1C(CC(C1O)=O)=CCO)=O,8,3,0,3,29,0.00014199999999999998
G5,C1(C(CO)C(C(C1C=C)=O)O)=O,8,3,0,3,29,0.00014199999999999998
G5,C(C)=C1C(C(CO)C(C1=O)O)=O,8,3,0,3,29,0.00014199999999999998
G5,C(CO)(CC1C(C=CC1O)=O)=O,4,2,0,2,7,9.499999999999999e-05
G5,C(CO)(C1CC(C=CC1O)=O)=O,4,2,0,2,7,9.499999999999999e-05
G5,C1(CCC(C=CC(C1O)O)=O)=O,4,3,0,3,7,0.00014199999999999998
G5,C1(C(C(C=CC=O)(CC1)O)O)=O,8,4,0,4,7,0.00018999999999999998
G5,C(CO)(C1CC(C=O)=CC1O)=O,4,2,0,2,29,9.499999999999999e-05
G5,C1(CCC(C=O)=CC(C1O)O)=O,4,4,0,4,29,0.00018999999999999998
G5,C1(CCC(C(C1O)O)=CC=O)=O,8,3,0,3,29,0.00014199999999999998
G5,C(CO)(C1C=C(C=O)CC1O)=O,4,2,0,2,29,9.499999999999999e-05
G5,C1(C(C(CC(C=O)=CC1)O)O)=O,4,3,0,3,29,0.00014199999999999998
G5,C(CC1C(C(C(CC=1)=O)O)O)=O,4,3,0,3,29,0.00014199999999999998
G5,C(C1C(C=O)=CCC1(CO)O)=O,4,2,0,2,29,9.499999999999999e-05
G5,C1C(C(C(C=O)=O)CC=1CO)O,4,2,0,2,29,9.499999999999999e-05
G5,C1C(C(C=O)=O)C(CC=1CO)O,4,2,0,2,29,9.499999999999999e-05
G5,C(C1C(CO)=CCC(C1O)=O)=O,4,2,0,2,29,9.499999999999999e-05
G5,C(C1C(CO)=CCC1(C=O)O)=O,4,2,0,2,29,9.499999999999999e-05
G5,C1(C(C(C(CC1C=C)=O)O)O)=O,8,5,0,5,12,0.00023700000000000001
G5,C(C1(C(C(CC1C=C)=O)O)O)=O,8,3,0,3,12,0.00014199999999999998
G5,C1(C(C(C(C(C1)=CC)=O)O)O)=O,8,5,0,5,12,0.00023700000000000001
G5,C(C1(C(CC(C1O)=O)=CC)O)=O,8,3,0,3,12,0.00014199999999999998
G5,C(C1(CC(C(C1O)=O)C=C)O)=O,8,3,0,3,12,0.00014199999999999998
G5,C(C1(CC(C(C1O)=O)=CC)O)=O,8,3,0,3,12,0.00014199999999999998
G5,C(C)(C(C1C(C=CC1O)=O)O)=O,8,3,0,3,45,0.00014199999999999998
G5,C1(CC(C=CC(CC1O)=O)O)=O,4,2,0,2,22,9.499999999999999e-05
G5,C1(CC(C=CC=O)(CC1O)O)=O,8,2,0,2,22,9.499999999999999e-05
G5,C1(CC(C=C(C=O)CC1O)O)=O,4,2,0,2,22,9.499999999999999e-05
G5,C1(CC(C(CC1O)=CC=O)O)=O,8,2,0,2,29,9.499999999999999e-05
G5,C1(CC(CC(C=O)=CC1O)O)=O,4,2,0,2,29,9.499999999999999e-05
G5,C(CC1C(CC(C(C=1)O)=O)O)=O,4,2,0,2,22,9.499999999999999e-05
G5,C(C1C(C=O)=CC(C1(C)O)O)=O,8,2,0,2,29,9.499999999999999e-05
G5,C1C(C(C(C=O)=O)C(C=1C)O)O,8,3,0,3,22,0.00014199999999999998
G5,C=C1C(C(C(C=O)=O)C(C1)O)O,8,3,0,3,22,0.00014199999999999998
G5,C(C1C(C(CC(C1O)=O)O)=C)=O,8,2,0,2,22,9.499999999999999e-05
G5,C(C1C(C(CC1(C=O)O)O)=C)=O,8,2,0,2,22,9.499999999999999e-05
G5,C1(C(CC(C(C1C=C)O)=O)O)=O,8,3,0,3,22,0.00014199999999999998
G5,C(C1(CC(C(C1C=C)O)=O)O)=O,8,2,0,2,45,9.499999999999999e-05
G5,C1(CC(C(C(C1O)=CC)=O)O)=O,8,2,0,2,22,9.499999999999999e-05
G5,C(C1(C(C(C(C1)=O)O)=CC)O)=O,8,2,0,2,45,9.499999999999999e-05
G5,C1(C=C(C(C(C1)O)=O)C(C)O)=O,4,2,0,2,29,9.499999999999999e-05
G5,C(C1(C(C(C)O)=CC(C1)=O)O)=O,4,2,0,2,22,9.499999999999999e-05
G5,C1(C(CC(C=O)(C1C=C)O)O)=O,8,2,0,2,22,9.499999999999999e-05
G5,C(C1C(CC(C=O)=CC1O)O)=O,8,5,0,5,29,0.00023700000000000001
G5,C(C1C(CC(C1O)=CC=O)O)=O,16,5,0,5,29,0.00023700000000000001
G5,C(CC1C(C(C=O)C(C=1)O)O)=O,8,5,0,5,29,0.00023700000000000001
G5,C(C1C(C=O)=CC(CC1O)O)=O,8,2,0,2,13,9.499999999999999e-05
G5,C1CC(C(C(C=O)=O)C(C=1)O)O,8,5,0,5,13,0.00023700000000000001
G5,C(C1C=CC(CC(C1O)=O)O)=O,8,2,0,2,13,9.499999999999999e-05
G5,C(C1C=CC(CC1(C=O)O)O)=O,8,2,0,2,13,9.499999999999999e-05
G5,C(C1C(C(C(C1O)=O)C=C)O)=O,16,5,0,5,29,0.00023700000000000001
G5,C(C1C(C(C(C1O)=O)=CC)O)=O,16,5,0,5,29,0.00023700000000000001
G5,C(C1C=C(C(C1O)=O)C(C)O)=O,8,2,0,2,29,9.499999999999999e-05
G5,C1CC(C(C(CO)C(C=1)O)=O)=O,4,3,0,3,53,0.00014199999999999998
G5,C1CC(C(C(C(C=1)=O)=O)CO)O,4,3,0,3,53,0.00014199999999999998
G5,C(C1C=CC(C1(CCO)O)=O)=O,4,2,0,2,53,9.499999999999999e-05
G5,C(CC1C(C(CO)C(C=1)O)=O)=O,4,3,0,3,29,0.00014199999999999998
G5,C1(C(CC(C1CO)O)=CC=O)=O,8,3,0,3,29,0.00014199999999999998
G5,C(C1C(C(CCO)=CC1O)=O)=O,4,3,0,3,29,0.00014199999999999998
G5,C(C1C(C(CC1O)=CCO)=O)=O,8,3,0,3,29,0.00014199999999999998
G5,C(C1C(C(CC1O)=O)=CCO)=O,8,2,0,2,29,9.499999999999999e-05
G5,C=CC1C(C(C(CO)C1O)=O)=O,8,3,0,3,29,0.00014199999999999998
G5,C(C)=C1C(C(C(CO)C1O)=O)=O,8,3,0,3,4,0.00014199999999999998
G5,C1(CC=CC(C1C(CO)=O)O)=O,4,3,0,3,26,0.00014199999999999998
G5,C1(CC(C(C(C=CC1)O)O)=O)=O,4,3,0,3,26,0.00014199999999999998
G5,C(CO)(C1C(C=CCC1O)=O)=O,4,3,0,3,26,0.00014199999999999998
G5,C1(C(C(CC=CC(C1)=O)O)O)=O,4,3,0,3,26,0.00014199999999999998
G5,C(C1C=CC(CC1(CO)O)=O)=O,4,2,0,2,26,9.499999999999999e-05
G5,C(CC1CC(C(C(C=1)O)O)=O)=O,4,4,0,4,32,0.00018999999999999998
G5,C1(C(C(CC(C1)=CC=O)O)O)=O,8,4,0,4,32,0.00018999999999999998
G5,C(CC1CC(C(C(C=1)=O)O)O)=O,4,3,0,3,46,0.00014199999999999998
G5,C(C1C(CC(CO)=CC1O)=O)=O,4,3,0,3,29,0.00014199999999999998
G5,C(C1C(C=C(CO)CC1O)=O)=O,4,3,0,3,26,0.00014199999999999998
G5,C(C1C(CO)=CC(CC1O)=O)=O,4,2,0,2,26,9.499999999999999e-05
G5,C1(CC(C(C(C1C=C)O)O)=O)=O,8,4,0,4,4,0.00018999999999999998
G5,C1(C(C(C(C(C1)=O)=CC)O)O)=O,8,3,0,3,4,0.00014199999999999998
G5,C1(CC(C(C(C1C=C)=O)O)O)=O,8,4,0,4,4,0.00018999999999999998
G5,C(C)=C1C(CC(C(C1=O)O)O)=O,8,4,0,4,4,0.00018999999999999998
G5,C1(C(C(CC(C=CC1)O)=O)O)=O,4,2,0,2,9,9.499999999999999e-05
G5,C1(CC(CC=CC(C1O)=O)O)=O,4,2,0,2,9,9.499999999999999e-05
G5,C(CC1C(C(CC(C=1)O)=O)O)=O,4,2,0,2,29,9.499999999999999e-05
G5,C1(CC(CC(C1O)=CC=O)O)=O,8,2,0,2,29,9.499999999999999e-05
G5,C(C1C(C(C(C)=CC1O)O)=O)=O,8,3,0,3,29,0.00014199999999999998
G5,C(C1C(C(C(CC1O)=C)O)=O)=O,8,3,0,3,29,0.00014199999999999998
G5,C(C1C(C(C(CC1O)=O)O)=C)=O,8,2,0,2,29,9.499999999999999e-05
G5,C1(C(C(CC(C1C=C)O)=O)O)=O,8,3,0,3,9,0.00014199999999999998
G5,C1(CC(C(C(C1O)=O)=CC)O)=O,8,2,0,2,9,9.499999999999999e-05
G5,C(C1C(C(CC1O)O)=CC=O)=O,16,2,0,2,13,9.499999999999999e-05
G5,C(C1C(C(CC=CC1O)O)=O)=O,8,3,0,3,29,0.00014199999999999998
G5,C(C1C(C(C=CCC1O)O)=O)=O,8,3,0,3,13,0.00014199999999999998
G5,C(C1C=CC(C(CC1O)=O)O)=O,8,2,0,2,13,9.499999999999999e-05
G5,C(CC1(C(C=CC1C=O)O)O)=O,8,3,0,3,13,0.000144
G5,C(C1C(C(C(C=C)C1O)O)=O)=O,16,3,0,3,29,0.00014199999999999998
G5,C(C1C(C(C(C1O)=CC)O)=O)=O,16,3,0,3,29,0.00014199999999999998
G5,C(C1C(C=C(C1O)C(C)O)=O)=O,8,4,0,4,29,0.00018999999999999998
G5,C1(C(C=CC(C1C(C)=O)O)O)=O,8,3,0,3,29,0.00014199999999999998
G5,C1(C(C=CC(CC(C1)=O)O)O)=O,4,2,0,2,29,9.499999999999999e-05
G5,C(C(C1CC(CC(C=1)O)=O)O)=O,4,2,0,2,27,9.499999999999999e-05
G5,C1(CC(C(C(C1)=CC=O)O)O)=O,8,2,0,2,29,9.499999999999999e-05
G5,C(C(C1CC(CC(C=1)=O)O)O)=O,4,2,0,2,27,9.499999999999999e-05
G5,C(CC1C(C(CC(C=1)=O)O)O)=O,4,2,0,2,29,9.499999999999999e-05
G5,C(C1C(C)=CC(C(C1O)O)=O)=O,8,2,0,2,6,9.499999999999999e-05
G5,C(C1C(CC(C(C1O)O)=O)=C)=O,8,3,0,3,29,0.00014199999999999998
G5,C(C(C1CC(C=O)C(C=1)O)O)=O,8,2,0,2,29,9.499999999999999e-05
G5,C(C1C(C(C(C1)=CC=O)O)O)=O,16,2,0,2,29,9.499999999999999e-05
G5,C(C1C=C(CC1O)C(C=O)O)=O,8,2,0,2,44,9.499999999999999e-05
G5,C(C1C=C(C(C1O)O)CC=O)=O,8,2,0,2,29,9.499999999999999e-05
G5,C(C1C(C(C=O)O)=CCC1O)=O,8,2,0,2,44,9.499999999999999e-05
G5,C(C(C(C1C(C=CC1)O)=O)O)=O,8,2,0,2,44,9.499999999999999e-05
G5,C(C(C=O)O)(C1C=CCC1O)=O,8,2,0,2,44,9.499999999999999e-05
G5,C(C1C=CCC(C(C1O)O)=O)=O,8,2,0,2,44,9.499999999999999e-05
G5,C(C1C=CCC1(C(C=O)O)O)=O,8,2,0,2,44,9.499999999999999e-05
G5,C(C1C(C(C(C1O)O)=O)=CC)=O,16,2,0,2,4,9.499999999999999e-05
G5,C(C(CC1C(CC(C=1)O)=O)O)=O,4,2,0,2,29,9.499999999999999e-05
G5,C(C=C1C(CC(C(C1)O)O)=O)=O,8,2,0,2,21,9.499999999999999e-05
G5,C(C(C=C1C(CC(C1)O)=O)O)=O,8,2,0,2,29,9.499999999999999e-05
G5,C(C1C(C(C)=O)=CC(C1O)O)=O,8,2,0,2,29,9.499999999999999e-05
G5,C(CC1C(CC(C(C=1)O)O)=O)=O,4,2,0,2,29,9.499999999999999e-05
G5,C(C(C1C(C(C)=CC1O)=O)O)=O,8,3,0,3,29,0.00014199999999999998
G5,C(C(C1C(C(CC1O)=C)=O)O)=O,8,3,0,3,21,0.00014199999999999998
G5,C(C1C(C(CC(C1O)O)=O)=C)=O,8,2,0,2,21,9.499999999999999e-05
G5,C=CC1C(C(CC(C1O)O)=O)=O,8,3,0,3,29,0.00014199999999999998
G5,C(C)=C1C(C(CC(C1O)O)=O)=O,8,2,0,2,14,9.499999999999999e-05
G5,C1C(CC(C(C=1C(C)O)=O)=O)O,4,2,0,2,14,9.499999999999999e-05
G5,C(C1C(CC(C1O)O)=CC=O)=O,16,2,0,2,29,9.499999999999999e-05
G5,C(C1C(CC=O)=CC(C1O)O)=O,8,3,0,3,29,0.00014199999999999998
G5,C(C(C1C(CC=CC1O)=O)O)=O,8,3,0,3,26,0.00014199999999999998
G5,C1(CC(C(C1C=CC=O)O)O)=O,16,2,0,2,26,9.499999999999999e-05
G5,C(C(C1C(C=CCC1O)=O)O)=O,8,3,0,3,29,0.00014199999999999998
G5,C(C1C=CC(CC(C1O)O)=O)=O,8,2,0,2,6,9.499999999999999e-05
G5,C1(C(C=O)C(C(C1C=C)O)O)=O,16,3,0,3,29,0.00014199999999999998
G5,C(C1C(C(C(C1O)O)=CC)=O)=O,16,3,0,3,29,0.00014199999999999998
G5,C(C1C(C(C(C)O)=CC1O)=O)=O,8,4,0,4,29,0.00018999999999999998
G5,C1C(C=CC(C(C(C=1)O)O)=O)O,8,3,0,3,32,0.00014199999999999998
G5,C(CO)=C1C(C(C(C1O)O)O)=O,16,3,0,3,0,0.00014199999999999998
G5,C1C(C(C(C=1C(CO)O)=O)O)O,8,3,0,3,0,0.00014199999999999998
G5,C(C1(C(CC(C1=C)O)=O)O)=O,4,2,0,2,25,9.499999999999999e-05
G5,C1(CC(C(C1(CO)O)=C)O)=O,4,2,0,2,45,9.499999999999999e-05
G5,C1(C(C(C(C1(CO)O)=C)O)O)=O,8,5,0,5,2,0.000239
G5,C(C1(C=CC(C(C1O)O)=O)O)=O,8,4,0,4,1,0.00018999999999999998
G5,C1(CC(C(C1(C=C)O)O)O)=O,8,3,0,3,0,0.00014199999999999998
G5,C1(CC(CC(C1(C=C)O)=O)O)=O,1,2,0,2,29,9.499999999999999e-05
G5,C1(CC(CC(C1(C=C)O)O)=O)=O,4,3,0,3,29,0.00014199999999999998
G5,C(C1C(C(C(C1)=O)(C=C)O)O)=O,8,3,0,3,29,0.00014199999999999998
G5,C(C1C(C(C(C(C=1)=O)O)O)O)=O,8,3,0,3,29,0.00014199999999999998
G5,C(C(C1C(C(C(C=1)=O)O)O)O)=O,8,3,0,3,29,0.00014199999999999998
G5,C1(C(C(C(C=1)=O)O)O)C(C)O,8,3,0,3,41,0.00014199999999999998
G5,C1(C(CO)=CC(C(C1)O)=O)=O,2,2,0,2,2,9.499999999999999e-05
G5,C(C1(C=C(C(C1)=O)CO)O)=O,2,3,0,3,29,0.00014199999999999998
G5,C1(CO)C(CC(C(C=1)=O)=O)O,2,2,0,2,5,9.499999999999999e-05
G5,C1(CC(C(CC1(C=C)O)=O)O)=O,4,2,0,2,4,9.499999999999999e-05
G5,C(C1(CC(C(C1)=O)(C=C)O)O)=O,4,2,0,2,29,9.499999999999999e-05
G5,C1(C(C(C)O)=CC(C(C1)O)=O)=O,4,2,0,2,4,9.499999999999999e-05
G5,C(C1(C=C(C(C1)=O)C(C)O)O)=O,4,3,0,3,29,0.00014199999999999998
G5,C1(C(CC(C(C=1)=O)=O)O)C(C)O,4,2,0,2,29,9.499999999999999e-05
G5,C=CC1(C=CC(C(C1O)O)=O)O,8,3,0,3,32,0.00014199999999999998
G5,C1(C(C(C(C=1)=O)O)O)C(CO)O,8,3,0,3,29,0.00014199999999999998
G5,C1(C(C2(C(O)OC(C2)C1)O)O)=O,16,4,0,4,20,0.00018999999999999998
G5,C(C1C(C2(CC1(CO2)O)O)O)=O,16,4,0,4,51,0.00018999999999999998
G5,C1(C(C2CC(C(O)O2)(C1)O)O)=O,16,3,0,3,51,0.00014199999999999998
G5,C1(C2C(CC(C(C1)O)(O2)O)O)=O,16,3,0,3,20,0.00014199999999999998
G5,C(C1C(C2CC1(C(O)O2)O)O)=O,32,4,0,4,20,0.00018999999999999998
G5,C1(C(O)OC2C(CC(C12)O)O)=O,32,3,0,3,20,0.00014199999999999998
G5,C(C1C2C(CC(C1O)(O)O2)O)=O,32,3,0,3,20,0.00014199999999999998
G5,C1(C(O)OC2CC(C(C12)O)O)=O,32,3,0,3,20,0.00014199999999999998
G5,C1(C2C(C(C1)O)C(C(O2)O)O)=O,32,2,0,2,45,9.499999999999999e-05
G5,C1(C(O)OC2C(C(C(C12)O)O)O)=O,64,3,0,3,0,0.00014199999999999998
G5,C1(C(C(C2C(C1C(O)O2)O)O)O)=O,64,6,0,6,1,0.000285
G5,C(C1C(C2C(C(C1(O)O2)O)O)O)=O,64,3,0,3,1,0.00014199999999999998
G5,C1(C(C(C2C1C(C(O)O2)O)O)O)=O,64,3,0,3,0,0.00014199999999999998
G5,C1(C(C2(C(O)OCC2C1)O)O)=O,16,3,0,3,12,0.00014199999999999998
G5,C1(C(C(C2(CC1CO2)O)O)O)=O,16,5,0,5,12,0.00023700000000000001
G5,C(C1C(C2COC1(C2O)O)O)=O,32,4,0,4,23,0.00018999999999999998
G5,C1(C2(CC(C(C1CO2)O)O)O)=O,16,4,0,4,14,0.00018999999999999998
G5,C1(C2CC(C1C(CCO)(O2)O)O)=O,16,4,0,4,30,0.00018999999999999998
G5,C(C1C(C2(CCC1(CO)O2)O)O)=O,16,3,0,3,29,0.00014199999999999998
G5,C1(C(C2(C(O)OC(C)C2C1)O)O)=O,32,3,0,3,12,0.00014199999999999998
G5,C1(C(C(C2(CC1C(C)O2)O)O)O)=O,32,4,0,4,12,0.00018999999999999998
G5,C(C1C(C2(CC(C1(C)O2)O)O)O)=O,32,3,0,3,22,0.00014199999999999998
G5,C1(C(C2C(C(O)OC2C)(C1)O)O)=O,32,2,0,2,45,9.499999999999999e-05
G5,C1(C2(CC(C1C(O2)O)O)CCO)=O,16,4,0,4,53,0.00018999999999999998
G5,C(C1C(CC2CC(C1(O)O2)O)O)=O,32,4,0,4,13,0.00018999999999999998
G5,C(C1C2CC(C(CC1O)(O)O2)O)=O,32,4,0,4,13,0.00018999999999999998
G5,C(C1C2(C(C(C1O)C(C)O2)O)O)=O,64,4,0,4,4,0.00018999999999999998
G5,C(C1CC2(CC(O)OC2C1O)O)=O,32,2,0,2,44,9.499999999999999e-05
G5,C(C1C2CCC(C(C1O)O)(O)O2)=O,32,4,0,4,44,0.00018999999999999998
G5,C1(C2(CC(C(CC(C1)O)O2)O)O)=O,16,3,0,3,21,0.00014199999999999998
G5,C(C1C2C(CC(C1(C)O)(O)O2)O)=O,32,3,0,3,21,0.00014199999999999998
G5,C1(CC(CC21CC(C(O2)O)O)O)=O,16,2,0,2,21,9.499999999999999e-05
G5,C1(C2(CC(C(C1C(C)O2)O)O)O)=O,32,4,0,4,14,0.00018999999999999998
G5,C(C1C(CC2C(CC1(O)O2)O)O)=O,32,4,0,4,6,0.00018999999999999998
G5,C(C1C2C(CC(CC1O)(O)O2)O)=O,32,4,0,4,6,0.00018999999999999998
G5,C1(C2C(C(C1)O)(C(C(O2)O)O)O)=O,32,2,0,2,0,9.499999999999999e-05
G5,C1(C2C(C(C(C1)O)(C(O2)O)O)O)=O,32,5,0,5,1,0.00023700000000000001
G5,C1(CC(C2C(C1(C(O)O2)O)O)O)=O,32,5,0,5,1,0.00023700000000000001
G5,C1(CC(C2C1(C(C(O)O2)O)O)O)=O,32,2,0,2,0,9.499999999999999e-05
G5,C(C1C2C(C(C(O)O2)(C1O)O)O)=O,64,4,0,4,43,0.00018999999999999998
G5,C1(C2C(C(C1)O)(CC(O2)O)O)=O,16,2,0,2,49,9.499999999999999e-05
G5,C1(CC(C2(CC1(CO2)O)O)O)=O,8,3,0,3,2,0.00014199999999999998
G5,C1(C2(CC(C(C1)O)(CO2)O)O)=O,8,3,0,3,5,0.00014199999999999998
G5,C(C1C(C2(COC1(C2)O)O)O)=O,16,4,0,4,14,0.00018999999999999998
G5,C(C1C(C2C(C1(C(O)O2)O)O)O)=O,64,4,0,4,1,0.00018999999999999998
G5,C1(CC(C2(CC1(C(C)O2)O)O)O)=O,16,3,0,3,4,0.00014199999999999998
G5,C1(C2(CC(C(C1)O)(C(C)O2)O)O)=O,16,3,0,3,14,0.00014199999999999998
G5,C(C1C(C2(CC1(O)OC2C)O)O)=O,32,4,0,4,25,0.00018999999999999998
G5,C(C1C(C2(CC1C(CO)O2)O)O)=O,32,3,0,3,46,0.00014199999999999998
G5,C(C1C(C(C2(CC1CO2)O)O)O)=O,32,3,0,3,11,0.00014199999999999998
G5,C1(C(C(C2C(CC(O)O2)C1)O)O)=O,32,3,0,3,32,0.00014199999999999998
G5,C(C1C(C(C2C1CC(O)O2)O)O)=O,64,2,0,2,43,9.499999999999999e-05
G5,C1(C(C2C(C)(C1C(O)O2)O)O)=O,32,4,0,4,49,0.00018999999999999998
G5,C1(C2C(C(CC(O2)O)(C1)O)O)=O,16,3,0,3,51,0.00014199999999999998
G5,C1(C(C2(C)C(C1C(O)O2)O)O)=O,32,4,0,4,49,0.00018999999999999998
G5,C1(C2C(CC(C(O2)O)(C1)O)O)=O,16,2,0,2,49,9.499999999999999e-05
G5,C1(C2CC(C(C(O2)O)O)(C1)O)=O,16,3,0,3,26,0.00014199999999999998
G5,C(C1C2C(CC1(C(O)O2)O)O)=O,32,4,0,4,20,0.00018999999999999998
G5,C1(C(O)OC2C(C1C(C2)O)O)=O,32,6,0,6,20,0.000285
G5,C1(C(O)OC2C(C1C(C2O)O)O)=O,64,6,0,6,0,0.000285
G5,C1(C(C2C(C1C(O)O2)O)O)=O,32,4,0,4,2,0.00018999999999999998
G5,C1(C(C2C(C(C1C(O)O2)O)O)O)=O,64,3,0,3,1,0.00014199999999999998
G5,C1(C(C2(C(O)OCC1C2)O)O)=O,16,5,0,5,12,0.00023700000000000001
G5,C1(C(C2(CC(C1CO2)O)O)O)=O,16,3,0,3,9,0.00014199999999999998
G5,C1(CC2(C(C(C1CO2)O)O)O)=O,16,3,0,3,41,0.00014199999999999998
G5,C1(C2COC(C1C(C2O)O)O)=O,32,4,0,4,2,0.00018999999999999998
G5,C1(C2CC(C1CC(CO)(O2)O)O)=O,16,3,0,3,7,0.00014199999999999998
G5,C1(C(O)OC2(CO)CC1C(C2)O)=O,16,3,0,3,29,0.00014199999999999998
G5,C(C1C2(CO)CCC1(C(O)O2)O)=O,16,4,0,4,29,0.00018999999999999998
G5,C1(C(C2(C(O)OC(C)C1C2)O)O)=O,32,4,0,4,12,0.00018999999999999998
G5,C1(C2CC(C1C(C(C)(O2)O)O)O)=O,32,4,0,4,45,0.00018999999999999998
G5,C1(C2CC(C(C1)O)(CC(O2)O)O)=O,16,2,0,2,22,9.499999999999999e-05
G5,C1(C(O)OC2(C)C(C1C(C2)O)O)=O,32,4,0,4,22,0.00018999999999999998
G5,C(C1C2(C)C(CC1(C(O)O2)O)O)=O,32,4,0,4,22,0.00018999999999999998
G5,C(C1C2CC(C1O)(CC(O)O2)O)=O,32,4,0,4,13,0.00018999999999999998
G5,C(C1C2CC(CC(C1O)(O)O2)O)=O,32,4,0,4,13,0.00018999999999999998
G5,C1(CC2CC(C1C(CO)(O)O2)O)=O,16,3,0,3,26,0.00014199999999999998
G5,C1(CC2(CO)CC(C1C(O)O2)O)=O,16,3,0,3,26,0.00014199999999999998
G5,C1(C(C2(C)CC(C1C(O)O2)O)O)=O,32,3,0,3,6,0.00014199999999999998
G5,C1(C(C2(CC(C1C(C)O2)O)O)O)=O,32,3,0,3,9,0.00014199999999999998
G5,C1(C(C2CC(C1C(C)(O)O2)O)O)=O,32,3,0,3,26,0.00014199999999999998
G5,C1(CC2(C(C(C1C(C)O2)O)O)O)=O,32,3,0,3,4,0.00014199999999999998
G5,C1(C(C)(O)OC2C(C1C(C2)O)O)=O,32,4,0,4,21,0.00018999999999999998
G5,C(C1C2C(CC1(C(C)(O)O2)O)O)=O,32,4,0,4,21,0.00018999999999999998
G5,C1(CC(C2CC1(CC(O)O2)O)O)=O,16,2,0,2,21,9.499999999999999e-05
G5,C1(C2(C)CC(C1C(C(O2)O)O)O)=O,32,4,0,4,21,0.00018999999999999998
G5,C1(C2C(C)OC(C1C(C2O)O)O)=O,64,4,0,4,4,0.00018999999999999998
G5,C1(C2C(C(C(C(O2)O)(C1)O)O)O)=O,32,3,0,3,51,0.00014199999999999998
G5,C1(CC2(C(O)OCC1(C2)O)O)=O,8,3,0,3,22,0.00014199999999999998
G5,C1(C2(COC(C1C(C2)O)O)O)=O,16,4,0,4,12,0.00018999999999999998
G5,C1(CC2(C(O)OC(C)C1(C2)O)O)=O,16,3,0,3,4,0.00014199999999999998
G5,C1(C2(C(C)OC(C1C(C2)O)O)O)=O,32,4,0,4,4,0.00018999999999999998
G5,C(C1C(C2(CC1C(CO2)O)O)O)=O,32,3,0,3,46,0.00014199999999999998
G5,C(C1C(C2C(C1CC(O)O2)O)O)=O,64,3,0,3,4,0.00014199999999999998
G5,C1(COC2(C(C1C(C2)O)O)O)=O,16,4,0,4,20,0.00018999999999999998
G5,C1(C(CC2(C(C1CO2)O)O)O)=O,16,4,0,4,20,0.00018999999999999998
G5,C1(C(C2C(C1C(C(O)O2)O)O)O)=O,64,4,0,4,0,0.00018999999999999998
G5,C1(C(C2COC(C1C2O)O)O)=O,32,4,0,4,23,0.00018999999999999998
G5,C1(C2CC(C(CC(O2)O)O)(C1)O)=O,16,2,0,2,45,9.499999999999999e-05
G5,C1(C(CC2(C(C1C(C)O2)O)O)O)=O,32,4,0,4,22,0.00018999999999999998
G5,C1(C2CC(C1C(CC(O2)O)O)O)=O,32,3,0,3,13,0.00014199999999999998
G5,C1(C(O)OC2CC(C1C(C2)O)O)=O,6,3,0,3,13,0.00014199999999999998
G5,C(C1C2CC(CC1(C(O)O2)O)O)=O,32,4,0,4,13,0.00018999999999999998
G5,C1(C(CC2CC(C1C(O)O2)O)O)=O,32,4,0,4,13,0.00018999999999999998
G5,C(C1C2CC(C1(CC(O)O2)O)O)=O,32,4,0,4,13,0.00018999999999999998
G5,C1(C(C2C(C1C(O)OC2C)O)O)=O,64,4,0,4,4,0.00018999999999999998
G5,C1(C(C2CC(C1CC(O)O2)O)O)=O,32,2,0,2,45,9.499999999999999e-05
G5,C1(C(C(O)OC2CC1C(C2)O)O)=O,32,2,0,2,44,9.499999999999999e-05
G5,C(C1C2CCC1(C(C(O)O2)O)O)=O,32,4,0,4,44,0.00018999999999999998
G5,C1(CC(O)OC2C(C1C(C2)O)O)=O,32,3,0,3,6,0.00014199999999999998
G5,C1(CC(C2CC(C1C(O)O2)O)O)=O,32,4,0,4,6,0.00018999999999999998
G5,C(C1C2C(CC1(CC(O)O2)O)O)=O,32,4,0,4,6,0.00018999999999999998
G5,C1(CC2CC(C1C(C(O)O2)O)O)=O,32,3,0,3,26,0.00014199999999999998
G5,C1(C(C2(C(O)OCC1C2O)O)O)=O,32,4,0,4,3,0.00018999999999999998
G5,C1(C2C(C(C(C(O2)O)O)(C1)O)O)=O,32,4,0,4,51,0.00018999999999999998
G5,C1(CC2(COC(C1C2O)O)O)=O,16,4,0,4,38,0.00018999999999999998
G5,C1(CC2(C(C1C(O)OC2C)O)O)=O,32,4,0,4,25,0.00018999999999999998
G5,C1(C2C(C(C1CCC(O2)O)O)O)=O,32,2,0,2,27,9.499999999999999e-05
G5,C1(C2C(C(C(CC(O2)O)C1)O)O)=O,32,3,0,3,32,0.00014199999999999998
G5,C1(C2C(CC(C(C(O2)O)O)C1)O)=O,32,4,0,4,32,0.00018999999999999998
G5,C1(C(C2(C(C1CC2O)O)O)O)=O,32,1,0,1,20,4.7e-05
G5,C1(C2(C(C(C1CC2O)O)O)O)=O,32,2,0,2,20,9.499999999999999e-05
G5,C1(C(C2(C(C1CC2(C)O)O)O)O)=O,32,1,0,1,7,4.7e-05
G5,C1(C2(C(C(C1CC2(C)O)O)O)O)=O,32,2,0,2,4,9.499999999999999e-05
G5,C(C1C(CC(C1C(CO)=O)O)O)=O,16,2,0,2,18,9.499999999999999e-05
G5,C(C1C(C(C=O)C(C1)(CO)O)O)=O,16,2,0,2,18,9.499999999999999e-05
G5,C(C1C(C(C(C(C1)=O)O)O)CO)=O,16,3,0,3,18,0.00014199999999999998
G5,C(C(CO)C1C(C(C(C1)=O)O)O)=O,16,3,0,3,18,0.000143
G5,C(C1C(C(C(CO)=O)CC1O)O)=O,16,2,0,2,18,9.499999999999999e-05
G5,C(CC(C1C(C(C(C1)O)O)=O)O)=O,16,3,0,3,18,0.000144
G5,C1(C(C(C(C1O)O)CO)CC=O)=O,16,3,0,3,46,0.00014199999999999998
G5,C1(C(CC(C1O)O)C(C=O)CO)=O,16,2,0,2,46,9.499999999999999e-05
G5,C(C(C1CC(CC1O)O)=O)=O,8,1,0,1,7,4.7e-05
G5,C(C1C(CCC(C1O)=O)O)=O,8,3,0,3,7,0.00014199999999999998
G5,C(C1C(CCC1(C=O)O)O)=O,8,2,0,2,7,9.499999999999999e-05
G5,C1(C(C(CC(CC1)O)O)O)=O,8,3,0,3,7,0.00014199999999999998
G5,C(CO)(C1C(CC(C1)O)O)=O,8,1,0,1,7,4.7e-05
G5,C(C1C(CCC1(CO)O)O)=O,8,2,0,2,7,9.499999999999999e-05
G5,C1(C(C(C(CC1)CO)O)O)=O,8,3,0,3,7,0.00014199999999999998
G5,C(C1C(CC(C1C=O)O)O)=O,10,1,0,1,18,4.7e-05
G5,C(C1C(C(C=O)C(C1)O)O)=O,16,2,0,2,18,9.499999999999999e-05
G5,C(C(C1CCC(CC1O)O)=O)=O,8,1,0,1,7,4.7e-05
G5,C(C1C(CCCC(C1O)=O)O)=O,8,3,0,3,7,0.00014199999999999998
G5,C(C1C(CCCC1(C=O)O)O)=O,8,2,0,2,7,9.499999999999999e-05
G5,C(C(C1CC(C)(CC1O)O)=O)=O,8,1,0,1,7,4.7e-05
G5,C(C1C(CCC(C1O)=O)(C)O)=O,8,3,0,3,7,0.00014199999999999998
G5,C(C1C(C)(CCC1(C=O)O)O)=O,8,2,0,2,7,9.499999999999999e-05
G5,C1(C(C(C(CC1)C(C)O)O)O)=O,16,3,0,3,7,0.00014199999999999998
G5,C1(C(C(CC(CCC1)O)O)O)=O,8,3,0,3,7,0.00014199999999999998
G5,C(CO)(C1C(CC(CC1)O)O)=O,8,1,0,1,7,4.7e-05
G5,C(C1C(CCCC1(CO)O)O)=O,8,2,0,2,7,9.499999999999999e-05
G5,C1(C(C(CC(CC1)(C)O)O)O)=O,8,3,0,3,7,0.00014199999999999998
G5,C(CO)(C1CC(C)(CC1O)O)=O,8,1,0,1,7,4.7e-05
G5,C(C1C(CO)(CCC1(C)O)O)=O,8,2,0,2,7,9.499999999999999e-05
G5,C(C1CC(CC(C1C=O)O)O)=O,16,1,0,1,43,4.7e-05
G5,C(C1C(C(CC1O)CC=O)O)=O,16,3,0,3,43,0.00014199999999999998
G5,C(C1CC(C(C=O)C(C1)O)O)=O,3,2,0,2,43,9.499999999999999e-05
G5,C(C1C(C)(CC(C1C=O)O)O)=O,16,1,0,1,28,4.7e-05
G5,C(C1CC(C(C=O)C1(C)O)O)=O,16,2,0,2,28,9.499999999999999e-05
G5,C(C(C1CCC(C(C1O)O)O)=O)=O,16,1,0,1,7,4.7e-05
G5,C(C(C1CC(C)(C(C1O)O)O)=O)=O,16,1,0,1,7,4.7e-05
G5,C1(C(C(C(CC1)(C(C)O)O)O)O)=O,16,3,0,3,7,0.00014199999999999998
G5,C1(C(C(C(C(CCC1)O)O)O)O)=O,16,3,0,3,27,0.00014199999999999998
G5,C(CO)(C1C(C(C(CC1)O)O)O)=O,16,1,0,1,27,4.7e-05
G5,C1(C(C(C(C(CC1)(C)O)O)O)O)=O,16,3,0,3,7,0.00014199999999999998
G5,C(CO)(C1CC(C)(C(C1O)O)O)=O,16,1,0,1,7,4.7e-05
G5,C(C1CC(C(C(C1C=O)O)O)O)=O,32,1,0,1,43,4.7e-05
G5,C(C1C(C)(C(C(C1C=O)O)O)O)=O,32,2,0,2,43,9.499999999999999e-05
G5,C1(C(C(CC(C(CC1)O)O)O)O)=O,16,3,0,3,7,0.00014199999999999998
G5,C(CO)(C1C(CC(C(C1)O)O)O)=O,16,1,0,1,7,4.7e-05
G5,C(C1C(C(CCC1(CO)O)O)O)=O,16,2,0,2,7,9.499999999999999e-05
G5,C1(C(C(C(CC1)C(CO)O)O)O)=O,16,3,0,3,7,0.00014199999999999998
G5,C(C1C(CC(CO)(C1C=O)O)O)=O,16,2,0,2,29,9.499999999999999e-05
G5,C(C1C(CC(C=O)C1(CO)O)O)=O,16,2,0,2,29,9.499999999999999e-05
G5,C(C1C(C(CC(C1C=O)O)O)O)=O,32,2,0,2,43,9.499999999999999e-05
G5,C(C1C(C(C(C1O)CC=O)O)O)=O,32,3,0,3,43,0.00014199999999999998
G5,C(C1C(C(C(C=O)CC1O)O)O)=O,32,2,0,2,43,9.499999999999999e-05
G5,C1(C(C(C(C=O)=O)CC1O)O)=O,8,1,0,1,20,4.7e-05
G5,C(CO)(C1CC(C(C1O)=O)O)=O,8,3,0,3,2,0.00014199999999999998
G5,C(C1C(C(C(C1C=O)O)=O)O)=O,10,1,0,1,43,4.7e-05
G5,C1(C(C)(C(C(C=O)=O)CC1O)O)=O,8,1,0,1,25,4.7e-05
G5,C1(C(CC(C(C(CC1)O)=O)=O)O)=O,4,2,0,2,25,9.499999999999999e-05
G5,C(C1(CCC(C(C(C1)=O)=O)O)O)=O,4,1,0,1,25,4.7e-05
G5,C1(C(CO)(C(C(C=O)=O)CC1)O)=O,4,1,0,1,7,4.7e-05
G5,C1(C(C(C(C(CCC1)=O)=O)O)O)=O,4,3,0,3,7,0.00014199999999999998
G5,C1(C(C(C(C(CO)=O)=O)CC1)O)=O,4,2,0,2,7,9.499999999999999e-05
G5,C(C1(CCCC(C(C1O)=O)=O)O)=O,4,2,0,2,7,9.499999999999999e-05
G5,C(C)(C1(C(CCC(C1O)=O)O)O)=O,8,5,0,5,25,0.00023700000000000001
G5,C1(C(C)(C(C(CCC1O)=O)O)O)=O,8,4,0,4,25,0.00018999999999999998
G5,C1(C(C)(C(C(CO)=O)CC1O)O)=O,8,1,0,1,25,4.7e-05
G5,C1(C(C(CCC(CO)(C1)O)O)=O)=O,4,1,0,1,25,4.7e-05
G5,C1(C(CO)(C(C(CCC1)=O)O)O)=O,4,5,0,5,7,0.00023700000000000001
G5,C1(C(CO)(C(C(CO)=O)CC1)O)=O,4,1,0,1,7,4.7e-05
G5,C(CO)(C1(CCCC(C1O)=O)O)=O,4,4,0,4,7,0.00018999999999999998
G5,C1(C(C(C(CO)(CCC1)O)O)=O)=O,4,2,0,2,7,9.499999999999999e-05
G5,C1(C(C(C=O)C(C=O)C1(C)O)O)=O,16,2,0,2,25,9.499999999999999e-05
G5,C(CC1C(CC(C(C1O)=O)=O)O)=O,8,2,0,2,25,9.499999999999999e-05
G5,C(C1CC(CC(C(C1O)=O)=O)O)=O,8,1,0,1,25,4.7e-05
G5,C1(CC(C=O)C(C=O)C1(CO)O)=O,8,1,0,1,43,4.7e-05
G5,C(CC1C(C(C(C(C1)=O)=O)O)O)=O,8,3,0,3,43,0.00014199999999999998
G5,C(C1CC(C(C(C(C1)=O)=O)O)O)=O,8,2,0,2,43,9.499999999999999e-05
G5,C1(C(C(C(C=O)=O)CC1(C)O)O)=O,8,1,0,1,25,4.7e-05
G5,C1(C(C(C(C=O)=O)CCC1O)O)=O,8,1,0,1,7,4.7e-05
G5,C(C1(C(CCC1C(C=O)=O)O)O)=O,8,1,0,1,7,4.7e-05
G5,C1(C(C(C(CCC1(C)O)=O)O)O)=O,8,5,0,5,7,0.00023700000000000001
G5,C(CO)(C1CC(C(C1O)=O)(C)O)=O,8,1,0,1,7,4.7e-05
G5,C1(C(C(C(C(CCC1)O)=O)O)O)=O,8,5,0,5,7,0.00023700000000000001
G5,C(CO)(C1CCC(C(C1O)=O)O)=O,8,1,0,1,7,4.7e-05
G5,C(C1(C(CCC1C(CO)=O)O)O)=O,8,1,0,1,7,4.7e-05
G5,C1(C(C(C=O)C(C=O)CC1O)O)=O,16,1,0,1,43,4.7e-05
G5,C(C1CC(C(C=O)(C1C=O)O)O)=O,16,2,0,2,43,9.499999999999999e-05
G5,C(C1(CCC(C(C1O)=O)(C)O)O)=O,8,2,0,2,7,9.499999999999999e-05
G5,C(C(C1CCC(C1(CO)O)O)=O)=O,8,1,0,1,7,4.7e-05
G5,C(C1(CCCC(C(C1O)=O)O)O)=O,8,2,0,2,7,9.499999999999999e-05
G5,C1(C(C(C(C)O)(C(CC1)O)O)O)=O,16,3,0,3,7,0.00014199999999999998
G5,C1(C(C(CO)(C(CC1)(C)O)O)O)=O,8,4,0,4,7,0.00020099999999999998
G5,C1(C(C(CO)(CCC1(C)O)O)O)=O,8,2,0,2,7,9.499999999999999e-05
G5,C1(C(C(CO)(C(CCC1)O)O)O)=O,8,4,0,4,7,0.00020099999999999998
G5,C(CO)(C1CCC(C1(CO)O)O)=O,8,1,0,1,7,4.7e-05
G5,C1(C(C(CO)(CCCC1O)O)O)=O,8,2,0,2,7,9.499999999999999e-05
G5,C(CC1C(C(C(C1(C)O)=O)O)O)=O,16,3,0,3,25,0.00014199999999999998
G5,C(C1CC(C(C(C1(C)O)=O)O)O)=O,16,2,0,2,25,9.499999999999999e-05
G5,C1(CC(C=O)C(C=O)C(C1O)O)=O,16,4,0,4,45,0.00018999999999999998
G5,C(C(C=O)C1C(C(C(C1)=O)O)O)=O,8,3,0,3,45,0.000143
G5,C(CC1C(C(C(C1C=O)O)O)=O)=O,16,3,0,3,45,0.00014199999999999998
G5,C(C(C=O)C1C(C(C(C1)O)O)=O)=O,8,2,0,2,45,9.499999999999999e-05
G5,C(C1CCC(C(C1O)O)=O)=O,8,3,0,3,45,0.00014199999999999998
G5,C1(CC(C(C=O)=O)C(C=O)C(C1)O)=O,8,2,0,2,45,9.499999999999999e-05
G5,C(C(C=O)C1C(C(CC(C1)=O)O)=O)=O,4,2,0,2,45,9.499999999999999e-05
G5,C(C1(C(CC(C1)=O)C(C=O)C=O)O)=O,4,2,0,2,45,9.499999999999999e-05
G5,C(C1C(CC(C1CC(C=O)=O)=O)O)=O,8,4,0,4,45,0.00018999999999999998
G5,C(C(C=O)C1C(CC(C(C1)=O)O)=O)=O,4,2,0,2,45,9.499999999999999e-05
G5,C(C1(CC(C(C1)=O)C(C=O)C=O)O)=O,4,1,0,1,45,4.7e-05
G5,C(C1C(CC(C1O)=O)C(C=O)C=O)=O,8,3,0,3,45,0.000143
G5,C(C1C(CC(C(CC1C=O)=O)=O)O)=O,8,3,0,3,45,0.00014199999999999998
G5,C(C(C=O)C1C(CC(C(C1)=O)=O)O)=O,4,2,0,2,45,9.499999999999999e-05
G5,C(CC1C(C(CC(C1C=O)O)=O)=O)=O,8,2,0,2,45,9.499999999999999e-05
G5,C(C(C=O)C1C(C(CC(C1)O)=O)=O)=O,4,1,0,1,45,4.7e-05
G5,C(C1C(C(C(CC1C=O)=O)C=O)O)=O,16,3,0,3,45,0.00014199999999999998
G5,C(C(C=O)C1C(C(C=O)C(C1)=O)O)=O,8,3,0,3,45,0.000143
G5,C(CC1C(C(C=O)C(C1C=O)O)=O)=O,16,3,0,3,45,0.00014199999999999998
G5,C(C1C(C(CC1O)C(C=O)C=O)=O)=O,8,2,0,2,45,9.499999999999999e-05
G5,C(C1C(CC(C1C(C=O)C=O)=O)O)=O,8,2,0,2,45,9.499999999999999e-05
G5,C(C1CCC(C(C(C=O)=O)C1O)=O)=O,8,3,0,3,45,0.00014199999999999998
G5,C(C(C=O)CC1C(CC(C1O)=O)=O)=O,4,2,0,2,45,9.499999999999999e-05
G5,C(C1CCC(C(C(C=O)C1O)=O)=O)=O,8,3,0,3,45,0.00014199999999999998
G5,C(C(C=O)CC1C(C(CC1O)=O)=O)=O,4,2,0,2,45,9.499999999999999e-05
G5,C(C(C1CC(CO)C(C1O)O)=O)=O,16,1,0,1,7,4.7e-05
G5,C(C(C1CC(CC(C1O)O)O)=O)=O,16,1,0,1,7,4.7e-05
G5,C1(C(C(C(C(CC1)CO)O)O)O)=O,16,4,0,4,7,0.00020099999999999998
G5,C(CO)(C1CC(CO)C(C1O)O)=O,16,1,0,1,7,4.7e-05
G5,C1(C(C(C(CC(CC1)O)O)O)O)=O,16,3,0,3,7,0.00014199999999999998
G5,C(CO)(C1C(C(CC(C1)O)O)O)=O,16,1,0,1,7,4.7e-05
G5,C(C1C(C(C(CO)C1C=O)O)O)=O,32,1,0,1,29,4.7e-05
G5,C1(C(C(C(C(O)=O)=O)CC1)O)=O,4,2,0,2,7,9.499999999999999e-05
G5,C(C1(CCCC(C1O)=O)O)(O)=O,4,4,0,4,7,0.00018999999999999998
G5,C(C1(CCC(C(C1O)O)=O)O)(O)=O,8,3,0,3,7,0.00014199999999999998
G5,C1(CC(C(C1CCC(C=O)=O)=O)O)=O,4,3,0,3,7,0.000143
G5,C(C)(C1C(C(C(C(C=O)=O)C1)O)=O)=O,8,1,0,1,7,4.7e-05
G5,C1(CC(C(CCC1C(C=O)=O)=O)O)=O,4,2,0,2,7,9.499999999999999e-05
G5,C(C1(CCC(C(C1)=O)C(C=O)=O)O)=O,4,1,0,1,7,4.7e-05
G5,C1(C(CCC(C=O)=O)C(C(C1)=O)O)=O,4,3,0,3,7,0.000143
G5,C1(CCC(C(C=O)=O)C(C(C1)=O)O)=O,4,2,0,2,7,9.499999999999999e-05
G5,C1(CC(C=O)(C(C(C=O)=O)CC1)O)=O,4,2,0,2,7,9.499999999999999e-05
G5,C1(CCCC(C(C1C(C=O)=O)O)=O)=O,4,4,0,4,7,0.00018999999999999998
G5,C(C1CCC(C1O)=O)(CC(C=O)=O)=O,4,2,0,2,7,9.499999999999999e-05
G5,C1(CCCC(C=O)(C1C(C=O)=O)O)=O,4,3,0,3,7,0.00014199999999999998
G5,C(CC(C=O)C1C(CC(C1=O)O)=O)=O,8,2,0,2,43,9.499999999999999e-05
G5,C(C1C(C=O)C(C(C1C(C)=O)=O)O)=O,16,1,0,1,43,4.7e-05
G5,C(CC1C(CC(C1C(C=O)=O)=O)O)=O,8,2,0,2,43,9.499999999999999e-05
G5,C1(CC(CC(C=O)C1C(C=O)=O)O)=O,8,1,0,1,43,4.7e-05
G5,C(CC(C=O)C1C(CC(C1O)=O)=O)=O,8,2,0,2,43,9.499999999999999e-05
G5,C(C1CC(CC(C(C1C=O)O)=O)=O)=O,8,1,0,1,43,4.7e-05
G5,C(C1C(C=O)CC(CC1(C=O)O)=O)=O,8,1,0,1,43,4.7e-05
G5,C(CC1C(C(C(C1)=O)C(C=O)=O)O)=O,8,3,0,3,43,0.00014199999999999998
G5,C(C1CC(C(C(C1)=O)C(C=O)=O)O)=O,8,2,0,2,43,9.499999999999999e-05
G5,C(C1C(C(C(C(C=O)=O)C1)O)=O)=O,8,1,0,1,23,4.7e-05
G5,C(C1C(C(C(C(CC1)=O)O)O)=O)=O,8,5,0,5,23,0.00023700000000000001
G5,C(CO)(C1CC(C=O)C(C1O)=O)=O,8,1,0,1,23,4.7e-05
G5,C1(C(C(C=O)(C(C=O)CC1)O)O)=O,8,4,0,4,23,0.00018999999999999998
G5,C1(C(C(C(C(C=O)=O)CC1)O)O)=O,8,4,0,4,23,0.00018999999999999998
G5,C(C1C(C(C(C=O)C1C=O)O)=O)=O,16,1,0,1,29,4.7e-05
G5,C1(C(CC(C1CCC(C=O)=O)O)=O)=O,4,4,0,4,14,0.00019099999999999998
G5,C(C1C(C(C)(C(C(C=O)=O)C1)O)=O)=O,8,1,0,1,14,4.7e-05
G5,C(C1C(C(CC(C(CC1)=O)O)=O)=O)=O,4,2,0,2,14,9.499999999999999e-05
G5,C(C1(CCC(C=O)C(C(C1)=O)=O)O)=O,4,1,0,1,14,4.7e-05
G5,C(C=O)(C1CCC(C(CC1O)=O)=O)=O,4,2,0,2,14,9.499999999999999e-05
G5,C(CC1(C(CCC1C(C=O)=O)=O)O)=O,4,2,0,2,14,9.499999999999999e-05
G5,C(C1C(C(CCCC(C1O)=O)=O)=O)=O,4,4,0,4,14,0.00018999999999999998
G5,C(CC(C(C1CCC(C1O)=O)=O)=O)=O,4,2,0,2,14,9.499999999999999e-05
G5,C(C1C(C(CCCC1(C=O)O)=O)=O)=O,4,3,0,3,14,0.00014199999999999998
G5,C(CC(C=O)C1C(C(CC1O)=O)=O)=O,8,3,0,3,14,0.000143
G5,C1(C(C)(C(C=O)C(C=O)C1C=O)O)=O,16,1,0,1,14,4.7e-05
G5,C(C1C(C(CC(C1CC=O)O)=O)=O)=O,8,2,0,2,14,9.499999999999999e-05
G5,C(C1C(C(CC(CC1C=O)O)=O)=O)=O,8,1,0,1,14,4.7e-05
G5,C(C1CC(C(CC=O)(C1C=O)O)=O)=O,8,1,0,1,14,4.7e-05
G5,C(C1C(C(CC(C1O)CC=O)=O)=O)=O,8,3,0,3,14,0.00014199999999999998
G5,C(C1CC(C(C=O)C(C(C1)=O)=O)O)=O,8,2,0,2,14,9.499999999999999e-05
G5,C1(C(C)(C(C(C=O)=O)CC1)O)=O,4,1,0,1,14,4.7e-05
G5,C1(C(C(C(C(C)=O)=O)CC1)O)=O,4,2,0,2,14,9.499999999999999e-05
G5,C1(C(CC(C(CCC1)=O)=O)O)=O,2,2,0,2,14,9.499999999999999e-05
G5,C(C1(CCCC(C(C1)=O)=O)O)=O,2,1,0,1,14,4.7e-05
G5,C(C)(C1(CCCC(C1O)=O)O)=O,4,3,0,3,14,0.00014199999999999998
G5,C1(C(C)(C(C(CCC1)=O)O)O)=O,4,3,0,3,14,0.00014199999999999998
G5,C1(C(C)(C(C(CO)=O)CC1)O)=O,4,1,0,1,14,4.7e-05
G5,C1(C(CC(CO)(CCC1)O)=O)=O,2,1,0,1,14,4.7e-05
G5,C1(CCC(C(C=O)=O)C(C1)O)=O,4,1,0,1,7,4.7e-05
G5,C(C1CCC(C1O)=O)(CC=O)=O,4,3,0,3,7,0.00014199999999999998
G5,C1(CCCC(C(C1C=O)O)=O)=O,4,4,0,4,7,0.00018999999999999998
G5,C1(CCCC(C=O)(C1C=O)O)=O,4,2,0,2,7,9.499999999999999e-05
G5,C1(CC(C(CCC1C=O)=O)O)=O,4,3,0,3,7,0.00014199999999999998
G5,C(C1(CCC(C=O)C(C1)=O)O)=O,4,1,0,1,7,4.7e-05
G5,C(CC1(CCCC(C1O)=O)O)=O,4,3,0,3,7,0.00014199999999999998
G5,C1(CCCC(C(C(C1)O)O)=O)=O,4,3,0,3,7,0.00014199999999999998
G5,C1(CC(C(C(CO)=O)CC1)O)=O,4,1,0,1,7,4.7e-05
G5,C(C1C(CCCC1(CO)O)=O)=O,4,2,0,2,7,9.499999999999999e-05
G5,C(C1CCC(C(C1(C)O)O)=O)=O,8,3,0,3,7,0.00014199999999999998
G5,C1(C(C(C(C(C)=O)CC1)O)O)=O,8,3,0,3,7,0.00014199999999999998
G5,C(C1C(CC(CO)(CC1)O)=O)=O,4,1,0,1,7,4.7e-05
G5,C(C1C(CC(C1CC=O)O)=O)=O,8,4,0,4,4,0.00019099999999999998
G5,C1(CC(CC(C=O)C1C=O)O)=O,8,1,0,1,29,4.7e-05
G5,C(C(C1CC2(CC1(CO2)O)O)=O)=O,8,1,0,1,35,4.7e-05
G5,C1(COC2(CCC(C(C12)O)=O)O)=O,8,3,0,3,35,0.00014199999999999998
G5,C1(C(C2C(CC(CC1)(O2)O)=O)O)=O,8,3,0,3,35,0.00014199999999999998
G5,C(C1(CCC2(C1C(CO2)=O)O)O)=O,8,2,0,2,35,9.499999999999999e-05
G5,C(C1(CCC2(CC(C1O2)=O)O)O)=O,8,2,0,2,35,9.499999999999999e-05
G5,C1(C(C2C(C(C(O2)O)CC1)=O)O)=O,16,3,0,3,7,0.00014199999999999998
G5,C(C1(CCC2C(C1OC2O)=O)O)=O,16,2,0,2,7,9.499999999999999e-05
G5,C1(C2CCC(C(C1C(O2)O)O)=O)=O,16,3,0,3,7,0.00014199999999999998
G5,C1(C2CCC(C=O)(C1C(O2)O)O)=O,16,2,0,2,7,9.499999999999999e-05
G5,C1(C(C2(COC(CC1)(C2)O)O)O)=O,8,3,0,3,35,0.00014199999999999998
G5,C(CO)(C1CC2(CC1(CO2)O)O)=O,8,1,0,1,35,4.7e-05
G5,C1(COC2(CCC(CO)(C12)O)O)=O,8,2,0,2,35,9.499999999999999e-05
G5,C1(C2C(CO)(CCC(C1)(O2)O)O)=O,8,2,0,2,35,9.499999999999999e-05
G5,C1(C(C2(COC(C2CC1)O)O)O)=O,16,3,0,3,7,0.00014199999999999998
G5,C1(C2C(CO)(CCC1C(O2)O)O)=O,16,2,0,2,7,9.499999999999999e-05
G5,C1(C(C2(C(CC1)OC(C2)O)O)O)=O,16,3,0,3,7,0.00014199999999999998
G5,C1(C2CCC(CO)(C1C(O2)O)O)=O,16,2,0,2,7,9.499999999999999e-05
G5,C(C1C2(COC(C2)(C1C=O)O)O)=O,16,1,0,1,35,4.7e-05
G5,C(CC1C(C2C(CC1(O2)O)=O)O)=O,16,3,0,3,35,0.00014199999999999998
G5,C(C1C2(C(C(CO2)=O)C(C1)O)O)=O,16,2,0,2,35,9.499999999999999e-05
G5,C(C1C2(CC(C(C(C1)O)O2)=O)O)=O,16,2,0,2,35,9.499999999999999e-05
G5,C(CC1C(C2C(C1C(O2)O)=O)O)=O,32,3,0,3,35,0.00014199999999999998
G5,C1(C2C(OC1C(CC2C=O)O)O)=O,32,2,0,2,35,9.499999999999999e-05
G5,C(CC1C(C2C(C1OC2O)=O)O)=O,32,3,0,3,43,0.00014199999999999998
G5,C(C1CC(C2C(C1OC2O)=O)O)=O,32,2,0,2,43,9.499999999999999e-05
G5,C1C(C(C(C=O)=O)CC(C(C=1)=O)O)O,8,1,0,1,7,4.7e-05
G5,C(C1C(C(C=CC(C1C=O)O)=O)O)=O,16,1,0,1,43,4.7e-05
G5,C1(C(C(C(CC(C=O)O)C1)O)O)=O,16,3,0,3,11,0.000143
G5,C(C1CC(C(C1C(CO)=O)O)O)=O,16,1,0,1,11,4.7e-05
G5,C(C1CC(C(C(C(C1)=O)O)O)O)=O,16,3,0,3,11,0.00014199999999999998
G5,C1(C(C(CC1CC(C=O)O)O)O)=O,16,2,0,2,11,9.499999999999999e-05
G5,C(C1C(C(CC1C(CO)=O)O)O)=O,16,1,0,1,11,4.7e-05
G5,C1(C(CC(C(C1O)O)O)CC=O)=O,16,3,0,3,11,0.00014199999999999998
G5,C(C(C)(C1C(C(C(C1)=O)O)O)O)=O,16,3,0,3,11,0.000143
G5,C(C1C(C(C(C(C1)=O)O)O)(C)O)=O,16,3,0,3,11,0.00014199999999999998
G5,C1(C(CC(C1O)O)C(C=O)(C)O)=O,16,2,0,2,7,9.499999999999999e-05
G5,C1(C(C(C(C1O)O)(C)O)CC=O)=O,16,3,0,3,7,0.00014199999999999998
G5,C1(C(C(CC1CCO)O)O)=O,8,2,0,2,46,9.499999999999999e-05
G5,C1(C(C(C(C(C)O)C1)O)O)=O,16,7,0,7,46,0.000332
G5,C1(C(C(CC1C(C)O)O)O)=O,16,2,0,2,46,9.499999999999999e-05
G5,C(CC1C(C(C(C1)=O)O)O)(O)=O,8,3,0,3,18,0.000143
G5,C1(C(CC(C1O)O)CC(O)=O)=O,8,2,0,2,18,9.499999999999999e-05
G5,C(C(C1CCC(C1O)O)=O)=O,8,1,0,1,7,4.7e-05
G5,C1(C(C2C(C(CO2)(CC1)O)=O)O)=O,8,3,0,3,10,0.00014199999999999998
G5,C(C1(CCC2(C(C1OC2)=O)O)O)=O,8,2,0,2,10,9.499999999999999e-05
G5,C1(C(C2C(C(C(CC1)O2)O)=O)O)=O,16,3,0,3,10,0.00014199999999999998
G5,C(C1(CCC2C(C(C1O2)=O)O)O)=O,16,2,0,2,10,9.499999999999999e-05
G5,C(C(C1CC2C(C1(CO2)O)O)=O)=O,16,1,0,1,10,4.7e-05
G5,C1(C2(CCC(C(C1CO2)O)=O)O)=O,8,3,0,3,34,0.00014199999999999998
G5,C1(C2(CCC(C=O)(C1CO2)O)O)=O,8,2,0,2,34,9.499999999999999e-05
G5,C1(C(C2C(C(O)OC2CC1)=O)O)=O,16,3,0,3,7,0.00014199999999999998
G5,C(C1(CCC2C1C(C(O)O2)=O)O)=O,16,2,0,2,7,9.499999999999999e-05
G5,C(C(C1CC2CC1(C(O)O2)O)=O)=O,16,1,0,1,7,4.7e-05
G5,C1(C(C(C=C)(C(CC1)O)O)O)=O,8,3,0,3,7,0.00014199999999999998
G5,C1(C(C(C(CCC1)O)O)O)=O,8,3,0,3,11,0.00014199999999999998
G5,C(CO)(C1C(C(CC1)O)O)=O,8,1,0,1,11,4.7e-05
G5,C1(C(C(C(CC1)(C)O)O)O)=O,8,3,0,3,11,0.00014199999999999998
G5,C1(C(C2(C(CC1)OCC2O)O)O)=O,16,3,0,3,10,0.00014199999999999998
G5,C1(C2C(CO)(CCC1(CO2)O)O)=O,8,2,0,2,10,9.499999999999999e-05
G5,C1(C(C2(COCC2(CC1)O)O)O)=O,8,3,0,3,10,0.00014199999999999998
G5,C1(C2C(CO)(CCC(C1O)O2)O)=O,16,2,0,2,10,9.499999999999999e-05
G5,C1(C(C2(COC(CC1)C2O)O)O)=O,16,3,0,3,10,0.00014199999999999998
G5,C(CO)(C1CC2C(C1(CO2)O)O)=O,16,1,0,1,10,4.7e-05
G5,C1(C2(CCC(CO)(C1CO2)O)O)=O,8,2,0,2,34,9.499999999999999e-05
G5,C1(C(C2(C(CC1)(O)OCC2)O)O)=O,8,3,0,3,34,0.00014199999999999998
G5,C1(C(C2(C(O)OCC2CC1)O)O)=O,16,3,0,3,7,0.00014199999999999998
G5,C1(C(O)OC2CCC(CO)(C12)O)=O,16,2,0,2,7,9.499999999999999e-05
G5,C1(C(C2(C(O)OC(CC1)C2)O)O)=O,16,3,0,3,7,0.00014199999999999998
G5,C(CO)(C1CC2CC1(C(O)O2)O)=O,16,1,0,1,7,4.7e-05
G5,C(CC1C(C2C(C1(CO2)O)=O)O)=O,16,3,0,3,10,0.00014199999999999998
G5,C(C1CC(C2C(C1(CO2)O)=O)O)=O,16,2,0,2,10,9.499999999999999e-05
G5,C(CC1C2C(C(C(C1O)O2)=O)O)=O,32,3,0,3,10,0.00014199999999999998
G5,C(C1C2C(C(C(C(C1)O)O2)=O)O)=O,32,2,0,2,10,9.499999999999999e-05
G5,C(C1C2(COC(C2O)C1C=O)O)=O,32,1,0,1,10,4.7e-05
G5,C(CC1C(C2C(C1(O)OC2)=O)O)=O,16,3,0,3,34,0.00014199999999999998
G5,C(C1CC(C2C(C1(O)OC2)=O)O)=O,16,2,0,2,34,9.499999999999999e-05
G5,C(C1C2C(C(C(O)O2)=O)C(C1)O)=O,32,2,0,2,34,9.499999999999999e-05
G5,C(C1C2CC(C(O)O2)(C1C=O)O)=O,32,1,0,1,34,4.7e-05
G5,C1(C(C(CO)CC(C1O)O)O)=O,16,2,0,2,5,9.499999999999999e-05
G5,C1(C(C(CC(C1O)O)CCO)O)=O,16,2,0,2,46,9.499999999999999e-05
G5,C1(C(C(CC(C1O)O)C(C)O)O)=O,32,2,0,2,46,9.499999999999999e-05
G5,C1(C(C(CO)(C(CCO)C1)O)O)=O,8,3,0,3,46,0.000143
G5,C1(C(C(CO)(CC1CCO)O)O)=O,8,2,0,2,46,9.499999999999999e-05
G5,C1(CC(C(C(C1)O)=O)CO)=O,4,2,0,2,55,9.499999999999999e-05
G5,C(C1(C(CO)CC(C1)=O)O)=O,4,2,0,2,55,9.499999999999999e-05
G5,C1(CC(C(CC1CO)=O)O)=O,4,3,0,3,55,0.000143
G5,C(C1(CC(C(C1)=O)CO)O)=O,4,1,0,1,55,4.7e-05
G5,C(C1C(CO)CC(C1O)=O)=O,8,5,0,5,55,0.00023799999999999998
G5,C1(C(CC(CO)C(C1)O)=O)=O,4,3,0,3,55,0.000143
G5,C(C1C(CC(CO)C1O)=O)=O,8,4,0,4,55,0.00018999999999999998
G5,C(C1C(C(CO)CC1O)=O)=O,8,2,0,2,29,9.499999999999999e-05
G5,C1(C(CO)C(C=O)C(C1)O)=O,8,3,0,3,55,0.000143
G5,C1(C(CCO)C(C(C1)=O)O)=O,4,4,0,4,55,0.00018999999999999998
G5,C1(CC(C(C(C1)O)=O)CCO)=O,4,2,0,2,46,9.499999999999999e-05
G5,C(C1(C(CCO)CC(C1)=O)O)=O,4,2,0,2,46,9.499999999999999e-05
G5,C1(CC(C(C(C1)O)=O)C(C)O)=O,8,2,0,2,46,9.499999999999999e-05
G5,C(C1(C(C(C)O)CC(C1)=O)O)=O,8,2,0,2,46,9.499999999999999e-05
G5,C1(CC(C(CC1CCO)=O)O)=O,4,3,0,3,46,0.000143
G5,C(C1(CC(C(C1)=O)CCO)O)=O,4,1,0,1,29,4.7e-05
G5,C1(CC(C(CC1C(C)O)=O)O)=O,8,3,0,3,46,0.000143
G5,C(C1(CC(C(C1)=O)C(C)O)O)=O,8,1,0,1,46,4.7e-05
G5,C(C1C(CCO)CC(C1O)=O)=O,8,4,0,4,46,0.00018999999999999998
G5,C(C1C(C(C)O)CC(C1O)=O)=O,16,4,0,4,46,0.00018999999999999998
G5,C1(C(CC(C(CCO)C1)O)=O)=O,4,3,0,3,29,0.000143
G5,C1(C(CC(C(C1)O)C(C)O)=O)=O,8,3,0,3,46,0.000143
G5,C1(C(CC(CC1CCO)O)=O)=O,4,1,0,1,46,4.7e-05
G5,C1(C(CC(CC1C(C)O)O)=O)=O,8,1,0,1,46,4.7e-05
G5,C(C1C(CC(C1O)CCO)=O)=O,8,4,0,4,29,0.00018999999999999998
G5,C(C1C(CC(C1O)C(C)O)=O)=O,16,4,0,4,46,0.00018999999999999998
G5,C(C1C(C(CC1O)CCO)=O)=O,8,2,0,2,29,9.499999999999999e-05
G5,C1(C(CCO)C(C=O)C(C1)O)=O,8,3,0,3,46,0.000143
G5,C(C1C(C(CC1O)C(C)O)=O)=O,16,2,0,2,46,9.499999999999999e-05
G5,C1(C(C(C)O)C(C=O)C(C1)O)=O,16,3,0,3,46,0.000143
G5,C1(C(CCCO)C(C(C1)=O)O)=O,4,3,0,3,46,0.000143
G5,C1(C(CC(C)O)C(C(C1)=O)O)=O,8,3,0,3,46,0.000143
G5,C1(C(CC(C1CCCO)O)=O)=O,4,3,0,3,46,0.000143
G5,C1(C(CC(C1CC(C)O)O)=O)=O,8,3,0,3,46,0.000143
G5,C(CC1C(C(CC(C1)=O)O)=O)(O)=O,4,2,0,2,18,9.499999999999999e-05
G5,C(CC1C(C=O)(CC(C1)=O)O)(O)=O,4,2,0,2,18,9.499999999999999e-05
G5,C(CC1C(CC(C(C1)=O)O)=O)(O)=O,4,2,0,2,18,9.499999999999999e-05
G5,C(C1(CC(C(C1)=O)CC(O)=O)O)=O,4,1,0,1,18,4.7e-05
G5,C(CC1C(C=O)C(C(C1)=O)O)(O)=O,8,3,0,3,18,0.000143
G5,C(CC1C(CC(C(C1)=O)=O)O)(O)=O,4,2,0,2,18,9.499999999999999e-05
G5,C(CC1C(C(CC(C1)O)=O)=O)(O)=O,4,1,0,1,29,4.7e-05
G5,C(C1C(CC(C1O)CC(O)=O)=O)=O,8,3,0,3,18,0.000143
G5,C1(C(CC(C1C=O)O)CC(O)=O)=O,8,2,0,2,18,9.499999999999999e-05
G5,C(CC1C(CC(C1C=O)O)=O)(O)=O,8,2,0,2,18,9.499999999999999e-05
G5,C(CCC1C(CC(C1O)=O)=O)(O)=O,4,3,0,3,18,0.000143
G5,C(CCC1C(C(CC1O)=O)=O)(O)=O,4,3,0,3,18,0.000143
G5,C1(CC(C(C=O)=O)C(C(C1)O)O)=O,8,2,0,2,0,9.499999999999999e-05
G5,C(C(C1C(C(CC(C1)=O)O)=O)O)=O,8,2,0,2,0,9.6e-05
G5,C(C(C1C(C=O)(CC(C1)=O)O)O)=O,8,2,0,2,0,9.6e-05
G5,C1(C(C(C(C1)O)O)CC(C=O)=O)=O,8,2,0,2,0,9.499999999999999e-05
G5,C(C(C1C(CC(C(C1)=O)O)=O)O)=O,8,2,0,2,0,9.6e-05
G5,C1(CC(C=O)(CC1C(C=O)O)O)=O,8,1,0,1,0,4.7e-05
G5,C(C(C1C(C=O)C(C(C1)=O)O)O)=O,16,3,0,3,0,0.000144
G5,C(C1C(C(CC(C(C1)=O)=O)O)O)=O,8,2,0,2,0,9.499999999999999e-05
G5,C(C(C1C(CC(C(C1)=O)=O)O)O)=O,8,2,0,2,0,9.6e-05
G5,C(CC1C(C(CC(C1O)O)=O)=O)=O,8,2,0,2,46,9.499999999999999e-05
G5,C(C(C1C(C(CC(C1)O)=O)=O)O)=O,8,1,0,1,46,4.7e-05
G5,C(C1C(C(C(C=O)C(C1)=O)O)O)=O,16,3,0,3,0,0.00014199999999999998
G5,C1(CC(C(C1C=O)O)C(C=O)O)=O,16,3,0,3,0,0.000143
G5,C1(C(C(C(C1C=O)O)O)CC=O)=O,16,3,0,3,0,0.00014199999999999998
G5,C1(C(CC(C1C=O)O)C(C=O)O)=O,16,2,0,2,0,9.499999999999999e-05
G5,C(C(C1C(CC(C1C=O)O)=O)O)=O,16,2,0,2,0,9.6e-05
G5,C1(CCC(C(C1C(C=O)=O)O)O)=O,8,3,0,3,0,0.00014199999999999998
G5,C(C(CC1C(CC(C1O)=O)=O)O)=O,8,2,0,2,0,9.6e-05
G5,C(C1C(C(CCC(C1O)O)=O)=O)=O,8,3,0,3,0,0.00014199999999999998
G5,C(C(CC1C(C(CC1O)=O)=O)O)=O,8,2,0,2,0,9.6e-05
G5,C1(C(C(CO)(C(CC1)O)O)O)=O,8,4,0,4,7,0.00020099999999999998
G5,C1(C(C(CO)(CCC1O)O)O)=O,8,2,0,2,7,9.499999999999999e-05
G5,C(C(C1CC(C(C1O)O)O)=O)=O,16,3,0,3,0,0.00014199999999999998
G5,C1(C(C(C(CC1)(CO)O)O)O)=O,8,3,0,3,7,0.00014199999999999998
G5,C1(C(C(C(C(CC1)O)O)O)O)=O,16,3,0,3,7,0.00014199999999999998
G5,C(CO)(C1C(C(C(C1)O)O)O)=O,16,2,0,2,29,9.499999999999999e-05
G5,C(C1C(C(C(C1C=O)O)O)O)=O,10,3,0,3,29,0.00014199999999999998
G5,C(C1CC(C(C1C(CO)=O)O)=O)=O,8,1,0,1,45,4.7e-05
G5,C(C1CC(C(C(C(C1)=O)O)O)=O)=O,3,3,0,3,45,0.00014199999999999998
G5,C(C1CC(C=O)(C(C(C1)=O)O)O)=O,8,3,0,3,45,0.00014199999999999998
G5,C1(C(C(C(CC(C=O)=O)C1)O)O)=O,8,3,0,3,45,0.000143
G5,C(C1C(C(CC1C(CO)=O)=O)O)=O,8,1,0,1,12,4.7e-05
G5,C(CC1C(C(C(C(C1)=O)O)O)=O)=O,8,3,0,3,12,0.00014199999999999998
G5,C(CC1C(C(C(C=O)(C1)O)O)=O)=O,8,3,0,3,12,0.00014199999999999998
G5,C1(C(CC(C1O)O)CC(C=O)=O)=O,8,2,0,2,12,9.499999999999999e-05
G5,C1(C(C(C(C=O)=O)CC1)O)=O,4,3,0,3,45,0.00014199999999999998
G5,C1(C(C(C(CCC1)=O)O)O)=O,3,3,0,3,7,0.00014199999999999998
G5,C(CO)(C1CCC(C1O)=O)=O,4,3,0,3,7,0.00014199999999999998
G5,C(C1(CCCC(C1O)=O)O)=O,4,4,0,4,7,0.00018999999999999998
G5,C1(CC(C(C=O)=O)C(C(C)=O)C1O)=O,8,1,0,1,45,4.7e-05
G5,C1(CC(C(CC(C(C=O)=O)C1)=O)O)=O,4,2,0,2,45,9.499999999999999e-05
G5,C(C1(CC(C(C=O)=O)CC(C1)=O)O)=O,4,2,0,2,45,9.499999999999999e-05
G5,C1(CC(C(C(C1)CC(C=O)=O)=O)O)=O,4,2,0,2,45,9.499999999999999e-05
G5,C(C1(C(CC(C1)=O)CC(C=O)=O)O)=O,4,2,0,2,45,9.499999999999999e-05
G5,C1(CC(C(C)=O)C(C(C=O)=O)C1O)=O,8,2,0,2,45,9.499999999999999e-05
G5,C1(CC(C(CC1O)=O)CC(C=O)=O)=O,4,3,0,3,45,0.000143
G5,C(C1(CC(C(C1)=O)CC(C=O)=O)O)=O,4,2,0,2,45,9.499999999999999e-05
G5,C(CC1C(C(C=O)=O)C(C(C1)=O)O)=O,8,4,0,4,45,0.00018999999999999998
G5,C(C1C(CC(C1O)=O)CC(C=O)=O)=O,8,4,0,4,45,0.00019099999999999998
G5,C(C1CC(C(C1C(C(C)=O)=O)O)=O)=O,8,1,0,1,45,4.7e-05
G5,C(C1CC(C(CC(C(C1)=O)=O)O)=O)=O,4,2,0,2,45,9.499999999999999e-05
G5,C(C1CC(C=O)(CC(C(C1)=O)=O)O)=O,4,2,0,2,45,9.499999999999999e-05
G5,C(C(CC1C(CC(C(C1)=O)=O)O)=O)=O,4,2,0,2,45,9.499999999999999e-05
G5,C1(CC(C=O)C(C(C=O)=O)C1(C)O)=O,8,2,0,2,45,9.499999999999999e-05
G5,C(C1C(C(CC1C(C(C)=O)=O)=O)O)=O,8,1,0,1,45,4.7e-05
G5,C(CC1C(C(CC(C(C1)=O)O)=O)=O)=O,4,2,0,2,45,9.499999999999999e-05
G5,C(C1(CC(C(C(C1)=O)=O)CC=O)O)=O,4,2,0,2,45,9.499999999999999e-05
G5,C1(C(C(CC(C1)O)CC(C=O)=O)=O)=O,4,1,0,1,45,4.7e-05
G5,C(CC(C1C(C(CC1C=O)=O)O)=O)=O,8,1,0,1,45,4.7e-05
G5,C(C1C(CC(C=O)CC(C1O)=O)=O)=O,8,3,0,3,45,0.00014199999999999998
G5,C(C1CC(C=O)(C(C=O)C(C1)=O)O)=O,8,3,0,3,45,0.00014199999999999998
G5,C(C1C(CC(C1O)CC(C=O)=O)=O)=O,8,3,0,3,45,0.000143
G5,C1(CC(C=O)C(C(C=O)=O)C(C1)O)=O,8,2,0,2,45,9.499999999999999e-05
G5,C(CC(C1CC(C(C1C=O)O)=O)=O)=O,8,1,0,1,45,4.7e-05
G5,C(C1C(C(CC=O)CC(C1O)=O)=O)=O,8,3,0,3,45,0.00014199999999999998
G5,C(C1(CC(C(C1C=O)=O)CC=O)O)=O,8,3,0,3,45,0.00014199999999999998
G5,C1(C(CC(C1C=O)O)CC(C=O)=O)=O,8,2,0,2,45,9.499999999999999e-05
G5,C(CC1C(CC(C1C(C=O)=O)O)=O)=O,8,2,0,2,45,9.499999999999999e-05
G5,C(C1(CCC(C=O)C(C1O)=O)O)=O,8,2,0,2,7,9.499999999999999e-05
G5,C1(C(CC(C(C=O)=O)C(C1)O)O)=O,8,1,0,1,7,4.7e-05
G5,C1(C(CCC(C(C1C=O)O)=O)O)=O,8,3,0,3,7,0.00014199999999999998
G5,C1(C(CCC(C=O)(C1C=O)O)O)=O,8,2,0,2,7,9.499999999999999e-05
G5,C1(C(C(C(C(CO)=O)CC1)O)O)=O,8,4,0,4,7,0.00018999999999999998
G5,C(C1C(C(C(CO)(CC1)O)O)=O)=O,8,2,0,2,7,9.499999999999999e-05
G5,C(CC1C(C(C(C1C=O)=O)O)O)=O,16,3,0,3,55,0.00014199999999999998
G5,C1(C(C(CC(C=O)C1C=O)O)O)=O,16,2,0,2,55,9.499999999999999e-05
G5,C1(C(C(C=O)C(C=O)C(C1)O)O)=O,16,2,0,2,43,9.499999999999999e-05
G5,C(CC1C(C(C=O)C(C1O)=O)O)=O,16,3,0,3,43,0.00014199999999999998
G5,C(C1CC(C(C=O)C(C1O)=O)O)=O,16,2,0,2,43,9.499999999999999e-05
G5,C1(CC(C(CCC1(C=O)O)=O)O)=O,4,2,0,2,1,9.499999999999999e-05
G5,C(C1(CCC(C=O)(C(C1)=O)O)O)=O,4,1,0,1,1,4.7e-05
G5,C(C1CCC(C1O)=O)(C(C=O)O)=O,8,2,0,2,1,9.499999999999999e-05
G5,C1(C(C(C(C(C)=O)(CC1)O)O)O)=O,8,3,0,3,1,0.00014199999999999998
G5,C(C1(CCC(C(C1(C)O)O)=O)O)=O,8,3,0,3,1,0.00014199999999999998
G5,C(C1(C(CC(CO)(CC1)O)=O)O)=O,4,1,0,1,1,4.7e-05
G5,C1(C(C(C(C(CCC1)=O)O)O)O)=O,3,3,0,3,7,0.00014199999999999998
G5,C1(C(C(CCC1)(C(C=O)O)O)O)=O,8,3,0,3,7,0.00014199999999999998
G5,C(C1(C(CC(C1CC=O)O)=O)O)=O,8,2,0,2,1,9.499999999999999e-05
G5,C1(CC(CC(C=O)C1(C=O)O)O)=O,8,1,0,1,1,4.7e-05
G5,C(C1CCC(C1O)=O)(C(CO)O)=O,8,2,0,2,7,9.499999999999999e-05
G5,C1(CC(C(CCC1(CO)O)=O)O)=O,4,2,0,2,7,9.499999999999999e-05
G5,C(C1(CCC(C(C1)=O)(CO)O)O)=O,4,1,0,1,7,4.7e-05
G5,C(C(C1CC(C(C1(C)O)O)O)=O)=O,16,1,0,1,20,4.7e-05
G5,C1(CC(C(CCC(C1O)O)=O)O)=O,8,2,0,2,7,9.499999999999999e-05
G5,C(C1(CCC(C(C(C1)=O)O)O)O)=O,8,1,0,1,20,4.7e-05
G5,C1(C(C(C(CO)O)(CCC1)O)O)=O,8,3,0,3,7,0.00014199999999999998
G5,C1(C(C(C)(C(CC1)(CO)O)O)O)=O,8,3,0,3,7,0.00014199999999999998
G5,C1(CC(CO)(CCC1(CO)O)O)=O,4,1,0,1,7,4.7e-05
G5,C1(C(C(C)(C(C(CC1)O)O)O)O)=O,16,3,0,3,7,0.00014199999999999998
G5,C(CO)(C1CC(C(C1(C)O)O)O)=O,16,1,0,1,7,4.7e-05
G5,C1(C(C(CCC(CO)(C1)O)O)O)=O,8,1,0,1,7,4.7e-05
G5,C1(CC(C(CC=O)C1(CO)O)O)=O,8,2,0,2,43,9.499999999999999e-05
G5,C(C1CC(CC(C1(CO)O)=O)O)=O,8,1,0,1,43,4.7e-05
G5,C(CC1C(CC(C(C1O)O)=O)O)=O,16,5,0,5,43,0.00023700000000000001
G5,C(C1C(C(C(CC(C1)O)=O)O)O)=O,16,1,0,1,43,4.7e-05
G5,C1(C(C(C(C=O)=O)CC1CO)O)=O,8,1,0,1,7,4.7e-05
G5,C1(C(C(C(C=O)=O)CC(C1)O)O)=O,8,1,0,1,7,4.7e-05
G5,C(C1(CC(CC1C(C=O)=O)O)O)=O,8,1,0,1,7,4.7e-05
G5,C1(C(C(C(C=O)=O)C(CC1)O)O)=O,8,3,0,3,7,0.00014199999999999998
G5,C(C1(CCC(C1C(C=O)=O)O)O)=O,8,2,0,2,7,9.499999999999999e-05
G5,C1(C(C(C(CCC1CO)=O)O)O)=O,8,5,0,5,7,0.00023700000000000001
G5,C(CO)(C1CC(C(C1O)=O)CO)=O,8,1,0,1,7,4.7e-05
G5,C(C1(C(CCC(C1O)=O)CO)O)=O,8,4,0,4,7,0.00018999999999999998
G5,C1(C(C(C(CCC(C1)O)=O)O)O)=O,8,5,0,5,7,0.00023700000000000001
G5,C(CO)(C1CC(CC(C1O)=O)O)=O,8,2,0,2,11,9.499999999999999e-05
G5,C(C1(CC(CCC(C1O)=O)O)O)=O,8,4,0,4,7,0.00018999999999999998
G5,C(C1(CC(CC1C(CO)=O)O)O)=O,8,1,0,1,7,4.7e-05
G5,C(C(C1C(CCC1(CO)O)O)=O)=O,8,2,0,2,7,9.499999999999999e-05
G5,C1(C(C(C=O)C(C=O)C1CO)O)=O,16,1,0,1,43,4.7e-05
G5,C(C1C(CC(C=O)(C1C=O)O)O)=O,16,2,0,2,43,9.499999999999999e-05
G5,C(C1C(C(C(C=O)=O)C(C1)O)O)=O,16,2,0,2,43,9.499999999999999e-05
G5,C1(C(CO)C(C(CCC1O)=O)O)=O,8,3,0,3,7,0.00014199999999999998
G5,C1(C(CO)C(C=O)(CCC1O)O)=O,8,2,0,2,7,9.499999999999999e-05
G5,C(C1(CCC(C(C1O)=O)CO)O)=O,8,2,0,2,7,9.499999999999999e-05
G5,C(C(C1CC(CC1(CO)O)O)=O)=O,8,1,0,1,7,4.7e-05
G5,C(CO)(C1C(CCC(C1O)=O)O)=O,8,3,0,3,7,0.00014199999999999998
G5,C(C1(CCC(CC(C1O)=O)O)O)=O,8,2,0,2,7,9.499999999999999e-05
G5,C(C1(CCC(C1C(CO)=O)O)O)=O,8,2,0,2,7,9.499999999999999e-05
G5,C1(C(C(C(CC1)O)(CCO)O)O)=O,8,3,0,3,7,0.00014199999999999998
G5,C1(C(CCC(CO)(C1CO)O)O)=O,8,2,0,2,7,9.499999999999999e-05
G5,C1(C(C(CO)(C(CC1)CO)O)O)=O,8,3,0,3,7,0.00014199999999999998
G5,C1(C(C(CO)(CCC1CO)O)O)=O,8,2,0,2,7,9.499999999999999e-05
G5,C1(C(C(CO)(CC(CC1)O)O)O)=O,8,3,0,3,7,0.00014199999999999998
G5,C(CO)(C1CC(CC1(CO)O)O)=O,8,1,0,1,7,4.7e-05
G5,C1(C(C(CO)(CCC(C1)O)O)O)=O,8,2,0,2,7,9.499999999999999e-05
G5,C(CO)(C1C(CCC1(CO)O)O)=O,8,2,0,2,7,9.499999999999999e-05
G5,C(CC1C(C(C(C1O)=O)CO)O)=O,16,3,0,3,3,0.00014199999999999998
G5,C(C1CC(C(C(C1O)=O)CO)O)=O,16,2,0,2,3,9.499999999999999e-05
G5,C1(C(CO)C(C=O)CC(C1O)O)=O,16,2,0,2,43,9.499999999999999e-05
G5,C(C1C(CC(C(C(C1)O)O)=O)O)=O,16,2,0,2,43,9.499999999999999e-05
G5,C(C1C(C(C(CO)=O)C(C1)O)O)=O,16,2,0,2,43,9.499999999999999e-05
G5,C(C1(CCC(C(C1O)O)=O)O)=O,8,3,0,3,29,0.00014199999999999998
G5,C(C1CC(CO)(C(C(C1)=O)O)O)=O,8,3,0,3,49,0.00014199999999999998
G5,C1(C(C(C(C1)CC(CO)=O)O)O)=O,8,4,0,4,49,0.00018999999999999998
G5,C(C1C(C(C)(C(C(C1)=O)O)O)O)=O,16,3,0,3,49,0.00014199999999999998
G5,C1(C(C(C(C1)O)CC(CO)=O)O)=O,8,3,0,3,7,0.00014199999999999998
G5,C1(C(C(C(C(C(C)=O)O)C1)O)O)=O,16,3,0,3,49,0.000143
G5,C(C1CC(CO)(CC(C1O)=O)O)=O,8,1,0,1,49,4.7e-05
G5,C1(C(C(C(C)(C1O)O)O)CC=O)=O,16,3,0,3,11,0.00014199999999999998
G5,C1(C(CC(C1O)O)C(C(C)=O)O)=O,16,2,0,2,11,9.499999999999999e-05
G5,C(CC1C(CO)(CC(C1O)=O)O)=O,8,2,0,2,49,9.499999999999999e-05
G5,C1(CC(C(CCC1O)=O)O)=O,4,2,0,2,7,9.499999999999999e-05
G5,C(C1(CCC(C(C1)=O)O)O)=O,4,1,0,1,7,4.7e-05
G5,C1(C(C(CO)(CCC1)O)O)=O,4,3,0,3,7,0.00014199999999999998
G5,C1(C(C(C)(C(CC1)O)O)O)=O,8,3,0,3,7,0.00014199999999999998
G5,C1(C(CCC(CO)(C1)O)O)=O,4,1,0,1,7,4.7e-05
G5,C(C1(CC(C(C=O)=O)C(C1)O)O)=O,8,1,0,1,7,4.7e-05
G5,C1(C(C(C=O)C(C=O)(CC1)O)O)=O,8,3,0,3,7,0.00014199999999999998
G5,C(C1(CCC(C=O)(C1C=O)O)O)=O,3,2,0,2,7,9.499999999999999e-05
G5,C(C1CC(C(C=O)=O)C(C1O)O)=O,16,1,0,1,7,4.7e-05
G5,C(C1CC(C(CO)=O)C(C1O)O)=O,16,1,0,1,7,4.7e-05
G5,C1(C(C(C(CC1)C(C=O)O)O)O)=O,16,3,0,3,7,0.00014199999999999998
G5,C(C1C(CC(C=O)C1(C=O)O)O)=O,16,2,0,2,43,9.499999999999999e-05
G5,C(C1C(C(C(C=O)C1C=O)O)O)=O,10,1,0,1,43,4.7e-05
G5,C1(C(C(CC1C(CO)O)O)O)=O,16,3,0,3,46,0.00014199999999999998
G5,C1(CC(C(C(C1)O)=O)C(CO)O)=O,8,2,0,2,46,9.499999999999999e-05
G5,C(C1(C(C(CO)O)CC(C1)=O)O)=O,8,2,0,2,46,9.499999999999999e-05
G5,C1(CC(C(CC1C(CO)O)=O)O)=O,8,2,0,2,46,9.499999999999999e-05
G5,C(C1(CC(C(C1)=O)C(CO)O)O)=O,8,1,0,1,46,4.7e-05
G5,C1(C(CC(C(C1)O)C(CO)O)=O)=O,8,2,0,2,46,9.499999999999999e-05
G5,C1(C(CC(CC1C(CO)O)O)=O)=O,8,1,0,1,46,4.7e-05
G5,C(C1C(CC(C1O)C(CO)O)=O)=O,16,3,0,3,46,0.000143
G5,C(C1C(C(CC1O)C(CO)O)=O)=O,16,2,0,2,46,9.499999999999999e-05
G5,C1(C(C(CO)O)C(C=O)C(C1)O)=O,16,2,0,2,46,9.499999999999999e-05
G5,C1(C(CC(CO)O)C(C(C1)=O)O)=O,8,2,0,2,46,9.499999999999999e-05
G5,C1(C(CC(C1CC(CO)O)O)=O)=O,8,2,0,2,46,9.499999999999999e-05
G5,C1(C(C(C(C(C(O)=O)O)C1)O)O)=O,16,5,0,5,33,0.00024900000000000004
G5,C1(C(CC(C1O)O)C(C(O)=O)O)=O,16,2,0,2,33,9.499999999999999e-05
G5,C1(C(CC(C1C(C)(C)O)O)O)=O,8,2,0,2,45,9.499999999999999e-05
G5,C(C)(CC1(CC(CC1O)O)O)=O,8,1,0,1,45,4.8e-05
G5,C1(C(C(CC1O)O)C(C=C)O)=O,16,2,0,2,45,9.499999999999999e-05
G5,C1(C(C(CC1O)O)C(C=CC)O)=O,32,2,0,2,45,9.499999999999999e-05
G5,C1(C(CC(C1C(CC=C)O)O)O)=O,16,2,0,2,45,9.499999999999999e-05
G5,C(C(C=C)C1(CC(CC1O)O)O)=O,16,1,0,1,45,4.8e-05
G5,C(C)(CC1(C(C(CC1O)O)O)O)=O,16,1,0,1,2,4.8e-05
G5,C1(CC(C(C1C(C)(C)O)=O)O)=O,4,2,0,2,26,9.499999999999999e-05
G5,C1(C(C(C)(C)O)C(C(C1)=O)O)=O,4,2,0,2,26,9.499999999999999e-05
G5,C1(CC(C(C1)(CC(C)=O)O)O)=O,4,1,0,1,26,4.8e-05
G5,C1(C(CC(C1)(CC(C)=O)O)O)=O,4,1,0,1,26,4.8e-05
G5,C1(CC(C(C1C2(C=COC2)O)=O)O)=O,8,2,0,2,26,9.499999999999999e-05
G5,C1(C(C(C(C1)=O)C2(C=COC2)O)O)=O,8,2,0,2,26,9.499999999999999e-05
G5,C1(CC(C(C2C(C=CO2)=O)(C1)O)O)=O,8,2,0,2,26,9.499999999999999e-05
G5,C1(C(CC(C2C(C=CO2)=O)(C1)O)O)=O,8,2,0,2,26,9.499999999999999e-05
G5,C1(CC(C(C1C(C=C)O)=O)O)=O,8,2,0,2,26,9.499999999999999e-05
G5,C1(C(C(C(C1)=O)C(C=C)O)O)=O,8,2,0,2,26,9.499999999999999e-05
G5,C1(C(CC(C1C(C=CC)O)=O)O)=O,16,2,0,2,26,9.499999999999999e-05
G5,C1(C(C(C(C1)=O)C(C=CC)O)O)=O,16,2,0,2,26,9.499999999999999e-05
G5,C1(CC(C(C1C(CC=C)O)=O)O)=O,8,2,0,2,26,9.499999999999999e-05
G5,C1(C(C(CC=C)O)C(C(C1)=O)O)=O,8,2,0,2,26,9.499999999999999e-05
G5,C(C(C=C)C1(C(CC(C1)=O)O)O)=O,8,1,0,1,26,4.8e-05
G5,C(C(C=C)C1(CC(C(C1)=O)O)O)=O,8,1,0,1,26,4.8e-05
G5,C1(C(CC(C1C(C)(C)O)O)=O)=O,4,2,0,2,45,9.499999999999999e-05
G5,C1(C(CC(C1)O)(CC(C)=O)O)=O,4,1,0,1,45,4.8e-05
G5,C1OCC(C=1)(C2C(C(CC2O)=O)=O)O,8,2,0,2,45,9.499999999999999e-05
G5,C1(C(CC(C1)O)(C2C(C=CO2)=O)O)=O,8,2,0,2,45,9.499999999999999e-05
G5,C=CC(C1C(C(CC1O)=O)=O)O,8,2,0,2,45,9.499999999999999e-05
G5,C(C)=CC(C1C(C(CC1O)=O)=O)O,16,2,0,2,45,9.499999999999999e-05
G5,C=CCC(C1C(C(CC1O)=O)=O)O,8,2,0,2,45,9.499999999999999e-05
G5,C(C(C=C)C1(C(CC(C1)O)=O)O)=O,8,1,0,1,45,4.8e-05
G5,C(CC1(C=CC(C1O)O)O)(C)=O,8,1,0,1,28,4.8e-05
G5,C1C(C(C(C=1)(C2C(C=CO2)=O)O)O)O,16,2,0,2,28,9.499999999999999e-05
G5,C(C(C=C)C1(C=CC(C1O)O)O)=O,16,1,0,1,28,4.8e-05
G5,C1(C=CC(C(C1C(C)(C)O)O)=O)=O,4,2,0,2,45,9.499999999999999e-05
G5,C(CC1(C=CC(CC1O)=O)O)(C)=O,4,1,0,1,45,4.8e-05
G5,C(CC1(C=CC(C(C1)O)=O)O)(C)=O,4,1,0,1,45,4.8e-05
G5,C=CC(C1C(C=CC(C1O)=O)=O)O,8,2,0,2,45,9.499999999999999e-05
G5,C(C(C1C(C=CC(C1O)=O)=O)O)=CC,16,2,0,2,45,9.499999999999999e-05
G5,C(CC(C1C(C=CC(C1O)=O)=O)O)=C,8,2,0,2,45,9.499999999999999e-05
G5,C(C(C=C)C1(C=CC(CC1O)=O)O)=O,8,1,0,1,45,4.8e-05
G5,C(C(C=C)C1(C=CC(C(C1)O)=O)O)=O,8,1,0,1,45,4.8e-05
G5,C(C1(C=CC(C1C(C)(C)O)=O)O)=O,4,2,0,2,45,9.499999999999999e-05
G5,C(C)(CC(C1(C=CC(C1)=O)O)O)=O,4,1,0,1,45,4.8e-05
G5,C(C1(C=CC(C1)(CC(C)=O)O)O)=O,4,1,0,1,45,4.8e-05
G5,C(C1(C=CC(C1C(C=C)O)=O)O)=O,8,2,0,2,45,9.499999999999999e-05
G5,C(C1(C=CC(C1C(C=CC)O)=O)O)=O,16,2,0,2,45,9.499999999999999e-05
G5,C(C1(C=CC(C1C(CC=C)O)=O)O)=O,8,2,0,2,45,9.499999999999999e-05
G5,C(C(C=C)C(C1(C=CC(C1)=O)O)O)=O,8,1,0,1,45,4.8e-05
G5,C(C1(C=CC(C1)(C(C=O)C=C)O)O)=O,8,1,0,1,45,4.8e-05
G5,C(C1C=CC(C1O)(CC(C)=O)O)=O,8,1,0,1,45,4.8e-05
G5,C(C)(CC(C1C=CC(C1O)=O)O)=O,8,1,0,1,45,4.8e-05
G5,C(C1C=CC(C1O)(C(C=O)C=C)O)=O,16,1,0,1,45,4.8e-05
G5,C(C(C=C)C(C1C=CC(C1O)=O)O)=O,16,1,0,1,45,4.8e-05
G5,C1C(C(C(C(C=1)=O)=O)C(C)(C)O)O,4,2,0,2,27,9.499999999999999e-05
G5,C1(CC(C=CC1(CC(C)=O)O)O)=O,4,1,0,1,27,4.8e-05
G5,C(CC1(C(C=CC(C1)O)=O)O)(C)=O,4,1,0,1,27,4.8e-05
G5,C=CC(C1C(C(C=CC1O)=O)=O)O,8,2,0,2,27,9.499999999999999e-05
G5,C(C(C1C(C(C=CC1O)=O)=O)O)=CC,16,2,0,2,27,9.499999999999999e-05
G5,C(CC(C1C(C(C=CC1O)=O)=O)O)=C,8,2,0,2,27,9.499999999999999e-05
G5,C(C(C=C)C1(C(CC(C=C1)O)=O)O)=O,8,1,0,1,27,4.8e-05
G5,C(C(C=C)C1(C(C=CC(C1)O)=O)O)=O,8,1,0,1,27,4.8e-05
G5,C(C1C(C=CC1(CC(C)=O)O)O)=O,8,1,0,1,45,4.8e-05
G5,C(C)(CC(C1C(C=CC1O)=O)O)=O,8,1,0,1,45,4.8e-05
G5,C(C(C=C)C1(C=CC(C1C=O)O)O)=O,16,1,0,1,45,4.8e-05
G5,C(C(C=C)C(C1C(C=CC1O)=O)O)=O,16,1,0,1,45,4.8e-05
G5,C(C(CO)C(CC(C)=O)O)(O)=O,4,3,0,3,18,0.000154
G5,C(C(C=C)C(C(C(O)=O)CO)O)=O,8,1,0,1,18,4.8e-05
G5,C(C(C(CC(C)=O)O)C(C)O)(O)=O,8,3,0,3,6,0.000154
G5,C(C(C(C(CC(C)=O)O)=O)O)(O)=O,4,4,0,4,5,0.000192
G5,C(C(C=O)C(CC(C)=O)O)(O)=O,4,7,0,7,6,0.000346
G5,C(C(C=C)C(C(C(O)=O)C=O)O)=O,8,1,0,1,17,4.8e-05
G5,C(C(C(C(O)=O)=O)C(C)(C)O)(O)=O,2,2,0,2,17,9.499999999999999e-05
G5,C(CC(C(O)=O)(CC(C)=O)O)(O)=O,2,1,0,1,17,4.8e-05
G5,C(C(C(C(O)=O)=O)C(C=C)O)(O)=O,4,2,0,2,17,9.499999999999999e-05
G5,C(C(C(C(C)=O)=O)C(C)(C)O)(O)=O,2,2,0,2,17,9.499999999999999e-05
G5,C(CC(C(CC(C)(C)O)=O)=O)(O)=O,1,1,0,1,17,4.8e-05
G5,C(CC(C(C)=O)(CC(C)=O)O)(O)=O,2,1,0,1,17,4.8e-05
G5,C(C(C)(CC(C)=O)O)(CC(O)=O)=O,2,1,0,1,17,4.8e-05
G5,C(C(C(C(C)=O)=O)C(C=C)O)(O)=O,4,2,0,2,17,9.499999999999999e-05
G5,C(CC(C(CC(C=C)O)=O)=O)(O)=O,2,1,0,1,17,4.8e-05
G5,C(C(C(CC=O)=O)C(C)(C)O)(O)=O,2,2,0,2,17,9.499999999999999e-05
G5,C(C(C(CC(O)=O)=O)C(C)(C)O)=O,2,2,0,2,17,9.499999999999999e-05
G5,C(CC(CC=O)(CC(C)=O)O)(O)=O,2,1,0,1,17,4.8e-05
G5,C(CC(CC(C)=O)O)(CC(O)=O)=O,2,3,0,3,6,0.000154
G5,C(C(C(CC=O)=O)C(C=C)O)(O)=O,4,2,0,2,17,9.499999999999999e-05
G5,C(C(C(CC(O)=O)=O)C(C=C)O)=O,4,2,0,2,17,9.499999999999999e-05
G5,C(C(C=O)C(CC(C)(C)O)=O)(O)=O,2,1,0,1,17,4.8e-05
G5,C(C(C=O)C(C)(CC(C)=O)O)(O)=O,4,3,0,3,28,0.000143
G5,C(C(C(C)=O)C(CC(C)=O)O)(O)=O,4,4,0,4,6,0.000202
G5,C(C(C=O)C(CC(C=C)O)=O)(O)=O,4,1,0,1,17,4.8e-05
G5,C(C(C(C=C)(CC(C)=O)O)O)(O)=O,4,1,0,1,17,4.8e-05
G5,C(C)(CC(C(C(CCO)O)O)O)=O,8,1,0,1,0,4.8e-05
G5,C(C)(CC(C(CO)C(CO)O)O)=O,8,2,0,2,6,0.000106
G5,C(C)(CC(C(C(C(C)O)O)O)O)=O,16,1,0,1,11,4.8e-05
G5,C(C(C(C(C(C)(C)O)O)=O)O)(O)=O,4,2,0,2,17,9.499999999999999e-05
G5,C(C(C(CO)(CC(C)=O)O)O)(O)=O,4,5,0,5,17,0.000271
G5,C(C(C(C(C(C=C)O)O)=O)O)(O)=O,8,4,0,4,27,0.000192
G5,C(C(C(C=O)=O)C(C)(C)O)(O)=O,2,2,0,2,17,9.499999999999999e-05
G5,C(CC(C(CC(C)=O)O)=O)(O)=O,2,2,0,2,0,9.499999999999999e-05
G5,C(CC(C=O)(CC(C)=O)O)(O)=O,2,3,0,3,29,0.000154
G5,C(C(C(C=O)=O)C(C=C)O)(O)=O,4,5,0,5,27,0.000239
G5,C(C(C(C=O)=O)C(C=CC)O)(O)=O,8,2,0,2,17,9.499999999999999e-05
G5,C(C(C(C=O)=O)C(CC=C)O)(O)=O,4,2,0,2,17,9.499999999999999e-05
G5,C(C(C=C)C(C(CC(O)=O)=O)O)=O,4,2,0,2,29,0.000106
G5,C(C(C=C)C(C=O)(CC(O)=O)O)=O,4,1,0,1,17,4.8e-05
G5,C(C(C=O)C(C(CC(C)=O)O)O)=O,4,4,0,4,27,0.00019099999999999998
G5,C(C(C=O)C(C(CO)CO)O)(O)=O,4,2,0,2,18,9.499999999999999e-05
G5,C(CC(C(CO)CO)O)(CCO)=O,2,1,0,1,18,4.8e-05
G5,C(C)(C(CO)C(C(CO)CO)O)=O,4,2,0,2,18,9.499999999999999e-05
G5,C(C)(CC(C(CO)CO)O)=O,2,2,0,2,18,0.000106
G5,C(OC(C=O)C(C(CO)CO)O)=O,4,2,0,2,18,9.499999999999999e-05
G5,C(C(C(C(CO)CO)O)CC=O)=O,4,1,0,1,18,4.8e-05
G5,C1OC(C(C=1)=O)C(C(CO)CO)O,4,2,0,2,18,9.499999999999999e-05
G5,C(C(C(C)C(C(CO)CO)O)=O)=O,4,1,0,1,18,4.8e-05
G5,C(C(C=C)C(C(CO)CO)O)=O,4,1,0,1,18,4.8e-05
G5,C(C)(CC(C(CO)C(C)O)O)=O,8,2,0,2,6,0.000106
G5,C(C(C=C)C(C(CO)C(C)O)O)=O,16,1,0,1,18,4.8e-05
G5,C(C(C(CO)O)=O)(CC(C)(C)O)=O,2,1,0,1,0,4.8e-05
G5,C(C)(C(C(CO)O)(CC(C)=O)O)=O,4,1,0,1,0,4.8e-05
G5,C(C(C)(CC(C)=O)O)(C(CO)O)=O,4,1,0,1,0,4.8e-05
G5,C=CC(CC(C(C(CO)O)=O)=O)O,4,1,0,1,0,4.8e-05
G5,C(C(C(C(C)(C)O)O)=O)(CCO)=O,2,2,0,2,2,9.499999999999999e-05
G5,C(C(CO)=O)(C(CO)C(C)(C)O)=O,2,2,0,2,2,9.499999999999999e-05
G5,C(C(CO)(CC(C)=O)O)(CCO)=O,2,1,0,1,2,4.8e-05
G5,C(CO)(C(CCO)(CC(C)=O)O)=O,2,3,0,3,26,0.000154
G5,C=CC(C(C(C(CCO)=O)=O)O)O,4,2,0,2,2,9.499999999999999e-05
G5,C=CC(C(C(C(CO)=O)=O)CO)O,4,2,0,2,2,9.499999999999999e-05
G5,C(C)(CC(C(CO)O)(C(C)O)O)=O,8,1,0,1,2,4.8e-05
G5,C(C(C=O)C(C(C=O)CO)O)(O)=O,8,6,0,6,18,0.000288
G5,C(C(CO)C(CC(CCO)=O)O)=O,4,4,0,4,2,0.000193
G5,C(C(CO)C(C(C(C)=O)CO)O)=O,8,6,0,6,18,0.00029
G5,C(C(CO)C(C(C=O)OC=O)O)=O,8,2,0,2,18,9.499999999999999e-05
G5,C(C(CO)C(C(C=O)CC=O)O)=O,8,6,0,6,18,0.00029
G5,C(C(CO)C(C1C(C=CO1)=O)O)=O,8,2,0,2,18,9.499999999999999e-05
G5,C(C(CO)C(C(C(C=O)=O)C)O)=O,8,3,0,3,49,0.000143
G5,C(C(C=C)C(C(C=O)CO)O)=O,8,1,0,1,18,4.8e-05
G5,C(CC(C(C(C=O)CO)=O)O)(C)=O,4,2,0,2,26,9.499999999999999e-05
G5,C(C(C)=O)(C(CO)C(C)(C)O)=O,2,2,0,2,14,9.499999999999999e-05
G5,C(C(CCO)=O)(CC(C)(C)O)=O,1,1,0,1,14,4.8e-05
G5,C(C)(C(CCO)(CC(C)=O)O)=O,2,1,0,1,14,4.8e-05
G5,C(C(C)(CC(C)=O)O)(CCO)=O,2,1,0,1,14,4.8e-05
G5,C=CC(C(C(C(C)=O)=O)CO)O,4,2,0,2,14,9.499999999999999e-05
G5,C=CC(CC(C(CCO)=O)=O)O,2,2,0,2,18,9.499999999999999e-05
G5,C(C)=CC(C(C(C(C)=O)=O)CO)O,8,2,0,2,14,9.499999999999999e-05
G5,C(C)=CC(CC(C(CCO)=O)=O)O,4,1,0,1,14,4.8e-05
G5,C(CC(C(C(C(C)=O)=O)CO)O)=C,4,2,0,2,14,9.499999999999999e-05
G5,C=CCC(CC(C(CCO)=O)=O)O,2,1,0,1,14,4.8e-05
G5,C(C(C=C)C(C(C)=O)(CCO)O)=O,4,1,0,1,14,4.8e-05
G5,C(C(C=C)C(C(CCO)=O)(C)O)=O,4,1,0,1,14,4.8e-05
G5,C(CC(C(CO)C(C)(C)O)=O)=O,2,2,0,2,2,9.499999999999999e-05
G5,C(C(C(CCO)=O)C(C)(C)O)=O,2,2,0,2,2,9.499999999999999e-05
G5,C(CC(CCO)(CC(C)=O)O)=O,2,3,0,3,4,0.000144
G5,C(CCO)(CC(CC(C)=O)O)=O,2,3,0,3,6,0.000154
G5,C(C(CO)C(C=C)O)(CC=O)=O,4,2,0,2,2,9.499999999999999e-05
G5,C(CCO)(C(C=O)C(C=C)O)=O,4,2,0,2,2,9.499999999999999e-05
G5,C(C(CO)C(C=CC)O)(CC=O)=O,8,2,0,2,2,9.499999999999999e-05
G5,C(CCO)(C(C=O)C(C=CC)O)=O,8,2,0,2,2,9.499999999999999e-05
G5,C(C(CO)C(CC=C)O)(CC=O)=O,4,2,0,2,2,9.499999999999999e-05
G5,C(C(C(CCO)=O)C(CC=C)O)=O,4,2,0,2,2,9.499999999999999e-05
G5,C(C(C=C)C(CCO)(CC=O)O)=O,4,1,0,1,2,4.8e-05
G5,C(C(C=C)C(CC(CCO)=O)O)=O,4,1,0,1,2,4.8e-05
G5,C(C(C(CC(C)(C)O)=O)CO)=O,2,1,0,1,6,4.8e-05
G5,C(C(CO)C(C)(CC(C)=O)O)=O,4,4,0,4,28,0.00019099999999999998
G5,C(C)(C(CO)C(CC(C)=O)O)=O,4,4,0,4,28,0.000202
G5,C(CC(C=C)O)(C(C=O)CO)=O,4,1,0,1,6,4.8e-05
G5,C(CC(C=CC)O)(C(C=O)CO)=O,8,1,0,1,6,4.8e-05
G5,C(C(C(CC(CC=C)O)=O)CO)=O,4,1,0,1,6,4.8e-05
G5,C(C(C=C)C(C)(C(C=O)CO)O)=O,8,1,0,1,6,4.8e-05
G5,C(C(C=C)C(C(C(C)=O)CO)O)=O,8,1,0,1,6,4.8e-05
G5,C1(C(C(C)(C)O)OC(C1CO)O)=O,8,2,0,2,27,9.499999999999999e-05
G5,C(C)(CC1(COC(C1CO)O)O)=O,8,1,0,1,27,4.8e-05
G5,C1(C(C(C=C)O)OC(C1CO)O)=O,16,2,0,2,27,9.499999999999999e-05
G5,C1(C(CO)OC(C1C(C)(C)O)O)=O,8,2,0,2,27,9.499999999999999e-05
G5,C(C)(CC1(C(CO)OC(C1)O)O)=O,8,3,0,3,27,0.000154
G5,C1(C(CO)OC(C1C(C=C)O)O)=O,16,2,0,2,27,9.499999999999999e-05
G5,C(CC(C=C)(C(CO)O)O)(C)=O,4,1,0,1,7,4.8e-05
G5,C(C(C=C)C(C=C)(C(CO)O)O)=O,8,1,0,1,7,4.8e-05
G5,C(C)(CC1(C(CO)OCC1O)O)=O,8,1,0,1,27,4.8e-05
G5,C(C)(CC1(C(O)OCC1CO)O)=O,8,1,0,1,34,4.8e-05
G5,C(C(C(CCO)O)C(C)(C)O)=O,4,2,0,2,18,9.499999999999999e-05
G5,C(C)(CC(CC(CCO)O)O)=O,4,1,0,1,18,4.8e-05
G5,C(C(C(CCO)O)C(C=C)O)=O,8,2,0,2,18,9.499999999999999e-05
G5,C(C(C(CCO)O)C(C=CC)O)=O,16,2,0,2,18,9.499999999999999e-05
G5,C(C(C(CC=C)O)C(CCO)O)=O,8,2,0,2,18,9.499999999999999e-05
G5,C(C(C=C)C(CC(CCO)O)O)=O,8,1,0,1,18,4.8e-05
G5,C(C(C(CC(C)O)O)C(C)(C)O)=O,8,2,0,2,28,9.499999999999999e-05
G5,C(C)(CC(CC(CC(C)O)O)O)=O,8,1,0,1,28,4.8e-05
G5,C(C(C(CC(C)O)O)C(C=C)O)=O,16,2,0,2,28,9.499999999999999e-05
G5,C(C)(CC(C(C(C)O)C(C)O)O)=O,6,1,0,1,4,4.8e-05
G5,C(C(C(C(C)O)O)(CC(C)=O)O)=O,8,2,0,2,0,9.6e-05
G5,C(CC(C(C(C(C)O)O)=O)O)(C)=O,8,4,0,4,5,0.000193
G5,C(C(C(CC=O)O)C(C)(C)O)=O,4,2,0,2,45,9.499999999999999e-05
G5,C(CC(CC(CC(C)=O)O)O)=O,4,2,0,2,45,9.6e-05
G5,C(CC(C(C=O)C(C=C)O)O)=O,8,2,0,2,45,9.499999999999999e-05
G5,C(CC(C(C=O)C(C=CC)O)O)=O,16,2,0,2,45,9.499999999999999e-05
G5,C(C(C(CC=C)O)C(CC=O)O)=O,8,2,0,2,45,9.499999999999999e-05
G5,C(C(C=C)C(CC(CC=O)O)O)=O,8,1,0,1,45,4.8e-05
G5,C(C(C=C)C(C(C=O)C(C)O)O)=O,16,1,0,1,4,4.8e-05
G5,C(C(C(C)(C)O)C(C(O)=O)(C)O)=O,4,2,0,2,28,9.499999999999999e-05
G5,C(C(C)(CC(CC(C)=O)O)O)(O)=O,4,2,0,2,14,0.000106
G5,C(C(C)(C(C=O)C(C=C)O)O)(O)=O,8,2,0,2,28,9.499999999999999e-05
G5,C(C(C(C(C)O)C(C)(C)O)=O)(O)=O,4,2,0,2,4,9.499999999999999e-05
G5,C(C(CC(C)O)(CC(C)=O)O)(O)=O,4,1,0,1,4,4.8e-05
G5,C=CC(C(C(C(O)=O)=O)C(C)O)O,8,2,0,2,4,9.499999999999999e-05
G5,C(C(C=O)C(CC(O)=O)O)(O)=O,4,2,0,2,28,9.6e-05
G5,C(C(C=O)C(C=O)(C(C)=O)O)(O)=O,4,4,0,4,25,0.000192
G5,C(C(C=O)C(C(C=O)=O)(C)O)(O)=O,4,2,0,2,25,9.6e-05
G5,C(CC(CC(C(C=O)=O)=O)O)(O)=O,2,1,0,1,25,4.8e-05
G5,C(C(C=O)C(C=O)(C=O)O)(O)=O,2,4,0,4,1,0.000192
G5,C(C(C=O)C(C(C=O)=O)O)(O)=O,4,2,0,2,1,9.6e-05
G5,C(C(C=O)C(C)(CCO)O)(O)=O,4,2,0,2,28,9.499999999999999e-05
G5,C(CC(CC(CCO)=O)O)(O)=O,2,1,0,1,28,4.8e-05
G5,C(CC(C(C(C)=O)CO)O)(O)=O,4,2,0,2,28,9.499999999999999e-05
G5,C(C(C=O)C(C)(C)O)(O)=O,2,2,0,2,28,9.6e-05
G5,C(CC(CC(C)=O)O)(O)=O,2,2,0,2,6,0.00010700000000000001
G5,C(OCC(C)(C(C(O)=O)C=O)O)=O,4,2,0,2,35,9.499999999999999e-05
G5,C(CC(CC(COC=O)=O)O)(O)=O,2,1,0,1,35,4.8e-05
G5,C(CC(C(C(C)=O)OC=O)O)(O)=O,4,2,0,2,35,9.499999999999999e-05
G5,C(OCC(C(C(O)=O)C=O)O)=O,4,2,0,2,28,9.499999999999999e-05
G5,C(CC(C(C=O)OC=O)O)(O)=O,4,2,0,2,28,9.499999999999999e-05
G5,C(C(C=O)C(COC(C)=O)O)(O)=O,4,2,0,2,28,9.499999999999999e-05
G5,C(CC(C(C=O)OC(C)=O)O)(O)=O,4,2,0,2,28,9.499999999999999e-05
G5,C(C(C=O)C(CCC=O)O)(O)=O,4,3,0,3,27,0.000143
G5,C(CC(C(C=O)CC=O)O)(O)=O,4,3,0,3,18,0.000154
G5,C(C(C=O)C(C=CCO)O)(O)=O,8,2,0,2,28,9.499999999999999e-05
G5,C(C(C=O)C(C(O)=O)(CO)O)(O)=O,4,6,0,6,33,0.0003
G5,C(CC(C(C(C(O)=O)=O)O)O)(O)=O,4,4,0,4,33,0.000213
G5,C(C(C=O)C(C)(CC(O)=O)O)(O)=O,4,2,0,2,6,9.499999999999999e-05
G5,C(CC(CC(CC(O)=O)O)=O)(O)=O,2,1,0,1,6,4.8e-05
G5,C(CC(C(C(O)=O)C(C)=O)O)(O)=O,4,2,0,2,6,9.499999999999999e-05
G5,C(C(C=O)C(C=CC(O)=O)O)(O)=O,8,4,0,4,18,0.000192
G5,C(C(C=O)C1(C(OCC1)=O)O)(O)=O,4,4,0,4,28,0.000192
G5,C(CC(C1C(C(OC1)=O)=O)O)(O)=O,4,2,0,2,28,9.499999999999999e-05
G5,C(C(C=O)C1(COC(C1)=O)O)(O)=O,4,2,0,2,28,9.499999999999999e-05
G5,C(CC(C1C(OCC1=O)=O)O)(O)=O,4,2,0,2,28,9.499999999999999e-05
G5,C(CC(C1C(CC(O1)=O)=O)O)(O)=O,4,2,0,2,28,9.499999999999999e-05
G5,C(C(C=O)C(C(C=C)O)O)(O)=O,8,2,0,2,28,9.6e-05
G5,C(C(C=O)C1(C=COC1)O)(O)=O,4,2,0,2,28,9.499999999999999e-05
G5,C(CC(C1C(C=CO1)=O)O)(O)=O,4,2,0,2,28,9.499999999999999e-05
G5,C(C(C=O)C(C(O)=O)(C=C)O)(O)=O,4,5,0,5,7,0.00025
G5,C(C(C=O)C(C(C)(CO)O)O)(O)=O,8,2,0,2,11,9.499999999999999e-05
G5,C(C(C=O)C(C(CC)=O)(C)O)(O)=O,4,2,0,2,28,9.499999999999999e-05
G5,C(C(C=O)C(C(C)=O)(CC)O)(O)=O,4,2,0,2,28,9.499999999999999e-05
G5,C(CC(CC(C(CC)=O)=O)O)(O)=O,2,1,0,1,28,4.8e-05
G5,C(CC(C(C(C(C)=O)=O)C)O)(O)=O,4,1,0,1,28,4.8e-05
G5,C(CC(CC(CC(C)=O)=O)O)(O)=O,2,1,0,1,28,4.8e-05
G5,C(CC(C(C(C)=O)C(C)=O)O)(O)=O,2,2,0,2,28,9.499999999999999e-05
G5,C(C(C=O)C(C(C)CC=O)O)(O)=O,8,3,0,3,28,0.000143
G5,C(C(C=O)C(CC(C=O)C)O)(O)=O,8,2,0,2,28,9.499999999999999e-05
G5,C(CC(C(C=O)C(C=O)C)O)(O)=O,8,2,0,2,18,9.499999999999999e-05
G5,C(C(C=O)C(C(CC)=O)O)(O)=O,4,2,0,2,28,9.499999999999999e-05
G5,C(C(C=O)C(C=O)(CC)O)(O)=O,4,2,0,2,28,9.499999999999999e-05
G5,C(CC(C(C(C=O)=O)C)O)(O)=O,4,1,0,1,28,4.8e-05
G5,C(C(C=O)C(C(C=O)C=O)O)(O)=O,4,6,0,6,45,0.000288
G5,C(C(C=O)C(C(O)=O)(CC)O)(O)=O,4,2,0,2,28,9.499999999999999e-05
G5,C(CC(C(C(C(O)=O)=O)C)O)(O)=O,4,1,0,1,28,4.8e-05
G5,C(C(C=O)C(C(C=CC)=O)O)(O)=O,8,2,0,2,28,9.499999999999999e-05
G5,C(C(C=O)C(C=O)(C=CC)O)(O)=O,8,2,0,2,28,9.499999999999999e-05
G5,C(C(C=O)C(C(CC=C)=O)O)(O)=O,4,2,0,2,28,9.499999999999999e-05
G5,C(C(C=O)C(C=O)(CC=C)O)(O)=O,4,2,0,2,28,9.499999999999999e-05
G5,C(CC(C(C=C)C(C=O)=O)O)(O)=O,4,2,0,2,29,0.000106
G5,C(C(C=O)C(C=CC=O)(C)O)(O)=O,8,2,0,2,28,9.499999999999999e-05
G5,C(C(C=O)C(C=CC(C)=O)O)(O)=O,8,2,0,2,28,9.499999999999999e-05
G5,C(CC(CC(C=CC=O)=O)O)(O)=O,4,2,0,2,29,0.000106
G5,C(C(C=O)C(C(CC=O)=C)O)(O)=O,4,2,0,2,28,9.499999999999999e-05
G5,C(C(C=O)C(CC(C=O)=C)O)(O)=O,4,2,0,2,28,9.499999999999999e-05
G5,C(C(C(C=O)=C)C(CC(O)=O)O)=O,4,1,0,1,28,4.8e-05
G5,C(C(C=O)C(C(C)=CC=O)O)(O)=O,8,2,0,2,28,9.499999999999999e-05
G5,C(C(C=O)C(C=C(C=O)C)O)(O)=O,8,2,0,2,28,9.499999999999999e-05
G5,C(C(C=O)C(C=C)O)(O)=O,4,2,0,2,28,9.499999999999999e-05
G5,C(C(C=O)C(C=CC)(CO)O)(O)=O,8,2,0,2,28,9.499999999999999e-05
G5,C(CC(C(C(C=CC)=O)O)O)(O)=O,8,2,0,2,28,9.499999999999999e-05
G5,C(C(C=O)C(CO)(CC=C)O)(O)=O,4,2,0,2,28,9.499999999999999e-05
G5,C(CC(C(C(CO)=O)C=C)O)(O)=O,4,1,0,1,28,4.8e-05
G5,C(CC(C(C(CC=C)=O)O)O)(O)=O,4,2,0,2,28,9.499999999999999e-05
G5,C(C(C=O)C(C)(C(C=C)O)O)(O)=O,8,2,0,2,28,9.499999999999999e-05
G5,C(CC(CC(C(C=C)O)=O)O)(O)=O,4,1,0,1,28,4.8e-05
G5,C(C(C=O)C(CC(CO)=C)O)(O)=O,4,2,0,2,28,9.499999999999999e-05
G5,C(CC(C(C=O)C(CO)=C)O)(O)=O,4,1,0,1,28,4.8e-05
G5,C(C(C=O)C(C=C(C)CO)O)(O)=O,8,2,0,2,28,9.499999999999999e-05
G5,C(C(C=O)C(C=CC)O)(O)=O,8,2,0,2,28,9.499999999999999e-05
G5,C(C(C=O)C(CC=C)O)(O)=O,4,2,0,2,28,9.499999999999999e-05
G5,C(C(C=C)C(CC(O)=O)O)=O,4,1,0,1,28,4.8e-05
G5,C(C(C=O)C(C=CCC=O)O)(O)=O,8,2,0,2,28,9.499999999999999e-05
G5,C(C(C=O)C(CC=CC=O)O)(O)=O,8,2,0,2,28,9.499999999999999e-05
G5,C(C(C=CC=O)C(CC(O)=O)O)=O,8,1,0,1,28,4.8e-05
G5,C(C(C(C)(C)O)C(C(C)=O)(C)O)=O,4,2,0,2,14,9.499999999999999e-05
G5,C(C(C)(CC=O)O)(CC(C)(C)O)=O,2,1,0,1,14,4.8e-05
G5,C(C)(C(C)(CC(CC(C)=O)O)O)=O,4,1,0,1,14,4.8e-05
G5,C(CC(C)(C(C)(CC(C)=O)O)O)=O,4,1,0,1,14,4.8e-05
G5,C(C)(C(C)(C(C=O)C(C=C)O)O)=O,8,2,0,2,14,9.499999999999999e-05
G5,C(CC(C=C)O)(C(C)(CC=O)O)=O,4,1,0,1,14,4.8e-05
G5,C(C(C)=O)(C(C(C)O)C(C)(C)O)=O,4,2,0,2,4,9.499999999999999e-05
G5,C(C(CC(C)(C)O)=O)(CC(C)O)=O,2,1,0,1,4,4.8e-05
G5,C(C)(C(CC(C)O)(CC(C)=O)O)=O,4,1,0,1,4,4.8e-05
G5,C(C(C)(CC(C)=O)O)(CC(C)O)=O,4,1,0,1,4,4.8e-05
G5,C=CC(C(C(C(C)=O)=O)C(C)O)O,8,2,0,2,4,9.499999999999999e-05
G5,C=CC(CC(C(CC(C)O)=O)=O)O,4,1,0,1,4,4.8e-05
G5,C(C(C(C)(CC=O)O)C(C)(C)O)=O,4,2,0,2,6,9.499999999999999e-05
G5,C(CC(C)(CC(CC(C)=O)O)O)=O,4,1,0,1,6,4.8e-05
G5,C(CC(C)(C(C=O)C(C=C)O)O)=O,8,2,0,2,6,9.499999999999999e-05
G5,C(C(C(CC(C)=O)O)C(C)(C)O)=O,4,2,0,2,6,9.499999999999999e-05
G5,C(CC(CC(CC(C)(C)O)=O)O)=O,2,1,0,1,6,4.8e-05
G5,C(CC(C(C(C)=O)C(C)(C)O)O)=O,4,2,0,2,6,9.499999999999999e-05
G5,C(C)(CC(CC(CC(C)=O)O)O)=O,3,1,0,1,6,4.8e-05
G5,C(CC(CC(C)(CC(C)=O)O)O)=O,4,1,0,1,6,4.8e-05
G5,C(C)(CC(C(C=O)C(C=C)O)O)=O,8,2,0,2,6,9.499999999999999e-05
G5,C(CC(C=C)O)(CC(CC=O)O)=O,4,1,0,1,6,4.8e-05
G5,C(C)(C(C(CC=O)O)C(C=C)O)=O,8,2,0,2,6,9.499999999999999e-05
G5,C(CC(C(C(C)O)C(C)(C)O)=O)=O,4,2,0,2,4,9.499999999999999e-05
G5,C(C(C(CC(C)O)=O)C(C)(C)O)=O,4,2,0,2,4,9.499999999999999e-05
G5,C(CC(CC(C)O)(CC(C)=O)O)=O,4,1,0,1,4,4.8e-05
G5,C(CC(C)O)(CC(CC(C)=O)O)=O,4,1,0,1,4,4.8e-05
G5,C(C(C(C)O)C(C=C)O)(CC=O)=O,8,2,0,2,4,9.499999999999999e-05
G5,C(CC(C)O)(C(C=O)C(C=C)O)=O,8,2,0,2,4,9.499999999999999e-05
G5,C(C(C(CC(C)(C)O)=O)C(C)O)=O,4,1,0,1,4,4.8e-05
G5,C(C(C(C)O)C(C)(CC(C)=O)O)=O,8,3,0,3,28,0.000143
G5,C(C)(C(C(CC(C)=O)O)C(C)O)=O,8,1,0,1,4,4.8e-05
G5,C(CC(C=C)O)(C(C=O)C(C)O)=O,8,1,0,1,4,4.8e-05
G5,C(C(C(C)(C)O)C(C(C=C)=O)O)=O,4,2,0,2,7,9.499999999999999e-05
G5,C(C)(CC(CC(C(C=C)=O)O)O)=O,4,1,0,1,7,4.8e-05
G5,C(CC(C(C=C)(CC(C)=O)O)O)=O,4,1,0,1,7,4.8e-05
G5,C(C(C(C=C)O)C(C(C=C)=O)O)=O,8,2,0,2,7,9.499999999999999e-05
G5,C(C(C(C=CC)O)C(C(C=C)=O)O)=O,16,2,0,2,7,9.499999999999999e-05
G5,C(C(C(CC=C)O)C(C(C=C)=O)O)=O,8,2,0,2,7,9.499999999999999e-05
G5,C(C(C=C)C(CC(C(C=C)=O)O)O)=O,8,1,0,1,7,4.8e-05
G5,C(CC(C(C=C)(C(C=O)C=C)O)O)=O,8,1,0,1,7,4.8e-05
G5,C(C(C=C)(C(C=O)C(C)(C)O)O)=O,4,2,0,2,7,9.499999999999999e-05
G5,C(C(C=C)(CC(CC(C)=O)O)O)=O,4,1,0,1,7,4.8e-05
G5,C(C)(CC(C(C=C)(CC=O)O)O)=O,4,1,0,1,7,4.8e-05
G5,C(C(C=C)(C(C=O)C(C=C)O)O)=O,8,2,0,2,7,9.499999999999999e-05
G5,C(C(C=C)(C(C=O)C(C=CC)O)O)=O,16,2,0,2,7,9.499999999999999e-05
G5,C(C(C=C)(C(C=O)C(CC=C)O)O)=O,8,2,0,2,7,9.499999999999999e-05
G5,C(C(C=C)C(CC(C=O)(C=C)O)O)=O,8,1,0,1,7,4.8e-05
G5,C(C(C=C)C(C(C=C)(CC=O)O)O)=O,8,1,0,1,7,4.8e-05
G5,C(C(C(C)(C)O)C(C=C)(CO)O)=O,4,2,0,2,7,9.499999999999999e-05
G5,C(C)(CC(CC(C=C)(CO)O)O)=O,4,1,0,1,7,4.8e-05
G5,C(C(C(C=C)O)C(C=C)(CO)O)=O,8,2,0,2,7,9.499999999999999e-05
G5,C(CC(C=C)(C(C(C)O)O)O)(C)=O,8,1,0,1,4,4.8e-05
G5,C(C(C(C)(C)O)C(C=CC=O)O)=O,8,2,0,2,43,9.499999999999999e-05
G5,C(C)(CC(CC(C=CC=O)O)O)=O,8,1,0,1,43,4.8e-05
G5,C(CC(C=CC(CC(C)=O)O)O)=O,8,1,0,1,43,4.8e-05
G5,C(C(C(C=C)O)C(C=CC=O)O)=O,16,2,0,2,43,9.499999999999999e-05
G5,C(C(C(C=CC)O)C(C=CC=O)O)=O,32,2,0,2,43,9.499999999999999e-05
G5,C(C(C(CC=C)O)C(C=CC=O)O)=O,16,2,0,2,43,9.499999999999999e-05
G5,C(C(C=C)C(CC(C=CC=O)O)O)=O,16,1,0,1,43,4.8e-05
G5,C(C(C=C)C(C=CC(CC=O)O)O)=O,16,1,0,1,43,4.8e-05
G5,C(C(C(C(C)O)O)C(C)(C)O)=O,8,2,0,2,11,9.499999999999999e-05
G5,C(C)(CC(CC(C(C)O)O)O)=O,8,1,0,1,11,4.8e-05
G5,C(C(C(C(C)O)O)C(C=C)O)=O,16,2,0,2,11,9.499999999999999e-05
G5,C(C(C(C(C)O)O)C(C=CC)O)=O,32,2,0,2,11,9.499999999999999e-05
G5,C(C(C(CC=C)O)C(C(C)O)O)=O,16,2,0,2,11,9.499999999999999e-05
G5,C(C(C=C)C(CC(C(C)O)O)O)=O,16,1,0,1,11,4.8e-05
G5,C(C)(C(C(C)(C)O)C(C(O)=O)O)=O,4,2,0,2,26,9.499999999999999e-05
G5,C(CC(C(O)=O)O)(CC(C)(C)O)=O,2,1,0,1,26,4.8e-05
G5,C(C(CC(C)(CC(C)=O)O)O)(O)=O,4,1,0,1,26,4.8e-05
G5,C(C(C(C(C)=O)C(C=C)O)O)(O)=O,8,2,0,2,26,9.499999999999999e-05
G5,C(C(CC(CC(C=C)O)=O)O)(O)=O,4,1,0,1,26,4.8e-05
G5,C(C(C=O)(CC(C(C=O)=O)=O)O)=O,1,1,0,1,25,4.8e-05
G5,C(C(C(CC(C(C=O)=O)=O)O)=O)=O,2,1,0,1,25,4.8e-05
G5,C(C(C(CC(C)(CCO)O)=O)=O)=O,2,1,0,1,25,4.8e-05
G5,C(C)(C(C=O)(CC(CCO)=O)O)=O,2,1,0,1,25,4.8e-05
G5,C(CC(C(C(C)=O)=O)O)(CCO)=O,2,1,0,1,25,4.8e-05
G5,C(CC(C(C=O)=O)(C)O)(CCO)=O,2,1,0,1,25,4.8e-05
G5,C(C(C(C)=O)(C(C(C)=O)CO)O)=O,4,2,0,2,25,9.499999999999999e-05
G5,C(C)(C(CO)C(C(C(C)=O)=O)O)=O,4,2,0,2,25,9.499999999999999e-05
G5,C(C)(C(CO)C(C(C=O)=O)(C)O)=O,4,2,0,2,25,9.499999999999999e-05
G5,C(C(C(CC(C)(C)O)=O)=O)=O,1,1,0,1,25,4.8e-05
G5,C(C(C(C)=O)(CC(C)=O)O)=O,2,2,0,2,11,9.499999999999999e-05
G5,C(C)(CC(C(C(C)=O)=O)O)=O,2,4,0,4,29,0.00018999999999999998
G5,C(CC(C(C=O)=O)(C)O)(C)=O,2,2,0,2,11,9.499999999999999e-05
G5,C(OCC(CC(C(C=O)=O)=O)O)=O,2,1,0,1,25,4.8e-05
G5,C(OC(C=O)C(C=O)(C(C)=O)O)=O,4,2,0,2,25,9.499999999999999e-05
G5,C(OC(C=O)C(C(C(C)=O)=O)O)=O,4,2,0,2,25,9.499999999999999e-05
G5,C(OC(C=O)C(C(C=O)=O)(C)O)=O,4,2,0,2,25,9.499999999999999e-05
G5,C(CCC(CC(C(C=O)=O)=O)O)=O,2,1,0,1,27,4.8e-05
G5,C(C(CC(C(C=O)=O)=O)O)=CCO,4,1,0,1,28,4.8e-05
G5,C=CC(C(CC(C(C=O)=O)=O)O)O,4,1,0,1,28,4.8e-05
G5,C1C(COC=1)(CC(C(C=O)=O)=O)O,2,1,0,1,25,4.8e-05
G5,C(C(C(C)=O)(C1C(C=CO1)=O)O)=O,4,2,0,2,25,9.499999999999999e-05
G5,C1OC(C(C=1)=O)C(C(C(C)=O)=O)O,4,2,0,2,25,9.499999999999999e-05
G5,C1OC(C(C=1)=O)C(C(C=O)=O)(C)O,4,2,0,2,25,9.499999999999999e-05
G5,C(C(CC(C(C=O)=O)=O)O)(CC)=O,2,1,0,1,25,4.8e-05
G5,C(C(CC)(CC(C(C=O)=O)=O)O)=O,2,1,0,1,25,4.8e-05
G5,C(C(C(C)=O)(C(C(C=O)=O)C)O)=O,4,1,0,1,25,4.8e-05
G5,C(C(C(C(C(C=O)=O)C)O)=O)(C)=O,4,1,0,1,25,4.8e-05
G5,C(C=O)(C(C)C(C(C=O)=O)(C)O)=O,4,1,0,1,25,4.8e-05
G5,C(C)=CC(C(CC(C(C=O)=O)=O)O)=O,4,1,0,1,28,4.8e-05
G5,C(C(C=CC)(CC(C(C=O)=O)=O)O)=O,4,1,0,1,28,4.8e-05
G5,C(C(CC(C(C=O)=O)=O)O)(CC=C)=O,2,1,0,1,28,4.8e-05
G5,C(C(CC(C(C=O)=O)=O)(CC=C)O)=O,2,1,0,1,28,4.8e-05
G5,C(C(C(C)=O)(C(C=C)C(C=O)=O)O)=O,4,1,0,1,28,4.8e-05
G5,C=CC(C(C=O)=O)C(C(C(C)=O)=O)O,4,1,0,1,28,4.8e-05
G5,C=CC(C(C=O)=O)C(C(C=O)=O)(C)O,4,1,0,1,28,4.8e-05
G5,C(C(C)(CC(C(C=O)=O)=O)O)=CC=O,4,1,0,1,25,4.8e-05
G5,C(C(CC(C(C=O)=O)=O)O)=CC(C)=O,4,1,0,1,25,4.8e-05
G5,C(C(C(C)=O)(CC(C=CC=O)=O)O)=O,4,1,0,1,28,4.8e-05
G5,C(C=CC(CC(C(C(C)=O)=O)O)=O)=O,4,1,0,1,25,4.8e-05
G5,C(C=O)(C(C)(CC(C=CC=O)=O)O)=O,4,1,0,1,28,4.8e-05
G5,C(CC(C(CC(C(C=O)=O)=O)O)=C)=O,2,1,0,1,28,4.8e-05
G5,C=C(C=O)CC(CC(C(C=O)=O)=O)O,2,1,0,1,28,4.8e-05
G5,C(C(C(C=O)=C)C(C=O)(C(C)=O)O)=O,4,1,0,1,28,4.8e-05
G5,C(C(C(C=O)=C)C(C(C(C)=O)=O)O)=O,4,1,0,1,28,4.8e-05
G5,C(C(C(C=O)=C)C(C(C=O)=O)(C)O)=O,4,1,0,1,28,4.8e-05
G5,C(C)(C(CC(C(C=O)=O)=O)O)=CC=O,4,1,0,1,28,4.8e-05
G5,C(C(CC(C(C=O)=O)=O)O)=C(C=O)C,4,1,0,1,28,4.8e-05
G5,C=CC(CC(C(C=O)=O)=O)O,2,1,0,1,25,4.8e-05
G5,C(C(CC(C(C=O)=O)=O)O)=CC,4,1,0,1,25,4.8e-05
G5,C=CCC(CC(C(C=O)=O)=O)O,2,1,0,1,25,4.8e-05
G5,C(C(C=C)C(C=O)(C(C)=O)O)=O,4,2,0,2,1,9.499999999999999e-05
G5,C(C(C=C)C(C(C(C)=O)=O)O)=O,4,4,0,4,29,0.00018999999999999998
G5,C(C(C=C)C(C(C=O)=O)(C)O)=O,4,2,0,2,25,9.499999999999999e-05
G5,C(CC=CC(CC(C(C=O)=O)=O)O)=O,4,1,0,1,28,4.8e-05
G5,C(CC(CC(C(C=O)=O)=O)O)=CC=O,4,1,0,1,28,4.8e-05
G5,C(C(C=CC=O)C(C=O)(C(C)=O)O)=O,8,1,0,1,28,4.8e-05
G5,C(C(C=CC=O)C(C(C(C)=O)=O)O)=O,8,1,0,1,28,4.8e-05
G5,C(C(C=CC=O)C(C(C=O)=O)(C)O)=O,8,1,0,1,28,4.8e-05
G5,C(CO)(C(C(C=O)=O)C(C)(C)O)=O,2,2,0,2,51,9.499999999999999e-05
G5,C(C(C(C)(C)O)O)(CC(C=O)=O)=O,2,2,0,2,51,9.499999999999999e-05
G5,C(C(CC(C)=O)O)(CC(CO)=O)=O,2,2,0,2,26,9.499999999999999e-05
G5,C(C)(CC(CO)(CC(C=O)=O)O)=O,2,3,0,3,45,0.000155
G5,C(CO)(C(C(C=O)=O)C(C=C)O)=O,4,2,0,2,51,9.499999999999999e-05
G5,C(C(C(C=C)O)O)(CC(C=O)=O)=O,4,2,0,2,51,9.499999999999999e-05
G5,C(CC(C)(C)O)(C(C(C=O)=O)O)=O,2,1,0,1,0,4.8e-05
G5,C(C)(C(C(C(CC(C)=O)O)=O)O)=O,4,3,0,3,25,0.000143
G5,C(C)(CC(C)(C(C(C=O)=O)O)O)=O,4,3,0,3,28,0.000143
G5,C(CC(C=C)O)(C(C(C=O)=O)O)=O,4,1,0,1,0,4.8e-05
G5,C(C(C=O)(CC(CCO)=O)O)=O,1,6,0,6,17,0.000298
G5,C(C(C=O)(C(C(C)=O)CO)O)=O,2,6,0,6,17,0.00028900000000000003
G5,C(OCC(CC(C=O)(C=O)O)=O)=O,1,1,0,1,35,4.8e-05
G5,C(OCC(CC(C(C=O)=O)O)=O)=O,2,1,0,1,35,4.8e-05
G5,C(OC(C(C)=O)C(C=O)(C=O)O)=O,2,2,0,2,35,9.499999999999999e-05
G5,C(OC(C(C)=O)C(C(C=O)=O)O)=O,4,2,0,2,35,9.499999999999999e-05
G5,C(OC(C=O)C(C=O)(C=O)O)=O,2,2,0,2,1,9.499999999999999e-05
G5,C(OC(C=O)C(C(C=O)=O)O)=O,4,2,0,2,1,9.499999999999999e-05
G5,C(C(C=O)(C(C=O)OC(C)=O)O)=O,2,2,0,2,28,9.499999999999999e-05
G5,C(C)(OC(C=O)C(C(C=O)=O)O)=O,4,2,0,2,28,9.499999999999999e-05
G5,C(C(C=O)(C(C(C(O)=O)=O)O)O)=O,2,2,0,2,33,9.6e-05
G5,C(C(C(C(C(C=O)=O)O)O)=O)(O)=O,4,2,0,2,33,9.6e-05
G5,C(C(C=O)(CC(CC(O)=O)=O)O)=O,1,5,0,5,17,0.00025
G5,C(C(C(C)=O)C(C=O)(C=O)O)(O)=O,2,5,0,5,17,0.000239
G5,C(C(C=O)(C1C(C(OC1)=O)=O)O)=O,2,2,0,2,28,9.499999999999999e-05
G5,C1(C(OCC1C(C(C=O)=O)O)=O)=O,4,2,0,2,28,9.499999999999999e-05
G5,C1(C(C(CO1)=O)C(C=O)(C=O)O)=O,2,2,0,2,28,9.499999999999999e-05
G5,C1(C(C(CO1)=O)C(C(C=O)=O)O)=O,4,2,0,2,28,9.499999999999999e-05
G5,C(C(C=O)(C1C(CC(O1)=O)=O)O)=O,2,2,0,2,28,9.499999999999999e-05
G5,C1(CC(C(C(C(C=O)=O)O)O1)=O)=O,4,2,0,2,28,9.499999999999999e-05
G5,C(C(C=O)(C1C(C=CO1)=O)O)=O,2,2,0,2,1,9.499999999999999e-05
G5,C1OC(C(C=1)=O)C(C(C=O)=O)O,4,2,0,2,1,9.499999999999999e-05
G5,C(C(C=O)(CC(C(CC)=O)=O)O)=O,1,1,0,1,28,4.8e-05
G5,C(C(CC)=O)(CC(C(C=O)=O)O)=O,2,1,0,1,28,4.8e-05
G5,C(C(C=O)(C(C(C(C)=O)=O)C)O)=O,2,1,0,1,28,4.8e-05
G5,C(C(C(C)C(C(C=O)=O)O)=O)(C)=O,4,1,0,1,28,4.8e-05
G5,C(C(C=O)(CC(CC(C)=O)=O)O)=O,1,1,0,1,28,4.8e-05
G5,C(CC(C(C=O)=O)O)(CC(C)=O)=O,2,1,0,1,28,4.8e-05
G5,C(C(C=O)(C(C(C)=O)C(C)=O)O)=O,1,2,0,2,28,9.499999999999999e-05
G5,C(C)(C(C(C)=O)C(C(C=O)=O)O)=O,2,2,0,2,28,9.499999999999999e-05
G5,C(C(C)C(C=O)C(C=O)(C=O)O)=O,4,2,0,2,1,9.6e-05
G5,C(C(C)C(C=O)C(C(C=O)=O)O)=O,8,2,0,2,28,9.6e-05
G5,C(C=O)(C(C)C(C(C=O)=O)O)=O,4,2,0,2,0,9.499999999999999e-05
G5,C(C(C=O)(C(C(C(O)=O)=O)C)O)=O,2,2,0,2,28,0.000106
G5,C(C(O)=O)(C(C)C(C(C=O)=O)O)=O,4,1,0,1,28,4.8e-05
G5,C(C(C=O)(C(C=C)C(C=O)=O)O)=O,2,1,0,1,28,4.8e-05
G5,C=CC(C(C=O)=O)C(C(C=O)=O)O,4,1,0,1,28,4.8e-05
G5,C(C(C=O)(CC(C=CC=O)=O)O)=O,2,1,0,1,1,4.8e-05
G5,C(C(C(CC(C=CC=O)=O)O)=O)=O,4,1,0,1,1,4.8e-05
G5,C(C(C(C=O)=C)C(C=O)(C=O)O)=O,2,1,0,1,28,4.8e-05
G5,C(C(C(C=O)=C)C(C(C=O)=O)O)=O,4,1,0,1,28,4.8e-05
G5,C(C(C=O)(C(C(C=CC)=O)O)O)=O,4,4,0,4,28,0.00019099999999999998
G5,C(C)=CC(C(C(C(C=O)=O)O)O)=O,8,4,0,4,28,0.00019099999999999998
G5,C(C(C=O)(C(C(CO)=O)C=C)O)=O,2,1,0,1,28,4.8e-05
G5,C(CO)(C(C=C)C(C(C=O)=O)O)=O,4,1,0,1,28,4.8e-05
G5,C(C(C=O)(C(C(CC=C)=O)O)O)=O,2,4,0,4,28,0.00019099999999999998
G5,C(C(C(C(C=O)=O)O)O)(CC=C)=O,4,4,0,4,28,0.00019099999999999998
G5,C(C(C=O)(CC(C(C=C)O)=O)O)=O,2,1,0,1,28,4.8e-05
G5,C(CC(C(C=O)=O)O)(C(C=C)O)=O,4,1,0,1,28,4.8e-05
G5,C(C(C(CO)=C)C(C=O)(C=O)O)=O,2,1,0,1,28,4.8e-05
G5,C(C(C(CO)=C)C(C(C=O)=O)O)=O,4,1,0,1,28,4.8e-05
G5,C(C(C=C)C(C=O)(C=O)O)=O,2,3,0,3,29,0.000143
G5,C(C(C=C)C(C(C=O)=O)O)=O,4,2,0,2,7,9.499999999999999e-05
G5,C(C(C=CC=O)C(C=O)(C=O)O)=O,4,1,0,1,28,4.8e-05
G5,C(C(C=CC=O)C(C(C=O)=O)O)=O,8,1,0,1,28,4.8e-05
G5,C(C(C(C(CC(C)=O)O)=O)O)=O,4,6,0,6,29,0.000296
G5,C(C(C=C)C(C=O)(C(C=O)O)O)=O,8,2,0,2,45,9.6e-05
G5,C(C(C=C)C(C(C(C=O)O)=O)O)=O,8,1,0,1,5,4.8e-05
G5,C(C(C=C)C(C(C(C=O)=O)O)O)=O,8,1,0,1,5,4.8e-05
G5,C(C)(C(C(C(C=O)=O)=O)C(C=C)O)=O,4,2,0,2,27,9.499999999999999e-05
G5,C(CC(C=C)O)(CC(C(C=O)=O)=O)=O,2,1,0,1,27,4.8e-05
G5,C(CC(C(C(C=O)=O)=O)C(C=C)O)=O,4,1,0,1,27,4.8e-05
G5,C(C(CC(C(C=O)=O)=O)C(C=C)O)=O,4,1,0,1,27,4.8e-05
G5,C=CC(C(C(C=O)=O)C(C(C)=O)=O)O,4,2,0,2,27,9.499999999999999e-05
G5,C=CC(CC(C(CC(C=O)=O)=O)=O)O,2,1,0,1,27,4.8e-05
G5,C(CC=O)(C(C(C=O)=O)C(C=C)O)=O,4,2,0,2,27,9.499999999999999e-05
G5,C(C(C(CC(C=O)=O)=O)C(C=C)O)=O,4,2,0,2,27,9.499999999999999e-05
G5,C=CC(C(C(C=CC(C=O)=O)=O)O)O,8,2,0,2,12,9.499999999999999e-05
G5,C(CC(C(C(C=O)(C)O)=O)O)(C)=O,4,2,0,2,26,9.499999999999999e-05
G5,C(C(C(CO)(C)O)(CC(C)=O)O)=O,4,3,0,3,27,0.000154
G5,C(CC(C(C(CO)(C)O)=O)O)(C)=O,4,1,0,1,0,4.8e-05
G5,C(C(C=O)C(C(C(C)(C)O)O)=O)=O,2,2,0,2,1,9.499999999999999e-05
G5,C(C(C=O)C(CO)(CC(C)=O)O)=O,2,5,0,5,26,0.00025
G5,C(C(C=O)C(C(C(C=C)O)O)=O)=O,4,2,0,2,1,9.499999999999999e-05
G5,C(C(C(C(C=O)O)=O)C(C)(C)O)=O,4,2,0,2,1,9.499999999999999e-05
G5,C(C(C(C(C=O)O)=O)C(C=C)O)=O,8,2,0,2,1,9.499999999999999e-05
G5,C(CC(C)(C)O)(CC(CO)=O)=O,1,1,0,1,26,4.8e-05
G5,C(C)(C(C(CO)=O)C(C)(C)O)=O,2,2,0,2,26,9.499999999999999e-05
G5,C(C(C(C)(C)O)O)(CC(C)=O)=O,2,2,0,2,26,9.499999999999999e-05
G5,C(C)(CC(C)(CC(CO)=O)O)=O,2,3,0,3,49,0.000143
G5,C(C)(CC(CO)(CC(C)=O)O)=O,1,1,0,1,26,4.8e-05
G5,C(CC(C=C)O)(CC(CO)=O)=O,2,2,0,2,26,9.499999999999999e-05
G5,C(CO)(C(C(C)=O)C(C=C)O)=O,4,2,0,2,26,9.499999999999999e-05
G5,C(C(C(C=C)O)O)(CC(C)=O)=O,4,3,0,3,26,0.000143
G5,C(CO)(CC(CC(C=CC)O)=O)=O,4,1,0,1,26,4.8e-05
G5,C(C)(C(C(CO)=O)C(C=CC)O)=O,8,2,0,2,26,9.499999999999999e-05
G5,C(C)(CC(C(C(C=CC)O)O)=O)=O,8,2,0,2,26,9.499999999999999e-05
G5,C(CC(CC=C)O)(CC(CO)=O)=O,2,1,0,1,26,4.8e-05
G5,C(C)(C(C(CO)=O)C(CC=C)O)=O,4,2,0,2,26,9.499999999999999e-05
G5,C(C(C(CC=C)O)O)(CC(C)=O)=O,4,2,0,2,26,9.499999999999999e-05
G5,C(C(C=C)C(C)(CC(CO)=O)O)=O,4,1,0,1,26,4.8e-05
G5,C(C(C=C)C(CO)(CC(C)=O)O)=O,4,2,0,2,45,9.499999999999999e-05
G5,C(CC(C)(C)O)(C(C(C)=O)O)=O,2,1,0,1,49,4.8e-05
G5,C(C)(CC(C)(C(C(C)=O)O)O)=O,4,4,0,4,28,0.00019099999999999998
G5,C(CC(C=C)O)(C(C(C)=O)O)=O,4,2,0,2,49,9.499999999999999e-05
G5,C(C)(C(C(CC(C=CC)O)=O)O)=O,8,1,0,1,49,4.8e-05
G5,C(CC(CC=C)O)(C(C(C)=O)O)=O,4,1,0,1,49,4.8e-05
G5,C(C(C=C)C(C)(C(C(C)=O)O)O)=O,8,1,0,1,49,4.8e-05
G5,C(CC(C)(CCO)O)(CCO)=O,2,1,0,1,28,4.8e-05
G5,C(C)(C(CO)C(C)(CCO)O)=O,4,2,0,2,28,9.499999999999999e-05
G5,C(CC(C)(C)O)(CCO)=O,1,1,0,1,28,4.8e-05
G5,C(C)(C(CO)C(C)(C)O)=O,2,2,0,2,28,9.499999999999999e-05
G5,C(C)(CC(C)(CCO)O)=O,2,1,0,1,28,4.8e-05
G5,C(OCC(C)(CC(CCO)=O)O)=O,2,1,0,1,35,4.8e-05
G5,C(OCC(C)(C(C(C)=O)CO)O)=O,4,2,0,2,35,9.499999999999999e-05
G5,C(OCC(CC(C)(CCO)O)=O)=O,2,1,0,1,35,4.8e-05
G5,C(OC(C(C)=O)C(C)(CCO)O)=O,4,2,0,2,35,9.499999999999999e-05
G5,C(OCC(CC(CCO)=O)O)=O,2,1,0,1,28,4.8e-05
G5,C(OCC(C(C(C)=O)CO)O)=O,4,2,0,2,28,9.499999999999999e-05
G5,C(OC(C=O)C(C)(CCO)O)=O,4,2,0,2,28,9.499999999999999e-05
G5,C(CC(COC(C)=O)O)(CCO)=O,2,1,0,1,28,4.8e-05
G5,C(C)(C(CO)C(COC(C)=O)O)=O,4,2,0,2,28,9.499999999999999e-05
G5,C(C(C(C)(CCO)O)OC(C)=O)=O,4,2,0,2,28,9.499999999999999e-05
G5,C(CCC(CC(CCO)=O)O)=O,2,1,0,1,27,4.8e-05
G5,C(CCC(C(C(C)=O)CO)O)=O,4,2,0,2,27,9.499999999999999e-05
G5,C(C(C(C)(CCO)O)CC=O)=O,4,3,0,3,28,0.000154
G5,C(CC(C=CCO)O)(CCO)=O,4,1,0,1,28,4.8e-05
G5,C(C)(C(CO)C(C=CCO)O)=O,8,2,0,2,28,9.499999999999999e-05
G5,C(C(CO)(C(C(C)=O)CO)O)(O)=O,4,5,0,5,33,0.00025299999999999997
G5,C(C(C(C(C)(CCO)O)O)=O)(O)=O,4,2,0,2,33,9.499999999999999e-05
G5,C(CC(C)(CC(CCO)=O)O)(O)=O,2,1,0,1,6,4.8e-05
G5,C(CC(C)(C(C(C)=O)CO)O)(O)=O,4,2,0,2,6,9.499999999999999e-05
G5,C(CC(CC(C)(CCO)O)=O)(O)=O,2,1,0,1,6,4.8e-05
G5,C(C(C(C)=O)C(C)(CCO)O)(O)=O,4,2,0,2,6,9.499999999999999e-05
G5,C(CC(C=CC(O)=O)O)(CCO)=O,4,1,0,1,18,4.8e-05
G5,C(C)(C(CO)C(C=CC(O)=O)O)=O,8,2,0,2,18,9.499999999999999e-05
G5,C1(C(CCO1)(CC(CCO)=O)O)=O,2,1,0,1,28,4.8e-05
G5,C1(C(CCO1)(C(C(C)=O)CO)O)=O,4,2,0,2,28,9.499999999999999e-05
G5,C1(C(C(CO1)C(C)(CCO)O)=O)=O,4,2,0,2,28,9.499999999999999e-05
G5,C1(CC(CO1)(CC(CCO)=O)O)=O,2,1,0,1,28,4.8e-05
G5,C1(CC(CO1)(C(C(C)=O)CO)O)=O,4,2,0,2,28,9.499999999999999e-05
G5,C1(C(C(CO1)=O)C(C)(CCO)O)=O,4,2,0,2,28,9.499999999999999e-05
G5,C1(CC(C(C(C)(CCO)O)O1)=O)=O,4,2,0,2,28,9.499999999999999e-05
G5,C(CCO)(CC(C(C=C)O)O)=O,4,1,0,1,28,4.8e-05
G5,C(C)(C(CO)C(C(C=C)O)O)=O,8,2,0,2,28,9.499999999999999e-05
G5,C(CC1(C=COC1)O)(CCO)=O,2,1,0,1,28,4.8e-05
G5,C(C)(C(CO)C1(C=COC1)O)=O,4,2,0,2,28,9.499999999999999e-05
G5,C1OC(C(C=1)=O)C(C)(CCO)O,4,2,0,2,28,9.499999999999999e-05
G5,C(C(C=C)(CC(CCO)=O)O)(O)=O,2,1,0,1,7,4.8e-05
G5,C(C(C=C)(C(C(C)=O)CO)O)(O)=O,4,2,0,2,7,9.499999999999999e-05
G5,C(CC(C(C)(CO)O)O)(CCO)=O,4,1,0,1,11,4.8e-05
G5,C(C)(C(CO)C(C(C)(CO)O)O)=O,8,2,0,2,11,9.499999999999999e-05
G5,C(C(C)(CC(CCO)=O)O)(CC)=O,2,1,0,1,28,4.8e-05
G5,C(C(C)(C(C(C)=O)CO)O)(CC)=O,4,2,0,2,28,9.499999999999999e-05
G5,C(C)(C(CC)(CC(CCO)=O)O)=O,2,1,0,1,28,4.8e-05
G5,C(C)(C(CO)C(C(C)=O)(CC)O)=O,4,2,0,2,28,9.499999999999999e-05
G5,C(C(CC)=O)(CC(C)(CCO)O)=O,2,1,0,1,28,4.8e-05
G5,C(C(C)=O)(C(C)C(C)(CCO)O)=O,4,1,0,1,28,4.8e-05
G5,C(CC(C)(CC(C)=O)O)(CCO)=O,2,2,0,2,27,9.499999999999999e-05
G5,C(C)(C(CO)C(C)(CC(C)=O)O)=O,4,3,0,3,28,0.000143
G5,C(CC(C)(CCO)O)(CC(C)=O)=O,2,1,0,1,28,4.8e-05
G5,C(C)(C(C(C)=O)C(C)(CCO)O)=O,2,2,0,2,28,9.499999999999999e-05
G5,C(CC(C)C(CC(CCO)=O)O)=O,4,1,0,1,28,4.8e-05
G5,C(CC(C)C(C(C(C)=O)CO)O)=O,8,2,0,2,28,9.499999999999999e-05
G5,C(C(C)CC(CC(CCO)=O)O)=O,4,1,0,1,28,4.8e-05
G5,C(C(C)CC(C(C(C)=O)CO)O)=O,8,2,0,2,28,9.499999999999999e-05
G5,C(C(C(C)(CCO)O)C(C=O)C)=O,8,2,0,2,28,9.499999999999999e-05
G5,C(CC(C(CC)=O)O)(CCO)=O,2,1,0,1,28,4.8e-05
G5,C(C)(C(CO)C(C(CC)=O)O)=O,4,2,0,2,28,9.499999999999999e-05
G5,C(C(CC)(CC(CCO)=O)O)=O,2,1,0,1,28,4.8e-05
G5,C(C(CC)(C(C(C)=O)CO)O)=O,4,2,0,2,28,9.499999999999999e-05
G5,C(C(C(C)C(C)(CCO)O)=O)=O,4,1,0,1,28,4.8e-05
G5,C(C(C=O)C(CC(CCO)=O)O)=O,2,4,0,4,2,0.000193
G5,C(C(C=O)C(C(C(C)=O)CO)O)=O,4,6,0,6,45,0.00029
G5,C(C(CC)(CC(CCO)=O)O)(O)=O,2,1,0,1,28,4.8e-05
G5,C(C(CC)(C(C(C)=O)CO)O)(O)=O,4,2,0,2,28,9.499999999999999e-05
G5,C(C(C(C)C(C)(CCO)O)=O)(O)=O,4,1,0,1,28,4.8e-05
G5,C(CC(C(C=CC)=O)O)(CCO)=O,4,1,0,1,28,4.8e-05
G5,C(C)(C(CO)C(C(C=CC)=O)O)=O,8,2,0,2,28,9.499999999999999e-05
G5,C(C(C=CC)(CC(CCO)=O)O)=O,4,1,0,1,28,4.8e-05
G5,C(C(C=CC)(C(C(C)=O)CO)O)=O,8,2,0,2,28,9.499999999999999e-05
G5,C(CC(C(CC=C)=O)O)(CCO)=O,2,1,0,1,28,4.8e-05
G5,C(C)(C(CO)C(C(CC=C)=O)O)=O,4,2,0,2,28,9.499999999999999e-05
G5,C(CC(C=O)(CC=C)O)(CCO)=O,2,1,0,1,28,4.8e-05
G5,C(C)(C(CO)C(C=O)(CC=C)O)=O,4,2,0,2,28,9.499999999999999e-05
G5,C=CC(C(C=O)=O)C(C)(CCO)O,4,1,0,1,28,4.8e-05
G5,C(CC(C=CC=O)(C)O)(CCO)=O,4,1,0,1,28,4.8e-05
G5,C(C)(C(CO)C(C=CC=O)(C)O)=O,8,2,0,2,28,9.499999999999999e-05
G5,C(CC(C=CC(C)=O)O)(CCO)=O,4,1,0,1,28,4.8e-05
G5,C(C)(C(CO)C(C=CC(C)=O)O)=O,8,2,0,2,28,9.499999999999999e-05
G5,C(C=CC(CC(C)(CCO)O)=O)=O,4,1,0,1,28,4.8e-05
G5,C(CC(C(CC=O)=C)O)(CCO)=O,2,1,0,1,28,4.8e-05
G5,C(C)(C(CO)C(C(CC=O)=C)O)=O,4,2,0,2,28,9.499999999999999e-05
G5,C(CC(CC(C=O)=C)O)(CCO)=O,2,1,0,1,28,4.8e-05
G5,C(C)(C(CO)C(CC(C=O)=C)O)=O,4,2,0,2,28,9.499999999999999e-05
G5,C(C(C(C=O)=C)C(C)(CCO)O)=O,4,1,0,1,28,4.8e-05
G5,C(CC(C(C)=CC=O)O)(CCO)=O,4,1,0,1,28,4.8e-05
G5,C(C)(C(CO)C(C(C)=CC=O)O)=O,8,2,0,2,28,9.499999999999999e-05
G5,C(CC(C=C(C=O)C)O)(CCO)=O,4,1,0,1,28,4.8e-05
G5,C(C)(C(CO)C(C=C(C=O)C)O)=O,8,2,0,2,28,9.499999999999999e-05
G5,C(CC(C=C)O)(CCO)=O,2,1,0,1,28,4.8e-05
G5,C(C)(C(CO)C(C=C)O)=O,4,2,0,2,28,9.499999999999999e-05
G5,C(CC(C=CC)(CO)O)(CCO)=O,4,1,0,1,28,4.8e-05
G5,C(C)(C(CO)C(C=CC)(CO)O)=O,8,2,0,2,28,9.499999999999999e-05
G5,C(C)=CC(C(C(C)(CCO)O)O)=O,8,2,0,2,28,9.499999999999999e-05
G5,C(CC(CO)(CC=C)O)(CCO)=O,2,1,0,1,28,4.8e-05
G5,C(C)(C(CO)C(CO)(CC=C)O)=O,4,2,0,2,28,9.499999999999999e-05
G5,C(CO)(C(C=C)C(C)(CCO)O)=O,4,1,0,1,28,4.8e-05
G5,C(C(C(C)(CCO)O)O)(CC=C)=O,4,2,0,2,28,9.499999999999999e-05
G5,C(CC(C)(C(C=C)O)O)(CCO)=O,4,1,0,1,28,4.8e-05
G5,C(C)(C(CO)C(C)(C(C=C)O)O)=O,8,2,0,2,28,9.499999999999999e-05
G5,C(CC(C)(CCO)O)(C(C=C)O)=O,4,1,0,1,28,4.8e-05
G5,C(CCO)(CC(CC(CO)=C)O)=O,2,1,0,1,28,4.8e-05
G5,C(C)(C(CO)C(CC(CO)=C)O)=O,4,2,0,2,28,9.499999999999999e-05
G5,C(C(C(CO)=C)C(C)(CCO)O)=O,4,1,0,1,28,4.8e-05
G5,C(CC(C=C(CO)C)O)(CCO)=O,4,1,0,1,28,4.8e-05
G5,C(C)(C(CO)C(C=C(CO)C)O)=O,8,2,0,2,28,9.499999999999999e-05
G5,C(CC(C=CC)O)(CCO)=O,4,1,0,1,28,4.8e-05
G5,C(C)(C(CO)C(C=CC)O)=O,8,2,0,2,28,9.499999999999999e-05
G5,C(CCO)(CC(CC=C)O)=O,2,1,0,1,28,4.8e-05
G5,C(C)(C(CO)C(CC=C)O)=O,4,2,0,2,28,9.499999999999999e-05
G5,C(C(C=C)C(C)(CCO)O)=O,4,1,0,1,28,4.8e-05
G5,C(CC(C=CCC=O)O)(CCO)=O,4,1,0,1,28,4.8e-05
G5,C(C)(C(CO)C(C=CCC=O)O)=O,8,2,0,2,28,9.499999999999999e-05
G5,C(CC(CC=CC=O)O)(CCO)=O,4,1,0,1,28,4.8e-05
G5,C(C)(C(CO)C(CC=CC=O)O)=O,8,2,0,2,28,9.499999999999999e-05
G5,C(C(C=CC=O)C(C)(CCO)O)=O,8,1,0,1,28,4.8e-05
G5,C(C(C(CC=O)=O)C(C)(C)O)=O,2,2,0,2,9,9.499999999999999e-05
G5,C(CC(CC=O)(CC(C)=O)O)=O,1,5,0,5,29,0.000239
G5,C(CC(C(C=O)C1(C=COC1)O)=O)=O,4,2,0,2,9,9.499999999999999e-05
G5,C(CC(C1C(C=CO1)=O)O)(CC=O)=O,4,2,0,2,9,9.499999999999999e-05
G5,C(CC(C1C(C=CO1)=O)(CC=O)O)=O,2,2,0,2,9,9.499999999999999e-05
G5,C(C(C(CC=O)=O)C(C=C)O)=O,4,2,0,2,9,9.499999999999999e-05
G5,C(C(C(CC=O)=O)C(C=CC)O)=O,8,2,0,2,9,9.499999999999999e-05
G5,C(C(C(CC=O)=O)C(CC=C)O)=O,4,2,0,2,9,9.499999999999999e-05
G5,C(C(C=C)C(CC(CC=O)=O)O)=O,4,1,0,1,9,4.8e-05
G5,C(C(C=C)C(CC=O)(CC=O)O)=O,2,1,0,1,9,4.8e-05
G5,C(C(C(CC(C)=O)=O)C(C)(C)O)=O,2,2,0,2,27,9.499999999999999e-05
G5,C(CC=O)(C(C(C)=O)C(C)(C)O)=O,2,2,0,2,27,9.499999999999999e-05
G5,C(CC(CC(CC(C)(C)O)=O)=O)=O,1,1,0,1,27,4.8e-05
G5,C(CC(CC(C)=O)O)(CC(C)=O)=O,2,2,0,2,27,9.6e-05
G5,C(CC(CC(C)=O)(CC(C)=O)O)=O,1,1,0,1,27,4.8e-05
G5,C(CC(C)(CC(C)=O)O)(CC=O)=O,2,2,0,2,27,9.6e-05
G5,C(C(C(CC(C)=O)=O)C(C=C)O)=O,4,2,0,2,27,9.499999999999999e-05
G5,C(CC=O)(C(C(C)=O)C(C=C)O)=O,4,2,0,2,27,9.499999999999999e-05
G5,C(CC(CC(CC(C=C)O)=O)=O)=O,2,1,0,1,27,4.8e-05
G5,C(C(C(CC(C)=O)=O)C(C=CC)O)=O,8,2,0,2,27,9.499999999999999e-05
G5,C(CC=O)(C(C(C)=O)C(C=CC)O)=O,8,2,0,2,27,9.499999999999999e-05
G5,C(CC(CC(CC(C=CC)O)=O)=O)=O,4,1,0,1,27,4.8e-05
G5,C(C(C(CC(C)=O)=O)C(CC=C)O)=O,4,2,0,2,27,9.499999999999999e-05
G5,C(CC=O)(C(C(C)=O)C(CC=C)O)=O,4,2,0,2,27,9.499999999999999e-05
G5,C(CC(CC(CC(CC=C)O)=O)=O)=O,2,1,0,1,27,4.8e-05
G5,C(C(C=C)C(CC(CC(C)=O)=O)O)=O,4,1,0,1,27,4.8e-05
G5,C(CC(CC(C)=O)(C(C=O)C=C)O)=O,4,1,0,1,27,4.8e-05
G5,C(C(C=C)C(C)(CC(CC=O)=O)O)=O,4,1,0,1,27,4.8e-05
G5,C(C)(CC(C)(C)O)=O,1,1,0,1,27,4.8e-05
G5,C(CCC(CO)(CC(C)=O)O)=O,2,1,0,1,7,4.8e-05
G5,C(C)(CC(CCC(CO)=O)O)=O,2,2,0,2,7,9.6e-05
G5,C(CCC=O)(C(C(C)(C)O)O)=O,2,2,0,2,7,9.499999999999999e-05
G5,C(CO)(C(C(C)(C)O)CC=O)=O,2,1,0,1,7,4.8e-05
G5,C(C(C(C)(C)O)CC(CO)=O)=O,2,1,0,1,7,4.8e-05
G5,C(C)(CC(CC(CCC=O)=O)O)=O,2,1,0,1,44,4.8e-05
G5,C(CC(CCC=O)(CC(C)=O)O)=O,2,2,0,2,44,9.499999999999999e-05
G5,C(CCC(CC(C)=O)O)(CC=O)=O,2,1,0,1,44,4.8e-05
G5,C(C(C(CCC=O)=O)C(C)(C)O)=O,2,2,0,2,44,9.499999999999999e-05
G5,C(C(C(C)(C)O)CC=O)(CC=O)=O,2,1,0,1,44,4.8e-05
G5,C(C(C(C)(C)O)CC(CC=O)=O)=O,2,1,0,1,44,4.8e-05
G5,C(C)(CC(C(CC(C)=O)O)O)=O,3,1,0,1,27,4.8e-05
G5,C(C(CC(C)(CC(C)=O)O)O)=O,4,1,0,1,27,4.8e-05
G5,C(C)(C(C(C)(C)O)C(C=O)O)=O,4,2,0,2,27,9.499999999999999e-05
G5,C(CC(C=O)O)(CC(C)(C)O)=O,2,1,0,1,27,4.8e-05
G5,C(CC(C=CCO)(CO)O)(C)=O,4,1,0,1,11,4.8e-05
G5,C(CO)=CC(C(C(C)(C)O)O)=O,4,2,0,2,11,9.499999999999999e-05
G5,C(C)(CC(CC(C=CCO)=O)O)=O,4,1,0,1,0,4.8e-05
G5,C(CC(C=CCO)(CC(C)=O)O)=O,4,1,0,1,0,4.8e-05
G5,C(C(C(C=CCO)=O)C(C)(C)O)=O,4,2,0,2,0,9.499999999999999e-05
G5,C(OCC(C)(CC(C)=O)O)=O,2,1,0,1,35,4.8e-05
G5,C(OCC(CC(C)(C)O)=O)=O,1,1,0,1,35,4.8e-05
G5,C(OC(C(C)=O)C(C)(C)O)=O,2,2,0,2,35,9.499999999999999e-05
G5,C(C)(CC(CO)(COCC=O)O)=O,2,1,0,1,27,4.8e-05
G5,C(C)(CC(COCC(CO)=O)O)=O,2,1,0,1,27,4.8e-05
G5,C(COC(C(CO)=O)C(C)(C)O)=O,2,2,0,2,27,9.499999999999999e-05
G5,C(COCC=O)(C(C(C)(C)O)O)=O,2,2,0,2,27,9.499999999999999e-05
G5,C(C(C(C)(C)O)OCC(CO)=O)=O,2,2,0,2,27,9.499999999999999e-05
G5,C(C)(CC(C)(C(OCC=O)O)O)=O,4,1,0,1,27,4.8e-05
G5,C(C)(CC(COC(C(C)=O)O)O)=O,4,1,0,1,27,4.8e-05
G5,C(COC(C(CC(C)(C)O)=O)O)=O,2,1,0,1,27,4.8e-05
G5,C(C(C(C)(C)O)OC(C(C)=O)O)=O,4,2,0,2,27,9.499999999999999e-05
G5,C(C)(CC(C(OCC(C)=O)O)O)=O,4,1,0,1,27,4.8e-05
G5,C(C)(CC(COC(C=O)O)(C)O)=O,4,1,0,1,27,4.8e-05
G5,C(COC(C=O)O)(CC(C)(C)O)=O,2,1,0,1,27,4.8e-05
G5,C(C)(C(C(C)(C)O)OC(C=O)O)=O,4,2,0,2,27,9.499999999999999e-05
G5,C(OCC(CC(C)=O)O)=O,2,2,0,2,44,9.499999999999999e-05
G5,C(OC(C=O)C(C)(C)O)=O,2,2,0,2,28,9.499999999999999e-05
G5,C(C)(CC(COC(CO)=O)O)=O,2,1,0,1,40,4.8e-05
G5,C(C(C(C)(C)O)OC(CO)=O)=O,2,2,0,2,40,9.499999999999999e-05
G5,C(C)(CC(COC(C)=O)O)=O,2,1,0,1,28,4.8e-05
G5,C(C(C(C)(C)O)OC(C)=O)=O,2,2,0,2,28,9.499999999999999e-05
G5,C(CC(C(C(CCO)O)=O)O)(C)=O,4,4,0,4,26,0.00020099999999999998
G5,C(C(C(CCO)O)(CC(C)=O)O)=O,4,2,0,2,27,9.6e-05
G5,C(C)(CC(CO)(C(CCO)O)O)=O,4,1,0,1,31,4.8e-05
G5,C(C(CCO)O)(C(C(C)(C)O)O)=O,4,2,0,2,31,9.499999999999999e-05
G5,C(CCC(C(CC(C)=O)O)=O)=O,2,1,0,1,20,4.8e-05
G5,C(CCC(C=O)(CC(C)=O)O)=O,2,2,0,2,20,9.499999999999999e-05
G5,C(C)(CC(CCC(C=O)=O)O)=O,2,2,0,2,20,9.6e-05
G5,C(CC(C(C=O)=O)C(C)(C)O)=O,2,1,0,1,20,4.8e-05
G5,C(C(C(C)(C)O)CC(C=O)=O)=O,2,1,0,1,20,4.8e-05
G5,C(CCC(CC(C)=O)O)=O,2,2,0,2,27,9.499999999999999e-05
G5,C(C(C(C)(C)O)CC=O)=O,2,1,0,1,27,4.8e-05
G5,C(C)(CC1(COC(CC1O)O)O)=O,8,1,0,1,27,4.8e-05
G5,C1(C(C(C)(C)O)OC(CC1O)O)=O,8,2,0,2,27,9.499999999999999e-05
G5,C(C)(CC(C(C=CCO)=O)O)=O,4,1,0,1,55,4.8e-05
G5,C(C(C=CCO)(CC(C)=O)O)=O,4,1,0,1,55,4.8e-05
G5,C(C)(CC(C=CCO)O)=O,4,1,0,1,28,4.8e-05
G5,C(C(C(C(C)(C)O)O)=O)(O)=O,2,2,0,2,33,9.499999999999999e-05
G5,C(C(CC(C)=O)(CC(C)=O)O)(O)=O,1,1,0,1,0,4.8e-05
G5,C(C)(CC(C)(CC(C(O)=O)=O)O)=O,2,2,0,2,0,9.499999999999999e-05
G5,C(C)(C(C(C(O)=O)=O)C(C)(C)O)=O,2,2,0,2,0,9.499999999999999e-05
G5,C(CC(C)(C)O)(CC(C(O)=O)=O)=O,1,1,0,1,0,4.8e-05
G5,C(C(CC=O)(CC(C)=O)O)(O)=O,2,5,0,5,29,0.000261
G5,C(C(C(C(O)=O)=O)C(C)(C)O)=O,2,2,0,2,45,9.499999999999999e-05
G5,C(CC(C)(CC(C)=O)O)(O)=O,2,1,0,1,6,4.8e-05
G5,C(CC(CC(C)(C)O)=O)(O)=O,1,1,0,1,6,4.8e-05
G5,C(C(C(C)=O)C(C)(C)O)(O)=O,2,2,0,2,6,9.499999999999999e-05
G5,C(CC(C=CC(O)=O)(CO)O)(C)=O,4,1,0,1,18,4.8e-05
G5,C(C=CC(C(C(C)(C)O)O)=O)(O)=O,4,2,0,2,18,9.499999999999999e-05
G5,C(C)(CC(C=CC(O)=O)O)=O,4,1,0,1,18,4.8e-05
G5,C(CO)(C(CO)(CC(C)=O)O)=O,2,6,0,6,29,0.000309
G5,C(C(CO)=O)(C(C(C)(C)O)O)=O,2,2,0,2,5,9.499999999999999e-05
G5,C(C(C=O)(C(C)(CC(C)=O)O)O)=O,2,3,0,3,28,0.000143
G5,C(C(C=O)(C(CC(C)(C)O)=O)O)=O,1,1,0,1,1,4.8e-05
G5,C(C(C(C(C)=O)(CC(C)=O)O)O)=O,4,3,0,3,14,0.000144
G5,C(C(C)(CC(C)=O)O)(C(C=O)O)=O,4,1,0,1,25,4.8e-05
G5,C(C(C(C(CC(C)(C)O)=O)=O)O)=O,2,1,0,1,25,4.8e-05
G5,C(C(C(CO)O)(CC(C)=O)O)(O)=O,4,3,0,3,26,0.000155
G5,C(C(CO)(CC(C)=O)O)(C(C)O)=O,4,1,0,1,0,4.8e-05
G5,C(CO)(C(C(C)O)(CC(C)=O)O)=O,4,3,0,3,17,0.000155
G5,C(C(C(C)O)=O)(C(C(C)(C)O)O)=O,4,2,0,2,0,9.499999999999999e-05
G5,C(CC(C(C=C)=O)(CO)O)(C)=O,2,1,0,1,7,4.8e-05
G5,C(CO)(C(C=C)(CC(C)=O)O)=O,2,1,0,1,7,4.8e-05
G5,C=CC(C(C(C(C)(C)O)O)=O)=O,2,2,0,2,7,9.499999999999999e-05
G5,C(C)(C(C(C)O)(CC(C)=O)O)=O,4,2,0,2,11,9.499999999999999e-05
G5,C(C(C)(CC(C)=O)O)(C(C)O)=O,4,1,0,1,49,4.8e-05
G5,C(C(C(C)O)=O)(CC(C)(C)O)=O,2,1,0,1,49,4.8e-05
G5,C(CC(C(C=C)=O)(C(C)O)O)(C)=O,4,1,0,1,7,4.8e-05
G5,C(C(C)O)(C(C=C)(CC(C)=O)O)=O,4,1,0,1,7,4.8e-05
G5,C(C)(CC(CO)(C(C)(CO)O)O)=O,4,1,0,1,49,4.8e-05
G5,C(C(C(C)(C)O)O)(C(CO)(C)O)=O,4,2,0,2,49,9.499999999999999e-05
G5,C(C(CO)(CC(C)=O)O)(CC=O)=O,2,2,0,2,4,9.499999999999999e-05
G5,C(C(C(C(CO)=O)=O)C(C)(C)O)=O,2,2,0,2,0,9.499999999999999e-05
G5,C(CC(C(C(C(C)(C)O)O)=O)=O)=O,2,2,0,2,0,9.499999999999999e-05
G5,C(C(C=O)(CC(CC(C)=O)O)O)=O,2,1,0,1,1,4.8e-05
G5,C(C(C=O)(C(C=O)C(C)(C)O)O)=O,2,2,0,2,1,9.499999999999999e-05
G5,C1(C(C(CC1)(CC(C)=O)O)O)=O,4,2,0,2,7,9.499999999999999e-05
G5,C1(C(C(C)(C)O)CC(C1O)=O)=O,4,1,0,1,47,4.8e-05
G5,C1(CCC(CO1)(CC(C)=O)O)=O,2,1,0,1,7,4.8e-05
G5,C1(COC(CC1C(C)(C)O)=O)=O,2,1,0,1,7,4.8e-05
G5,C1(CCC(OC1C(C)(C)O)=O)=O,2,2,0,2,7,9.499999999999999e-05
G5,C(C)(CC1(COCC(C1)=O)O)=O,2,1,0,1,54,4.8e-05
G5,C1(C(C(C)(C)O)OCC(C1)=O)=O,2,2,0,2,54,9.499999999999999e-05
G5,C1(COCC(C1C(C)(C)O)=O)=O,1,2,0,2,54,9.499999999999999e-05
G5,C(C)(CC1(COC(CO)C1O)O)=O,8,1,0,1,27,4.8e-05
G5,C1(C(C(C)(C)O)OC(CO)C1O)=O,8,2,0,2,27,9.499999999999999e-05
G5,C(C)(CC1(C(O)OC(CO)C1)O)=O,8,1,0,1,27,4.8e-05
G5,C1(C(O)OC(CO)C1C(C)(C)O)=O,8,2,0,2,27,9.499999999999999e-05
G5,C(C)(CC1(COC(CO)(C1)O)O)=O,4,1,0,1,27,4.8e-05
G5,C1(COC(CO)(C1C(C)(C)O)O)=O,4,2,0,2,27,9.499999999999999e-05
G5,C1(C(C(C)(C)O)OC(CO)(C1)O)=O,4,2,0,2,27,9.499999999999999e-05
G5,C1(C(CCO1)(CC(C)=O)O)=O,2,1,0,1,28,4.8e-05
G5,C1(C(C(CO1)C(C)(C)O)=O)=O,2,2,0,2,28,9.499999999999999e-05
G5,C1(CC(CO1)(CC(C)=O)O)=O,2,1,0,1,28,4.8e-05
G5,C1(C(C(CO1)=O)C(C)(C)O)=O,2,2,0,2,28,9.499999999999999e-05
G5,C1(CC(C(C(C)(C)O)O1)=O)=O,2,2,0,2,28,9.499999999999999e-05
G5,C(C)(CC1(COCC(C1O)O)O)=O,8,1,0,1,27,4.8e-05
G5,C1(C(C(C)(C)O)OCC(C1O)O)=O,8,2,0,2,27,9.499999999999999e-05
G5,C(C)(CC1(C(O)OCC(C1)O)O)=O,8,1,0,1,27,4.8e-05
G5,C1(C(O)OCC(C1C(C)(C)O)O)=O,8,2,0,2,27,9.499999999999999e-05
G5,C1(C(CC(CO1)(CC(C)=O)O)O)=O,4,1,0,1,27,4.8e-05
G5,C1(COC(C(C1C(C)(C)O)O)=O)=O,4,2,0,2,27,9.499999999999999e-05
G5,C1(CC(C(OC1C(C)(C)O)=O)O)=O,4,2,0,2,27,9.499999999999999e-05
G5,C(C)(CC(C(C=C)O)O)=O,4,1,0,1,28,4.8e-05
G5,C(CC1(C=COC1)O)(C)=O,2,1,0,1,28,4.8e-05
G5,C1OC(C(C=1)=O)C(C)(C)O,2,2,0,2,28,9.499999999999999e-05
G5,C(CC1(C=CC(O)OC1)O)(C)=O,4,1,0,1,27,4.8e-05
G5,C1C(OC(C(C=1)=O)C(C)(C)O)O,4,2,0,2,27,9.499999999999999e-05
G5,C(C)(CC(CCCC(C=O)=O)O)=O,2,1,0,1,7,4.8e-05
G5,C(CC(C(CCCC=O)=O)O)(C)=O,2,1,0,1,7,4.8e-05
G5,C(CCCC(C=O)(CC(C)=O)O)=O,2,1,0,1,7,4.8e-05
G5,C(C(CCC(C=O)=O)C(C)(C)O)=O,2,1,0,1,7,4.8e-05
G5,C(CCC(C(C=O)=O)C(C)(C)O)=O,2,1,0,1,7,4.8e-05
G5,C(C)(CC(CCCC(CO)=O)O)=O,2,1,0,1,27,4.8e-05
G5,C(CCCC(CO)(CC(C)=O)O)=O,2,1,0,1,27,4.8e-05
G5,C(C(CCC(CO)=O)C(C)(C)O)=O,2,1,0,1,27,4.8e-05
G5,C(CCCC(C(C(C)(C)O)O)=O)=O,2,2,0,2,27,9.499999999999999e-05
G5,C(CCC(C(CO)=O)C(C)(C)O)=O,2,1,0,1,27,4.8e-05
G5,C(C)(CC(CC(C=O)CC=O)O)=O,4,2,0,2,43,9.499999999999999e-05
G5,C(CC(C(CC(C)=O)O)CC=O)=O,2,2,0,2,43,9.499999999999999e-05
G5,C(CC(C=O)C(C=O)C(C)(C)O)=O,4,1,0,1,43,4.8e-05
G5,C(CC(C(C)O)(CC(C)=O)O)=O,4,1,0,1,45,4.8e-05
G5,C(C(C)O)(CC(CC(C)=O)O)=O,4,1,0,1,45,4.8e-05
G5,C(C(C(C(C)O)=O)C(C)(C)O)=O,4,2,0,2,45,9.499999999999999e-05
G5,C(C)(CC(C(C(CO)CO)O)O)=O,4,1,0,1,2,4.8e-05
G5,C(C)(CC(C(CC(C)O)O)O)=O,8,1,0,1,11,4.8e-05
G5,C(C)(CC(C(C)O)(C(C)O)O)=O,3,1,0,1,49,4.8e-05
G5,C(C(C)(C(CO)(CC(C)=O)O)O)=O,4,3,0,3,27,0.000154
G5,C(C(C(C(C(C)(C)O)O)=O)(C)O)=O,4,2,0,2,0,9.499999999999999e-05
G5,C(C)(CC(C(CC(CO)O)O)O)=O,8,1,0,1,0,4.8e-05
G5,C(C(C(C)O)(CC(C)=O)O)(O)=O,4,3,0,3,4,0.000144
G5,C(C(C=CC(CC(C)=O)O)O)=O,8,1,0,1,20,4.8e-05
G5,C(C)(CC(C(C=CC=O)O)O)=O,8,1,0,1,20,4.8e-05
G5,C(C)(CC(C)(C(CCO)O)O)=O,4,1,0,1,45,4.8e-05
G5,C(C(CCO)O)(CC(C)(C)O)=O,2,1,0,1,45,4.8e-05
G5,C(C)(CC(C(C)(CCO)O)O)=O,4,1,0,1,29,4.8e-05
G5,C(C)(CC(C(C)(C(CO)O)O)O)=O,8,1,0,1,0,4.8e-05
G5,C(C)(CC(C(CO)(CCO)O)O)=O,4,2,0,2,29,0.000106
G5,C(CC(C=CC(C)=O)(CO)O)(C)=O,4,1,0,1,45,4.8e-05
G5,C(CC(C=CC(CO)=O)(C)O)(C)=O,4,1,0,1,45,4.8e-05
G5,C(C=CC(C)=O)(C(C(C)(C)O)O)=O,4,2,0,2,45,9.499999999999999e-05
G5,C(C=CC(CO)=O)(CC(C)(C)O)=O,2,1,0,1,45,4.8e-05
G5,C(CC=CC(CO)(CC(C)=O)O)=O,4,1,0,1,29,4.8e-05
G5,C(C)(CC(CC=CC(CO)=O)O)=O,4,1,0,1,29,4.8e-05
G5,C(CC=CC(C(C(C)(C)O)O)=O)=O,4,2,0,2,29,9.499999999999999e-05
G5,C(C(C=CC(CO)=O)C(C)(C)O)=O,4,1,0,1,29,4.8e-05
G5,C(CC(C(C=CCCO)=O)O)(C)=O,4,1,0,1,29,4.8e-05
G5,C(C(C=CCCO)(CC(C)=O)O)=O,4,1,0,1,29,4.8e-05
G5,C(C)(C(C=CCO)(CC(C)=O)O)=O,4,1,0,1,27,4.8e-05
G5,C(CC(C(C=CCO)=O)(C)O)(C)=O,4,1,0,1,27,4.8e-05
G5,C(CO)=CC(C(CC(C)(C)O)=O)=O,2,1,0,1,27,4.8e-05
G5,C(CC(C=CC(CCO)=O)O)(C)=O,4,1,0,1,27,4.8e-05
G5,C(CC(C=CC=O)(CCO)O)(C)=O,4,1,0,1,27,4.8e-05
G5,C(C=CC(C(CO)C(C)(C)O)=O)=O,4,2,0,2,27,9.499999999999999e-05
G5,C(C)(CC(CO)(CC(C=C)=O)O)=O,2,1,0,1,27,4.8e-05
G5,C(C)(CC(C=C)(CC(CO)=O)O)=O,2,1,0,1,27,4.8e-05
G5,C(C(C(C)(C)O)O)(CC(C=C)=O)=O,2,2,0,2,27,9.499999999999999e-05
G5,C(CO)(C(C(C=C)=O)C(C)(C)O)=O,2,2,0,2,27,9.499999999999999e-05
G5,C(CC(C(C=C)=O)(CCO)O)(C)=O,2,1,0,1,45,4.8e-05
G5,C(CCO)(C(C=C)(CC(C)=O)O)=O,2,1,0,1,45,4.8e-05
G5,C=CC(C(C(CO)C(C)(C)O)=O)=O,2,2,0,2,45,9.499999999999999e-05
G5,C(C)(CC(CO)(CC=CC=O)O)=O,4,1,0,1,27,4.8e-05
G5,C(CO)(CC=CC(CC(C)=O)O)=O,4,1,0,1,27,4.8e-05
G5,C(C(C(C)(C)O)O)(CC=CC=O)=O,4,2,0,2,27,9.499999999999999e-05
G5,C(CO)(C(C=CC=O)C(C)(C)O)=O,4,1,0,1,27,4.8e-05
G5,C(C(CC(C)=O)O)(CC=CCO)=O,4,1,0,1,27,4.8e-05
G5,C(C(CC(C)=O)(CC=CCO)O)=O,4,1,0,1,27,4.8e-05
G5,C(C(C(C=O)=O)C(C)(C)O)=CCO,4,1,0,1,27,4.8e-05
G5,C(CC(C(C)(CC(C)=O)O)O)(O)=O,4,1,0,1,27,4.8e-05
G5,C(CC(C(CC(C)(C)O)=O)O)(O)=O,2,1,0,1,27,4.8e-05
G5,C(CC(C)(C(CC(C)=O)O)O)(O)=O,4,1,0,1,29,4.8e-05
G5,C(C(C=C)(CC(C)=O)O)(O)=O,2,1,0,1,7,4.8e-05
G5,C(C)(CC1(COCC1(CO)O)O)=O,4,1,0,1,10,4.8e-05
G5,C1(C(C(C)(C)O)OCC1(CO)O)=O,4,2,0,2,10,9.499999999999999e-05
G5,C(C)(CC(C(C)(CO)O)O)=O,4,2,0,2,11,0.000106
G5,C(C)(CC1(CCOC1(CO)O)O)=O,4,1,0,1,34,4.8e-05
G5,C1(C(CO)(O)OCC1C(C)(C)O)=O,4,2,0,2,34,9.499999999999999e-05
G5,C(C)(CC(C(C)(C(C)O)O)O)=O,8,1,0,1,18,4.8e-05
G5,C1(CCC(C(C1)(CC(C)=O)O)=O)=O,2,1,0,1,45,4.8e-05
G5,C1(CCC(C(C1)=O)(CC(C)=O)O)=O,2,1,0,1,45,4.8e-05
G5,C(C)(CC1(CCC(C(C1)=O)=O)O)=O,2,1,0,1,45,4.8e-05
G5,C1(CCC(C(C1C(C)(C)O)=O)=O)=O,2,2,0,2,45,9.499999999999999e-05
G5,C1(CC(C(C(C1)=O)=O)C(C)(C)O)=O,2,1,0,1,45,4.8e-05
G5,C1(C(C(C)(C)O)CC(C(C1)=O)=O)=O,2,1,0,1,45,4.8e-05
G5,C(C)(CC(C1C(C(CC1)=O)=O)O)=O,4,1,0,1,45,4.8e-05
G5,C1(C(CCC1C=O)(CC(C)=O)O)=O,4,1,0,1,45,4.8e-05
G5,C(CC1(C(CCC1C=O)=O)O)(C)=O,4,1,0,1,45,4.8e-05
G5,C(C1C(C(C(C1)C(C)(C)O)=O)=O)=O,4,1,0,1,45,4.8e-05
G5,C1(CC(CC(C1)=O)(CC(C)=O)O)=O,1,1,0,1,45,4.8e-05
G5,C1(CC(CC(C1C(C)(C)O)=O)=O)=O,1,2,0,2,45,9.499999999999999e-05
G5,C(C)(CC1(C(C=O)CC(C1)=O)O)=O,4,1,0,1,45,4.8e-05
G5,C1(CC(CC1C=O)(CC(C)=O)O)=O,4,1,0,1,45,4.8e-05
G5,C(C)(CC(C1C(CC(C1)=O)=O)O)=O,4,1,0,1,45,4.8e-05
G5,C1(C(C=O)CC(C1C(C)(C)O)=O)=O,4,2,0,2,45,9.499999999999999e-05
G5,C1(C(C=O)C(C(C1)=O)C(C)(C)O)=O,4,1,0,1,45,4.8e-05
G5,C(C1CC(C(C1)=O)(CC(C)=O)O)=O,4,1,0,1,45,4.8e-05
G5,C(C)(CC(C1CC(C(C1)=O)=O)O)=O,2,1,0,1,45,4.8e-05
G5,C(C1CC(C(C1C(C)(C)O)=O)=O)=O,4,1,0,1,45,4.8e-05
G5,C1(CCC(CC(C)=O)(C1C=O)O)=O,4,1,0,1,45,4.8e-05
G5,C(C)(CC(C1C(CCC1=O)=O)O)=O,2,1,0,1,45,4.8e-05
G5,C1(C(C(C)(C)O)CC(C1C=O)=O)=O,4,1,0,1,45,4.8e-05
G5,C(C)(CC1(C(C(C=CC1)=O)O)O)=O,4,1,0,1,32,4.8e-05
G5,C1(C(C(C=CC1)(CC(C)=O)O)O)=O,4,1,0,1,32,4.8e-05
G5,C1(C(C(C=CC1C(C)(C)O)=O)O)=O,4,1,0,1,32,4.8e-05
G5,C(C)(CC1(C(C=CC(C1)=O)O)O)=O,4,1,0,1,45,4.8e-05
G5,C1(CC(C=CC1O)(CC(C)=O)O)=O,4,1,0,1,45,4.8e-05
G5,C1(C(C=CC(C1C(C)(C)O)=O)O)=O,4,2,0,2,45,9.499999999999999e-05
G5,C(CO)(C(CC)(CC(C)=O)O)=O,2,1,0,1,42,4.8e-05
G5,C(C(CO)(CC(C)=O)O)(CC)=O,2,1,0,1,42,4.8e-05
G5,C(C(CO)=O)(C(C)C(C)(C)O)=O,2,1,0,1,42,4.8e-05
G5,C(C(C(C(C)(C)O)O)=O)(CC)=O,2,2,0,2,42,9.499999999999999e-05
G5,C(CC(CO)C(CC(C)=O)O)=O,4,2,0,2,55,9.499999999999999e-05
G5,C(C(CO)CC(CC(C)=O)O)=O,4,1,0,1,55,4.8e-05
G5,C(C(C(C)(C)O)C(C=O)CO)=O,4,1,0,1,55,4.8e-05
G5,C(CC(C(CC(C=O)C)=O)O)(C)=O,4,1,0,1,28,4.8e-05
G5,C(C(C)CC(C=O)(CC(C)=O)O)=O,4,1,0,1,28,4.8e-05
G5,C(C)(CC(C(C)CC(C=O)=O)O)=O,4,2,0,2,28,9.499999999999999e-05
G5,C(C(C)C(C(C=O)=O)C(C)(C)O)=O,4,1,0,1,28,4.8e-05
G5,C(C)(C(CC(C)=O)(CC(C)=O)O)=O,1,1,0,1,14,4.8e-05
G5,C(C)(CC(C(C)(CC(C)=O)O)=O)=O,2,1,0,1,14,4.8e-05
G5,C(C)(CC(C)(CC(C(C)=O)=O)O)=O,2,2,0,2,14,9.499999999999999e-05
G5,C(C)(C(C(C(C)=O)=O)C(C)(C)O)=O,2,2,0,2,14,9.499999999999999e-05
G5,C(C)(CC(C(CC(C)(C)O)=O)=O)=O,1,1,0,1,14,4.8e-05
G5,C(CC(C)(C)O)(CC(C(C)=O)=O)=O,1,1,0,1,14,4.8e-05
G5,C(C)(CC(C(C(C(C)=O)=O)C)O)=O,4,2,0,2,45,9.6e-05
G5,C(C(C)(CC(C)=O)O)(C(C=O)C)=O,4,1,0,1,45,4.8e-05
G5,C(CC(C(C)=O)(C(C=O)C)O)(C)=O,4,1,0,1,45,4.8e-05
G5,C(C(C(C(CC(C)(C)O)=O)=O)C)=O,2,1,0,1,45,4.8e-05
G5,C(C)(CC(CC(C(CC)=O)=O)O)=O,2,2,0,2,27,9.6e-05
G5,C(CC(C(CC)=O)(CC=O)O)(C)=O,2,1,0,1,27,4.8e-05
G5,C(C(CC)(CC(C)=O)O)(CC=O)=O,2,1,0,1,27,4.8e-05
G5,C(C(C(C(CC)=O)=O)C(C)(C)O)=O,2,2,0,2,27,9.499999999999999e-05
G5,C(CC(C(C(C)C(C)(C)O)=O)=O)=O,2,1,0,1,27,4.8e-05
G5,C(C)(C(CCC=O)(CC(C)=O)O)=O,2,1,0,1,46,4.8e-05
G5,C(CC(C(CCC=O)=O)(C)O)(C)=O,2,1,0,1,46,4.8e-05
G5,C(C)(CC(CCC(C(C)=O)=O)O)=O,2,1,0,1,46,4.8e-05
G5,C(CC(C(C(C)=O)=O)C(C)(C)O)=O,2,1,0,1,46,4.8e-05
G5,C(CCC(C(CC(C)(C)O)=O)=O)=O,1,1,0,1,46,4.8e-05
G5,C(C(C(C)(C)O)CC(C(C)=O)=O)=O,2,1,0,1,46,4.8e-05
G5,C(CC(C(C(C)CC=O)=O)O)(C)=O,4,1,0,1,45,4.8e-05
G5,C(CC(C)C(C=O)(CC(C)=O)O)=O,4,2,0,2,45,9.499999999999999e-05
G5,C(C)(CC(CC(C(C=O)=O)C)O)=O,4,1,0,1,45,4.8e-05
G5,C(C(C(C)(C)O)C(C(C=O)=O)C)=O,4,1,0,1,45,4.8e-05
G5,C(CC(C)C(CO)(CC(C)=O)O)=O,4,1,0,1,0,4.8e-05
G5,C(C)(CC(CC(C(CO)=O)C)O)=O,4,1,0,1,0,4.8e-05
G5,C(C(C)CC=O)(C(C(C)(C)O)O)=O,4,2,0,2,0,9.499999999999999e-05
G5,C(C(C(C)(C)O)C(C(CO)=O)C)=O,4,1,0,1,0,4.8e-05
G5,C(C(CC)(CC(C)=O)O)(CCO)=O,2,1,0,1,27,4.8e-05
G5,C(C(CCO)(CC(C)=O)O)(CC)=O,2,1,0,1,27,4.8e-05
G5,C(C(CCO)=O)(C(C)C(C)(C)O)=O,2,1,0,1,27,4.8e-05
G5,C(C(CC)=O)(C(CO)C(C)(C)O)=O,2,2,0,2,27,9.499999999999999e-05
G5,C(C)(CC(CCO)(CC(C)=O)O)=O,1,1,0,1,27,4.8e-05
G5,C(CCO)(C(C(C)=O)C(C)(C)O)=O,2,2,0,2,27,9.499999999999999e-05
G5,C(C(CO)C(C)(C)O)(CC(C)=O)=O,2,2,0,2,27,9.499999999999999e-05
G5,C(CC(C)(C)O)(CC(CCO)=O)=O,1,1,0,1,27,4.8e-05
G5,C(CC(C(CC(C)=O)O)CCO)=O,4,1,0,1,46,4.8e-05
G5,C(C(CC(CC(C)=O)O)CCO)=O,4,1,0,1,46,4.8e-05
G5,C(C(CCO)C(C=O)C(C)(C)O)=O,4,1,0,1,46,4.8e-05
G5,C(C(C)CC(CO)(CC(C)=O)O)=O,4,1,0,1,28,4.8e-05
G5,C(C)(CC(C(C)CC(CO)=O)O)=O,4,2,0,2,28,9.499999999999999e-05
G5,C(C(C)C(C(CO)=O)C(C)(C)O)=O,4,1,0,1,28,4.8e-05
G5,C(C(C)CC(C(C(C)(C)O)O)=O)=O,4,2,0,2,28,9.499999999999999e-05
G5,C(C(C)(CC(C)=O)O)(C(CO)C)=O,4,1,0,1,27,4.8e-05
G5,C(C)(C(C(CO)C)(CC(C)=O)O)=O,4,1,0,1,27,4.8e-05
G5,C(C(CC(C)(C)O)=O)(C(C)CO)=O,2,1,0,1,27,4.8e-05
G5,C(C(C)C(C(C)(CC(C)=O)O)O)=O,8,1,0,1,27,4.8e-05
G5,C(C)(CC(C(C)C(C(C)=O)O)O)=O,8,1,0,1,27,4.8e-05
G5,C(C(C)C(C(CC(C)(C)O)=O)O)=O,4,1,0,1,27,4.8e-05
G5,C(C(C)(CC(C)=O)O)(CC)=O,2,1,0,1,28,4.8e-05
G5,C(C)(C(CC)(CC(C)=O)O)=O,2,1,0,1,28,4.8e-05
G5,C(C(CC)=O)(CC(C)(C)O)=O,1,1,0,1,28,4.8e-05
G5,C(C(C)=O)(C(C)C(C)(C)O)=O,2,1,0,1,28,4.8e-05
G5,C(C)(CC(C)(CC(C)=O)O)=O,1,1,0,1,28,4.8e-05
G5,C(CC(C)(C)O)(CC(C)=O)=O,1,1,0,1,28,4.8e-05
G5,C(C)(C(C(C)=O)C(C)(C)O)=O,1,2,0,2,28,9.499999999999999e-05
G5,C(CC(C)C(CC(C)=O)O)=O,4,2,0,2,28,9.499999999999999e-05
G5,C(C(C)CC(CC(C)=O)O)=O,4,1,0,1,28,4.8e-05
G5,C(C(C(C)(C)O)C(C=O)C)=O,4,1,0,1,28,4.8e-05
G5,C(CC(C(C(C=O)C)=O)O)(C)=O,4,1,0,1,49,4.8e-05
G5,C(CC(C=O)(C(C=O)C)O)(C)=O,4,1,0,1,49,4.8e-05
G5,C(C)(CC(C(C(C=O)=O)C)O)=O,4,2,0,2,49,9.6e-05
G5,C(CC(C(C(CO)C)=O)O)(C)=O,4,1,0,1,28,4.8e-05
G5,C(C(C(CO)C)(CC(C)=O)O)=O,4,1,0,1,28,4.8e-05
G5,C(C(C)C(C(CC(C)=O)O)O)=O,8,1,0,1,49,4.8e-05
G5,C(C(C(C(CC(C)=O)O)C)O)=O,8,1,0,1,49,4.8e-05
G5,C(CC(C(CC)=O)O)(C)=O,2,1,0,1,28,4.8e-05
G5,C(C(CC)(CC(C)=O)O)=O,2,1,0,1,28,4.8e-05
G5,C(C(C(C)C(C)(C)O)=O)=O,2,1,0,1,28,4.8e-05
G5,C(C)(CC(C)(C(C(C=C)=O)O)O)=O,4,3,0,3,28,0.000143
G5,C(C)(C(C(C=C)(CC(C)=O)O)O)=O,4,1,0,1,9,4.8e-05
G5,C(CC(C)(C)O)(C(C(C=C)=O)O)=O,2,1,0,1,9,4.8e-05
G5,C(C)(CC(C)(C(C=CC=O)O)O)=O,8,1,0,1,45,4.8e-05
G5,C(C)(C(C=CC(CC(C)=O)O)O)=O,8,1,0,1,45,4.8e-05
G5,C(CC(C)(C)O)(C(C=CC=O)O)=O,4,1,0,1,45,4.8e-05
G5,C(CC1(C=CC(C1CO)=O)O)(C)=O,4,1,0,1,45,4.8e-05
G5,C(C(C=O)C(C)(CC(C)=O)O)=O,2,4,0,4,28,0.00019099999999999998
G5,C(C(C=O)C(CC(C)(C)O)=O)=O,1,1,0,1,6,4.8e-05
G5,C(C)(CC(C(C(C)=O)C(C)=O)O)=O,2,3,0,3,28,0.000143
G5,C(C(C(C)=O)C(C)(CC(C)=O)O)=O,4,3,0,3,28,0.000143
G5,C(CC(C)(C)O)(C(C=O)C(C)=O)=O,2,1,0,1,6,4.8e-05
G5,C(C(C=O)C(C(CC(C)=O)O)=O)=O,2,2,0,2,26,9.499999999999999e-05
G5,C(CC(C)(C)O)(C(C(C)=O)CO)=O,2,1,0,1,28,4.8e-05
G5,C(C)(CC(C(C(C(O)=O)=O)C)O)=O,4,2,0,2,27,9.6e-05
G5,C(CC(C(O)=O)(C(C=O)C)O)(C)=O,4,1,0,1,27,4.8e-05
G5,C(C)(CC(C(C=O)CC=O)O)=O,4,4,0,4,6,0.00019099999999999998
G5,C(C(C=O)CC(CC(C)=O)O)=O,2,1,0,1,43,4.8e-05
G5,C(C(C=O)C(C=O)C(C)(C)O)=O,2,1,0,1,43,4.8e-05
G5,C(C(C(C(CC(C)=O)O)C)O)(O)=O,8,1,0,1,49,4.8e-05
G5,C(C(C(CO)C)(CC(C)=O)O)(O)=O,4,1,0,1,28,4.8e-05
G5,C(C)(CC(C(C(C)=O)CC=O)O)=O,4,2,0,2,45,9.499999999999999e-05
G5,C(C(C(C)=O)CC(CC(C)=O)O)=O,4,1,0,1,45,4.8e-05
G5,C(C)(CC(C)(C(C=O)CC=O)O)=O,4,2,0,2,45,9.499999999999999e-05
G5,C(C(C(C)(C)O)C(C=O)C(C)=O)=O,4,1,0,1,45,4.8e-05
G5,C(CC(C)(C)O)(C(C=O)CC=O)=O,2,1,0,1,45,4.8e-05
G5,C(C(CC)(CC(C)=O)O)(O)=O,2,1,0,1,28,4.8e-05
G5,C(C(C(C)C(C)(C)O)=O)(O)=O,2,1,0,1,28,4.8e-05
G5,C(C)(CC1(C=C(C(C1)=O)CO)O)=O,2,1,0,1,45,4.8e-05
G5,C(C)(CC1(C(CO)=CC(C1)=O)O)=O,2,1,0,1,45,4.8e-05
G5,C1(C=C(C(C1C(C)(C)O)=O)CO)=O,2,2,0,2,45,9.499999999999999e-05
G5,C(C)(CC1(C(C(CO)=CC1)=O)O)=O,2,1,0,1,45,4.8e-05
G5,C1(CC=C(CO)C1(CC(C)=O)O)=O,2,1,0,1,45,4.8e-05
G5,C1C(C(C(C=1CO)=O)=O)C(C)(C)O,2,1,0,1,45,4.8e-05
G5,C(CC1(C(C(C(C1)O)=O)=C)O)(C)=O,4,1,0,1,45,4.8e-05
G5,C(CC1(C(C(CC1O)=O)=C)O)(C)=O,4,1,0,1,45,4.8e-05
G5,C=C1C(C(C(C)(C)O)C(C1=O)O)=O,4,2,0,2,45,9.499999999999999e-05
G5,C(C)(CC1(C(C(C(C1)=C)=O)O)O)=O,4,1,0,1,47,4.8e-05
G5,C1(C(C(C(C1)=C)(CC(C)=O)O)O)=O,4,1,0,1,47,4.8e-05
G5,C1(C(C(C(C1C(C)(C)O)=C)=O)O)=O,4,1,0,1,47,4.8e-05
G5,C(C)(CC1(C(C(C(C1)=O)=C)O)O)=O,4,1,0,1,45,4.8e-05
G5,C1(CC(C(C1O)=C)(CC(C)=O)O)=O,4,1,0,1,45,4.8e-05
G5,C1(C(C(C(C1C(C)(C)O)=O)=C)O)=O,4,2,0,2,45,9.499999999999999e-05
G5,C(CC1(C(C(C(C1)O)=C)=O)O)(C)=O,4,1,0,1,45,4.8e-05
G5,C1(CC(C(C1(CC(C)=O)O)=C)O)=O,4,1,0,1,45,4.8e-05
G5,C=C1C(C(C(C(C)(C)O)C1O)=O)=O,4,2,0,2,45,9.499999999999999e-05
G5,C(CC1(C=C(C=O)C(C1)O)O)(C)=O,4,1,0,1,45,4.8e-05
G5,C(C)(CC(C1C(CC(C=1)=O)O)O)=O,4,1,0,1,45,4.8e-05
G5,C1(C=C(C=O)C(C1C(C)(C)O)O)=O,4,2,0,2,45,9.499999999999999e-05
G5,C(C)(CC1(C(C(C=O)=CC1)O)O)=O,4,1,0,1,27,4.8e-05
G5,C1(C(C(C(CC(C)=O)O)=CC1)O)=O,4,1,0,1,27,4.8e-05
G5,C1(C(C(C=O)=CC1C(C)(C)O)O)=O,4,1,0,1,27,4.8e-05
G5,C(C)(CC1(C(C=C(C=O)C1)O)O)=O,4,1,0,1,45,4.8e-05
G5,C1(C(C=C(C(CC(C)=O)O)C1)O)=O,4,1,0,1,45,4.8e-05
G5,C1(C(C=C(C=O)C1C(C)(C)O)O)=O,4,1,0,1,45,4.8e-05
G5,C(CC1(C(C=O)=CC(C1)O)O)(C)=O,4,1,0,1,45,4.8e-05
G5,C(C)(CC(C1C(CC(C=1)O)=O)O)=O,4,1,0,1,45,4.8e-05
G5,C1C(C(C(C=1C=O)=O)C(C)(C)O)O,4,2,0,2,45,9.499999999999999e-05
G5,C(CC(C=C)O)(C(CC(C)=O)O)=O,4,1,0,1,27,4.8e-05
G5,C(C(CC(C=C)O)(CC(C)=O)O)=O,4,1,0,1,27,4.8e-05
G5,C=CC(C(C(C=O)=O)C(C)(C)O)O,4,2,0,2,27,9.499999999999999e-05
G5,C(CC(CC(C)=O)O)(C(C=C)O)=O,4,2,0,2,27,9.6e-05
G5,C(CC(C(C=C)O)(CC(C)=O)O)=O,4,1,0,1,27,4.8e-05
G5,C(C(C(C(C=C)O)=O)C(C)(C)O)=O,4,2,0,2,27,9.499999999999999e-05
G5,C(C(C(CC(C)=O)O)O)(CC=C)=O,4,3,0,3,28,0.000143
G5,C(C(C(CC(C)=O)(CC=C)O)O)=O,4,1,0,1,4,4.8e-05
G5,C(C(C=O)O)(C(C=C)C(C)(C)O)=O,4,1,0,1,4,4.8e-05
G5,C(C)(CC(C(CC(C=C)=O)O)O)=O,4,1,0,1,27,4.8e-05
G5,C(C(CC(C=C)(CC(C)=O)O)O)=O,4,1,0,1,27,4.8e-05
G5,C(C(C(C(C=C)=O)C(C)(C)O)O)=O,4,2,0,2,27,9.499999999999999e-05
G5,C1(C(C=CC1C(CC(C)=O)O)O)=O,8,1,0,1,45,4.8e-05
G5,C(C1C=CC(C1(CC(C)=O)O)O)=O,8,1,0,1,45,4.8e-05
G5,C1(CC=CC1(C(CC(C)=O)O)O)=O,4,1,0,1,45,4.8e-05
G5,C(C1(C=CCC1(CC(C)=O)O)O)=O,4,1,0,1,45,4.8e-05
G5,C(C1(C(C(C=C1)C(C)(C)O)=O)O)=O,4,1,0,1,45,4.8e-05
G5,C(C)(CC(C)(C1C=CC(O1)=O)O)=O,4,1,0,1,48,4.8e-05
G5,C(CC(C)(C)O)(C1C=CC(O1)=O)=O,2,1,0,1,48,4.8e-05
G5,C(C)(CC(CC1C=CC(O1)=O)O)=O,4,1,0,1,48,4.8e-05
G5,C(C(C(C)(C)O)C1C=CC(O1)=O)=O,4,2,0,2,48,9.499999999999999e-05
G5,C(C)(C1C(C=CO1)(CC(C)=O)O)=O,4,1,0,1,9,4.8e-05
G5,C(C)(CC(C)(C1C(C=CO1)=O)O)=O,4,3,0,3,28,0.000143
G5,C(CC(C)(C)O)(C1C(C=CO1)=O)=O,2,1,0,1,9,4.8e-05
G5,C(CC1C(C=CO1)(CC(C)=O)O)=O,4,1,0,1,45,4.8e-05
G5,C(C)(CC(CC1C(C=CO1)=O)O)=O,4,1,0,1,45,4.8e-05
G5,C(C(C(C)(C)O)C1C(C=CO1)=O)=O,4,2,0,2,45,9.499999999999999e-05
G5,C(CC1(C=CC(OCC1)=O)O)(C)=O,2,1,0,1,19,4.8e-05
G5,C1(C=CC(C(CO1)C(C)(C)O)=O)=O,2,2,0,2,19,9.499999999999999e-05
G5,C(C)(CC1(COC(C=CC1)=O)O)=O,2,1,0,1,48,4.8e-05
G5,C1(COC(C=CC1C(C)(C)O)=O)=O,2,1,0,1,48,4.8e-05
G5,C1(C(C(C)(C)O)OC(C=CC1)=O)=O,2,2,0,2,48,9.499999999999999e-05
G5,C1(CCOC=CC1(CC(C)=O)O)=O,2,1,0,1,45,4.8e-05
G5,C(CC1(C(C=COCC1)=O)O)(C)=O,2,1,0,1,45,4.8e-05
G5,C1OCC(C(C(C=1)=O)=O)C(C)(C)O,2,2,0,2,45,9.499999999999999e-05
G5,C(C)(CC1(C=COCC(C1)=O)O)=O,2,1,0,1,38,4.8e-05
G5,C(C)(CC1(COC=CC(C1)=O)O)=O,2,1,0,1,38,4.8e-05
G5,C1(COC=CC(C1C(C)(C)O)=O)=O,2,2,0,2,38,9.499999999999999e-05
G5,C1(C(C(C)(C)O)OC=CC(C1)=O)=O,2,2,0,2,38,9.499999999999999e-05
G5,C1(CC(C=CCO1)(CC(C)=O)O)=O,2,1,0,1,19,4.8e-05
G5,C1(C(C(C=CCO1)=O)C(C)(C)O)=O,2,2,0,2,19,9.499999999999999e-05
G5,C(CC1(C(C=CCOC1)=O)O)(C)=O,2,1,0,1,36,4.8e-05
G5,C1(COCC=CC1(CC(C)=O)O)=O,2,1,0,1,36,4.8e-05
G5,C1COC(C(C(C=1)=O)=O)C(C)(C)O,2,2,0,2,36,9.499999999999999e-05
G5,C1(CC=CC(CO1)(CC(C)=O)O)=O,2,1,0,1,48,4.8e-05
G5,C1(CC=CC(C(C(C)(C)O)O1)=O)=O,2,2,0,2,48,9.499999999999999e-05
G5,C(CC1(C=CC(COC1)=O)O)(C)=O,2,1,0,1,45,4.8e-05
G5,C1(C=CC(COC1C(C)(C)O)=O)=O,2,2,0,2,45,9.499999999999999e-05
G5,C(CC(C=C1C(CCO1)=O)O)(C)=O,4,1,0,1,45,4.8e-05
G5,C(CC1(C(OCC1)=CC=O)O)(C)=O,4,1,0,1,45,4.8e-05
G5,C(C=C1C(C(CO1)C(C)(C)O)=O)=O,4,2,0,2,45,9.499999999999999e-05
G5,C1(COC(C1)=CC(CC(C)=O)O)=O,4,1,0,1,45,4.8e-05
G5,C(C)(CC1(COC(C1)=CC=O)O)=O,4,1,0,1,45,4.8e-05
G5,C1(COC(C1C(C)(C)O)=CC=O)=O,4,2,0,2,45,9.499999999999999e-05
G5,C1(C(C(C)(C)O)OC(C1)=CC=O)=O,4,2,0,2,45,9.499999999999999e-05
G5,C(C(CC(C)=O)O)(C1C=CCO1)=O,4,1,0,1,39,4.8e-05
G5,C(C(CC(C)=O)(C1C=CCO1)O)=O,4,1,0,1,39,4.8e-05
G5,C(C1C=CC(C(CC(C)=O)O)O1)=O,8,1,0,1,40,4.8e-05
G5,C1(C(C(CC(C)=O)O)OC(C1)=C)=O,4,1,0,1,26,4.8e-05
G5,C(C1C(CC(C)=O)(CC(O1)=C)O)=O,4,1,0,1,26,4.8e-05
G5,C1(C(C=O)OC(C1C(C)(C)O)=C)=O,4,2,0,2,26,9.499999999999999e-05
G5,C(C)(CC(C1CC(C(O1)=C)=O)O)=O,4,1,0,1,14,4.8e-05
G5,C(C1CC(C(O1)=C)(CC(C)=O)O)=O,4,1,0,1,14,4.8e-05
G5,C(C1C(C(C(O1)=C)=O)C(C)(C)O)=O,4,2,0,2,14,9.499999999999999e-05
G5,C(CC(C1OCCC(C=1)=O)O)(C)=O,2,1,0,1,30,4.8e-05
G5,C(CC1(C=C(C=O)OCC1)O)(C)=O,2,1,0,1,30,4.8e-05
G5,C(C1OCC(C(C=1)=O)C(C)(C)O)=O,2,2,0,2,30,9.499999999999999e-05
G5,C1(COC(C(CC(C)=O)O)=CC1)=O,2,1,0,1,12,4.8e-05
G5,C(C)(CC1(COC(C=O)=CC1)O)=O,2,1,0,1,12,4.8e-05
G5,C1(COC(C=O)=CC1C(C)(C)O)=O,2,1,0,1,12,4.8e-05
G5,C1(C(C(C)(C)O)OC(C=O)=CC1)=O,2,2,0,2,12,9.499999999999999e-05
G5,C1(C(C(CC(C)=O)O)OC=CC1)=O,4,1,0,1,37,4.8e-05
G5,C(C1C(CC(C)=O)(CC=CO1)O)=O,4,1,0,1,37,4.8e-05
G5,C1(C(C=O)OC=CC1C(C)(C)O)=O,4,1,0,1,37,4.8e-05
G5,C(C)(CC(C1CC(C=CO1)=O)O)=O,4,1,0,1,37,4.8e-05
G5,C(C1CC(C=CO1)(CC(C)=O)O)=O,4,1,0,1,37,4.8e-05
G5,C(C1C(C(C=CO1)=O)C(C)(C)O)=O,4,2,0,2,37,9.499999999999999e-05
G5,C(C)(CC(C1CC(C(C=1)=O)O)O)=O,4,1,0,1,45,4.8e-05
G5,C(CC1(C=C(C=O)CC1O)O)(C)=O,4,1,0,1,45,4.8e-05
G5,C1(C(C=CC1CO)(CC(C)=O)O)=O,4,1,0,1,45,4.8e-05
G5,C(CC1(C(C=CC1CO)=O)O)(C)=O,4,1,0,1,45,4.8e-05
G5,C(C)(CC(C1C(C(CC=1)O)=O)O)=O,4,1,0,1,27,4.8e-05
G5,C(CC1(C(C=O)=CCC1O)O)(C)=O,4,1,0,1,27,4.8e-05
G5,C(C)(CC(CO)(C(C=C)O)O)=O,4,1,0,1,31,4.8e-05
G5,C(C(C(C)(C)O)O)(C(C=C)O)=O,4,2,0,2,31,9.499999999999999e-05
G5,C(C)(CC(C=C(CO)CO)O)=O,2,1,0,1,18,4.8e-05
G5,C(CC(C=CC(CO)O)O)(C)=O,8,1,0,1,46,4.8e-05
G5,C(C)(CC(C(C=C(C=O)C)=O)O)=O,4,1,0,1,45,4.8e-05
G5,C(C(C=C(C=O)C)(CC(C)=O)O)=O,4,1,0,1,45,4.8e-05
G5,C(C)(CC(C(C)=CC(C=O)=O)O)=O,4,1,0,1,45,4.8e-05
G5,C(C(CC(C)=O)O)(CC(C=O)=C)=O,2,1,0,1,45,4.8e-05
G5,C(C(CC(C)=O)(CC(C=O)=C)O)=O,2,1,0,1,45,4.8e-05
G5,C(C)(CC(C(CC(C=O)=O)=C)O)=O,2,1,0,1,45,4.8e-05
G5,C=C(C=O)C(C(C=O)=O)C(C)(C)O,2,1,0,1,45,4.8e-05
G5,C(C)(CC(C(C=CC=O)=O)O)=O,4,4,0,4,29,0.00018999999999999998
G5,C(C(C=CC=O)(CC(C)=O)O)=O,4,1,0,1,20,4.8e-05
G5,C(C)(CC(C=CC(C=O)=O)O)=O,4,1,0,1,20,4.8e-05
G5,C(C)(CC(C(C=C(C)CO)=O)O)=O,4,1,0,1,49,4.8e-05
G5,C(C(C=C(CO)C)(CC(C)=O)O)=O,4,1,0,1,49,4.8e-05
G5,C(C(CC(C)=O)O)(CC(CO)=C)=O,2,1,0,1,49,4.8e-05
G5,C(C(CC(CO)=C)(CC(C)=O)O)=O,2,1,0,1,49,4.8e-05
G5,C=C(CO)C(C(C=O)=O)C(C)(C)O,2,1,0,1,49,4.8e-05
G5,C(CO)(CC(C(CC(C)=O)O)=C)=O,2,1,0,1,16,4.8e-05
G5,C(C)(CC(CO)(CC(C=O)=C)O)=O,2,1,0,1,16,4.8e-05
G5,C(CO)(C(C(C=O)=C)C(C)(C)O)=O,2,1,0,1,16,4.8e-05
G5,C(C(C(C)(C)O)O)(CC(C=O)=C)=O,2,2,0,2,16,9.499999999999999e-05
G5,C(C)(CC(C(C)=CC(CO)=O)O)=O,4,1,0,1,16,4.8e-05
G5,C(CC(C=C(C=O)C)(CO)O)(C)=O,4,1,0,1,16,4.8e-05
G5,C(C=C(C=O)C)(C(C(C)(C)O)O)=O,4,2,0,2,16,9.499999999999999e-05
G5,C(C)(C(C(C(CC(C)=O)O)=C)O)=O,4,1,0,1,45,4.8e-05
G5,C(C)(CC(C)(C(C(C=O)=C)O)O)=O,4,1,0,1,45,4.8e-05
G5,C(CC(C)(C)O)(C(C(C=O)=C)O)=O,2,1,0,1,45,4.8e-05
G5,C(C)(CC(C(C=CC)=O)O)=O,4,1,0,1,28,4.8e-05
G5,C(C(C=CC)(CC(C)=O)O)=O,4,1,0,1,28,4.8e-05
G5,C(C(CC(C)=O)O)(CC=C)=O,2,1,0,1,28,4.8e-05
G5,C(C(CC=C)(CC(C)=O)O)=O,2,1,0,1,28,4.8e-05
G5,C=CC(C(C=O)=O)C(C)(C)O,2,1,0,1,28,4.8e-05
G5,C(CC(C=CC=O)(C)O)(C)=O,4,1,0,1,28,4.8e-05
G5,C(C)(CC(C=CC(C)=O)O)=O,4,1,0,1,28,4.8e-05
G5,C(C=CC(CC(C)(C)O)=O)=O,2,1,0,1,28,4.8e-05
G5,C(CC(C(CC(C)=O)O)=C)=O,2,1,0,1,28,4.8e-05
G5,C(C)(CC(CC(C=O)=C)O)=O,2,1,0,1,28,4.8e-05
G5,C(C(C(C=O)=C)C(C)(C)O)=O,2,1,0,1,28,4.8e-05
G5,C(C)(CC(C(C)=CC=O)O)=O,4,1,0,1,28,4.8e-05
G5,C(C)(CC(C=C(C=O)C)O)=O,4,1,0,1,28,4.8e-05
G5,C(C)(CC(C(C(CO)=O)=C)O)=O,2,3,0,3,25,0.000143
G5,C(CC(C(C=O)=C)(CO)O)(C)=O,2,1,0,1,9,4.8e-05
G5,C=C(C=O)C(C(C(C)(C)O)O)=O,2,2,0,2,9,9.499999999999999e-05
G5,C(C)(CC(C(C(CO)=O)=CC)O)=O,4,1,0,1,45,4.8e-05
G5,C(CC(C(C=O)=CC)(CO)O)(C)=O,4,1,0,1,45,4.8e-05
G5,C(C)=C(C(C(C(C)(C)O)O)=O)C=O,4,2,0,2,45,9.499999999999999e-05
G5,C(C)(CC(C(C(CO)=O)C=C)O)=O,4,2,0,2,45,9.6e-05
G5,C(C(C(C(C(C)(C)O)O)=O)C=C)=O,4,2,0,2,45,9.499999999999999e-05
G5,C(CC(CO)=CC(CC(C)=O)O)=O,4,1,0,1,46,4.8e-05
G5,C(C)(CC(CC(CO)=CC=O)O)=O,4,1,0,1,46,4.8e-05
G5,C(C(C(CO)=CC=O)C(C)(C)O)=O,4,1,0,1,46,4.8e-05
G5,C(C(C(C=C)(CC(C)=O)O)O)=O,4,2,0,2,27,9.499999999999999e-05
G5,C(C)(CC(C(C(C=CC)=O)O)O)=O,8,3,0,3,28,0.000143
G5,C(C(C(C=CC)(CC(C)=O)O)O)=O,8,1,0,1,28,4.8e-05
G5,C(CC(C(C(CC(C)=O)O)O)=C)=O,4,1,0,1,6,4.8e-05
G5,C(C(C(CC(CC(C)=O)O)=C)O)=O,4,1,0,1,6,4.8e-05
G5,C(C(C(C(C=O)O)=C)C(C)(C)O)=O,4,1,0,1,6,4.8e-05
G5,C(C)(CC(C(C(C)=CC=O)O)O)=O,8,1,0,1,6,4.8e-05
G5,C(C(C(C)=CC(CC(C)=O)O)O)=O,8,1,0,1,6,4.8e-05
G5,C(CC(C=CC)(C(CO)O)O)(C)=O,8,1,0,1,28,4.8e-05
G5,C(C)(CC(C(CO)O)(CC=C)O)=O,4,1,0,1,28,4.8e-05
G5,C(C(CO)O)(C(C=C)C(C)(C)O)=O,4,1,0,1,28,4.8e-05
G5,C(C)(CC(CC(C(CO)O)=C)O)=O,4,1,0,1,27,4.8e-05
G5,C(C(C(C(CO)O)=C)C(C)(C)O)=O,4,1,0,1,27,4.8e-05
G5,C(CC(C=C(C)C(CO)O)O)(C)=O,8,1,0,1,46,4.8e-05
G5,C(C)(CC(C(C(CO)=C)=O)O)=O,2,1,0,1,49,4.8e-05
G5,C(C(C(CO)=C)(CC(C)=O)O)=O,2,1,0,1,49,4.8e-05
G5,C(CC(C(CO)=C)(CO)O)(C)=O,2,1,0,1,49,4.8e-05
G5,C=C(C(C(C(C)(C)O)O)=O)CO,2,2,0,2,49,9.499999999999999e-05
G5,C(C)(CC(C(C(C=O)=C)O)O)=O,4,1,0,1,16,4.8e-05
G5,C(C(C(C(CC(C)=O)O)=C)O)=O,4,1,0,1,16,4.8e-05
G5,C(C)(CC(C=C(C=O)CO)O)=O,4,1,0,1,18,4.8e-05
G5,C(C)(CC(C(CO)=CC=O)O)=O,4,1,0,1,18,4.8e-05
G5,C(C)(CC(C=C)O)=O,2,1,0,1,27,4.8e-05
G5,C(CC(C(C(C(C)O)=C)=O)O)(C)=O,4,1,0,1,4,4.8e-05
G5,C(C(C(C(C)O)=C)(CC(C)=O)O)=O,4,1,0,1,4,4.8e-05
G5,C(C)(CC(C(C(CO)=CC)=O)O)=O,4,1,0,1,27,4.8e-05
G5,C(C(C(CO)=CC)(CC(C)=O)O)=O,4,1,0,1,27,4.8e-05
G5,C(CC(C(C(C=C)CO)=O)O)(C)=O,4,1,0,1,28,4.8e-05
G5,C(CC(C=O)(C(C=C)CO)O)(C)=O,4,1,0,1,28,4.8e-05
G5,C(CC(C(CC(C)=O)O)=CCO)=O,4,1,0,1,3,4.8e-05
G5,C(C)(CC(CC(C=O)=CCO)O)=O,4,1,0,1,3,4.8e-05
G5,C(C(C(C=O)=CCO)C(C)(C)O)=O,4,1,0,1,3,4.8e-05
G5,C(CC(C(CCO)=CC=O)O)(C)=O,4,1,0,1,46,4.8e-05
G5,C(CC(C=C(C=O)CCO)O)(C)=O,4,1,0,1,46,4.8e-05
G5,C(C)(CC(CCO)(C(C=C)O)O)=O,4,1,0,1,27,4.8e-05
G5,C(C(CO)C(C)(C)O)(C(C=C)O)=O,4,2,0,2,27,9.499999999999999e-05
G5,C(CC(C(C(C)O)=C)(CO)O)(C)=O,4,1,0,1,4,4.8e-05
G5,C=C(C(C(C(C)(C)O)O)=O)C(C)O,4,2,0,2,4,9.499999999999999e-05
G5,C(CC(C(CO)=CC)(CO)O)(C)=O,4,1,0,1,27,4.8e-05
G5,C(C)=C(C(C(C(C)(C)O)O)=O)CO,4,2,0,2,27,9.499999999999999e-05
G5,C(C)(CC(CO)(C(C=C)CO)O)=O,4,1,0,1,28,4.8e-05
G5,C(C(C(C)(C)O)O)(C(C=C)CO)=O,4,2,0,2,28,9.499999999999999e-05
G5,C(C)(CC(CC(CO)=CCO)O)=O,4,1,0,1,3,4.8e-05
G5,C(C(C(CO)=CCO)C(C)(C)O)=O,4,1,0,1,3,4.8e-05
G5,C(CC(C=C(CO)CCO)O)(C)=O,4,1,0,1,46,4.8e-05
G5,C(CC(C=C(CO)C)(CO)O)(C)=O,4,1,0,1,49,4.8e-05
G5,C(CO)(C)=CC(C(C(C)(C)O)O)=O,4,2,0,2,49,9.499999999999999e-05
G5,C(C)(CC(CO)(CC(CO)=C)O)=O,2,1,0,1,49,4.8e-05
G5,C(CO)(C(C(CO)=C)C(C)(C)O)=O,2,1,0,1,49,4.8e-05
G5,C(C(C(C)(C)O)O)(CC(CO)=C)=O,2,2,0,2,49,9.499999999999999e-05
G5,C(C)(CC(C)(C(C(CO)=C)O)O)=O,4,1,0,1,49,4.8e-05
G5,C(CC(C)(C)O)(C(C(CO)=C)O)=O,2,1,0,1,49,4.8e-05
G5,C(CC(C=CC)(CO)O)(C)=O,4,1,0,1,28,4.8e-05
G5,C(C)=CC(C(C(C)(C)O)O)=O,4,2,0,2,28,9.499999999999999e-05
G5,C(C)(CC(CO)(CC=C)O)=O,2,1,0,1,28,4.8e-05
G5,C(CO)(C(C=C)C(C)(C)O)=O,2,1,0,1,28,4.8e-05
G5,C(C(C(C)(C)O)O)(CC=C)=O,2,2,0,2,28,9.499999999999999e-05
G5,C(C)(CC(C)(C(C=C)O)O)=O,4,1,0,1,28,4.8e-05
G5,C(CC(C)(C)O)(C(C=C)O)=O,2,1,0,1,28,4.8e-05
G5,C(C)(CC(CC(CO)=C)O)=O,2,1,0,1,28,4.8e-05
G5,C(C(C(CO)=C)C(C)(C)O)=O,2,1,0,1,28,4.8e-05
G5,C(C)(CC(C=C(C)CO)O)=O,4,1,0,1,28,4.8e-05
G5,C(CC(C=C(C=O)C(C)O)O)(C)=O,8,1,0,1,28,4.8e-05
G5,C(CC(C(C(C)O)=CC=O)O)(C)=O,8,1,0,1,28,4.8e-05
G5,C(C)(CC(C(C(C=O)=CC)O)O)=O,8,1,0,1,45,4.8e-05
G5,C(C(C(C(CC(C)=O)O)=CC)O)=O,8,1,0,1,45,4.8e-05
G5,C(C(C=C)C(C(CC(C)=O)O)O)=O,8,2,0,2,45,9.499999999999999e-05
G5,C(C)(CC(C(C=C)C(C=O)O)O)=O,8,1,0,1,45,4.8e-05
G5,C(CC=CC(C(CC(C)=O)O)O)=O,8,1,0,1,43,4.8e-05
G5,C(C(C=CCC(CC(C)=O)O)O)=O,8,1,0,1,43,4.8e-05
G5,C(C(C=CC(C=O)O)C(C)(C)O)=O,8,1,0,1,43,4.8e-05
G5,C(C)(CC(C(CC=CC=O)O)O)=O,8,1,0,1,27,4.8e-05
G5,C(C(CC=CC(CC(C)=O)O)O)=O,8,1,0,1,27,4.8e-05
G5,C(C)(CC(C=CC)O)=O,4,1,0,1,45,4.8e-05
G5,C(C)(CC(CC=C)O)=O,2,1,0,1,45,4.8e-05
G5,C(C(C=C)C(C)(C)O)=O,2,1,0,1,45,4.8e-05
G5,C(C)(CC(C(C(CO)=C)O)O)=O,4,1,0,1,49,4.8e-05
G5,C(C)(CC(C(C=C)(CO)O)O)=O,4,1,0,1,29,4.8e-05
G5,C(C)(CC(C(C(C)=O)(C=C)O)O)=O,4,2,0,2,27,9.6e-05
G5,C(C(C=C)(C(C)(CC(C)=O)O)O)=O,4,2,0,2,27,9.499999999999999e-05
G5,C(C(C(CC(C)(C)O)=O)(C=C)O)=O,2,1,0,1,27,4.8e-05
G5,C(C)(CC(C)(C(C=C)(CO)O)O)=O,4,1,0,1,27,4.8e-05
G5,C(CC(C)(C)O)(C(C=C)(CO)O)=O,2,1,0,1,27,4.8e-05
G5,C(C(C=C)(C(CC(C)=O)O)O)=O,4,4,0,4,29,0.00019099999999999998
G5,C(C(C(C(CC(C)=O)O)=C)O)(O)=O,4,1,0,1,33,4.8e-05
G5,C(C)(CC(CC1OCC(C=1)=O)O)=O,2,1,0,1,48,4.8e-05
G5,C(CC1OCC(C=1)(CC(C)=O)O)=O,2,1,0,1,48,4.8e-05
G5,C(C(C1OCC(C=1)=O)C(C)(C)O)=O,2,2,0,2,48,9.499999999999999e-05
G5,C(CC1OC(C(C=1)=O)C(C)(C)O)=O,2,2,0,2,48,9.499999999999999e-05
G5,C(C)(CC(C1C(C=C(C)O1)=O)O)=O,4,1,0,1,26,4.8e-05
G5,C(C1C(C=C(C)O1)(CC(C)=O)O)=O,4,1,0,1,26,4.8e-05
G5,C(C)(CC(C(C(C=C)O)O)O)=O,8,1,0,1,27,4.8e-05
G5,C(C1CC(C(O1)O)(CC(C)=O)O)=O,8,1,0,1,0,4.8e-05
G5,C(C)(CC(C1CC(C(O)O1)=O)O)=O,8,1,0,1,0,4.8e-05
G5,C1(C(OC(C=O)C1C(C)(C)O)O)=O,8,2,0,2,0,9.499999999999999e-05
G5,C(C)(CC1(C(O)OC(C)C1)O)=O,8,1,0,1,45,4.8e-05
G5,C1(C(O)OC(C)C1C(C)(C)O)=O,8,2,0,2,45,9.499999999999999e-05
G5,C(C)(CC(C1COC(C1O)O)O)=O,16,1,0,1,27,4.8e-05
G5,C(C)(CC(C1C(CC(O)O1)O)O)=O,16,1,0,1,0,4.8e-05
G5,C(C)(CC(C1(CC(CO1)O)O)O)=O,8,1,0,1,0,4.8e-05
G5,C(C)(CC1(C(O)OCC1O)O)=O,8,1,0,1,0,4.8e-05
G5,C(C)(CC1(COC(C)(C1O)O)O)=O,8,1,0,1,0,4.8e-05
G5,C1(C(C(C)(C)O)OC(C)(C1O)O)=O,8,2,0,2,0,9.499999999999999e-05
G5,C(C)(CC1(COC(C1O)O)O)=O,8,1,0,1,5,4.8e-05
G5,C1(C(C(C)(C)O)OC(C1O)O)=O,8,2,0,2,5,9.499999999999999e-05
G5,C(C)(CC(C1CC(C(O)O1)O)O)=O,16,1,0,1,27,4.8e-05
G5,C(C)(CC1(C(C)OC(C1O)O)O)=O,16,1,0,1,0,4.8e-05
G5,C(C)(CC(C1(COC(C1)O)O)O)=O,8,1,0,1,27,4.8e-05
G5,C(C)(CC1(CC(O)OCC1O)O)=O,8,2,0,2,27,9.499999999999999e-05
G5,C1(C(COC(C1C(C)(C)O)O)O)=O,8,2,0,2,27,9.499999999999999e-05
G5,C(C)(CC1(CCOC(C1O)O)O)=O,8,2,0,2,27,9.499999999999999e-05
G5,C1(C(C(O)OCC1C(C)(C)O)O)=O,8,2,0,2,27,9.499999999999999e-05
G5,C(CC(C(CCCO)=O)O)(C)=O,2,1,0,1,55,4.8e-05
G5,C(C(CCCO)(CC(C)=O)O)=O,2,1,0,1,55,4.8e-05
G5,C(C(C(CCO)C(C)(C)O)=O)=O,2,1,0,1,55,4.8e-05
G5,C(CC(C(CCCCO)=O)O)(C)=O,2,1,0,1,46,4.8e-05
G5,C(C(CCCCO)(CC(C)=O)O)=O,2,1,0,1,46,4.8e-05
G5,C(C(C(CCCO)C(C)(C)O)=O)=O,2,1,0,1,46,4.8e-05
G5,C(CC(C(CCC(C)O)=O)O)(C)=O,4,1,0,1,27,4.8e-05
G5,C(C(CCC(C)O)(CC(C)=O)O)=O,4,1,0,1,27,4.8e-05
G5,C(C(C(CC(C)O)C(C)(C)O)=O)=O,4,1,0,1,27,4.8e-05
G5,C(C)(CC(CO)(CCCO)O)=O,2,1,0,1,55,4.8e-05
G5,C(C(C(C)(C)O)O)(CCCO)=O,2,2,0,2,55,9.499999999999999e-05
G5,C(CO)(C(CCO)C(C)(C)O)=O,2,1,0,1,55,4.8e-05
G5,C(C)(CC(CO)(CCCCO)O)=O,2,1,0,1,27,4.8e-05
G5,C(C(C(C)(C)O)O)(CCCCO)=O,2,2,0,2,27,9.499999999999999e-05
G5,C(CO)(C(CCCO)C(C)(C)O)=O,2,1,0,1,27,4.8e-05
G5,C(C)(CC(CO)(CCC(C)O)O)=O,4,1,0,1,27,4.8e-05
G5,C(C(C(C)(C)O)O)(CCC(C)O)=O,4,2,0,2,27,9.499999999999999e-05
G5,C(CO)(C(CC(C)O)C(C)(C)O)=O,4,1,0,1,27,4.8e-05
G5,C(CC(C(CC(C)=O)O)C(C)O)=O,8,1,0,1,27,4.8e-05
G5,C(C(CC(CC(C)=O)O)C(C)O)=O,8,1,0,1,27,4.8e-05
G5,C(C(C(C)O)C(C=O)C(C)(C)O)=O,8,1,0,1,27,4.8e-05
G5,C(C)(CC1(C=CC(C1O)=O)O)=O,4,1,0,1,47,4.8e-05
G5,C(CC=CC(CC(C)=O)O)=O,4,1,0,1,28,4.8e-05
G5,C(C)(CC(CC=CC=O)O)=O,4,1,0,1,28,4.8e-05
G5,C(C(C=CC=O)C(C)(C)O)=O,4,1,0,1,28,4.8e-05
G5,C(CCC(C(C(C=C)O)O)=O)=O,4,4,0,4,7,0.00018999999999999998
G5,C(CC(C(CO)=O)C(C=C)O)=O,4,1,0,1,7,4.8e-05
G5,C(C(CC(CO)=O)C(C=C)O)=O,4,1,0,1,7,4.8e-05
G5,C(CCC(C(C(C=CC)O)O)=O)=O,8,2,0,2,7,9.499999999999999e-05
G5,C(CC(C(CO)=O)C(C=CC)O)=O,8,1,0,1,7,4.8e-05
G5,C(C(CC(CO)=O)C(C=CC)O)=O,8,1,0,1,7,4.8e-05
G5,C(CCC=O)(C(C(CC=C)O)O)=O,4,2,0,2,7,9.499999999999999e-05
G5,C(CO)(C(C(CC=C)O)CC=O)=O,4,1,0,1,7,4.8e-05
G5,C(C(C(CC=C)O)CC(CO)=O)=O,4,1,0,1,7,4.8e-05
G5,C(C(C=C)C(CCC=O)(CO)O)=O,4,1,0,1,7,4.8e-05
G5,C(C(C=C)C(CCC(CO)=O)O)=O,4,1,0,1,7,4.8e-05
G5,C(C(C(CCC=O)=O)C(C=C)O)=O,4,2,0,2,44,9.499999999999999e-05
G5,C(CC(C(CC=O)C(C=C)O)=O)=O,4,1,0,1,44,4.8e-05
G5,C(CC(CC(C=O)C(C=C)O)=O)=O,4,1,0,1,44,4.8e-05
G5,C(C(C(CCC=O)=O)C(C=CC)O)=O,8,2,0,2,44,9.499999999999999e-05
G5,C(CC(C(CC=O)C(C=CC)O)=O)=O,8,1,0,1,44,4.8e-05
G5,C(CC(CC(C=O)C(C=CC)O)=O)=O,8,1,0,1,44,4.8e-05
G5,C(C(C(CCC=O)=O)C(CC=C)O)=O,4,2,0,2,44,9.499999999999999e-05
G5,C(C(C(CC=C)O)CC=O)(CC=O)=O,4,1,0,1,44,4.8e-05
G5,C(C(C(CC=C)O)CC(CC=O)=O)=O,4,1,0,1,44,4.8e-05
G5,C(C(C=C)C(CC(CCC=O)=O)O)=O,4,1,0,1,44,4.8e-05
G5,C(C(C=C)C(CCC=O)(CC=O)O)=O,4,1,0,1,44,4.8e-05
G5,C(C(C=C)C(CCC(CC=O)=O)O)=O,4,1,0,1,44,4.8e-05
G5,C(C(C(C(C)=O)C(C=C)O)O)=O,8,2,0,2,27,9.499999999999999e-05
G5,C(C(CC(CC(C=C)O)=O)O)=O,4,2,0,2,27,9.499999999999999e-05
G5,C(C(C(C(C)=O)C(C=CC)O)O)=O,16,2,0,2,27,9.499999999999999e-05
G5,C(C(CC(CC(C=CC)O)=O)O)=O,8,1,0,1,27,4.8e-05
G5,C(C)(C(C(CC=C)O)C(C=O)O)=O,8,2,0,2,27,9.499999999999999e-05
G5,C(CC(C=O)O)(CC(CC=C)O)=O,4,1,0,1,27,4.8e-05
G5,C(C(C=C)C(C)(CC(C=O)O)O)=O,8,1,0,1,27,4.8e-05
G5,C=CC(C(C(C=CCO)=O)O)O,8,3,0,3,11,0.000143
G5,C(C)=CC(C(C(C=CCO)=O)O)O,16,2,0,2,11,9.499999999999999e-05
G5,C(CC(C(C(C=CCO)=O)O)O)=C,8,2,0,2,11,9.499999999999999e-05
G5,C(C(C=C)C(C=CCO)(CO)O)=O,8,1,0,1,11,4.8e-05
G5,C(C(C(C=CCO)=O)C(C=C)O)=O,8,2,0,2,0,9.499999999999999e-05
G5,C(C(C(C=CCO)=O)C(C=CC)O)=O,16,2,0,2,0,9.499999999999999e-05
G5,C(C(C(C=CCO)=O)C(CC=C)O)=O,8,2,0,2,0,9.499999999999999e-05
G5,C(C(C=C)C(CC(C=CCO)=O)O)=O,8,1,0,1,0,4.8e-05
G5,C(C(C=C)C(C=CCO)(CC=O)O)=O,8,1,0,1,0,4.8e-05
G5,C(OCC(CC(COC=O)=O)O)=O,2,1,0,1,35,4.8e-05
G5,C(OCC(C(C(C)=O)OC=O)O)=O,4,2,0,2,35,9.499999999999999e-05
G5,C(OCC(C)(C(C=O)OC=O)O)=O,4,2,0,2,35,9.499999999999999e-05
G5,C(CCC(CC(COC=O)=O)O)=O,2,1,0,1,35,4.8e-05
G5,C(CCC(C(C(C)=O)OC=O)O)=O,4,2,0,2,35,9.499999999999999e-05
G5,C(C(C(C)(COC=O)O)CC=O)=O,4,1,0,1,35,4.8e-05
G5,C(OCC(CC(C=CCO)O)=O)=O,4,1,0,1,35,4.8e-05
G5,C(OC(C(C)=O)C(C=CCO)O)=O,8,2,0,2,35,9.499999999999999e-05
G5,C(OCC(CC(C(C=C)O)O)=O)=O,4,1,0,1,35,4.8e-05
G5,C(OC(C(C)=O)C(C(C=C)O)O)=O,8,2,0,2,35,9.499999999999999e-05
G5,C(OCC(CC1(C=COC1)O)=O)=O,2,1,0,1,35,4.8e-05
G5,C(OC(C(C)=O)C1(C=COC1)O)=O,4,2,0,2,35,9.499999999999999e-05
G5,C(OCC(C)(C1C(C=CO1)=O)O)=O,4,2,0,2,35,9.499999999999999e-05
G5,C(COC=O)(CC(C(CC)=O)O)=O,2,1,0,1,35,4.8e-05
G5,C(C(C(C(C)=O)OC=O)O)(CC)=O,4,2,0,2,35,9.499999999999999e-05
G5,C(C(CC)(CC(COC=O)=O)O)=O,2,1,0,1,35,4.8e-05
G5,C(C(CC)(C(C(C)=O)OC=O)O)=O,4,2,0,2,35,9.499999999999999e-05
G5,C(OCC(C)(C(C(C=O)=O)C)O)=O,4,1,0,1,35,4.8e-05
G5,C(OCC(CC(C=C)O)=O)=O,2,1,0,1,35,4.8e-05
G5,C(OC(C(C)=O)C(C=C)O)=O,4,2,0,2,35,9.499999999999999e-05
G5,C(OCC(CC(C=CC)O)=O)=O,4,1,0,1,35,4.8e-05
G5,C(OC(C(C)=O)C(C=CC)O)=O,8,2,0,2,35,9.499999999999999e-05
G5,C(OCC(CC(CC=C)O)=O)=O,2,1,0,1,35,4.8e-05
G5,C(OC(C(C)=O)C(CC=C)O)=O,4,2,0,2,35,9.499999999999999e-05
G5,C(OCC(C)(C(C=O)C=C)O)=O,4,1,0,1,35,4.8e-05
G5,C(COC(C(CO)=O)C(C=C)O)=O,4,2,0,2,27,9.499999999999999e-05
G5,C(COCC(C(C(C=C)O)O)=O)=O,4,2,0,2,27,9.499999999999999e-05
G5,C(C(C(C=C)O)OCC(CO)=O)=O,4,2,0,2,27,9.499999999999999e-05
G5,C(COC(C(CC(C=C)O)=O)O)=O,4,1,0,1,27,4.8e-05
G5,C(C(C(C=C)O)OC(C(C)=O)O)=O,8,2,0,2,27,9.499999999999999e-05
G5,C(C(O)OCC(CC(C=C)O)=O)=O,4,1,0,1,27,4.8e-05
G5,C(C(O)OC(C(C)=O)C(C=C)O)=O,8,2,0,2,27,9.499999999999999e-05
G5,C(OCC(C(C=O)OC=O)O)=O,4,2,0,2,28,9.499999999999999e-05
G5,C(C(C(COC(C)=O)O)OC=O)=O,4,2,0,2,28,9.499999999999999e-05
G5,C(OCC(C(C=O)OC(C)=O)O)=O,4,2,0,2,28,9.499999999999999e-05
G5,C(CCC(C(C=O)OC=O)O)=O,4,2,0,2,27,9.499999999999999e-05
G5,C(C(C(COC=O)O)CC=O)=O,4,1,0,1,27,4.8e-05
G5,C(OC(C=O)C(C=CCO)O)=O,8,2,0,2,28,9.499999999999999e-05
G5,C(C(CO)(C(C=O)OC=O)O)(O)=O,4,2,0,2,33,9.499999999999999e-05
G5,C(OCC(C(C(C(O)=O)=O)O)O)=O,4,2,0,2,33,9.499999999999999e-05
G5,C(CC(C)(C(C=O)OC=O)O)(O)=O,4,2,0,2,6,9.499999999999999e-05
G5,C(OCC(CC(CC(O)=O)=O)O)=O,2,1,0,1,6,4.8e-05
G5,C(OCC(C(C(O)=O)C(C)=O)O)=O,4,2,0,2,6,9.499999999999999e-05
G5,C(OC(C=O)C(C=CC(O)=O)O)=O,8,2,0,2,18,9.499999999999999e-05
G5,C1(C(CCO1)(C(C=O)OC=O)O)=O,4,2,0,2,28,9.499999999999999e-05
G5,C(OCC(C1C(C(OC1)=O)=O)O)=O,4,2,0,2,28,9.499999999999999e-05
G5,C1(CC(CO1)(C(C=O)OC=O)O)=O,4,2,0,2,28,9.499999999999999e-05
G5,C(OCC(C1C(OCC1=O)=O)O)=O,4,2,0,2,28,9.499999999999999e-05
G5,C(OCC(C1C(CC(O1)=O)=O)O)=O,4,2,0,2,28,9.499999999999999e-05
G5,C(OC(C=O)C(C(C=C)O)O)=O,8,2,0,2,28,9.499999999999999e-05
G5,C(OC(C=O)C1(C=COC1)O)=O,4,2,0,2,28,9.499999999999999e-05
G5,C(OCC(C1C(C=CO1)=O)O)=O,4,2,0,2,28,9.499999999999999e-05
G5,C(OC(C=O)C(C(O)=O)(C=C)O)=O,4,2,0,2,7,9.499999999999999e-05
G5,C(OC(C=O)C(C(C)(CO)O)O)=O,8,2,0,2,11,9.499999999999999e-05
G5,C(C(C)(C(C=O)OC=O)O)(CC)=O,4,2,0,2,28,9.499999999999999e-05
G5,C(C)(C(CC)(C(C=O)OC=O)O)=O,4,2,0,2,28,9.499999999999999e-05
G5,C(OCC(CC(C(CC)=O)=O)O)=O,2,1,0,1,28,4.8e-05
G5,C(OCC(C(C(C(C)=O)=O)C)O)=O,4,1,0,1,28,4.8e-05
G5,C(C(C(C)(CC(C)=O)O)OC=O)=O,4,2,0,2,28,9.499999999999999e-05
G5,C(OCC(CC(CC(C)=O)=O)O)=O,2,1,0,1,28,4.8e-05
G5,C(OCC(C(C(C)=O)C(C)=O)O)=O,2,2,0,2,28,9.499999999999999e-05
G5,C(CC(C)C(C(C=O)OC=O)O)=O,8,2,0,2,28,9.499999999999999e-05
G5,C(C(C)CC(C(C=O)OC=O)O)=O,8,2,0,2,28,9.499999999999999e-05
G5,C(OCC(C(C=O)C(C=O)C)O)=O,8,1,0,1,28,4.8e-05
G5,C(C(C(C=O)OC=O)O)(CC)=O,4,2,0,2,28,9.499999999999999e-05
G5,C(C(CC)(C(C=O)OC=O)O)=O,4,2,0,2,28,9.499999999999999e-05
G5,C(OCC(C(C(C=O)=O)C)O)=O,4,1,0,1,28,4.8e-05
G5,C(OC(C=O)C(C(C=O)C=O)O)=O,4,2,0,2,1,9.499999999999999e-05
G5,C(C(CC)(C(C=O)OC=O)O)(O)=O,4,2,0,2,28,9.499999999999999e-05
G5,C(OCC(C(C(C(O)=O)=O)C)O)=O,4,1,0,1,28,4.8e-05
G5,C(OC(C=O)C(C(C=CC)=O)O)=O,8,2,0,2,28,9.499999999999999e-05
G5,C(OC(C=O)C(C=O)(C=CC)O)=O,8,2,0,2,28,9.499999999999999e-05
G5,C(OC(C=O)C(C(CC=C)=O)O)=O,4,2,0,2,28,9.499999999999999e-05
G5,C(OC(C=O)C(C=O)(CC=C)O)=O,4,2,0,2,28,9.499999999999999e-05
G5,C(OCC(C(C=C)C(C=O)=O)O)=O,4,1,0,1,28,4.8e-05
G5,C(OC(C=O)C(C=CC=O)(C)O)=O,8,2,0,2,28,9.499999999999999e-05
G5,C(OC(C=O)C(C=CC(C)=O)O)=O,8,2,0,2,28,9.499999999999999e-05
G5,C(OCC(CC(C=CC=O)=O)O)=O,4,1,0,1,28,4.8e-05
G5,C(OC(C=O)C(C(CC=O)=C)O)=O,4,2,0,2,28,9.499999999999999e-05
G5,C(OC(C=O)C(CC(C=O)=C)O)=O,4,2,0,2,28,9.499999999999999e-05
G5,C(OCC(C(C=O)C(C=O)=C)O)=O,4,1,0,1,28,4.8e-05
G5,C(OC(C=O)C(C(C)=CC=O)O)=O,8,2,0,2,28,9.499999999999999e-05
G5,C(OC(C=O)C(C=C(C=O)C)O)=O,8,2,0,2,28,9.499999999999999e-05
G5,C(OC(C=O)C(C=C)O)=O,4,2,0,2,28,9.499999999999999e-05
G5,C(OC(C=O)C(C=CC)(CO)O)=O,8,2,0,2,28,9.499999999999999e-05
G5,C(OCC(C(C(C=CC)=O)O)O)=O,8,2,0,2,28,9.499999999999999e-05
G5,C(OC(C=O)C(CO)(CC=C)O)=O,4,2,0,2,28,9.499999999999999e-05
G5,C(OCC(C(C(CO)=O)C=C)O)=O,4,1,0,1,28,4.8e-05
G5,C(OCC(C(C(CC=C)=O)O)O)=O,4,2,0,2,28,9.499999999999999e-05
G5,C(OC(C=O)C(C)(C(C=C)O)O)=O,8,2,0,2,28,9.499999999999999e-05
G5,C(OCC(CC(C(C=C)O)=O)O)=O,4,1,0,1,28,4.8e-05
G5,C(C(C(CC(CO)=C)O)OC=O)=O,4,2,0,2,28,9.499999999999999e-05
G5,C(OCC(C(C=O)C(CO)=C)O)=O,4,1,0,1,28,4.8e-05
G5,C(OC(C=O)C(C=C(C)CO)O)=O,8,2,0,2,28,9.499999999999999e-05
G5,C(OC(C=O)C(C=CC)O)=O,8,2,0,2,28,9.499999999999999e-05
G5,C(OC(C=O)C(CC=C)O)=O,4,2,0,2,28,9.499999999999999e-05
G5,C(OCC(C(C=O)C=C)O)=O,4,1,0,1,28,4.8e-05
G5,C(OC(C=O)C(C=CCC=O)O)=O,8,2,0,2,28,9.499999999999999e-05
G5,C(OC(C=O)C(CC=CC=O)O)=O,8,2,0,2,28,9.499999999999999e-05
G5,C(OCC(C(C=O)C=CC=O)O)=O,8,1,0,1,28,4.8e-05
G5,C(CO)(OC(C=O)C(C=C)O)=O,4,2,0,2,40,9.499999999999999e-05
G5,C(CO)(OC(C=O)C(C=CC)O)=O,8,2,0,2,40,9.499999999999999e-05
G5,C(C(C(CC=C)O)OC(CO)=O)=O,4,2,0,2,40,9.499999999999999e-05
G5,C(C(C=C)C(COC(CO)=O)O)=O,4,1,0,1,40,4.8e-05
G5,C(CCC(C(C=O)OC(C)=O)O)=O,4,2,0,2,28,9.499999999999999e-05
G5,C(C)(OCC(C(C=O)CC=O)O)=O,4,1,0,1,28,4.8e-05
G5,C(C)(OC(C=O)C(C=CCO)O)=O,8,2,0,2,28,9.499999999999999e-05
G5,C(C(C(C(C=C)O)O)OC(C)=O)=O,8,2,0,2,28,9.499999999999999e-05
G5,C(C)(OC(C=O)C1(C=COC1)O)=O,4,2,0,2,28,9.499999999999999e-05
G5,C(C)(OCC(C1C(C=CO1)=O)O)=O,4,2,0,2,28,9.499999999999999e-05
G5,C(C(C(C=O)OC(C)=O)O)(CC)=O,4,2,0,2,28,9.499999999999999e-05
G5,C(C)(OC(C=O)C(C=O)(CC)O)=O,4,2,0,2,28,9.499999999999999e-05
G5,C(C)(OCC(C(C(C=O)=O)C)O)=O,4,1,0,1,28,4.8e-05
G5,C(C)(OC(C=O)C(C=C)O)=O,4,2,0,2,28,9.499999999999999e-05
G5,C(C)(OC(C=O)C(C=CC)O)=O,8,2,0,2,28,9.499999999999999e-05
G5,C(C(C(CC=C)O)OC(C)=O)=O,4,2,0,2,28,9.499999999999999e-05
G5,C(C(C=C)C(COC(C)=O)O)=O,4,1,0,1,28,4.8e-05
G5,C(C(C(C=C)O)O)(C(CCO)O)=O,8,2,0,2,31,9.499999999999999e-05
G5,C(CC(C(C=O)=O)C1(C=COC1)O)=O,4,1,0,1,20,4.8e-05
G5,C(C(CC(C=O)=O)C1(C=COC1)O)=O,4,1,0,1,20,4.8e-05
G5,C(CCC(C(C1C(C=CO1)=O)O)=O)=O,4,2,0,2,20,9.499999999999999e-05
G5,C(CCC(C=O)(C1C(C=CO1)=O)O)=O,4,2,0,2,20,9.499999999999999e-05
G5,C1OC(C(C=1)=O)C(CCC(C=O)=O)O,4,2,0,2,20,9.499999999999999e-05
G5,C(CC(C(C=O)=O)C(C=C)O)=O,4,2,0,2,27,9.499999999999999e-05
G5,C(C(CC(C=O)=O)C(C=C)O)=O,4,1,0,1,20,4.8e-05
G5,C(CC(C(C=O)=O)C(C=CC)O)=O,8,1,0,1,20,4.8e-05
G5,C(C(CC(C=O)=O)C(C=CC)O)=O,8,1,0,1,20,4.8e-05
G5,C(CC(C(C=O)=O)C(CC=C)O)=O,4,1,0,1,20,4.8e-05
G5,C(C(C(CC=C)O)CC(C=O)=O)=O,4,1,0,1,20,4.8e-05
G5,C(C(C=C)C(C(CCC=O)=O)O)=O,4,1,0,1,20,4.8e-05
G5,C(CCC(C=O)(C(C=O)C=C)O)=O,4,2,0,2,45,9.499999999999999e-05
G5,C(C(C=C)C(CCC(C=O)=O)O)=O,4,1,0,1,20,4.8e-05
G5,C(CCC(C(C=O)CC=O)O)=O,4,2,0,2,55,9.499999999999999e-05
G5,C(CC(C=O)C(C=CCO)O)=O,8,1,0,1,27,4.8e-05
G5,C(CCC(C(C(C(O)=O)=O)O)O)=O,4,3,0,3,33,0.000143
G5,C(CC(C)(C(C=O)CC=O)O)(O)=O,4,3,0,3,28,0.000154
G5,C(CC(CC(CCC=O)O)=O)(O)=O,2,1,0,1,6,4.8e-05
G5,C(CCC(C(C(O)=O)C(C)=O)O)=O,4,2,0,2,6,9.499999999999999e-05
G5,C(CC(C=O)C(C=CC(O)=O)O)=O,8,2,0,2,18,9.499999999999999e-05
G5,C1(C(CCO1)(C(C=O)CC=O)O)=O,4,2,0,2,28,9.499999999999999e-05
G5,C(CCC(C1C(C(OC1)=O)=O)O)=O,4,2,0,2,28,9.499999999999999e-05
G5,C(CCC(C1C(OCC1=O)=O)O)=O,4,2,0,2,27,9.499999999999999e-05
G5,C(CCC(C1C(CC(O1)=O)=O)O)=O,4,2,0,2,27,9.499999999999999e-05
G5,C(C(C(C(C=C)O)O)CC=O)=O,8,1,0,1,28,4.8e-05
G5,C(CC(C=O)C1(C=COC1)O)=O,4,1,0,1,27,4.8e-05
G5,C(CCC(C1C(C=CO1)=O)O)=O,4,2,0,2,27,9.499999999999999e-05
G5,C(C(C=C)(C(C=O)CC=O)O)(O)=O,4,2,0,2,7,9.499999999999999e-05
G5,C(C(C(C(C)(CO)O)O)CC=O)=O,8,1,0,1,11,4.8e-05
G5,C(C(C)(C(C=O)CC=O)O)(CC)=O,4,1,0,1,28,4.8e-05
G5,C(C)(C(CC)(C(C=O)CC=O)O)=O,4,1,0,1,28,4.8e-05
G5,C(CCC(CC(C(CC)=O)=O)O)=O,2,2,0,2,27,9.499999999999999e-05
G5,C(CCC(C(C(C(C)=O)=O)C)O)=O,4,2,0,2,27,9.499999999999999e-05
G5,C(CCC(CC(CC(C)=O)=O)O)=O,2,2,0,2,27,9.499999999999999e-05
G5,C(CCC(C(C(C)=O)C(C)=O)O)=O,2,3,0,3,27,0.000143
G5,C(CC(C)C(C(C=O)CC=O)O)=O,8,2,0,2,55,9.499999999999999e-05
G5,C(C(C)CC(C(C=O)CC=O)O)=O,8,1,0,1,28,4.8e-05
G5,C(CCC(C(C=O)C(C=O)C)O)=O,8,1,0,1,28,4.8e-05
G5,C(C(C(C=O)CC=O)O)(CC)=O,4,1,0,1,27,4.8e-05
G5,C(CC(C=O)C(C=O)(CC)O)=O,4,1,0,1,27,4.8e-05
G5,C(CCC(C(C(C=O)=O)C)O)=O,4,2,0,2,28,9.499999999999999e-05
G5,C(C(C(C(C=O)C=O)O)CC=O)=O,4,4,0,4,43,0.00019099999999999998
G5,C(C(CC)(C(C=O)CC=O)O)(O)=O,4,1,0,1,28,4.8e-05
G5,C(CCC(C(C(C(O)=O)=O)C)O)=O,4,2,0,2,28,9.499999999999999e-05
G5,C(C(C=CC=O)(C(C=O)CC=O)O)=O,8,2,0,2,20,9.499999999999999e-05
G5,C(CC(C=O)C(C=CC(C=O)=O)O)=O,8,2,0,2,55,9.6e-05
G5,C(CC(C=O)C(C(C=CC)=O)O)=O,8,2,0,2,28,9.499999999999999e-05
G5,C(C(C=CC)(C(C=O)CC=O)O)=O,8,1,0,1,28,4.8e-05
G5,C(CC(C=O)C(C(CC=C)=O)O)=O,4,2,0,2,28,9.499999999999999e-05
G5,C(CC(C=O)C(C=O)(CC=C)O)=O,4,1,0,1,28,4.8e-05
G5,C(CCC(C(C=C)C(C=O)=O)O)=O,4,2,0,2,28,9.499999999999999e-05
G5,C(CC(C=O)C(C=CC=O)(C)O)=O,8,1,0,1,27,4.8e-05
G5,C(CC(C=O)C(C=CC(C)=O)O)=O,8,1,0,1,27,4.8e-05
G5,C(CCC(CC(C=CC=O)=O)O)=O,4,2,0,2,27,9.499999999999999e-05
G5,C(CC(C(C(C=O)CC=O)O)=C)=O,4,2,0,2,28,9.499999999999999e-05
G5,C(C(C(CC(C=O)=C)O)CC=O)=O,4,1,0,1,27,4.8e-05
G5,C(C(C(C=O)=C)C(CCC=O)O)=O,4,1,0,1,27,4.8e-05
G5,C(CC(C=O)C(C(C)=CC=O)O)=O,8,2,0,2,28,9.499999999999999e-05
G5,C(CC(C=O)C(C=C(C=O)C)O)=O,8,1,0,1,28,4.8e-05
G5,C(CC(C=O)C(C=C)O)=O,4,1,0,1,27,4.8e-05
G5,C(CC(C=O)C(C=CC)(CO)O)=O,8,1,0,1,28,4.8e-05
G5,C(CCC(C(C(C=CC)=O)O)O)=O,8,3,0,3,28,0.000143
G5,C(C(C(CO)(CC=C)O)CC=O)=O,4,1,0,1,28,4.8e-05
G5,C(CCC(C(C(CO)=O)C=C)O)=O,4,2,0,2,28,9.499999999999999e-05
G5,C(CCC(C(C(CC=C)=O)O)O)=O,4,3,0,3,28,0.000143
G5,C(C(C(C)(C(C=C)O)O)CC=O)=O,8,1,0,1,28,4.8e-05
G5,C(CCC(CC(C(C=C)O)=O)O)=O,4,2,0,2,27,9.499999999999999e-05
G5,C(C(C(CC(CO)=C)O)CC=O)=O,4,1,0,1,28,4.8e-05
G5,C(CCC(C(C=O)C(CO)=C)O)=O,4,1,0,1,28,4.8e-05
G5,C(C(CC=O)C(C=C(C)CO)O)=O,8,1,0,1,28,4.8e-05
G5,C(CC(C=O)C(C=CC)O)=O,8,1,0,1,27,4.8e-05
G5,C(C(C(CC=C)O)CC=O)=O,4,1,0,1,27,4.8e-05
G5,C(C(C=C)C(CCC=O)O)=O,4,1,0,1,27,4.8e-05
G5,C(CC(C=O)C1(C=CC(C1O)=O)O)=O,8,2,0,2,47,9.499999999999999e-05
G5,C(CC=CC(C(C=O)CC=O)O)=O,8,1,0,1,28,4.8e-05
G5,C(C(C(CC=CC=O)O)CC=O)=O,8,1,0,1,27,4.8e-05
G5,C(C(C=CC=O)C(CCC=O)O)=O,8,1,0,1,28,4.8e-05
G5,C1(C(C(C=C)O)OC(CC1O)O)=O,16,2,0,2,27,9.499999999999999e-05
G5,C1OC(C(C=1)=O)C(C(C=CCO)=O)O,8,2,0,2,55,9.499999999999999e-05
G5,C(C(C=CCO)(C1C(C=CO1)=O)O)=O,8,2,0,2,55,9.499999999999999e-05
G5,C(C(C=C)C(C(C=CCO)=O)O)=O,8,1,0,1,55,4.8e-05
G5,C(C(C=C)C(C=O)(C=CCO)O)=O,8,1,0,1,55,4.8e-05
G5,C(C(C(C(C(O)=O)=O)O)O)=CCO,8,2,0,2,33,9.499999999999999e-05
G5,C(CC(CC(C=CCO)O)=O)(O)=O,4,1,0,1,6,4.8e-05
G5,C(C(C(C)=O)C(C=CCO)O)(O)=O,8,2,0,2,6,9.499999999999999e-05
G5,C(CO)=CC(C1C(C(OC1)=O)=O)O,8,2,0,2,28,9.499999999999999e-05
G5,C1(C(C(CO1)=O)C(C=CCO)O)=O,8,2,0,2,28,9.499999999999999e-05
G5,C1(CC(C(C(C=CCO)O)O1)=O)=O,8,2,0,2,28,9.499999999999999e-05
G5,C1OC(C(C=1)=O)C(C=CCO)O,8,2,0,2,28,9.499999999999999e-05
G5,C(CO)=CC(CC(C(CC)=O)=O)O,4,1,0,1,28,4.8e-05
G5,C(CO)=CC(C(C(C(C)=O)=O)C)O,8,1,0,1,28,4.8e-05
G5,C(C)(CC(CC(C=CCO)O)=O)=O,4,1,0,1,28,4.8e-05
G5,C(C)(C(C(C)=O)C(C=CCO)O)=O,4,2,0,2,28,9.499999999999999e-05
G5,C(C(C)C(C=O)C(C=CCO)O)=O,16,1,0,1,28,4.8e-05
G5,C(CO)=CC(C(C(C=O)=O)C)O,8,1,0,1,28,4.8e-05
G5,C(CO)=CC(C(C(C(O)=O)=O)C)O,8,1,0,1,28,4.8e-05
G5,C=CC(C(C=O)=O)C(C=CCO)O,8,1,0,1,28,4.8e-05
G5,C(C(CC(C=CC=O)=O)O)=CCO,8,1,0,1,28,4.8e-05
G5,C(C(C(C=O)=C)C(C=CCO)O)=O,8,1,0,1,28,4.8e-05
G5,C(CO)=CC(C(C(C=CC)=O)O)O,16,2,0,2,28,9.499999999999999e-05
G5,C(CO)(C(C=C)C(C=CCO)O)=O,8,1,0,1,28,4.8e-05
G5,C(C(C(C=CCO)O)O)(CC=C)=O,8,2,0,2,28,9.499999999999999e-05
G5,C(CC(C=CCO)O)(C(C=C)O)=O,8,1,0,1,28,4.8e-05
G5,C(C(C(CO)=C)C(C=CCO)O)=O,8,1,0,1,28,4.8e-05
G5,C(C(C=C)C(C=CCO)O)=O,8,1,0,1,28,4.8e-05
G5,C(C(C=CC=O)C(C=CCO)O)=O,16,1,0,1,28,4.8e-05
G5,C=CC(C(C(C(C(O)=O)=O)O)O)O,8,2,0,2,33,9.499999999999999e-05
G5,C1OCC(C=1)(C(C(C(O)=O)=O)O)O,4,2,0,2,33,9.499999999999999e-05
G5,C(C(CO)(C1C(C=CO1)=O)O)(O)=O,4,2,0,2,33,9.499999999999999e-05
G5,C(C(C(C(C(O)=O)=O)O)O)(CC)=O,4,2,0,2,33,9.499999999999999e-05
G5,C(C(CC)(C(C(C(O)=O)=O)O)O)=O,4,2,0,2,33,9.499999999999999e-05
G5,C(C(CO)(C(C(C=O)=O)C)O)(O)=O,4,3,0,3,33,0.000156
G5,C=CC(C(C(C(O)=O)=O)O)O,4,6,0,6,33,0.000308
G5,C(C(C(C(C(O)=O)=O)O)O)=CC,8,2,0,2,33,9.499999999999999e-05
G5,C(CC(C(C(C(O)=O)=O)O)O)=C,4,2,0,2,33,9.499999999999999e-05
G5,C(C(C=C)C(C(O)=O)(CO)O)=O,4,2,0,2,7,9.499999999999999e-05
G5,C(C)(C(C(C(O)=O)=O)C(C=C)O)=O,4,2,0,2,0,9.499999999999999e-05
G5,C(CC(C=C)O)(CC(C(O)=O)=O)=O,2,1,0,1,0,4.8e-05
G5,C(C(C(C(O)=O)=O)C(C=C)O)=O,4,2,0,2,45,9.499999999999999e-05
G5,C(C(C(C(O)=O)=O)C(C=CC)O)=O,8,2,0,2,45,9.499999999999999e-05
G5,C(C(C(C(O)=O)=O)C(CC=C)O)=O,4,2,0,2,45,9.499999999999999e-05
G5,C(C(C=C)C(C(O)=O)(CC=O)O)=O,4,1,0,1,45,4.8e-05
G5,C(C(C=C)C(CC(C(O)=O)=O)O)=O,4,2,0,2,29,0.000106
G5,C(CC(C(C=C)O)O)(CC(O)=O)=O,4,1,0,1,6,4.8e-05
G5,C(C(C(C)=O)C(C(C=C)O)O)(O)=O,8,2,0,2,6,9.499999999999999e-05
G5,C(CC(CC1(C=COC1)O)=O)(O)=O,2,1,0,1,6,4.8e-05
G5,C(C(C(C)=O)C1(C=COC1)O)(O)=O,4,2,0,2,6,9.499999999999999e-05
G5,C(CC(C)(C1C(C=CO1)=O)O)(O)=O,4,2,0,2,6,9.499999999999999e-05
G5,C(CC(C(CC)=O)O)(CC(O)=O)=O,2,1,0,1,6,4.8e-05
G5,C(C)(C(C(O)=O)C(C(CC)=O)O)=O,4,2,0,2,6,9.499999999999999e-05
G5,C(C(CC)(CC(CC(O)=O)=O)O)=O,2,1,0,1,6,4.8e-05
G5,C(C(CC)(C(C(O)=O)C(C)=O)O)=O,4,2,0,2,6,9.499999999999999e-05
G5,C(CC(C)(C(C(C=O)=O)C)O)(O)=O,4,1,0,1,6,4.8e-05
G5,C(CC(CC(C=C)O)=O)(O)=O,2,1,0,1,6,4.8e-05
G5,C(C(C(C)=O)C(C=C)O)(O)=O,4,2,0,2,6,9.499999999999999e-05
G5,C(CC(CC(C=CC)O)=O)(O)=O,4,1,0,1,6,4.8e-05
G5,C(C(C(C)=O)C(C=CC)O)(O)=O,8,2,0,2,6,9.499999999999999e-05
G5,C(CC(CC(CC=C)O)=O)(O)=O,2,1,0,1,6,4.8e-05
G5,C(C(C(C)=O)C(CC=C)O)(O)=O,4,2,0,2,6,9.499999999999999e-05
G5,C(C(C=C)C(C)(CC(O)=O)O)=O,4,1,0,1,6,4.8e-05
G5,C=CC(C(C(C=CC(O)=O)=O)O)O,8,2,0,2,18,9.499999999999999e-05
G5,C1OC(C(C=1)=O)C(C=CC(O)=O)O,8,2,0,2,18,9.499999999999999e-05
G5,C(C(C(C(C=O)=O)C)O)=CC(O)=O,8,1,0,1,18,4.8e-05
G5,C=CC(C(C=O)=O)C(C=CC(O)=O)O,8,1,0,1,18,4.8e-05
G5,C(C(CC(C=CC=O)=O)O)=CC(O)=O,8,1,0,1,18,4.8e-05
G5,C(C(C(C=O)=C)C(C=CC(O)=O)O)=O,8,1,0,1,18,4.8e-05
G5,C(C(C=C)C(C=CC(O)=O)O)=O,8,1,0,1,18,4.8e-05
G5,C(C(C=CC=O)C(C=CC(O)=O)O)=O,16,1,0,1,18,4.8e-05
G5,C=CC(C(C(C(CO)=O)=O)O)O,4,2,0,2,5,9.499999999999999e-05
G5,C(C)=CC(C(C(C(CO)=O)=O)O)O,8,2,0,2,5,9.499999999999999e-05
G5,C(CC(C(C(C(CO)=O)=O)O)O)=C,4,2,0,2,5,9.499999999999999e-05
G5,C(C(C=C)C(C(CO)=O)(CO)O)=O,4,1,0,1,5,4.8e-05
G5,C(C(C=C)C(C(C=O)(C=O)O)O)=O,4,1,0,1,1,4.8e-05
G5,C(C(C=O)(C(CC(C=C)O)=O)O)=O,2,1,0,1,1,4.8e-05
G5,C(C(C(C(CC(C=C)O)=O)=O)O)=O,4,1,0,1,25,4.8e-05
G5,C=CC(C(C(C(C(C)O)=O)=O)O)O,8,2,0,2,0,9.499999999999999e-05
G5,C1C(COC=1)(C(C(C(C=C)=O)=O)O)O,4,2,0,2,7,9.499999999999999e-05
G5,C1OC(C(C=1)=O)C(C(C=C)=O)(CO)O,4,2,0,2,7,9.499999999999999e-05
G5,C(CO)(C(C=C)(C1C(C=CO1)=O)O)=O,4,2,0,2,7,9.499999999999999e-05
G5,C=CC(C(C(C(C=C)=O)=O)O)O,4,2,0,2,7,9.499999999999999e-05
G5,C=CC(C(C(C(C=CC)O)O)=O)=O,8,2,0,2,7,9.499999999999999e-05
G5,C(CC(C(C(C(C=C)=O)=O)O)O)=C,4,2,0,2,7,9.499999999999999e-05
G5,C(C(C=C)C(C(C=C)=O)(CO)O)=O,4,1,0,1,7,4.8e-05
G5,C(C(C=C)C(C(CO)=O)(C=C)O)=O,4,1,0,1,7,4.8e-05
G5,C=CC(CC(C(C(C)O)=O)=O)O,4,1,0,1,49,4.8e-05
G5,C(C)=CC(CC(C(C(C)O)=O)=O)O,8,1,0,1,49,4.8e-05
G5,C(CC(CC(C(C(C)O)=O)=O)O)=C,4,1,0,1,49,4.8e-05
G5,C(C(C=C)C(C(C)=O)(C(C)O)O)=O,8,1,0,1,49,4.8e-05
G5,C(C(C=C)C(C(C(C)O)=O)(C)O)=O,8,1,0,1,49,4.8e-05
G5,C(C(C=C)C(C(C=C)=O)(C(C)O)O)=O,8,1,0,1,7,4.8e-05
G5,C(C(C=C)C(C(C(C)O)=O)(C=C)O)=O,8,1,0,1,7,4.8e-05
G5,C(C(C(C=C)O)O)(C(CO)(C)O)=O,8,2,0,2,49,9.499999999999999e-05
G5,C(C(C(C(CO)=O)=O)C(C=C)O)=O,4,2,0,2,0,9.499999999999999e-05
G5,C(CC(C(C(C(C=C)O)O)=O)=O)=O,4,2,0,2,0,9.499999999999999e-05
G5,C(C(C=O)(C(C=O)C(C=C)O)O)=O,4,2,0,2,1,9.499999999999999e-05
G5,C1(CC(C(C1O)=O)C2(C=COC2)O)=O,8,1,0,1,47,4.8e-05
G5,C1(C(C(CC1)(C2C(C=CO2)=O)O)O)=O,8,2,0,2,47,9.499999999999999e-05
G5,C1(CC(C(C1O)=O)C(C=C)O)=O,8,1,0,1,47,4.8e-05
G5,C1(CC(C(C1O)=O)C(C=CC)O)=O,16,1,0,1,47,4.8e-05
G5,C1(C(C(CC=C)O)CC(C1O)=O)=O,8,1,0,1,47,4.8e-05
G5,C(C(C=C)C1(CCC(C1O)=O)O)=O,8,1,0,1,47,4.8e-05
G5,C1(CC(C(CO1)=O)C2(C=COC2)O)=O,4,1,0,1,7,4.8e-05
G5,C1(CCC(C(C2(C=COC2)O)O1)=O)=O,4,2,0,2,7,9.499999999999999e-05
G5,C1(CCC(CO1)(C2C(C=CO2)=O)O)=O,4,2,0,2,7,9.499999999999999e-05
G5,C1(CC(C(CO1)=O)C(C=C)O)=O,4,1,0,1,7,4.8e-05
G5,C1(CCC(C(C(C=C)O)O1)=O)=O,4,2,0,2,7,9.499999999999999e-05
G5,C1(CC(C(CO1)=O)C(C=CC)O)=O,8,1,0,1,7,4.8e-05
G5,C1(CCC(C(C(C=CC)O)O1)=O)=O,8,2,0,2,7,9.499999999999999e-05
G5,C1(COC(CC1C(CC=C)O)=O)=O,4,1,0,1,7,4.8e-05
G5,C1(CCC(OC1C(CC=C)O)=O)=O,4,2,0,2,7,9.499999999999999e-05
G5,C(C(C=C)C1(COC(CC1)=O)O)=O,4,1,0,1,7,4.8e-05
G5,C1(COC(C(C1)=O)C2(C=COC2)O)=O,4,2,0,2,54,9.499999999999999e-05
G5,C1(COCC(C1C2(C=COC2)O)=O)=O,2,2,0,2,54,9.499999999999999e-05
G5,C1(COCC(C2C(C=CO2)=O)(C1)O)=O,4,2,0,2,54,9.499999999999999e-05
G5,C1(C(C(C=C)O)OCC(C1)=O)=O,4,2,0,2,54,9.499999999999999e-05
G5,C1(COCC(C1C(C=C)O)=O)=O,2,2,0,2,54,9.499999999999999e-05
G5,C1(COC(C(C1)=O)C(C=CC)O)=O,8,2,0,2,54,9.499999999999999e-05
G5,C1(COCC(C1C(C=CC)O)=O)=O,4,2,0,2,54,9.499999999999999e-05
G5,C1(C(C(CC=C)O)OCC(C1)=O)=O,4,2,0,2,54,9.499999999999999e-05
G5,C1(COCC(C1C(CC=C)O)=O)=O,2,2,0,2,54,9.499999999999999e-05
G5,C(C(C=C)C1(COCC(C1)=O)O)=O,4,1,0,1,54,4.8e-05
G5,C1(C(C(C=C)O)OC(CO)C1O)=O,16,2,0,2,27,9.499999999999999e-05
G5,C1(C(O)OC(CO)C1C(C=C)O)=O,16,2,0,2,27,9.499999999999999e-05
G5,C1(COC(CO)(C1C(C=C)O)O)=O,8,2,0,2,27,9.499999999999999e-05
G5,C1(C(C(C=C)O)OC(CO)(C1)O)=O,8,2,0,2,27,9.499999999999999e-05
G5,C=CC(C(C1C(C(OC1)=O)=O)O)O,8,2,0,2,28,9.499999999999999e-05
G5,C1OCC(C=1)(C2C(C(OC2)=O)=O)O,4,2,0,2,28,9.499999999999999e-05
G5,C1(C(CCO1)(C2C(C=CO2)=O)O)=O,4,2,0,2,28,9.499999999999999e-05
G5,C(C(C1C(C(OC1)=O)=O)O)(CC)=O,4,2,0,2,28,9.499999999999999e-05
G5,C(C(CC)(C1C(C(OC1)=O)=O)O)=O,4,2,0,2,28,9.499999999999999e-05
G5,C1(C(CCO1)(C(C(C=O)=O)C)O)=O,4,1,0,1,28,4.8e-05
G5,C(C)=CC(C(C1C(C(OC1)=O)=O)O)=O,8,2,0,2,28,9.499999999999999e-05
G5,C(C(C=CC)(C1C(C(OC1)=O)=O)O)=O,8,2,0,2,28,9.499999999999999e-05
G5,C(C(C1C(C(OC1)=O)=O)O)(CC=C)=O,4,2,0,2,28,9.499999999999999e-05
G5,C(C(CC=C)(C1C(C(OC1)=O)=O)O)=O,4,2,0,2,28,9.499999999999999e-05
G5,C1(C(CCO1)(C(C=C)C(C=O)=O)O)=O,4,1,0,1,28,4.8e-05
G5,C(C(C)(C1C(C(OC1)=O)=O)O)=CC=O,8,2,0,2,28,9.499999999999999e-05
G5,C(C(C1C(C(OC1)=O)=O)O)=CC(C)=O,8,2,0,2,28,9.499999999999999e-05
G5,C1(C(CCO1)(CC(C=CC=O)=O)O)=O,4,1,0,1,28,4.8e-05
G5,C(CC(C(C1C(C(OC1)=O)=O)O)=C)=O,4,2,0,2,28,9.499999999999999e-05
G5,C=C(C=O)CC(C1C(C(OC1)=O)=O)O,4,2,0,2,28,9.499999999999999e-05
G5,C(C(C(C=O)=C)C1(C(OCC1)=O)O)=O,4,1,0,1,28,4.8e-05
G5,C(C(C1C(C(OC1)=O)=O)O)(C)=CC=O,8,2,0,2,28,9.499999999999999e-05
G5,C(C(C1C(C(OC1)=O)=O)O)=C(C=O)C,8,2,0,2,28,9.499999999999999e-05
G5,C=CC(C1C(C(OC1)=O)=O)O,4,2,0,2,28,9.499999999999999e-05
G5,C(C)=CC(C1C(C(OC1)=O)=O)O,8,2,0,2,28,9.499999999999999e-05
G5,C=CCC(C1C(C(OC1)=O)=O)O,4,2,0,2,28,9.499999999999999e-05
G5,C(C(C=C)C1(C(OCC1)=O)O)=O,4,1,0,1,28,4.8e-05
G5,C(CC=CC(C1C(C(OC1)=O)=O)O)=O,8,2,0,2,28,9.499999999999999e-05
G5,C(CC(C1C(C(OC1)=O)=O)O)=CC=O,8,2,0,2,28,9.499999999999999e-05
G5,C(C(C=CC=O)C1(C(OCC1)=O)O)=O,8,1,0,1,28,4.8e-05
G5,C1(C(C(CO1)=O)C(C(C=C)O)O)=O,8,2,0,2,28,9.499999999999999e-05
G5,C1(CC(C(C(C(C=C)O)O)O1)=O)=O,8,2,0,2,28,9.499999999999999e-05
G5,C1(C(C(CO1)=O)C2(C=COC2)O)=O,4,2,0,2,28,9.499999999999999e-05
G5,C1(CC(C(C2(C=COC2)O)O1)=O)=O,4,2,0,2,28,9.499999999999999e-05
G5,C1(CC(CO1)(C2C(C=CO2)=O)O)=O,4,2,0,2,28,9.499999999999999e-05
G5,C1(COC(C1C(C(CC)=O)O)=O)=O,4,2,0,2,28,9.499999999999999e-05
G5,C(C(C1C(CC(O1)=O)=O)O)(CC)=O,4,2,0,2,28,9.499999999999999e-05
G5,C(C(CC)(C1C(OCC1=O)=O)O)=O,4,2,0,2,28,9.499999999999999e-05
G5,C(C(CC)(C1C(CC(O1)=O)=O)O)=O,4,2,0,2,28,9.499999999999999e-05
G5,C1(CC(CO1)(C(C(C=O)=O)C)O)=O,4,1,0,1,28,4.8e-05
G5,C1(C(C(CO1)=O)C(C(C=CC)=O)O)=O,8,2,0,2,28,9.499999999999999e-05
G5,C1(CC(C(C(C(C=CC)=O)O)O1)=O)=O,8,2,0,2,28,9.499999999999999e-05
G5,C1(C(C(CO1)=O)C(C=O)(C=CC)O)=O,8,2,0,2,28,9.499999999999999e-05
G5,C(C(C=CC)(C1C(CC(O1)=O)=O)O)=O,8,2,0,2,28,9.499999999999999e-05
G5,C1(C(C(CO1)=O)C(C(CC=C)=O)O)=O,4,2,0,2,28,9.499999999999999e-05
G5,C1(CC(C(C(C(CC=C)=O)O)O1)=O)=O,4,2,0,2,28,9.499999999999999e-05
G5,C1(C(C(CO1)=O)C(C=O)(CC=C)O)=O,4,2,0,2,28,9.499999999999999e-05
G5,C1(CC(C(C(C=O)(CC=C)O)O1)=O)=O,4,2,0,2,28,9.499999999999999e-05
G5,C1(CC(CO1)(C(C=C)C(C=O)=O)O)=O,4,1,0,1,28,4.8e-05
G5,C1(C(C(CO1)=O)C(C=CC=O)(C)O)=O,8,2,0,2,28,9.499999999999999e-05
G5,C1(CC(C(C(C=CC=O)(C)O)O1)=O)=O,8,2,0,2,28,9.499999999999999e-05
G5,C1(C(C(CO1)=O)C(C=CC(C)=O)O)=O,8,2,0,2,28,9.499999999999999e-05
G5,C1(CC(C(C(C=CC(C)=O)O)O1)=O)=O,8,2,0,2,28,9.499999999999999e-05
G5,C1(CC(CO1)(CC(C=CC=O)=O)O)=O,4,1,0,1,28,4.8e-05
G5,C1(C(C(CO1)=O)C(C(CC=O)=C)O)=O,4,2,0,2,28,9.499999999999999e-05
G5,C1(CC(C(C(C(CC=O)=C)O)O1)=O)=O,4,2,0,2,28,9.499999999999999e-05
G5,C1(C(C(CO1)=O)C(CC(C=O)=C)O)=O,4,2,0,2,28,9.499999999999999e-05
G5,C1(CC(C(C(CC(C=O)=C)O)O1)=O)=O,4,2,0,2,28,9.499999999999999e-05
G5,C(C(C(C=O)=C)C1(COC(C1)=O)O)=O,4,1,0,1,28,4.8e-05
G5,C1(C(C(CO1)=O)C(C(C)=CC=O)O)=O,8,2,0,2,28,9.499999999999999e-05
G5,C1(CC(C(C(C(C)=CC=O)O)O1)=O)=O,8,2,0,2,28,9.499999999999999e-05
G5,C1(C(C(CO1)=O)C(C=C(C=O)C)O)=O,8,2,0,2,28,9.499999999999999e-05
G5,C1(CC(C(C(C=C(C=O)C)O)O1)=O)=O,8,2,0,2,28,9.499999999999999e-05
G5,C1(C(C(CO1)=O)C(C=C)O)=O,4,2,0,2,28,9.499999999999999e-05
G5,C1(CC(C(C(C=C)O)O1)=O)=O,4,2,0,2,28,9.499999999999999e-05
G5,C1(C(C(CO1)=O)C(C=CC)O)=O,8,2,0,2,28,9.499999999999999e-05
G5,C1(CC(C(C(C=CC)O)O1)=O)=O,8,2,0,2,28,9.499999999999999e-05
G5,C1(C(C(CO1)=O)C(CC=C)O)=O,4,2,0,2,28,9.499999999999999e-05
G5,C1(CC(C(C(CC=C)O)O1)=O)=O,4,2,0,2,28,9.499999999999999e-05
G5,C(C(C=C)C1(COC(C1)=O)O)=O,4,1,0,1,28,4.8e-05
G5,C1(C(C(CO1)=O)C(C=CCC=O)O)=O,8,2,0,2,28,9.499999999999999e-05
G5,C(CC=CC(C1C(CC(O1)=O)=O)O)=O,8,2,0,2,28,9.499999999999999e-05
G5,C1(C(C(CO1)=O)C(CC=CC=O)O)=O,8,2,0,2,28,9.499999999999999e-05
G5,C1(CC(C(C(CC=CC=O)O)O1)=O)=O,8,2,0,2,28,9.499999999999999e-05
G5,C(C(C=CC=O)C1(COC(C1)=O)O)=O,8,1,0,1,28,4.8e-05
G5,C1(C(C(C=C)O)OCC(C1O)O)=O,16,2,0,2,27,9.499999999999999e-05
G5,C1(C(O)OCC(C1C(C=C)O)O)=O,16,2,0,2,27,9.499999999999999e-05
G5,C1(C(C(C(CO1)=O)C(C=C)O)O)=O,8,2,0,2,27,9.499999999999999e-05
G5,C1(C(CC(C(C(C=C)O)O1)=O)O)=O,8,2,0,2,27,9.499999999999999e-05
G5,C(C(C(C1C(C=CO1)=O)O)O)=C,8,2,0,2,28,9.499999999999999e-05
G5,C=CC(C(CC(C(CC)=O)=O)O)O,4,1,0,1,28,4.8e-05
G5,C(C(C(C(C(C(C)=O)=O)C)O)O)=C,8,1,0,1,28,4.8e-05
G5,C(CC(C(C=C)O)O)(CC(C)=O)=O,4,1,0,1,28,4.8e-05
G5,C(C)(C(C(C)=O)C(C(C=C)O)O)=O,4,2,0,2,28,9.499999999999999e-05
G5,C(C(C(C(C=C)O)O)C(C=O)C)=O,16,1,0,1,28,4.8e-05
G5,C=CC(C(C(C(C=O)=O)C)O)O,8,1,0,1,28,4.8e-05
G5,C=CC(C(C(C(C(O)=O)=O)C)O)O,8,1,0,1,28,4.8e-05
G5,C=CC(C(C=O)=O)C(C(C=C)O)O,8,1,0,1,28,4.8e-05
G5,C=CC(C(CC(C=CC=O)=O)O)O,8,1,0,1,28,4.8e-05
G5,C(C(C(C=O)=C)C(C(C=C)O)O)=O,8,1,0,1,28,4.8e-05
G5,C(C(C(C(C(C=CC)=O)O)O)O)=C,16,2,0,2,28,9.499999999999999e-05
G5,C(CO)(C(C=C)C(C(C=C)O)O)=O,8,1,0,1,28,4.8e-05
G5,C(C(C(C(C=C)O)O)O)(CC=C)=O,8,2,0,2,28,9.499999999999999e-05
G5,C(CC(C(C=C)O)O)(C(C=C)O)=O,8,1,0,1,28,4.8e-05
G5,C(C(C(CO)=C)C(C(C=C)O)O)=O,8,1,0,1,28,4.8e-05
G5,C(C(C=C)C(C(C=C)O)O)=O,8,1,0,1,28,4.8e-05
G5,C(C(C=CC=O)C(C(C=C)O)O)=O,16,1,0,1,28,4.8e-05
G5,C1OCC(C=1)(C2C(C=CO2)=O)O,4,2,0,2,28,9.499999999999999e-05
G5,C1C(O)OCC(C=1)(C2C(C=CO2)=O)O,8,2,0,2,27,9.499999999999999e-05
G5,C1C(COC=1)(C2C(C=CC(O2)O)=O)O,8,2,0,2,27,9.499999999999999e-05
G5,C(C(C=CC(C1C(C=CO1)=O)O)O)=O,16,2,0,2,20,9.499999999999999e-05
G5,C(C(C(C1C(C=CO1)=O)O)O)=CC=O,16,2,0,2,20,9.499999999999999e-05
G5,C(C(C=C)(C1C(C=CO1)=O)O)(O)=O,4,2,0,2,7,9.499999999999999e-05
G5,C1OC(C(C=1)=O)C(C(C)(CO)O)O,8,2,0,2,11,9.499999999999999e-05
G5,C(C(C)(C1C(C=CO1)=O)O)(CC)=O,4,2,0,2,28,9.499999999999999e-05
G5,C(C)(C(CC)(C1C(C=CO1)=O)O)=O,4,2,0,2,28,9.499999999999999e-05
G5,C1C(COC=1)(CC(C(CC)=O)=O)O,2,1,0,1,28,4.8e-05
G5,C1C(COC=1)(C(C(C(C)=O)=O)C)O,4,1,0,1,28,4.8e-05
G5,C(C)(CC(CC1(C=COC1)O)=O)=O,2,1,0,1,28,4.8e-05
G5,C(C)(C(C(C)=O)C1(C=COC1)O)=O,2,2,0,2,28,9.499999999999999e-05
G5,C(CC(C)C(C1C(C=CO1)=O)O)=O,8,2,0,2,28,9.499999999999999e-05
G5,C(C(C)CC(C1C(C=CO1)=O)O)=O,8,2,0,2,28,9.499999999999999e-05
G5,C(C(C)C(C=O)C1(C=COC1)O)=O,8,1,0,1,28,4.8e-05
G5,C(C(C1C(C=CO1)=O)O)(C(C=O)C)=O,8,2,0,2,49,9.499999999999999e-05
G5,C(C(C)C(C=O)(C1C(C=CO1)=O)O)=O,8,2,0,2,49,9.499999999999999e-05
G5,C1OC(C(C=1)=O)C(C(C(C=O)=O)C)O,8,2,0,2,49,9.499999999999999e-05
G5,C(C(C1C(C=CO1)=O)O)(CC)=O,4,2,0,2,28,9.499999999999999e-05
G5,C(C(CC)(C1C(C=CO1)=O)O)=O,4,2,0,2,28,9.499999999999999e-05
G5,C1OCC(C=1)(C(C(C=O)=O)C)O,4,1,0,1,28,4.8e-05
G5,C(C(C(C)=O)C(C1C(C=CO1)=O)O)=O,8,2,0,2,6,9.499999999999999e-05
G5,C(C(C=O)C(C)(C1C(C=CO1)=O)O)=O,4,4,0,4,9,0.00019099999999999998
G5,C(C(C=O)C(CC1(C=COC1)O)=O)=O,2,1,0,1,6,4.8e-05
G5,C(C(C=O)C(C1C(C=CO1)=O)O)=O,4,2,0,2,1,9.499999999999999e-05
G5,C(C(C(C1C(C=CO1)=O)O)CC=O)=O,8,2,0,2,43,9.499999999999999e-05
G5,C(C(C=O)CC(C1C(C=CO1)=O)O)=O,4,2,0,2,43,9.499999999999999e-05
G5,C(C(C=O)C(C=O)C1(C=COC1)O)=O,4,1,0,1,43,4.8e-05
G5,C(C(CC)(C1C(C=CO1)=O)O)(O)=O,4,2,0,2,28,9.499999999999999e-05
G5,C1OCC(C=1)(C(C(C(O)=O)=O)C)O,4,1,0,1,28,4.8e-05
G5,C1OC(C(C=1)=O)C(C(C=CC=O)=O)O,8,2,0,2,20,9.499999999999999e-05
G5,C(C(C=CC=O)(C1C(C=CO1)=O)O)=O,8,2,0,2,20,9.499999999999999e-05
G5,C1OC(C(C=1)=O)C(C=CC(C=O)=O)O,8,2,0,2,20,9.499999999999999e-05
G5,C1OC(C(C=1)=O)C(C(C=CC)=O)O,8,2,0,2,28,9.499999999999999e-05
G5,C(C(C=CC)(C1C(C=CO1)=O)O)=O,8,2,0,2,28,9.499999999999999e-05
G5,C(C(C1C(C=CO1)=O)O)(CC=C)=O,4,2,0,2,28,9.499999999999999e-05
G5,C(C(CC=C)(C1C(C=CO1)=O)O)=O,4,2,0,2,28,9.499999999999999e-05
G5,C1OCC(C=1)(C(C=C)C(C=O)=O)O,4,1,0,1,28,4.8e-05
G5,C(C(C)(C1C(C=CO1)=O)O)=CC=O,8,2,0,2,28,9.499999999999999e-05
G5,C1OC(C(C=1)=O)C(C=CC(C)=O)O,8,2,0,2,28,9.499999999999999e-05
G5,C1C(COC=1)(CC(C=CC=O)=O)O,4,1,0,1,28,4.8e-05
G5,C(CC(C(C1C(C=CO1)=O)O)=C)=O,4,2,0,2,28,9.499999999999999e-05
G5,C1OC(C(C=1)=O)C(CC(C=O)=C)O,4,2,0,2,28,9.499999999999999e-05
G5,C(C(C(C=O)=C)C1(C=COC1)O)=O,4,1,0,1,28,4.8e-05
G5,C1OC(C(C=1)=O)C(C(C)=CC=O)O,8,2,0,2,28,9.499999999999999e-05
G5,C1OC(C(C=1)=O)C(C=C(C=O)C)O,8,2,0,2,28,9.499999999999999e-05
G5,C=C(C(CO)=O)C(C1C(C=CO1)=O)O,4,2,0,2,9,9.499999999999999e-05
G5,C1OC(C(C=1)=O)C(C(C=O)=C)(CO)O,4,2,0,2,9,9.499999999999999e-05
G5,C1C(COC=1)(C(C(C(C=O)=C)=O)O)O,4,2,0,2,9,9.499999999999999e-05
G5,C1OC(C(C=1)=O)C(C(C(C=C)=O)O)O,8,2,0,2,0,9.499999999999999e-05
G5,C(C(C(C=C)(C1C(C=CO1)=O)O)O)=O,8,2,0,2,0,9.499999999999999e-05
G5,C=C(C(C(C1C(C=CO1)=O)O)=O)CO,4,2,0,2,49,9.499999999999999e-05
G5,C(C(C(CO)=C)(C1C(C=CO1)=O)O)=O,4,2,0,2,49,9.499999999999999e-05
G5,C1OC(C(C=1)=O)C(C(C(C=O)=C)O)O,8,2,0,2,16,9.499999999999999e-05
G5,C(C(C(C(C1C(C=CO1)=O)O)=C)O)=O,8,2,0,2,16,9.499999999999999e-05
G5,C1OC(C(C=1)=O)C(C=C(C=O)CO)O,8,2,0,2,18,9.499999999999999e-05
G5,C1OC(C(C=1)=O)C(C(CO)=CC=O)O,8,2,0,2,18,9.499999999999999e-05
G5,C=CC(C1C(C=CO1)=O)O,4,2,0,2,28,9.499999999999999e-05
G5,C(C)=CC(CO)(C1C(C=CO1)=O)O,8,2,0,2,28,9.499999999999999e-05
G5,C1C(COC=1)(C(C(C=CC)=O)O)O,8,2,0,2,28,9.499999999999999e-05
G5,C(CC(CO)(C1C(C=CO1)=O)O)=C,4,2,0,2,28,9.499999999999999e-05
G5,C(CO)(C(C=C)C1(C=COC1)O)=O,4,1,0,1,28,4.8e-05
G5,C(C(C1(C=COC1)O)O)(CC=C)=O,4,2,0,2,28,9.499999999999999e-05
G5,C(C(C(C)(C1C(C=CO1)=O)O)O)=C,8,2,0,2,28,9.499999999999999e-05
G5,C(CC1(C=COC1)O)(C(C=C)O)=O,4,1,0,1,28,4.8e-05
G5,C=C(CO)CC(C1C(C=CO1)=O)O,4,2,0,2,28,9.499999999999999e-05
G5,C(C(C(CO)=C)C1(C=COC1)O)=O,4,1,0,1,28,4.8e-05
G5,C1OC(C(C=1)=O)C(C=C(C)CO)O,8,2,0,2,28,9.499999999999999e-05
G5,C1OC(C(C=1)=O)C(C=CC)O,8,2,0,2,28,9.499999999999999e-05
G5,C(CC(C1C(C=CO1)=O)O)=C,4,2,0,2,28,9.499999999999999e-05
G5,C(C(C=C)C1(C=COC1)O)=O,4,1,0,1,28,4.8e-05
G5,C(C(C=C)(C(C1C(C=CO1)=O)O)O)=O,8,2,0,2,28,9.499999999999999e-05
G5,C1OC(C(C=1)=O)C2(C=CC(C2O)=O)O,8,2,0,2,47,9.499999999999999e-05
G5,C(CC=CC(C1C(C=CO1)=O)O)=O,8,2,0,2,28,9.499999999999999e-05
G5,C(CC(C1C(C=CO1)=O)O)=CC=O,8,2,0,2,28,9.499999999999999e-05
G5,C(C(C=CC=O)C1(C=COC1)O)=O,8,1,0,1,28,4.8e-05
G5,C=CC(C1C(C=CC(O)O1)=O)O,8,2,0,2,27,9.499999999999999e-05
G5,C(C)=CC(C1C(C=CC(O)O1)=O)O,16,2,0,2,27,9.499999999999999e-05
G5,C(CC(C1C(C=CC(O1)O)=O)O)=C,8,2,0,2,27,9.499999999999999e-05
G5,C(C(C=C)C1(C=CC(O)OC1)O)=O,8,1,0,1,27,4.8e-05
G5,C(C(CCC(C=O)=O)C(C=C)O)=O,4,1,0,1,7,4.8e-05
G5,C(CCC(C(C=O)=O)C(C=C)O)=O,4,2,0,2,27,9.499999999999999e-05
G5,C(C(CCC(C=O)=O)C(C=CC)O)=O,8,1,0,1,7,4.8e-05
G5,C(CCC(C(C=O)=O)C(C=CC)O)=O,8,1,0,1,7,4.8e-05
G5,C(C(CCC(C=O)=O)C(CC=C)O)=O,4,1,0,1,7,4.8e-05
G5,C(CCC(C(C=O)=O)C(CC=C)O)=O,4,1,0,1,7,4.8e-05
G5,C(C(C=C)C(CCCC(C=O)=O)O)=O,4,1,0,1,7,4.8e-05
G5,C(CCCC(C(C(C=O)C=C)O)=O)=O,4,1,0,1,7,4.8e-05
G5,C(CCCC(C=O)(C(C=O)C=C)O)=O,4,1,0,1,7,4.8e-05
G5,C(CO)(CCC(C=O)C(C=C)O)=O,4,1,0,1,27,4.8e-05
G5,C(CCCC(C(C(C=C)O)O)=O)=O,4,2,0,2,27,9.499999999999999e-05
G5,C(CO)(C(CCC=O)C(C=C)O)=O,4,1,0,1,27,4.8e-05
G5,C(CC(C=O)C(C=O)C(C=C)O)=O,8,1,0,1,43,4.8e-05
G5,C(CC(C=O)C(C=O)C(C=CC)O)=O,16,1,0,1,43,4.8e-05
G5,C(CC(C=O)C(C=O)C(CC=C)O)=O,8,1,0,1,43,4.8e-05
G5,C(C(CC(C(C=O)C=C)O)CC=O)=O,8,1,0,1,43,4.8e-05
G5,C(C(C=C)C(C(CC=O)CC=O)O)=O,4,1,0,1,43,4.8e-05
G5,C(C(C)O)(C(C=O)C(C=C)O)=O,8,2,0,2,45,9.499999999999999e-05
G5,C(C(C)O)(C(C=O)C(C=CC)O)=O,16,2,0,2,45,9.499999999999999e-05
G5,C(C(C(C(C)O)=O)C(CC=C)O)=O,8,2,0,2,45,9.499999999999999e-05
G5,C(C(C=C)C(C(C)O)(CC=O)O)=O,8,1,0,1,45,4.8e-05
G5,C(C(C=C)C(CC(C(C)O)=O)O)=O,8,1,0,1,45,4.8e-05
G5,C(C(C=C)C(C(CC(C)O)O)O)=O,16,1,0,1,11,4.8e-05
G5,C(C(C=C)C(C(C)O)(C(C)O)O)=O,6,1,0,1,49,4.8e-05
G5,C(C(C(C(C(C=C)O)O)=O)(C)O)=O,8,2,0,2,0,9.499999999999999e-05
G5,C(C(C=C)C(C(O)=O)(C(C)O)O)=O,8,1,0,1,4,4.8e-05
G5,C(C(C=C)C(C=CC(C=O)O)O)=O,16,1,0,1,20,4.8e-05
G5,C(C(C=C)C(C(C=CC=O)O)O)=O,16,1,0,1,20,4.8e-05
G5,C(CC(C=C)O)(C(CCO)O)=O,4,1,0,1,45,4.8e-05
G5,C(CC(C=CC)O)(C(CCO)O)=O,8,1,0,1,45,4.8e-05
G5,C(C(CCO)O)(CC(CC=C)O)=O,4,1,0,1,45,4.8e-05
G5,C(C(C=C)C(C)(C(CCO)O)O)=O,8,1,0,1,45,4.8e-05
G5,C(C(C=C)C(C(C)(CCO)O)O)=O,8,1,0,1,29,4.8e-05
G5,C=CC(C(C(C=CC(C)=O)=O)O)O,8,2,0,2,45,9.499999999999999e-05
G5,C=CC(CC(C=CC(CO)=O)=O)O,4,1,0,1,45,4.8e-05
G5,C(C)=CC(C(C(C=CC(C)=O)=O)O)O,16,2,0,2,45,9.499999999999999e-05
G5,C(C)=CC(CC(C=CC(CO)=O)=O)O,8,1,0,1,45,4.8e-05
G5,C(CC(C(C(C=CC(C)=O)=O)O)O)=C,8,2,0,2,45,9.499999999999999e-05
G5,C(CC(CC(C=CC(CO)=O)=O)O)=C,4,1,0,1,45,4.8e-05
G5,C(C(C=C)C(C=CC(C)=O)(CO)O)=O,8,1,0,1,45,4.8e-05
G5,C(C(C=C)C(C=CC(CO)=O)(C)O)=O,8,1,0,1,45,4.8e-05
G5,C(CC=CC(C(C(C=C)O)O)=O)=O,8,2,0,2,29,9.499999999999999e-05
G5,C(C(C=CC(CO)=O)C(C=C)O)=O,8,1,0,1,29,4.8e-05
G5,C(CC=CC(C(C(C=CC)O)O)=O)=O,16,2,0,2,29,9.499999999999999e-05
G5,C(C(C=CC(CO)=O)C(C=CC)O)=O,16,1,0,1,29,4.8e-05
G5,C(CC=CC(C(C(CC=C)O)O)=O)=O,8,2,0,2,29,9.499999999999999e-05
G5,C(C(C=CC(CO)=O)C(CC=C)O)=O,8,1,0,1,29,4.8e-05
G5,C(CC=CC(CO)(C(C=O)C=C)O)=O,8,1,0,1,29,4.8e-05
G5,C(C(C=C)C(CC=CC(CO)=O)O)=O,8,1,0,1,29,4.8e-05
G5,C(C(C=C)C(C(C=CCCO)=O)O)=O,8,1,0,1,29,4.8e-05
G5,C(C(C=C)C(C=O)(C=CCCO)O)=O,8,1,0,1,29,4.8e-05
G5,C=CC(CC(C(C=CCO)=O)=O)O,4,1,0,1,27,4.8e-05
G5,C(C)=CC(CC(C(C=CCO)=O)=O)O,8,1,0,1,27,4.8e-05
G5,C(CC(CC(C(C=CCO)=O)=O)O)=C,4,1,0,1,27,4.8e-05
G5,C(C(C=C)C(C(C)=O)(C=CCO)O)=O,8,1,0,1,27,4.8e-05
G5,C(C(C=C)C(C(C=CCO)=O)(C)O)=O,8,1,0,1,27,4.8e-05
G5,C=CC(C(C(C=CC=O)=O)CO)O,8,2,0,2,27,9.499999999999999e-05
G5,C(C)=CC(C(C(C=CC=O)=O)CO)O,16,2,0,2,27,9.499999999999999e-05
G5,C=CCC(C(C(C=CC=O)=O)CO)O,8,2,0,2,27,9.499999999999999e-05
G5,C(C(C=C)C(C=CC(CCO)=O)O)=O,8,1,0,1,27,4.8e-05
G5,C(C(C=C)C(C=CC=O)(CCO)O)=O,8,1,0,1,27,4.8e-05
G5,C(C(C(C=C)O)O)(CC(C=C)=O)=O,4,2,0,2,27,9.499999999999999e-05
G5,C(CO)(C(C(C=C)=O)C(C=C)O)=O,4,2,0,2,27,9.499999999999999e-05
G5,C(C(C(C=CC)O)O)(CC(C=C)=O)=O,8,2,0,2,27,9.499999999999999e-05
G5,C(CO)(C(C(C=C)=O)C(C=CC)O)=O,8,2,0,2,27,9.499999999999999e-05
G5,C(C(C(CC=C)O)O)(CC(C=C)=O)=O,4,2,0,2,27,9.499999999999999e-05
G5,C(CO)(C(C(C=C)=O)C(CC=C)O)=O,4,2,0,2,27,9.499999999999999e-05
G5,C(C(C=C)C(CO)(CC(C=C)=O)O)=O,4,1,0,1,27,4.8e-05
G5,C(C(C=C)C(C=C)(CC(CO)=O)O)=O,4,1,0,1,27,4.8e-05
G5,C=CC(C(C(C(C=C)=O)=O)CO)O,4,2,0,2,45,9.499999999999999e-05
G5,C(C)=CC(C(C(C(C=C)=O)=O)CO)O,8,2,0,2,45,9.499999999999999e-05
G5,C=CCC(C(C(C(C=C)=O)=O)CO)O,4,2,0,2,45,9.499999999999999e-05
G5,C(C(C=C)C(C(C=C)=O)(CCO)O)=O,4,1,0,1,45,4.8e-05
G5,C(C(C=C)C(C(CCO)=O)(C=C)O)=O,4,1,0,1,45,4.8e-05
G5,C(C(C(C=C)O)O)(CC=CC=O)=O,8,2,0,2,27,9.499999999999999e-05
G5,C(CO)(C(C=CC=O)C(C=C)O)=O,8,1,0,1,27,4.8e-05
G5,C(C(C(C=CC)O)O)(CC=CC=O)=O,16,2,0,2,27,9.499999999999999e-05
G5,C(CO)(C(C=CC=O)C(C=CC)O)=O,16,1,0,1,27,4.8e-05
G5,C(C(C(CC=C)O)O)(CC=CC=O)=O,8,2,0,2,27,9.499999999999999e-05
G5,C(CO)(C(C=CC=O)C(CC=C)O)=O,8,1,0,1,27,4.8e-05
G5,C(C(C=C)C(CO)(CC=CC=O)O)=O,8,1,0,1,27,4.8e-05
G5,C(C(C=C)C(C=CCC(CO)=O)O)=O,8,1,0,1,27,4.8e-05
G5,C=CC(C(C=CCO)C(C=O)=O)O,8,1,0,1,27,4.8e-05
G5,C(C(C(C=O)=O)C(C=CC)O)=CCO,16,1,0,1,27,4.8e-05
G5,C(CC(C(C=CCO)C(C=O)=O)O)=C,8,1,0,1,27,4.8e-05
G5,C(C(C=C)C(C(CC=CCO)=O)O)=O,8,1,0,1,27,4.8e-05
G5,C(C(C=C)C(C=O)(CC=CCO)O)=O,8,1,0,1,27,4.8e-05
G5,C(CC(C(CC(C=C)O)=O)O)(O)=O,4,1,0,1,27,4.8e-05
G5,C(C(C=C)(C(C(C=O)=O)C)O)(O)=O,4,1,0,1,7,4.8e-05
G5,C(C(C=C)(C(C=C)C(C=O)=O)O)(O)=O,4,1,0,1,7,4.8e-05
G5,C(C(C=C)(CC(C=CC=O)=O)O)(O)=O,4,1,0,1,7,4.8e-05
G5,C(C(C(C=O)=C)C(C(O)=O)(C=C)O)=O,4,1,0,1,7,4.8e-05
G5,C(C(C=C)C(C(O)=O)(C=C)O)=O,4,1,0,1,7,4.8e-05
G5,C(C(C=CC=O)C(C(O)=O)(C=C)O)=O,8,1,0,1,7,4.8e-05
G5,C=CC(CC(C=CC(C(O)=O)=O)=O)O,4,1,0,1,29,4.8e-05
G5,C(C(C=CC(C(O)=O)=O)C(C=C)O)=O,8,1,0,1,29,4.8e-05
G5,C=CC(CC(C(C=CC(O)=O)=O)=O)O,4,1,0,1,29,4.8e-05
G5,C(C(C(C=CC(O)=O)=O)C(C=C)O)=O,8,2,0,2,29,9.499999999999999e-05
G5,C(C(C(C=CC=O)=O)C(C=C)O)(O)=O,8,2,0,2,29,9.499999999999999e-05
G5,C=CC(C(C(C=C)=O)C(C(O)=O)=O)O,4,2,0,2,29,9.499999999999999e-05
G5,C(C(C(C(C=C)=O)=O)C(C=C)O)(O)=O,4,2,0,2,29,9.499999999999999e-05
G5,C=CC(C(C=CC=O)C(C(O)=O)=O)O,8,1,0,1,29,4.8e-05
G5,C=CC(C(C=CC(O)=O)C(C=O)=O)O,8,1,0,1,29,4.8e-05
G5,C1(C(C(C=C)O)OCC1(CO)O)=O,8,2,0,2,10,9.499999999999999e-05
G5,C(C(C=C)C(C(C(O)=O)(C)O)O)=O,8,1,0,1,25,4.8e-05
G5,C(C(C(C)C(C(C)(CO)O)O)=O)=O,8,1,0,1,11,4.8e-05
G5,C(C(C=C)C(C(C)(CO)O)O)=O,8,1,0,1,11,4.8e-05
G5,C1(C(CO)(O)OCC1C(C=C)O)=O,8,2,0,2,34,9.499999999999999e-05
G5,C(C(C=C)C(C(C)(C(C)O)O)O)=O,16,1,0,1,18,4.8e-05
G5,C1(CCC(C(C1C(C=C)O)=O)=O)=O,4,2,0,2,45,9.499999999999999e-05
G5,C1(CC(C(C(C1)=O)=O)C(C=C)O)=O,4,1,0,1,45,4.8e-05
G5,C1(C(CC(C(C1)=O)=O)C(C=C)O)=O,4,1,0,1,45,4.8e-05
G5,C1(CCC(C(C1C(C=CC)O)=O)=O)=O,8,2,0,2,45,9.499999999999999e-05
G5,C1(CC(C(C(C1)=O)=O)C(C=CC)O)=O,8,1,0,1,45,4.8e-05
G5,C1(C(CC(C(C1)=O)=O)C(C=CC)O)=O,8,1,0,1,45,4.8e-05
G5,C1(CCC(C(C1C(CC=C)O)=O)=O)=O,4,2,0,2,45,9.499999999999999e-05
G5,C1(CC(C(C(C1)=O)=O)C(CC=C)O)=O,4,1,0,1,45,4.8e-05
G5,C1(C(C(CC=C)O)CC(C(C1)=O)=O)=O,4,1,0,1,45,4.8e-05
G5,C(C(C=C)C1(C(CCC(C1)=O)=O)O)=O,4,1,0,1,45,4.8e-05
G5,C1(CCC(C(C1)=O)(C(C=O)C=C)O)=O,4,1,0,1,45,4.8e-05
G5,C(C(C=C)C1(CCC(C(C1)=O)=O)O)=O,4,1,0,1,45,4.8e-05
G5,C(C1C(C(C(C1)C(C=C)O)=O)=O)=O,8,1,0,1,45,4.8e-05
G5,C(C1C(C(C(C1)C(C=CC)O)=O)=O)=O,16,1,0,1,45,4.8e-05
G5,C(C1C(C(C(C1)C(CC=C)O)=O)=O)=O,8,1,0,1,45,4.8e-05
G5,C(C(C=C)C(C1C(C(CC1)=O)=O)O)=O,8,1,0,1,45,4.8e-05
G5,C(C1C(C(CC1)(C(C=O)C=C)O)=O)=O,8,1,0,1,45,4.8e-05
G5,C(C1CCC(C1(C(C=O)C=C)O)=O)=O,8,1,0,1,45,4.8e-05
G5,C1(CC(CC(C1C(C=C)O)=O)=O)=O,2,2,0,2,45,9.499999999999999e-05
G5,C1(CC(CC(C1C(C=CC)O)=O)=O)=O,4,2,0,2,45,9.499999999999999e-05
G5,C1(CC(CC(C1C(CC=C)O)=O)=O)=O,2,2,0,2,45,9.499999999999999e-05
G5,C(C(C=C)C1(CC(CC(C1)=O)=O)O)=O,2,1,0,1,45,4.8e-05
G5,C(C1C(C(C(C1)=O)C(C=C)O)=O)=O,8,2,0,2,45,9.499999999999999e-05
G5,C(C1C(CC(C1C(C=C)O)=O)=O)=O,8,1,0,1,45,4.8e-05
G5,C(C1C(C(C(C1)=O)C(C=CC)O)=O)=O,16,2,0,2,45,9.499999999999999e-05
G5,C(C1C(CC(C1C(C=CC)O)=O)=O)=O,16,1,0,1,45,4.8e-05
G5,C1(C(C=O)CC(C1C(CC=C)O)=O)=O,8,2,0,2,45,9.499999999999999e-05
G5,C1(C(C=O)C(C(C1)=O)C(CC=C)O)=O,8,1,0,1,45,4.8e-05
G5,C(C1C(CC(C1)=O)(C(C=O)C=C)O)=O,8,1,0,1,45,4.8e-05
G5,C(C(C=C)C1(CC(C=O)C(C1)=O)O)=O,8,1,0,1,45,4.8e-05
G5,C(C(C=C)C(C1C(CC(C1)=O)=O)O)=O,8,1,0,1,45,4.8e-05
G5,C(C1CC(C(C1C(C=C)O)=O)=O)=O,8,1,0,1,45,4.8e-05
G5,C(C1CC(C(C1C(C=CC)O)=O)=O)=O,16,1,0,1,45,4.8e-05
G5,C(C1CC(C(C1C(CC=C)O)=O)=O)=O,8,1,0,1,45,4.8e-05
G5,C(C1CC(C(C1)=O)(C(C=O)C=C)O)=O,8,1,0,1,45,4.8e-05
G5,C(C(C=C)C(C1CC(C(C1)=O)=O)O)=O,4,1,0,1,45,4.8e-05
G5,C(C1C(CC(C1=O)C(C=C)O)=O)=O,8,1,0,1,45,4.8e-05
G5,C(C1C(CC(C1=O)C(C=CC)O)=O)=O,16,1,0,1,45,4.8e-05
G5,C1(C(C(CC=C)O)CC(C1C=O)=O)=O,8,1,0,1,45,4.8e-05
G5,C(C(C=C)C1(CCC(C1C=O)=O)O)=O,8,1,0,1,45,4.8e-05
G5,C(C(C=C)C(C1C(CCC1=O)=O)O)=O,4,1,0,1,45,4.8e-05
G5,C1(C(C(C=CC1C(C=C)O)=O)O)=O,8,1,0,1,32,4.8e-05
G5,C1(C(C(C=CC1C(C=CC)O)=O)O)=O,16,1,0,1,32,4.8e-05
G5,C1(C(C(C=CC1C(CC=C)O)=O)O)=O,8,1,0,1,32,4.8e-05
G5,C(C(C=C)C1(C(C(C=CC1)=O)O)O)=O,8,1,0,1,32,4.8e-05
G5,C(C(C=C)C1(C=CCC(C1O)=O)O)=O,8,1,0,1,32,4.8e-05
G5,C1(C(C=CC(C1C(C=C)O)=O)O)=O,8,2,0,2,45,9.499999999999999e-05
G5,C1(C(C=CC(C1C(C=CC)O)=O)O)=O,16,2,0,2,45,9.499999999999999e-05
G5,C1(C(C=CC(C1C(CC=C)O)=O)O)=O,8,2,0,2,45,9.499999999999999e-05
G5,C(C(C=C)C1(C(C=CC(C1)=O)O)O)=O,8,1,0,1,45,4.8e-05
G5,C(C(C=C)C1(C=CC(C(C1)=O)O)O)=O,8,1,0,1,45,4.8e-05
G5,C=CC(C(C(C(CO)=O)=O)C)O,4,1,0,1,42,4.8e-05
G5,C=CC(C(C(C(CC)=O)=O)O)O,4,2,0,2,42,9.499999999999999e-05
G5,C(C)=CC(C(C(C(CO)=O)=O)C)O,8,1,0,1,42,4.8e-05
G5,C(C)=CC(C(C(C(CC)=O)=O)O)O,8,2,0,2,42,9.499999999999999e-05
G5,C(CC(C(C(C(CO)=O)=O)C)O)=C,4,1,0,1,42,4.8e-05
G5,C(CC(C(C(C(CC)=O)=O)O)O)=C,4,2,0,2,42,9.499999999999999e-05
G5,C(C(C=C)C(C(CO)=O)(CC)O)=O,4,1,0,1,42,4.8e-05
G5,C(C(C=C)C(C(CC)=O)(CO)O)=O,4,1,0,1,42,4.8e-05
G5,C(C(CO)C(C=O)C(C=C)O)=O,8,1,0,1,55,4.8e-05
G5,C(C(CO)C(C=O)C(C=CC)O)=O,16,1,0,1,55,4.8e-05
G5,C(C(C(CC=C)O)C(C=O)CO)=O,8,1,0,1,55,4.8e-05
G5,C(C(C=C)C(C(CO)CC=O)O)=O,8,1,0,1,55,4.8e-05
G5,C(C(C=C)C(CC(C=O)CO)O)=O,8,1,0,1,55,4.8e-05
G5,C=CC(C(C(C=O)=O)CC(C=O)=O)O,4,1,0,1,7,4.8e-05
G5,C(C(C)C(C(C=O)=O)C(C=C)O)=O,8,1,0,1,28,4.8e-05
G5,C(C(C)C(C(C=O)=O)C(C=CC)O)=O,16,1,0,1,28,4.8e-05
G5,C(C(C)C(C(C=O)=O)C(CC=C)O)=O,8,1,0,1,28,4.8e-05
G5,C(C(C)CC(C(C(C=O)C=C)O)=O)=O,8,1,0,1,28,4.8e-05
G5,C(C(C)CC(C=O)(C(C=O)C=C)O)=O,8,1,0,1,28,4.8e-05
G5,C(C(C=C)C(C(C)CC(C=O)=O)O)=O,8,1,0,1,28,4.8e-05
G5,C(C)(C(C(C(C)=O)=O)C(C=C)O)=O,4,2,0,2,14,9.499999999999999e-05
G5,C(C)(CC(C(CC(C=C)O)=O)=O)=O,2,1,0,1,14,4.8e-05
G5,C(CC(C=C)O)(CC(C(C)=O)=O)=O,2,1,0,1,14,4.8e-05
G5,C(C)(C(C(C(C)=O)=O)C(C=CC)O)=O,8,2,0,2,14,9.499999999999999e-05
G5,C(C)(CC(C(CC(C=CC)O)=O)=O)=O,4,1,0,1,14,4.8e-05
G5,C(CC(C=CC)O)(CC(C(C)=O)=O)=O,4,1,0,1,14,4.8e-05
G5,C(C)(C(C(C(C)=O)=O)C(CC=C)O)=O,4,2,0,2,14,9.499999999999999e-05
G5,C(C)(CC(C(CC(CC=C)O)=O)=O)=O,2,1,0,1,14,4.8e-05
G5,C(CC(CC=C)O)(CC(C(C)=O)=O)=O,2,1,0,1,14,4.8e-05
G5,C(C(C=C)C(C(C)=O)(CC(C)=O)O)=O,4,1,0,1,14,4.8e-05
G5,C(C(C)(C(C=O)C=C)O)(CC(C)=O)=O,4,1,0,1,14,4.8e-05
G5,C(C(C=C)C(C)(CC(C(C)=O)=O)O)=O,4,1,0,1,14,4.8e-05
G5,C(C(C(C(CC(C=C)O)=O)=O)C)=O,4,1,0,1,45,4.8e-05
G5,C(C(C(C(CC(C=CC)O)=O)=O)C)=O,8,1,0,1,45,4.8e-05
G5,C(C(C(C(CC(CC=C)O)=O)=O)C)=O,4,1,0,1,45,4.8e-05
G5,C(C(C=C)C(C(C(C(C)=O)=O)C)O)=O,8,1,0,1,45,4.8e-05
G5,C(C(C(C(C)(C(C=O)C=C)O)=O)C)=O,8,1,0,1,45,4.8e-05
G5,C(C(C)C(C(C)=O)(C(C=O)C=C)O)=O,8,1,0,1,45,4.8e-05
G5,C(C(C(C(CC=O)=O)=O)C(C=C)O)=O,4,2,0,2,2,9.499999999999999e-05
G5,C(C(C(C(CC)=O)=O)C(C=C)O)=O,4,2,0,2,27,9.499999999999999e-05
G5,C(CC(C(C(C)C(C=C)O)=O)=O)=O,4,1,0,1,27,4.8e-05
G5,C(C(C(C(CC)=O)=O)C(C=CC)O)=O,8,2,0,2,27,9.499999999999999e-05
G5,C(CC(C(C(C)C(C=CC)O)=O)=O)=O,8,1,0,1,27,4.8e-05
G5,C(C(C(C(CC)=O)=O)C(CC=C)O)=O,4,2,0,2,27,9.499999999999999e-05
G5,C(CC(C(C(C)C(CC=C)O)=O)=O)=O,4,1,0,1,27,4.8e-05
G5,C(C(C=C)C(CC(C(CC)=O)=O)O)=O,4,1,0,1,27,4.8e-05
G5,C(CC(C(CC)=O)(C(C=O)C=C)O)=O,4,1,0,1,27,4.8e-05
G5,C(CC(C(CC)(C(C=O)C=C)O)=O)=O,4,1,0,1,27,4.8e-05
G5,C(CC(C(C(C)=O)=O)C(C=C)O)=O,4,1,0,1,46,4.8e-05
G5,C(CCC(C(CC(C=C)O)=O)=O)=O,2,1,0,1,46,4.8e-05
G5,C(C(CC(C(C)=O)=O)C(C=C)O)=O,4,1,0,1,46,4.8e-05
G5,C(CC(C(C(C)=O)=O)C(C=CC)O)=O,8,1,0,1,46,4.8e-05
G5,C(CCC(C(CC(C=CC)O)=O)=O)=O,4,1,0,1,46,4.8e-05
G5,C(C(CC(C(C)=O)=O)C(C=CC)O)=O,8,1,0,1,46,4.8e-05
G5,C(CC(C(C(C)=O)=O)C(CC=C)O)=O,4,1,0,1,46,4.8e-05
G5,C(CCC(C(CC(CC=C)O)=O)=O)=O,2,1,0,1,46,4.8e-05
G5,C(C(C(CC=C)O)CC(C(C)=O)=O)=O,4,1,0,1,46,4.8e-05
G5,C(CCC(C(C)=O)(C(C=O)C=C)O)=O,4,1,0,1,46,4.8e-05
G5,C(C(C=C)C(C(CCC=O)=O)(C)O)=O,4,1,0,1,46,4.8e-05
G5,C(C(C=C)C(CCC(C(C)=O)=O)O)=O,4,1,0,1,46,4.8e-05
G5,C(C(C(C=C)O)C(C(C=O)=O)C)=O,8,1,0,1,45,4.8e-05
G5,C(C(C(C=CC)O)C(C(C=O)=O)C)=O,16,1,0,1,45,4.8e-05
G5,C(C(C(CC=C)O)C(C(C=O)=O)C)=O,8,1,0,1,45,4.8e-05
G5,C(CC(C(C(C(C=O)C=C)O)=O)C)=O,8,1,0,1,45,4.8e-05
G5,C(CC(C)C(C=O)(C(C=O)C=C)O)=O,8,2,0,2,45,9.499999999999999e-05
G5,C(C(C=C)C(CC(C(C=O)=O)C)O)=O,8,1,0,1,45,4.8e-05
G5,C(CC(C(C(C(C=C)O)O)=O)C)=O,8,2,0,2,0,9.499999999999999e-05
G5,C(CO)(C(C)C(C=O)C(C=C)O)=O,8,1,0,1,0,4.8e-05
G5,C=CC(C(C(C(CCO)=O)=O)C)O,4,1,0,1,27,4.8e-05
G5,C=CC(C(C(C(CC)=O)=O)CO)O,4,2,0,2,27,9.499999999999999e-05
G5,C(C)(C(C(CCO)=O)C(C=C)O)=O,4,2,0,2,27,9.499999999999999e-05
G5,C(C)(CC(C(CO)C(C=C)O)=O)=O,4,2,0,2,27,9.499999999999999e-05
G5,C(CC(C=C)O)(CC(CCO)=O)=O,2,1,0,1,27,4.8e-05
G5,C(C(CCO)C(C=O)C(C=C)O)=O,8,1,0,1,46,4.8e-05
G5,C(C(C)C(C(CO)=O)C(C=C)O)=O,8,1,0,1,28,4.8e-05
G5,C(C(C)CC(C(C(C=C)O)O)=O)=O,8,2,0,2,28,9.499999999999999e-05
G5,C=CC(CC(C(C(CO)C)=O)=O)O,4,1,0,1,27,4.8e-05
G5,C(C(C)C(C(CC(C=C)O)=O)O)=O,8,1,0,1,27,4.8e-05
G5,C(C(CC(C(CC)=O)=O)O)(CC)=O,2,1,0,1,28,4.8e-05
G5,C(C(C(C(C(C)=O)=O)C)O)(CC)=O,4,1,0,1,28,4.8e-05
G5,C(C(CC)(CC(C(CC)=O)=O)O)=O,2,1,0,1,28,4.8e-05
G5,C(C(CC)(C(C(C(C)=O)=O)C)O)=O,4,1,0,1,28,4.8e-05
G5,C(C(C)(C(C(C=O)=O)C)O)(CC)=O,4,1,0,1,28,4.8e-05
G5,C(C)(C(CC)(C(C(C=O)=O)C)O)=O,4,1,0,1,28,4.8e-05
G5,C(C)=CC(C(CC(C(CC)=O)=O)O)=O,4,1,0,1,28,4.8e-05
G5,C(C)=CC(C(C(C(C(C)=O)=O)C)O)=O,8,1,0,1,28,4.8e-05
G5,C(C(C=CC)(CC(C(CC)=O)=O)O)=O,4,1,0,1,28,4.8e-05
G5,C(C(C=CC)(C(C(C(C)=O)=O)C)O)=O,8,1,0,1,28,4.8e-05
G5,C(C(CC(C(CC)=O)=O)O)(CC=C)=O,2,1,0,1,28,4.8e-05
G5,C(C(C(C(C(C)=O)=O)C)O)(CC=C)=O,4,1,0,1,28,4.8e-05
G5,C(C(CC=C)(CC(C(CC)=O)=O)O)=O,2,1,0,1,28,4.8e-05
G5,C(C(CC=C)(C(C(C(C)=O)=O)C)O)=O,4,1,0,1,28,4.8e-05
G5,C(C(C)(C(C=C)C(C=O)=O)O)(CC)=O,4,1,0,1,28,4.8e-05
G5,C(C)(C(CC)(C(C=C)C(C=O)=O)O)=O,4,1,0,1,28,4.8e-05
G5,C(C(C)(CC(C(CC)=O)=O)O)=CC=O,4,1,0,1,28,4.8e-05
G5,C(C(C)(C(C(C(C)=O)=O)C)O)=CC=O,8,1,0,1,28,4.8e-05
G5,C(C(CC(C(CC)=O)=O)O)=CC(C)=O,4,1,0,1,28,4.8e-05
G5,C(C(C(C(C(C)=O)=O)C)O)=CC(C)=O,8,1,0,1,28,4.8e-05
G5,C(C(C)(CC(C=CC=O)=O)O)(CC)=O,4,1,0,1,28,4.8e-05
G5,C(C)(C(CC)(CC(C=CC=O)=O)O)=O,4,1,0,1,28,4.8e-05
G5,C(CC(C(CC(C(CC)=O)=O)O)=C)=O,2,1,0,1,28,4.8e-05
G5,C(CC(C(C(C(C(C)=O)=O)C)O)=C)=O,4,1,0,1,28,4.8e-05
G5,C=C(C=O)CC(CC(C(CC)=O)=O)O,2,1,0,1,28,4.8e-05
G5,C=C(C=O)CC(C(C(C(C)=O)=O)C)O,4,1,0,1,28,4.8e-05
G5,C(C(C(C=O)=C)C(C(CC)=O)(C)O)=O,4,1,0,1,28,4.8e-05
G5,C(C(C(C=O)=C)C(C(C)=O)(CC)O)=O,4,1,0,1,28,4.8e-05
G5,C(C(CC(C(CC)=O)=O)O)(C)=CC=O,4,1,0,1,28,4.8e-05
G5,C(C(C(C(C(C)=O)=O)C)O)(C)=CC=O,8,1,0,1,28,4.8e-05
G5,C(C(CC(C(CC)=O)=O)O)=C(C=O)C,4,1,0,1,28,4.8e-05
G5,C(C(C(C(C(C)=O)=O)C)O)=C(C=O)C,8,1,0,1,28,4.8e-05
G5,C=CC(CC(C(CC)=O)=O)O,2,1,0,1,28,4.8e-05
G5,C=CC(C(C(C(C)=O)=O)C)O,4,1,0,1,28,4.8e-05
G5,C(C)=CC(CC(C(CC)=O)=O)O,4,1,0,1,28,4.8e-05
G5,C(C)=CC(C(C(C(C)=O)=O)C)O,8,1,0,1,28,4.8e-05
G5,C=CCC(CC(C(CC)=O)=O)O,2,1,0,1,28,4.8e-05
G5,C(CC(C(C(C(C)=O)=O)C)O)=C,4,1,0,1,28,4.8e-05
G5,C(C(C=C)C(C(CC)=O)(C)O)=O,4,1,0,1,28,4.8e-05
G5,C(C(C=C)C(C(C)=O)(CC)O)=O,4,1,0,1,28,4.8e-05
G5,C(CC=CC(CC(C(CC)=O)=O)O)=O,4,1,0,1,28,4.8e-05
G5,C(CC=CC(C(C(C(C)=O)=O)C)O)=O,8,1,0,1,28,4.8e-05
G5,C(CC(CC(C(CC)=O)=O)O)=CC=O,4,1,0,1,28,4.8e-05
G5,C(CC(C(C(C(C)=O)=O)C)O)=CC=O,8,1,0,1,28,4.8e-05
G5,C(C(C=CC=O)C(C(CC)=O)(C)O)=O,8,1,0,1,28,4.8e-05
G5,C(C(C=CC=O)C(C(C)=O)(CC)O)=O,8,1,0,1,28,4.8e-05
G5,C(C)(CC(CC(C(CC)=O)O)=O)=O,2,1,0,1,28,4.8e-05
G5,C(C)(C(C(C)=O)C(C(CC)=O)O)=O,2,2,0,2,28,9.499999999999999e-05
G5,C(C(CC)(CC(CC(C)=O)=O)O)=O,2,1,0,1,28,4.8e-05
G5,C(C(CC)(C(C(C)=O)C(C)=O)O)=O,2,2,0,2,28,9.499999999999999e-05
G5,C(C)(CC(C)(C(C(C=O)=O)C)O)=O,4,1,0,1,28,4.8e-05
G5,C(C)(CC(CC(C(C=CC)=O)O)=O)=O,4,1,0,1,28,4.8e-05
G5,C(C)(C(C(C)=O)C(C(C=CC)=O)O)=O,4,2,0,2,28,9.499999999999999e-05
G5,C(C(C=CC)(CC(CC(C)=O)=O)O)=O,4,1,0,1,28,4.8e-05
G5,C(C(C=CC)(C(C(C)=O)C(C)=O)O)=O,4,2,0,2,28,9.499999999999999e-05
G5,C(C(CC(CC(C)=O)=O)O)(CC=C)=O,2,1,0,1,28,4.8e-05
G5,C(C)(C(C(C)=O)C(C(CC=C)=O)O)=O,2,2,0,2,28,9.499999999999999e-05
G5,C(C(CC(CC(C)=O)=O)(CC=C)O)=O,2,1,0,1,28,4.8e-05
G5,C(C(CC=C)(C(C(C)=O)C(C)=O)O)=O,2,2,0,2,28,9.499999999999999e-05
G5,C(C)(CC(C)(C(C=C)C(C=O)=O)O)=O,4,1,0,1,28,4.8e-05
G5,C(C)(CC(CC(C=CC=O)(C)O)=O)=O,4,1,0,1,28,4.8e-05
G5,C(C)(C(C(C)=O)C(C=CC=O)(C)O)=O,4,2,0,2,28,9.499999999999999e-05
G5,C(C)(CC(CC(C=CC(C)=O)O)=O)=O,4,1,0,1,28,4.8e-05
G5,C(C)(C(C(C)=O)C(C=CC(C)=O)O)=O,4,2,0,2,28,9.499999999999999e-05
G5,C(C)(CC(C)(CC(C=CC=O)=O)O)=O,4,1,0,1,28,4.8e-05
G5,C(CC(C(CC(CC(C)=O)=O)O)=C)=O,2,1,0,1,28,4.8e-05
G5,C(CC(C(C(C(C)=O)C(C)=O)O)=C)=O,2,2,0,2,28,9.499999999999999e-05
G5,C(CC(CC(C=O)=C)O)(CC(C)=O)=O,2,1,0,1,28,4.8e-05
G5,C(C)(C(C(C)=O)C(CC(C=O)=C)O)=O,2,2,0,2,28,9.499999999999999e-05
G5,C(C(C(C=O)=C)C(C)(CC(C)=O)O)=O,4,1,0,1,28,4.8e-05
G5,C(C)(CC(CC(C(C)=CC=O)O)=O)=O,4,1,0,1,28,4.8e-05
G5,C(C)(C(C(C)=O)C(C(C)=CC=O)O)=O,4,2,0,2,28,9.499999999999999e-05
G5,C(C)(CC(CC(C=C(C=O)C)O)=O)=O,4,1,0,1,28,4.8e-05
G5,C(C)(C(C(C)=O)C(C=C(C=O)C)O)=O,4,2,0,2,28,9.499999999999999e-05
G5,C(CC(C=C)O)(CC(C)=O)=O,2,1,0,1,28,4.8e-05
G5,C(C)(C(C(C)=O)C(C=C)O)=O,2,2,0,2,28,9.499999999999999e-05
G5,C(C)(CC(CC(C=CC)O)=O)=O,4,1,0,1,28,4.8e-05
G5,C(C)(C(C(C)=O)C(C=CC)O)=O,4,2,0,2,28,9.499999999999999e-05
G5,C(CC(CC=C)O)(CC(C)=O)=O,2,1,0,1,28,4.8e-05
G5,C(C)(C(C(C)=O)C(CC=C)O)=O,2,2,0,2,28,9.499999999999999e-05
G5,C(C(C=C)C(C)(CC(C)=O)O)=O,4,1,0,1,28,4.8e-05
G5,C(CC=CC(CC(CC(C)=O)=O)O)=O,4,1,0,1,28,4.8e-05
G5,C(CC=CC(C(C(C)=O)C(C)=O)O)=O,4,2,0,2,28,9.499999999999999e-05
G5,C(CC(CC=CC=O)O)(CC(C)=O)=O,4,1,0,1,28,4.8e-05
G5,C(C)(C(C(C)=O)C(CC=CC=O)O)=O,4,2,0,2,28,9.499999999999999e-05
G5,C(C(C=CC=O)C(C)(CC(C)=O)O)=O,8,1,0,1,28,4.8e-05
G5,C(C(C(C=O)C(C=O)C)O)(CC)=O,8,1,0,1,28,4.8e-05
G5,C(C(C)C(C=O)C(C=O)(CC)O)=O,8,1,0,1,28,4.8e-05
G5,C(CC(C)C(C(C(C=O)=O)C)O)=O,8,2,0,2,28,9.499999999999999e-05
G5,C(C(C)CC(C(C(C=O)=O)C)O)=O,8,1,0,1,28,4.8e-05
G5,C(C(C)C(C=O)C(C(C=CC)=O)O)=O,16,2,0,2,28,9.499999999999999e-05
G5,C(C(C)C(C=O)C(C=O)(C=CC)O)=O,16,1,0,1,28,4.8e-05
G5,C(C(C)C(C=O)C(C(CC=C)=O)O)=O,8,2,0,2,28,9.499999999999999e-05
G5,C(C(C(C=O)(CC=C)O)C(C=O)C)=O,8,1,0,1,28,4.8e-05
G5,C(CC(C)C(C(C=C)C(C=O)=O)O)=O,8,2,0,2,28,9.499999999999999e-05
G5,C(C(C)CC(C(C=C)C(C=O)=O)O)=O,8,1,0,1,28,4.8e-05
G5,C(C(C)C(C=O)C(C=CC=O)(C)O)=O,16,1,0,1,28,4.8e-05
G5,C(C(C)C(C=O)C(C=CC(C)=O)O)=O,16,1,0,1,28,4.8e-05
G5,C(CC(C)C(CC(C=CC=O)=O)O)=O,8,2,0,2,27,9.499999999999999e-05
G5,C(C(C)CC(CC(C=CC=O)=O)O)=O,8,1,0,1,28,4.8e-05
G5,C(C(C)C(C=O)C(C(CC=O)=C)O)=O,8,2,0,2,28,9.499999999999999e-05
G5,C(C(C)C(C=O)C(CC(C=O)=C)O)=O,8,1,0,1,28,4.8e-05
G5,C(C(C(C=O)=C)C(C(C)CC=O)O)=O,8,1,0,1,28,4.8e-05
G5,C(C(C(C=O)=C)C(CC(C=O)C)O)=O,8,1,0,1,28,4.8e-05
G5,C(C(C)C(C=O)C(C(C)=CC=O)O)=O,16,2,0,2,28,9.499999999999999e-05
G5,C(C(C)C(C=O)C(C=C(C=O)C)O)=O,16,1,0,1,28,4.8e-05
G5,C(C(C)C(C=O)C(C=C)O)=O,8,1,0,1,28,4.8e-05
G5,C(C(C)C(C=O)C(C=CC)O)=O,16,1,0,1,28,4.8e-05
G5,C(C(C)C(C=O)C(CC=C)O)=O,8,1,0,1,28,4.8e-05
G5,C(C(C=C)C(C(C)CC=O)O)=O,8,1,0,1,28,4.8e-05
G5,C(C(C=C)C(CC(C=O)C)O)=O,8,1,0,1,28,4.8e-05
G5,C(C(C)C(C=O)C(C=CCC=O)O)=O,16,1,0,1,28,4.8e-05
G5,C(C(C)C(C=O)C(CC=CC=O)O)=O,16,1,0,1,28,4.8e-05
G5,C(C(C=CC=O)C(C(C)CC=O)O)=O,16,1,0,1,28,4.8e-05
G5,C(C(C=CC=O)C(CC(C=O)C)O)=O,16,1,0,1,28,4.8e-05
G5,C(C(C(C(C(C=O)C=C)O)=O)C)=O,8,1,0,1,49,4.8e-05
G5,C(C(C)C(C=O)(C(C=O)C=C)O)=O,8,1,0,1,49,4.8e-05
G5,C(C(C=C)C(C(C(C=O)=O)C)O)=O,8,1,0,1,49,4.8e-05
G5,C(C(C=C)C(C(C(CO)C)=O)O)=O,8,1,0,1,28,4.8e-05
G5,C(C(C=C)C(C=O)(C(CO)C)O)=O,8,1,0,1,28,4.8e-05
G5,C(C(C=C)C(C(C(C=O)C)O)O)=O,16,1,0,1,49,4.8e-05
G5,C(C(C=C)C(C(C)C(C=O)O)O)=O,16,1,0,1,49,4.8e-05
G5,C(C(C(C(C=O)=O)C)O)(CC)=O,4,1,0,1,28,4.8e-05
G5,C(C(CC)(C(C(C=O)=O)C)O)=O,4,1,0,1,28,4.8e-05
G5,C(C(C=O)C(C(C(C=O)=O)C)O)=O,4,3,0,3,49,0.000144
G5,C(C(CC)(C(C(C=O)=O)C)O)(O)=O,4,1,0,1,28,4.8e-05
G5,C(C(C(C(C(O)=O)=O)C)O)(CC)=O,4,1,0,1,28,4.8e-05
G5,C(C(CC)(C(C(C(O)=O)=O)C)O)=O,4,1,0,1,28,4.8e-05
G5,C(C=O)(C(C)C(C(C=CC=O)=O)O)=O,8,1,0,1,20,4.8e-05
G5,C(C(C=CC=O)(C(C(C=O)=O)C)O)=O,8,1,0,1,20,4.8e-05
G5,C(C(C(C(C=O)=O)C)O)=CC(C=O)=O,8,1,0,1,20,4.8e-05
G5,C(C)=CC(C(C(C(C=O)=O)C)O)=O,8,1,0,1,28,4.8e-05
G5,C(C(C=CC)(C(C(C=O)=O)C)O)=O,8,1,0,1,28,4.8e-05
G5,C(C(C(C(C=O)=O)C)O)(CC=C)=O,4,1,0,1,28,4.8e-05
G5,C(C(CC=C)(C(C(C=O)=O)C)O)=O,4,1,0,1,28,4.8e-05
G5,C(C(C(C=C)C(C=O)=O)O)(CC)=O,4,1,0,1,28,4.8e-05
G5,C(C(CC)(C(C=C)C(C=O)=O)O)=O,4,1,0,1,28,4.8e-05
G5,C(C(C)(C(C(C=O)=O)C)O)=CC=O,8,1,0,1,28,4.8e-05
G5,C(C(C(C(C=O)=O)C)O)=CC(C)=O,8,1,0,1,28,4.8e-05
G5,C(C(CC(C=CC=O)=O)O)(CC)=O,4,1,0,1,28,4.8e-05
G5,C(C(CC)(CC(C=CC=O)=O)O)=O,4,1,0,1,28,4.8e-05
G5,C(CC(C(C(C(C=O)=O)C)O)=C)=O,4,1,0,1,28,4.8e-05
G5,C=C(C=O)CC(C(C(C=O)=O)C)O,4,1,0,1,28,4.8e-05
G5,C(C(C(C=O)=C)C(C(CC)=O)O)=O,4,1,0,1,28,4.8e-05
G5,C(C(C(C=O)=C)C(C=O)(CC)O)=O,4,1,0,1,28,4.8e-05
G5,C(C(C(C(C=O)=O)C)O)(C)=CC=O,8,1,0,1,28,4.8e-05
G5,C(C(C(C(C=O)=O)C)O)=C(C=O)C,8,1,0,1,28,4.8e-05
G5,C=CC(C(C(C=O)=O)C)O,4,1,0,1,28,4.8e-05
G5,C(C(CO)(C(C(C=O)=O)C)O)=CC,8,1,0,1,28,4.8e-05
G5,C(C(C(C(C=CC)=O)O)O)(CC)=O,8,2,0,2,28,9.499999999999999e-05
G5,C(C(CC)(C(C(C=CC)=O)O)O)=O,8,2,0,2,28,9.499999999999999e-05
G5,C=CCC(CO)(C(C(C=O)=O)C)O,4,1,0,1,28,4.8e-05
G5,C(CO)(C(C=C)C(C(CC)=O)O)=O,4,1,0,1,28,4.8e-05
G5,C(C(CC)(C(C(CO)=O)C=C)O)=O,4,1,0,1,28,4.8e-05
G5,C(C(C(C(CC=C)=O)O)O)(CC)=O,4,2,0,2,28,9.499999999999999e-05
G5,C(C(CC)(C(C(CC=C)=O)O)O)=O,4,2,0,2,28,9.499999999999999e-05
G5,C=CC(C(C)(C(C(C=O)=O)C)O)O,8,1,0,1,28,4.8e-05
G5,C(CC(C(CC)=O)O)(C(C=C)O)=O,4,1,0,1,28,4.8e-05
G5,C(C(CC)(CC(C(C=C)O)=O)O)=O,4,1,0,1,28,4.8e-05
G5,C=C(CO)CC(C(C(C=O)=O)C)O,4,1,0,1,28,4.8e-05
G5,C(C(C(CO)=C)C(C(CC)=O)O)=O,4,1,0,1,28,4.8e-05
G5,C(C(CC)(C(C=O)C(CO)=C)O)=O,4,1,0,1,28,4.8e-05
G5,C(CO)(C)=CC(C(C(C=O)=O)C)O,8,1,0,1,28,4.8e-05
G5,C(C)=CC(C(C(C=O)=O)C)O,8,1,0,1,28,4.8e-05
G5,C=CCC(C(C(C=O)=O)C)O,4,1,0,1,28,4.8e-05
G5,C(C(C=C)C(C(CC)=O)O)=O,4,1,0,1,28,4.8e-05
G5,C(C(C=C)C(C=O)(CC)O)=O,4,1,0,1,28,4.8e-05
G5,C1C(C(C(C=1)=O)O)(C(C(C=O)=O)C)O,8,1,0,1,47,4.8e-05
G5,C(CC=CC(C(C(C=O)=O)C)O)=O,8,1,0,1,28,4.8e-05
G5,C(CC(C(C(C=O)=O)C)O)=CC=O,8,1,0,1,28,4.8e-05
G5,C(C(C=CC=O)C(C(CC)=O)O)=O,8,1,0,1,28,4.8e-05
G5,C(C(C=CC=O)C(C=O)(CC)O)=O,8,1,0,1,28,4.8e-05
G5,C(CC(C=C)O)(C(C(C=C)=O)O)=O,4,1,0,1,9,4.8e-05
G5,C(CC(C=CC)O)(C(C(C=C)=O)O)=O,8,1,0,1,9,4.8e-05
G5,C(CC(CC=C)O)(C(C(C=C)=O)O)=O,4,1,0,1,9,4.8e-05
G5,C(C(C=C)C(C)(C(C(C=C)=O)O)O)=O,8,1,0,1,9,4.8e-05
G5,C(C(C=C)C(C=C)(C(C(C)=O)O)O)=O,8,1,0,1,9,4.8e-05
G5,C(CC(C=C)O)(C(C=CC=O)O)=O,8,1,0,1,45,4.8e-05
G5,C(CC(C=CC)O)(C(C=CC=O)O)=O,16,1,0,1,45,4.8e-05
G5,C(CC(CC=C)O)(C(C=CC=O)O)=O,8,1,0,1,45,4.8e-05
G5,C(C(C=C)C(C)(C(C=CC=O)O)O)=O,16,1,0,1,45,4.8e-05
G5,C(C(C=C)C(C=CC(C(C)=O)O)O)=O,16,1,0,1,45,4.8e-05
G5,C(C(C=C)C1(C=CC(C1CO)=O)O)=O,8,1,0,1,45,4.8e-05
G5,C(C(C=O)C(C(CC(C=C)O)=O)=O)=O,2,1,0,1,14,4.8e-05
G5,C(C(C(CC(C=C)O)=O)C(C=O)=O)=O,4,1,0,1,23,4.8e-05
G5,C(C(C=O)C(CC(C=C)O)=O)=O,2,1,0,1,6,4.8e-05
G5,C(C(C=O)C(CC(C=CC)O)=O)=O,4,1,0,1,6,4.8e-05
G5,C(C(C=O)C(CC(CC=C)O)=O)=O,2,1,0,1,6,4.8e-05
G5,C(C(C=C)C(C(C=O)C(C)=O)O)=O,8,1,0,1,6,4.8e-05
G5,C(C(C=C)C(C)(C(C=O)C=O)O)=O,4,1,0,1,6,4.8e-05
G5,C(C(C(CC(C=C)O)=O)C(C)=O)=O,4,1,0,1,6,4.8e-05
G5,C(C(C(C)=O)C(CC(C=CC)O)=O)=O,8,1,0,1,6,4.8e-05
G5,C(CC(CC=C)O)(C(C=O)C(C)=O)=O,4,1,0,1,6,4.8e-05
G5,C(C(C=C)C(C(C(C)=O)C(C)=O)O)=O,4,1,0,1,6,4.8e-05
G5,C(C(C=C)C(C)(C(C=O)C(C)=O)O)=O,8,1,0,1,6,4.8e-05
G5,C(C(C=C)C(C=O)(C(C=O)C=O)O)=O,4,1,0,1,23,4.8e-05
G5,C(C(C=O)C(C(C(C=O)C=C)O)=O)=O,4,1,0,1,23,4.8e-05
G5,C(C(C=C)C(C(C=O)C(C=O)=O)O)=O,8,1,0,1,23,4.8e-05
G5,C(C)(C(C(CC(C=C)O)=O)CO)=O,4,1,0,1,28,4.8e-05
G5,C(C(C=O)C(C(C=C)C(C=O)=O)O)=O,4,1,0,1,1,4.8e-05
G5,C(C(C(C=O)=C)C(C(C=O)C=O)O)=O,4,1,0,1,1,4.8e-05
G5,C(C(C=C)C(C(C=O)C=O)O)=O,4,1,0,1,1,4.8e-05
G5,C(C(C=CC=O)C(C(C=O)C=O)O)=O,8,1,0,1,1,4.8e-05
G5,C(C(C(C=O)=O)C(C=O)C(C=C)O)=O,8,1,0,1,33,4.8e-05
G5,C(C(C=O)C(C=O)C(C=C)O)=O,4,1,0,1,43,4.8e-05
G5,C(C(C=O)C(C=O)C(C=CC)O)=O,8,1,0,1,43,4.8e-05
G5,C(C(C=O)C(C=O)C(CC=C)O)=O,4,1,0,1,43,4.8e-05
G5,C(C(C(C(C=O)C=C)O)CC=O)=O,8,1,0,1,43,4.8e-05
G5,C(C(C=C)C(CC(C=O)C=O)O)=O,4,1,0,1,43,4.8e-05
G5,C(C(C(C)=O)C(C=O)C(C=C)O)=O,8,1,0,1,45,4.8e-05
G5,C(C(C(CC(C=C)O)=O)CC=O)=O,4,1,0,1,45,4.8e-05
G5,C(C(C(C)=O)C(C=O)C(C=CC)O)=O,16,1,0,1,45,4.8e-05
G5,C(C(C(CC(C=CC)O)=O)CC=O)=O,8,1,0,1,45,4.8e-05
G5,C(C(C(CC=C)O)C(C=O)C(C)=O)=O,8,1,0,1,45,4.8e-05
G5,C(CC(CC=C)O)(C(C=O)CC=O)=O,4,1,0,1,45,4.8e-05
G5,C(C)(C(C(C(C=O)C=C)O)CC=O)=O,8,1,0,1,45,4.8e-05
G5,C(C(C=C)C(CC(C=O)C(C)=O)O)=O,8,1,0,1,45,4.8e-05
G5,C(C(C(C)(C(C=O)C=C)O)CC=O)=O,8,1,0,1,45,4.8e-05
G5,C=CC(C(C(C(O)=O)=O)C)O,4,1,0,1,28,4.8e-05
G5,C(C)=CC(C(C(C(O)=O)=O)C)O,8,1,0,1,28,4.8e-05
G5,C=CCC(C(C(C(O)=O)=O)C)O,4,1,0,1,28,4.8e-05
G5,C(C(C=C)C(C(O)=O)(CC)O)=O,4,1,0,1,28,4.8e-05
G5,C(C)(C1C(C(C(O1)=O)=O)C(C=C)O)=O,8,2,0,2,27,9.499999999999999e-05
G5,C(CC(C=C)O)(C1CC(C(O1)=O)=O)=O,4,1,0,1,27,4.8e-05
G5,C(CC1C(C(C(O1)=O)=O)C(C=C)O)=O,8,2,0,2,27,9.499999999999999e-05
G5,C(C(C1CC(C(O1)=O)=O)C(C=C)O)=O,8,2,0,2,27,9.499999999999999e-05
G5,C1(C(C(C(C(C)=O)O1)=O)C(C=C)O)=O,8,2,0,2,27,9.499999999999999e-05
G5,C1(CC(C(C(CC(C=C)O)=O)O1)=O)=O,4,1,0,1,27,4.8e-05
G5,C1(C(C(C(CC=O)O1)=O)C(C=C)O)=O,8,2,0,2,27,9.499999999999999e-05
G5,C1(CC(C(C(C=O)C(C=C)O)O1)=O)=O,8,2,0,2,27,9.499999999999999e-05
G5,C1(CCOC(C(C1C(C=C)O)=O)=O)=O,4,2,0,2,27,9.499999999999999e-05
G5,C1(C(COC(C(C1)=O)=O)C(C=C)O)=O,4,2,0,2,27,9.499999999999999e-05
G5,C1(COC(C(C(C1)C(C=C)O)=O)=O)=O,4,1,0,1,27,4.8e-05
G5,C1(COC(C(CC1C(C=C)O)=O)=O)=O,4,1,0,1,27,4.8e-05
G5,C1(CCC(C(OC1C(C=C)O)=O)=O)=O,4,2,0,2,27,9.499999999999999e-05
G5,C1(C(C(C(CCO1)=O)=O)C(C=C)O)=O,4,2,0,2,27,9.499999999999999e-05
G5,C1(CC(C(C(CO1)C(C=C)O)=O)=O)=O,4,2,0,2,27,9.499999999999999e-05
G5,C1(C(C(CC(CO1)=O)=O)C(C=C)O)=O,4,2,0,2,27,9.499999999999999e-05
G5,C1(CC(OCC(C1C(C=C)O)=O)=O)=O,4,2,0,2,27,9.499999999999999e-05
G5,C1(CC(CC(C(C(C=C)O)O1)=O)=O)=O,4,2,0,2,27,9.499999999999999e-05
G5,C=CC(C1C(C(CO)=CC1=O)=O)O,4,2,0,2,45,9.499999999999999e-05
G5,C(C(C1C(C(CO)=CC1=O)=O)O)=CC,8,2,0,2,45,9.499999999999999e-05
G5,C(CC(C1C(C=C(C1=O)CO)=O)O)=C,4,2,0,2,45,9.499999999999999e-05
G5,C(C(C=C)C1(C=C(C(C1)=O)CO)O)=O,4,1,0,1,45,4.8e-05
G5,C(C(C=C)C1(C(CO)=CC(C1)=O)O)=O,4,1,0,1,45,4.8e-05
G5,C=CC(C1C=C(C(C1=O)=O)CO)O,4,1,0,1,45,4.8e-05
G5,C1C(C(C(C=1CO)=O)=O)C(C=CC)O,8,1,0,1,45,4.8e-05
G5,C(CC(C1C=C(C(C1=O)=O)CO)O)=C,4,1,0,1,45,4.8e-05
G5,C(C(C=C)C1(C(C(CO)=CC1)=O)O)=O,4,1,0,1,45,4.8e-05
G5,C(C(C=C)C1(C(CC=C1CO)=O)O)=O,4,1,0,1,45,4.8e-05
G5,C=CC(C1C(C(C(C1O)=O)=C)=O)O,8,2,0,2,45,9.499999999999999e-05
G5,C=C1C(C(C(C1=O)C(C=CC)O)O)=O,16,2,0,2,45,9.499999999999999e-05
G5,C(CC(C1C(C(C(C1O)=O)=C)=O)O)=C,8,2,0,2,45,9.499999999999999e-05
G5,C(C(C=C)C1(C(C(C(C1)O)=O)=C)O)=O,8,1,0,1,45,4.8e-05
G5,C(C(C=C)C1(C(C(CC1O)=O)=C)O)=O,8,1,0,1,45,4.8e-05
G5,C1(C(C(C(C1C(C=C)O)=C)=O)O)=O,8,1,0,1,47,4.8e-05
G5,C1(C(C(C(C1C(C=CC)O)=C)=O)O)=O,16,1,0,1,47,4.8e-05
G5,C1(C(C(C(C1C(CC=C)O)=C)=O)O)=O,8,1,0,1,47,4.8e-05
G5,C(C(C=C)C1(C(C(C(C1)=C)=O)O)O)=O,8,1,0,1,47,4.8e-05
G5,C(C(C=C)C1(C(CC(C1O)=O)=C)O)=O,8,1,0,1,47,4.8e-05
G5,C1(C(C(C(C1C(C=C)O)=O)=C)O)=O,8,2,0,2,45,9.499999999999999e-05
G5,C1(C(C(C(C1C(C=CC)O)=O)=C)O)=O,16,2,0,2,45,9.499999999999999e-05
G5,C1(C(C(C(C1C(CC=C)O)=O)=C)O)=O,8,2,0,2,45,9.499999999999999e-05
G5,C(C(C=C)C1(C(C(C(C1)=O)=C)O)O)=O,8,1,0,1,45,4.8e-05
G5,C(C(C=C)C1(C(C(C(C1)=O)O)=C)O)=O,8,1,0,1,45,4.8e-05
G5,C=CC(C1C(C(C(C1O)=C)=O)=O)O,8,2,0,2,45,9.499999999999999e-05
G5,C=C1C(C(C(C(C=CC)O)C1O)=O)=O,16,2,0,2,45,9.499999999999999e-05
G5,C(CC(C1C(C(C(C1O)=C)=O)=O)O)=C,8,2,0,2,45,9.499999999999999e-05
G5,C(C(C=C)C1(C(C(C(C1)O)=C)=O)O)=O,8,1,0,1,45,4.8e-05
G5,C(C(C=C)C1(C(CC(C1=C)O)=O)O)=O,8,1,0,1,45,4.8e-05
G5,C=CC(C1C(C=C(C=O)C1O)=O)O,8,2,0,2,45,9.499999999999999e-05
G5,C(C(C1C(C=C(C=O)C1O)=O)O)=CC,16,2,0,2,45,9.499999999999999e-05
G5,C(CC(C1C(C=C(C=O)C1O)=O)O)=C,8,2,0,2,45,9.499999999999999e-05
G5,C(C(C=C)C1(C=C(C=O)C(C1)O)O)=O,8,1,0,1,45,4.8e-05
G5,C(C(C=C)C(C1C(CC(C=1)=O)O)O)=O,8,1,0,1,45,4.8e-05
G5,C1(C(C(C=O)=CC1C(C=C)O)O)=O,8,1,0,1,27,4.8e-05
G5,C1(C(C(C=O)=CC1C(C=CC)O)O)=O,16,1,0,1,27,4.8e-05
G5,C1(C(C(C=O)=CC1C(CC=C)O)O)=O,8,1,0,1,27,4.8e-05
G5,C(C(C=C)C1(C(C(C=O)=CC1)O)O)=O,8,1,0,1,27,4.8e-05
G5,C(C(C=C)C(C1C(C(CC=1)=O)O)O)=O,8,1,0,1,27,4.8e-05
G5,C1(C(C=C(C=O)C1C(C=C)O)O)=O,8,1,0,1,45,4.8e-05
G5,C1(C(C=C(C=O)C1C(C=CC)O)O)=O,16,1,0,1,45,4.8e-05
G5,C1(C(C=C(C=O)C1C(CC=C)O)O)=O,8,1,0,1,45,4.8e-05
G5,C(C(C=C)C1(C(C=C(C=O)C1)O)O)=O,8,1,0,1,45,4.8e-05
G5,C(C(C=C)C(C1CC(C(C=1)O)=O)O)=O,8,1,0,1,45,4.8e-05
G5,C=CC(C1C(C(C=O)=CC1O)=O)O,8,2,0,2,45,9.499999999999999e-05
G5,C(C(C1C(C(C=O)=CC1O)=O)O)=CC,16,2,0,2,45,9.499999999999999e-05
G5,C(CC(C1C(C(C=O)=CC1O)=O)O)=C,8,2,0,2,45,9.499999999999999e-05
G5,C(C(C=C)C1(C(C=O)=CC(C1)O)O)=O,8,1,0,1,45,4.8e-05
G5,C(C(C=C)C(C1C(CC(C=1)O)=O)O)=O,8,1,0,1,45,4.8e-05
G5,C=CC(C(C(C=O)=O)C(C=C)O)O,3,2,0,2,27,9.499999999999999e-05
G5,C=CC(C(C(C=O)=O)C(C=CC)O)O,16,2,0,2,27,9.499999999999999e-05
G5,C(CC(C(C(C=O)=O)C(C=C)O)O)=C,8,2,0,2,27,9.499999999999999e-05
G5,C(C(C=C)C(C(CC(C=C)O)=O)O)=O,8,1,0,1,27,4.8e-05
G5,C(C(C=C)C(C=O)(CC(C=C)O)O)=O,8,1,0,1,27,4.8e-05
G5,C(C(C(C(C=C)O)=O)C(C=C)O)=O,8,2,0,2,27,9.499999999999999e-05
G5,C(C(C(C(C=C)O)=O)C(C=CC)O)=O,16,2,0,2,27,9.499999999999999e-05
G5,C(C(C(C(C=C)O)=O)C(CC=C)O)=O,8,2,0,2,27,9.499999999999999e-05
G5,C(C(C=C)C(CC(C(C=C)O)=O)O)=O,8,1,0,1,27,4.8e-05
G5,C(CC(C(C=C)O)(C(C=O)C=C)O)=O,8,1,0,1,27,4.8e-05
G5,C(C(C(C(C=C)C(C=C)O)=O)O)=O,8,1,0,1,4,4.8e-05
G5,C(C(C(C(C=C)C(C=CC)O)=O)O)=O,16,1,0,1,4,4.8e-05
G5,C(C(C(C(C=C)C(CC=C)O)=O)O)=O,8,1,0,1,4,4.8e-05
G5,C(C(C=C)C(C(C(CC=C)=O)O)O)=O,8,1,0,1,4,4.8e-05
G5,C(C(C=C)C(C(C=O)O)(CC=C)O)=O,8,1,0,1,4,4.8e-05
G5,C(C(C(C(C=C)=O)C(C=C)O)O)=O,8,2,0,2,27,9.499999999999999e-05
G5,C(C(C(C(C=C)=O)C(C=CC)O)O)=O,16,2,0,2,27,9.499999999999999e-05
G5,C(C(C(C(C=C)=O)C(CC=C)O)O)=O,8,2,0,2,27,9.499999999999999e-05
G5,C(C(C=C)C(C(CC(C=C)=O)O)O)=O,8,1,0,1,27,4.8e-05
G5,C(C(CC(C=C)(C(C=O)C=C)O)O)=O,8,1,0,1,27,4.8e-05
G5,C(C(C=C)C(C1C(C(C=C1)O)=O)O)=O,16,1,0,1,45,4.8e-05
G5,C(C(C=C)C1(C(C=CC1C=O)O)O)=O,16,1,0,1,45,4.8e-05
G5,C(C1(C(C(C=C1)C(C=C)O)=O)O)=O,8,1,0,1,45,4.8e-05
G5,C(C1(C(C(C=C1)C(C=CC)O)=O)O)=O,16,1,0,1,45,4.8e-05
G5,C(C1(C(C(C=C1)C(CC=C)O)=O)O)=O,8,1,0,1,45,4.8e-05
G5,C(C(C=C)C(C1(C(CC=C1)=O)O)O)=O,8,1,0,1,45,4.8e-05
G5,C(C(C=C)C1(CC=CC1(C=O)O)O)=O,8,1,0,1,45,4.8e-05
G5,C(CC(C=C)O)(C1C=CC(O1)=O)=O,4,1,0,1,48,4.8e-05
G5,C(CC(C=CC)O)(C1C=CC(O1)=O)=O,8,1,0,1,48,4.8e-05
G5,C(CC(CC=C)O)(C1C=CC(O1)=O)=O,4,1,0,1,48,4.8e-05
G5,C(C(C=C)C(C)(C1C=CC(O1)=O)O)=O,8,1,0,1,48,4.8e-05
G5,C(C(C1C=CC(O1)=O)C(C=C)O)=O,8,2,0,2,48,9.499999999999999e-05
G5,C(C(C1C=CC(O1)=O)C(C=CC)O)=O,16,2,0,2,48,9.499999999999999e-05
G5,C(C(C(CC=C)O)C1C=CC(O1)=O)=O,8,2,0,2,48,9.499999999999999e-05
G5,C(C(C=C)C(CC1C=CC(O1)=O)O)=O,8,1,0,1,48,4.8e-05
G5,C(CC(C=C)O)(C1C(C=CO1)=O)=O,4,1,0,1,9,4.8e-05
G5,C(CC(C=CC)O)(C1C(C=CO1)=O)=O,8,1,0,1,9,4.8e-05
G5,C(CC(CC=C)O)(C1C(C=CO1)=O)=O,4,1,0,1,9,4.8e-05
G5,C(C(C=C)C1(C=COC1C(C)=O)O)=O,8,1,0,1,9,4.8e-05
G5,C(C(C=C)C(C)(C1C(C=CO1)=O)O)=O,8,1,0,1,9,4.8e-05
G5,C(C(C1C(C=CO1)=O)C(C=C)O)=O,8,2,0,2,45,9.499999999999999e-05
G5,C(C(C1C(C=CO1)=O)C(C=CC)O)=O,16,2,0,2,45,9.499999999999999e-05
G5,C(C(C(CC=C)O)C1C(C=CO1)=O)=O,8,2,0,2,45,9.499999999999999e-05
G5,C(CC1C(C=CO1)(C(C=O)C=C)O)=O,8,1,0,1,45,4.8e-05
G5,C(C(C=C)C(CC1C(C=CO1)=O)O)=O,8,1,0,1,45,4.8e-05
G5,C=CC(C1C(C=CC(OC1)=O)=O)O,4,2,0,2,19,9.499999999999999e-05
G5,C(C)=CC(C1C(C=CC(OC1)=O)=O)O,8,2,0,2,19,9.499999999999999e-05
G5,C=CCC(C1C(C=CC(OC1)=O)=O)O,4,2,0,2,19,9.499999999999999e-05
G5,C(C(C=C)C1(C=CC(OCC1)=O)O)=O,4,1,0,1,19,4.8e-05
G5,C1(COC(C=CC1C(C=C)O)=O)=O,4,1,0,1,48,4.8e-05
G5,C1(C(C(C=C)O)OC(C=CC1)=O)=O,4,2,0,2,48,9.499999999999999e-05
G5,C1(COC(C=CC1C(C=CC)O)=O)=O,8,1,0,1,48,4.8e-05
G5,C1(C(C(C=CC)O)OC(C=CC1)=O)=O,8,2,0,2,48,9.499999999999999e-05
G5,C1(COC(C=CC1C(CC=C)O)=O)=O,4,1,0,1,48,4.8e-05
G5,C1(C(C(CC=C)O)OC(C=CC1)=O)=O,4,2,0,2,48,9.499999999999999e-05
G5,C(C(C=C)C1(COC(C=CC1)=O)O)=O,4,1,0,1,48,4.8e-05
G5,C=CC(C1C(C(C=COC1)=O)=O)O,4,2,0,2,45,9.499999999999999e-05
G5,C(C)=CC(C1C(C(C=COC1)=O)=O)O,8,2,0,2,45,9.499999999999999e-05
G5,C=CCC(C1C(C(C=COC1)=O)=O)O,4,2,0,2,45,9.499999999999999e-05
G5,C(C(C=C)C1(C(CCOC=C1)=O)O)=O,4,1,0,1,45,4.8e-05
G5,C(C(C=C)C1(C(C=COCC1)=O)O)=O,4,1,0,1,45,4.8e-05
G5,C1(COC=CC(C1C(C=C)O)=O)=O,4,2,0,2,38,9.499999999999999e-05
G5,C1(C(C(C=C)O)OC=CC(C1)=O)=O,4,2,0,2,38,9.499999999999999e-05
G5,C1(COC=CC(C1C(C=CC)O)=O)=O,8,2,0,2,38,9.499999999999999e-05
G5,C1(C(C(C=CC)O)OC=CC(C1)=O)=O,8,2,0,2,38,9.499999999999999e-05
G5,C1(COC=CC(C1C(CC=C)O)=O)=O,4,2,0,2,38,9.499999999999999e-05
G5,C1(C(C(CC=C)O)OC=CC(C1)=O)=O,4,2,0,2,38,9.499999999999999e-05
G5,C(C(C=C)C1(C=COCC(C1)=O)O)=O,4,1,0,1,38,4.8e-05
G5,C(C(C=C)C1(COC=CC(C1)=O)O)=O,4,1,0,1,38,4.8e-05
G5,C1(C(C(C=CCO1)=O)C(C=C)O)=O,4,2,0,2,19,9.499999999999999e-05
G5,C1(C(C(C=CCO1)=O)C(C=CC)O)=O,8,2,0,2,19,9.499999999999999e-05
G5,C1(C(C(C=CCO1)=O)C(CC=C)O)=O,4,2,0,2,19,9.499999999999999e-05
G5,C(C(C=C)C1(C=CCOC(C1)=O)O)=O,4,1,0,1,19,4.8e-05
G5,C=CC(C1C(C(C=CCO1)=O)=O)O,4,2,0,2,36,9.499999999999999e-05
G5,C(C)=CC(C1C(C(C=CCO1)=O)=O)O,8,2,0,2,36,9.499999999999999e-05
G5,C(CC(C1C(C(C=CCO1)=O)=O)O)=C,4,2,0,2,36,9.499999999999999e-05
G5,C(C(C=C)C1(C(C=CCOC1)=O)O)=O,4,1,0,1,36,4.8e-05
G5,C(C(C=C)C1(C(COCC=C1)=O)O)=O,4,1,0,1,36,4.8e-05
G5,C1(CC=CC(C(C(C=C)O)O1)=O)=O,4,2,0,2,48,9.499999999999999e-05
G5,C1(CC=CC(C(C(C=CC)O)O1)=O)=O,8,2,0,2,48,9.499999999999999e-05
G5,C1(CC=CC(C(C(CC=C)O)O1)=O)=O,4,2,0,2,48,9.499999999999999e-05
G5,C1(CC=CC(CO1)(C(C=O)C=C)O)=O,4,1,0,1,48,4.8e-05
G5,C=CC(C1C(C=CC(CO1)=O)=O)O,4,2,0,2,45,9.499999999999999e-05
G5,C(C)=CC(C1C(C=CC(CO1)=O)=O)O,8,2,0,2,45,9.499999999999999e-05
G5,C(CC(C1C(C=CC(CO1)=O)=O)O)=C,4,2,0,2,45,9.499999999999999e-05
G5,C(C(C=C)C1(C=CC(COC1)=O)O)=O,4,1,0,1,45,4.8e-05
G5,C=CC(C1C(C(OC1)=CC=O)=O)O,8,2,0,2,45,9.499999999999999e-05
G5,C(C)=CC(C1C(C(OC1)=CC=O)=O)O,16,2,0,2,45,9.499999999999999e-05
G5,C=CCC(C1C(C(OC1)=CC=O)=O)O,8,2,0,2,45,9.499999999999999e-05
G5,C(C(C=C)C(C=C1C(CCO1)=O)O)=O,8,1,0,1,45,4.8e-05
G5,C(C(C=C)C1(C(OCC1)=CC=O)O)=O,8,1,0,1,45,4.8e-05
G5,C1(COC(C1C(C=C)O)=CC=O)=O,8,2,0,2,45,9.499999999999999e-05
G5,C1(C(C(C=C)O)OC(C1)=CC=O)=O,8,2,0,2,45,9.499999999999999e-05
G5,C1(COC(C1C(C=CC)O)=CC=O)=O,16,2,0,2,45,9.499999999999999e-05
G5,C1(C(C(C=CC)O)OC(C1)=CC=O)=O,16,2,0,2,45,9.499999999999999e-05
G5,C1(COC(C1C(CC=C)O)=CC=O)=O,8,2,0,2,45,9.499999999999999e-05
G5,C1(C(C(CC=C)O)OC(C1)=CC=O)=O,8,2,0,2,45,9.499999999999999e-05
G5,C(C(C=C)C(C=C1CC(CO1)=O)O)=O,8,1,0,1,45,4.8e-05
G5,C(C(C=C)C1(COC(C1)=CC=O)O)=O,8,1,0,1,45,4.8e-05
G5,C(C(C=C)C(C(C1C=CCO1)=O)O)=O,8,1,0,1,39,4.8e-05
G5,C(C(C=C)C(C=O)(C1C=CCO1)O)=O,8,1,0,1,39,4.8e-05
G5,C(C(C=C)C(C1C=CC(C=O)O1)O)=O,16,1,0,1,40,4.8e-05
G5,C(C1C(C(C(O1)=C)C(C=C)O)=O)=O,8,2,0,2,26,9.499999999999999e-05
G5,C(C1C(C(C(O1)=C)C(C=CC)O)=O)=O,16,2,0,2,26,9.499999999999999e-05
G5,C(C1C(C(C(O1)=C)C(CC=C)O)=O)=O,8,2,0,2,26,9.499999999999999e-05
G5,C(C(C=C)C(C1C(CC(O1)=C)=O)O)=O,8,1,0,1,26,4.8e-05
G5,C(C(C=C)C1(C(C=O)OC(C1)=C)O)=O,8,1,0,1,26,4.8e-05
G5,C(C1C(C(C(O1)=C)=O)C(C=C)O)=O,8,2,0,2,14,9.499999999999999e-05
G5,C(C1C(C(C(O1)=C)=O)C(C=CC)O)=O,16,2,0,2,14,9.499999999999999e-05
G5,C(C1C(C(C(O1)=C)=O)C(CC=C)O)=O,8,2,0,2,14,9.499999999999999e-05
G5,C(C(C=C)C(C1CC(C(O1)=C)=O)O)=O,8,1,0,1,14,4.8e-05
G5,C(C1CC(C(O1)=C)(C(C=O)C=C)O)=O,8,1,0,1,14,4.8e-05
G5,C=CC(C1C(C=C(C=O)OC1)=O)O,4,2,0,2,30,9.499999999999999e-05
G5,C(C)=CC(C1C(C=C(C=O)OC1)=O)O,8,2,0,2,30,9.499999999999999e-05
G5,C=CCC(C1C(C=C(C=O)OC1)=O)O,4,2,0,2,30,9.499999999999999e-05
G5,C(C(C=C)C(C1OCCC(C=1)=O)O)=O,4,1,0,1,30,4.8e-05
G5,C(C(C=C)C1(C=C(C=O)OCC1)O)=O,4,1,0,1,30,4.8e-05
G5,C1(COC(C=O)=CC1C(C=C)O)=O,4,1,0,1,12,4.8e-05
G5,C1(C(C(C=C)O)OC(C=O)=CC1)=O,4,2,0,2,12,9.499999999999999e-05
G5,C1(COC(C=O)=CC1C(C=CC)O)=O,8,1,0,1,12,4.8e-05
G5,C1(C(C(C=CC)O)OC(C=O)=CC1)=O,8,2,0,2,12,9.499999999999999e-05
G5,C1(COC(C=O)=CC1C(CC=C)O)=O,4,1,0,1,12,4.8e-05
G5,C1(C(C(CC=C)O)OC(C=O)=CC1)=O,4,2,0,2,12,9.499999999999999e-05
G5,C(C(C=C)C(C1OCC(CC=1)=O)O)=O,4,1,0,1,12,4.8e-05
G5,C(C(C=C)C1(COC(C=O)=CC1)O)=O,4,1,0,1,12,4.8e-05
G5,C(C1C(C(C=CO1)C(C=C)O)=O)=O,8,1,0,1,37,4.8e-05
G5,C(C1C(C(C=CO1)C(C=CC)O)=O)=O,16,1,0,1,37,4.8e-05
G5,C(C1C(C(C=CO1)C(CC=C)O)=O)=O,8,1,0,1,37,4.8e-05
G5,C(C(C=C)C(C1C(CC=CO1)=O)O)=O,8,1,0,1,37,4.8e-05
G5,C(C(C=C)C1(C(C=O)OC=CC1)O)=O,8,1,0,1,37,4.8e-05
G5,C(C1C(C(C=CO1)=O)C(C=C)O)=O,8,2,0,2,37,9.499999999999999e-05
G5,C(C1C(C(C=CO1)=O)C(C=CC)O)=O,16,2,0,2,37,9.499999999999999e-05
G5,C(C1C(C(C=CO1)=O)C(CC=C)O)=O,8,2,0,2,37,9.499999999999999e-05
G5,C(C(C=C)C(C1CC(C=CO1)=O)O)=O,8,1,0,1,37,4.8e-05
G5,C(C1CC(C=CO1)(C(C=O)C=C)O)=O,8,1,0,1,37,4.8e-05
G5,C(C1C(C(CC(O1)=O)C(C=C)O)=O)=O,8,1,0,1,27,4.8e-05
G5,C1(CC(C(C(C=O)O1)C(C=C)O)=O)=O,8,2,0,2,27,9.499999999999999e-05
G5,C1(C(C(CC(C=O)O1)=O)C(C=C)O)=O,8,2,0,2,27,9.499999999999999e-05
G5,C(C(C=C)C(C1CC(C(C=1)=O)O)O)=O,8,1,0,1,45,4.8e-05
G5,C(C(C=C)C1(C=C(C=O)CC1O)O)=O,8,1,0,1,45,4.8e-05
G5,C(C(C=C)C1(C(C(C=C1)CO)=O)O)=O,8,1,0,1,45,4.8e-05
G5,C(C(C=C)C1(C(C=CC1CO)=O)O)=O,8,1,0,1,45,4.8e-05
G5,C(C(C=C)C(C1C(C(CC=1)O)=O)O)=O,8,1,0,1,27,4.8e-05
G5,C(C(C=C)C1(C(C=O)=CCC1O)O)=O,8,1,0,1,27,4.8e-05
G5,C(C(C(C=C)O)O)(C(C=C)O)=O,8,2,0,2,31,9.499999999999999e-05
G5,C(C(C(C=CC)O)O)(C(C=C)O)=O,16,2,0,2,31,9.499999999999999e-05
G5,C(C(C(CC=C)O)O)(C(C=C)O)=O,8,2,0,2,31,9.499999999999999e-05
G5,C(C(C=C)C(CO)(C(C=C)O)O)=O,8,1,0,1,31,4.8e-05
G5,C(C(C=C)C(C=C(CO)CO)O)=O,4,1,0,1,18,4.8e-05
G5,C(C(C=C)C(C=CC(CO)O)O)=O,16,1,0,1,46,4.8e-05
G5,C(C(C=C)C(C(C=C(C=O)C)=O)O)=O,8,1,0,1,45,4.8e-05
G5,C(C(C=C)C(C=O)(C=C(C=O)C)O)=O,8,1,0,1,45,4.8e-05
G5,C(C(C=C)C(C(C)=CC(C=O)=O)O)=O,8,1,0,1,45,4.8e-05
G5,C=CC(C(C(C=O)=O)C(C=O)=C)O,4,1,0,1,45,4.8e-05
G5,C=C(C=O)C(C(C=O)=O)C(C=CC)O,8,1,0,1,45,4.8e-05
G5,C=CCC(C(C(C=O)=O)C(C=O)=C)O,4,1,0,1,45,4.8e-05
G5,C(C(C=C)C(C(CC(C=O)=C)=O)O)=O,4,1,0,1,45,4.8e-05
G5,C(C(C=C)C(C=O)(CC(C=O)=C)O)=O,4,1,0,1,45,4.8e-05
G5,C(C(C=C)C(C(CC(C=O)=O)=C)O)=O,4,1,0,1,45,4.8e-05
G5,C(C(C=C)C(C(C=CC=O)=O)O)=O,8,1,0,1,20,4.8e-05
G5,C(C(C=C)C(C=O)(C=CC=O)O)=O,8,1,0,1,20,4.8e-05
G5,C(C(C=C)C(C=CC(C=O)=O)O)=O,8,1,0,1,20,4.8e-05
G5,C(C(C=C)C(C(C=C(C)CO)=O)O)=O,8,1,0,1,49,4.8e-05
G5,C(C(C=C)C(C=O)(C=C(CO)C)O)=O,8,1,0,1,49,4.8e-05
G5,C=C(CO)C(C(C=O)=O)C(C=C)O,4,1,0,1,49,4.8e-05
G5,C=C(CO)C(C(C=O)=O)C(C=CC)O,8,1,0,1,49,4.8e-05
G5,C(CC(C(C(CO)=C)C(C=O)=O)O)=C,4,1,0,1,49,4.8e-05
G5,C(C(C=C)C(C(CC(CO)=C)=O)O)=O,4,1,0,1,49,4.8e-05
G5,C(C(C=C)C(C=O)(CC(CO)=C)O)=O,4,1,0,1,49,4.8e-05
G5,C(CO)(C(C(C=O)=C)C(C=C)O)=O,4,1,0,1,16,4.8e-05
G5,C(C(C(C=C)O)O)(CC(C=O)=C)=O,4,2,0,2,16,9.499999999999999e-05
G5,C(CO)(C(C(C=O)=C)C(C=CC)O)=O,8,1,0,1,16,4.8e-05
G5,C(C(C(C=CC)O)O)(CC(C=O)=C)=O,8,2,0,2,16,9.499999999999999e-05
G5,C(CO)(C(C(C=O)=C)C(CC=C)O)=O,4,1,0,1,16,4.8e-05
G5,C(C(C(CC=C)O)O)(CC(C=O)=C)=O,4,2,0,2,16,9.499999999999999e-05
G5,C(C(C=C)C(C(CC(CO)=O)=C)O)=O,4,1,0,1,16,4.8e-05
G5,C(C(C=C)C(CO)(CC(C=O)=C)O)=O,4,1,0,1,16,4.8e-05
G5,C=CC(C(C(C=C(C=O)C)=O)O)O,8,2,0,2,16,9.499999999999999e-05
G5,C(C)=CC(C(C(C=C(C=O)C)=O)O)O,16,2,0,2,16,9.499999999999999e-05
G5,C(CC(C(C(C=C(C=O)C)=O)O)O)=C,8,2,0,2,16,9.499999999999999e-05
G5,C(C(C=C)C(C(C)=CC(CO)=O)O)=O,8,1,0,1,16,4.8e-05
G5,C(C(C=C)C(C=C(C=O)C)(CO)O)=O,8,1,0,1,16,4.8e-05
G5,C(CC(C=C)O)(C(C(C=O)=C)O)=O,4,1,0,1,45,4.8e-05
G5,C(CC(C=CC)O)(C(C(C=O)=C)O)=O,8,1,0,1,45,4.8e-05
G5,C(CC(CC=C)O)(C(C(C=O)=C)O)=O,4,1,0,1,45,4.8e-05
G5,C(C(C=C)C(C(C(C(C)=O)O)=C)O)=O,8,1,0,1,45,4.8e-05
G5,C(C(C=C)C(C)(C(C(C=O)=C)O)O)=O,8,1,0,1,45,4.8e-05
G5,C=CC(C(C=O)=O)C(C(C=CC)=O)O,8,1,0,1,28,4.8e-05
G5,C(C(C=CC)(C(C=C)C(C=O)=O)O)=O,8,1,0,1,28,4.8e-05
G5,C(C)=CC(C(CC(C=CC=O)=O)O)=O,8,1,0,1,28,4.8e-05
G5,C(C(C=CC)(CC(C=CC=O)=O)O)=O,8,1,0,1,28,4.8e-05
G5,C(C(C(C=O)=C)C(C(C=CC)=O)O)=O,8,1,0,1,28,4.8e-05
G5,C(C(C(C=O)=C)C(C=O)(C=CC)O)=O,8,1,0,1,28,4.8e-05
G5,C(C)=CC(C(C(C(C=CC)=O)O)O)=O,10,2,0,2,28,9.499999999999999e-05
G5,C(C(C=CC)(C(C(C=CC)=O)O)O)=O,16,2,0,2,28,9.499999999999999e-05
G5,C(CO)(C(C=C)C(C(C=CC)=O)O)=O,8,1,0,1,28,4.8e-05
G5,C(C(C=CC)(C(C(CO)=O)C=C)O)=O,8,1,0,1,28,4.8e-05
G5,C(C(C(C(C=CC)=O)O)O)(CC=C)=O,8,4,0,4,28,0.00019099999999999998
G5,C(C(C=CC)(C(C(CC=C)=O)O)O)=O,8,2,0,2,28,9.499999999999999e-05
G5,C(CC(C(C=CC)=O)O)(C(C=C)O)=O,8,1,0,1,28,4.8e-05
G5,C(C(C=CC)(CC(C(C=C)O)=O)O)=O,8,1,0,1,28,4.8e-05
G5,C(C(C(CO)=C)C(C(C=CC)=O)O)=O,8,1,0,1,28,4.8e-05
G5,C(C(C(CO)=C)C(C=O)(C=CC)O)=O,8,1,0,1,28,4.8e-05
G5,C(C(C=C)C(C(C=CC)=O)O)=O,8,1,0,1,28,4.8e-05
G5,C(C(C=C)C(C=O)(C=CC)O)=O,8,1,0,1,28,4.8e-05
G5,C(C(C=CC=O)C(C(C=CC)=O)O)=O,16,1,0,1,28,4.8e-05
G5,C(C(C=CC=O)C(C=O)(C=CC)O)=O,16,1,0,1,28,4.8e-05
G5,C(C(C(C=C)C(C=O)=O)O)(CC=C)=O,4,1,0,1,28,4.8e-05
G5,C(C(CC=C)(C(C=C)C(C=O)=O)O)=O,4,1,0,1,28,4.8e-05
G5,C=CC(C(C=O)=O)C(C=CC=O)(C)O,8,1,0,1,28,4.8e-05
G5,C=CC(C(C=O)=O)C(C=CC(C)=O)O,8,1,0,1,28,4.8e-05
G5,C(C(CC(C=CC=O)=O)O)(CC=C)=O,4,1,0,1,28,4.8e-05
G5,C(C(CC(C=CC=O)=O)(CC=C)O)=O,4,1,0,1,28,4.8e-05
G5,C(CC(C(C(C=C)C(C=O)=O)O)=C)=O,4,1,0,1,28,4.8e-05
G5,C=CC(C(C=O)=O)C(CC(C=O)=C)O,4,1,0,1,28,4.8e-05
G5,C(C(C(C=O)=C)C(C(CC=C)=O)O)=O,4,1,0,1,28,4.8e-05
G5,C(C(C(C=O)=C)C(C=O)(CC=C)O)=O,4,1,0,1,28,4.8e-05
G5,C=CC(C(C=O)=O)C(C(C)=CC=O)O,8,1,0,1,28,4.8e-05
G5,C=CC(C(C=O)=O)C(C=C(C=O)C)O,8,1,0,1,28,4.8e-05
G5,C=CC(C(C=O)=O)C(C=C)O,4,1,0,1,28,4.8e-05
G5,C(C(CO)(C(C=C)C(C=O)=O)O)=CC,8,1,0,1,28,4.8e-05
G5,C(C(CC=C)(C(C(C=CC)=O)O)O)=O,8,2,0,2,28,9.499999999999999e-05
G5,C=CC(C(C=O)=O)C(CO)(CC=C)O,4,1,0,1,28,4.8e-05
G5,C(CO)(C(C=C)C(C(CC=C)=O)O)=O,4,1,0,1,28,4.8e-05
G5,C(C(CC=C)(C(C(CO)=O)C=C)O)=O,4,1,0,1,28,4.8e-05
G5,C(C(C(C(CC=C)=O)O)O)(CC=C)=O,3,2,0,2,28,9.499999999999999e-05
G5,C(C(CC=C)(C(C(CC=C)=O)O)O)=O,4,2,0,2,28,9.499999999999999e-05
G5,C=CC(C(C=O)=O)C(C)(C(C=C)O)O,8,1,0,1,28,4.8e-05
G5,C(C(CC(C(C=C)O)=O)O)(CC=C)=O,4,1,0,1,28,4.8e-05
G5,C(C(CC=C)(CC(C(C=C)O)=O)O)=O,4,1,0,1,28,4.8e-05
G5,C=CC(C(C=O)=O)C(CC(CO)=C)O,4,1,0,1,28,4.8e-05
G5,C(C(C(CO)=C)C(C(CC=C)=O)O)=O,4,1,0,1,28,4.8e-05
G5,C(C(C(CO)=C)C(C=O)(CC=C)O)=O,4,1,0,1,28,4.8e-05
G5,C=CC(C(C=O)=O)C(C=C(C)CO)O,8,1,0,1,28,4.8e-05
G5,C=CC(C(C=O)=O)C(C=CC)O,8,1,0,1,28,4.8e-05
G5,C=CC(C(C=O)=O)C(CC=C)O,4,1,0,1,28,4.8e-05
G5,C(C(C=C)C(C(CC=C)=O)O)=O,4,1,0,1,28,4.8e-05
G5,C(C(C=C)C(C=O)(CC=C)O)=O,4,1,0,1,28,4.8e-05
G5,C(CC=CC(C(C=C)C(C=O)=O)O)=O,8,1,0,1,28,4.8e-05
G5,C=CC(C(C=O)=O)C(CC=CC=O)O,8,1,0,1,28,4.8e-05
G5,C(C(C=CC=O)C(C(CC=C)=O)O)=O,8,1,0,1,28,4.8e-05
G5,C(C(C=CC=O)C(C=O)(CC=C)O)=O,8,1,0,1,28,4.8e-05
G5,C(C(C)(CC(C=CC=O)=O)O)=CC=O,8,1,0,1,28,4.8e-05
G5,C(C(CC(C=CC=O)=O)O)=CC(C)=O,8,1,0,1,28,4.8e-05
G5,C(CC(C(CC(C=CC=O)=O)O)=C)=O,4,1,0,1,28,4.8e-05
G5,C=C(C=O)CC(CC(C=CC=O)=O)O,4,1,0,1,28,4.8e-05
G5,C(C(C(C=O)=C)C(C=CC=O)(C)O)=O,8,1,0,1,28,4.8e-05
G5,C(C(C(C=O)=C)C(C=CC(C)=O)O)=O,8,1,0,1,28,4.8e-05
G5,C(C)(C(CC(C=CC=O)=O)O)=CC=O,8,1,0,1,28,4.8e-05
G5,C(C(CC(C=CC=O)=O)O)=C(C=O)C,8,1,0,1,28,4.8e-05
G5,C=CC(CC(C=CC=O)=O)O,4,1,0,1,28,4.8e-05
G5,C(C)=CC(CO)(CC(C=CC=O)=O)O,8,1,0,1,28,4.8e-05
G5,C(C)=CC(C(C(C=CC=O)(C)O)O)=O,16,2,0,2,28,9.499999999999999e-05
G5,C(C)=CC(C(C(C=CC(C)=O)O)O)=O,16,2,0,2,28,9.499999999999999e-05
G5,C=CCC(CO)(CC(C=CC=O)=O)O,4,1,0,1,28,4.8e-05
G5,C(CO)(C(C=C)C(C=CC=O)(C)O)=O,8,1,0,1,28,4.8e-05
G5,C(CO)(C(C=C)C(C=CC(C)=O)O)=O,8,1,0,1,28,4.8e-05
G5,C(C(C(C=CC=O)(C)O)O)(CC=C)=O,8,2,0,2,28,9.499999999999999e-05
G5,C(C(C(C=CC(C)=O)O)O)(CC=C)=O,8,2,0,2,28,9.499999999999999e-05
G5,C=CC(C(C)(CC(C=CC=O)=O)O)O,8,1,0,1,28,4.8e-05
G5,C(CC(C=CC=O)(C)O)(C(C=C)O)=O,8,1,0,1,28,4.8e-05
G5,C(CC(C=CC(C)=O)O)(C(C=C)O)=O,8,1,0,1,28,4.8e-05
G5,C=C(CO)CC(CC(C=CC=O)=O)O,4,1,0,1,28,4.8e-05
G5,C(C(C(CO)=C)C(C=CC=O)(C)O)=O,8,1,0,1,28,4.8e-05
G5,C(C(C(CO)=C)C(C=CC(C)=O)O)=O,8,1,0,1,28,4.8e-05
G5,C(C(CC(C=CC=O)=O)O)=C(C)CO,8,1,0,1,28,4.8e-05
G5,C(C(CC(C=CC=O)=O)O)=CC,8,1,0,1,28,4.8e-05
G5,C=CCC(CC(C=CC=O)=O)O,4,1,0,1,28,4.8e-05
G5,C(C(C=C)C(C=CC=O)(C)O)=O,8,1,0,1,28,4.8e-05
G5,C(C(C=C)C(C=CC(C)=O)O)=O,8,1,0,1,28,4.8e-05
G5,C(CC=CC(CC(C=CC=O)=O)O)=O,8,1,0,1,28,4.8e-05
G5,C(CC(CC(C=CC=O)=O)O)=CC=O,8,1,0,1,28,4.8e-05
G5,C(C(C=CC=O)C(C=CC=O)(C)O)=O,16,1,0,1,28,4.8e-05
G5,C(C(C=CC=O)C(C=CC(C)=O)O)=O,16,1,0,1,28,4.8e-05
G5,C(C(C(C=O)=C)C(C(CC=O)=C)O)=O,4,1,0,1,28,4.8e-05
G5,C(C(C(C=O)=C)C(CC(C=O)=C)O)=O,4,1,0,1,28,4.8e-05
G5,C(C(C(C=O)=C)C(C(C)=CC=O)O)=O,8,1,0,1,28,4.8e-05
G5,C(C(C(C=O)=C)C(C=C(C=O)C)O)=O,8,1,0,1,28,4.8e-05
G5,C(C(C(C=O)=C)C(C=C)O)=O,4,1,0,1,28,4.8e-05
G5,C(C(C(C=O)=C)C(C=CC)(CO)O)=O,8,1,0,1,28,4.8e-05
G5,C(CC(C(C(C(C=CC)=O)O)O)=C)=O,8,2,0,2,28,9.499999999999999e-05
G5,C=C(C=O)CC(C(C(C=CC)=O)O)O,8,2,0,2,28,9.499999999999999e-05
G5,C(C(C(C=O)=C)C(CO)(CC=C)O)=O,4,1,0,1,28,4.8e-05
G5,C(CC(C(C(C(CO)=O)C=C)O)=C)=O,4,1,0,1,28,4.8e-05
G5,C(CO)(C(C=C)C(CC(C=O)=C)O)=O,4,1,0,1,28,4.8e-05
G5,C(CC(C(C(C(CC=C)=O)O)O)=C)=O,4,2,0,2,28,9.499999999999999e-05
G5,C(C(C(CC(C=O)=C)O)O)(CC=C)=O,4,2,0,2,28,9.499999999999999e-05
G5,C(C(C(C=O)=C)C(C)(C(C=C)O)O)=O,8,1,0,1,28,4.8e-05
G5,C(CC(C(CC(C(C=C)O)=O)O)=C)=O,4,1,0,1,28,4.8e-05
G5,C(CC(CC(C=O)=C)O)(C(C=C)O)=O,4,1,0,1,28,4.8e-05
G5,C(C(C(C=O)=C)C(CC(CO)=C)O)=O,4,1,0,1,28,4.8e-05
G5,C(C(C(CO)=C)C(C(CC=O)=C)O)=O,4,1,0,1,28,4.8e-05
G5,C(C(C(CO)=C)C(CC(C=O)=C)O)=O,4,1,0,1,28,4.8e-05
G5,C(C(C(C=O)=C)C(C=C(C)CO)O)=O,8,1,0,1,28,4.8e-05
G5,C(C(C(C=O)=C)C(C=CC)O)=O,8,1,0,1,28,4.8e-05
G5,C(C(C(C=O)=C)C(CC=C)O)=O,4,1,0,1,28,4.8e-05
G5,C(C(C=C)C(C(CC=O)=C)O)=O,4,1,0,1,28,4.8e-05
G5,C(C(C=C)C(CC(C=O)=C)O)=O,4,1,0,1,28,4.8e-05
G5,C(C(C(C=O)=C)C(C=CCC=O)O)=O,8,1,0,1,28,4.8e-05
G5,C(C(C(C=O)=C)C(CC=CC=O)O)=O,8,1,0,1,28,4.8e-05
G5,C(C(C=CC=O)C(C(CC=O)=C)O)=O,8,1,0,1,28,4.8e-05
G5,C(C(C=CC=O)C(CC(C=O)=C)O)=O,8,1,0,1,28,4.8e-05
G5,C(C)=CC(C(C(C(C)=CC=O)O)O)=O,16,2,0,2,28,9.499999999999999e-05
G5,C(C(C(C(C=CC)=O)O)O)=C(C=O)C,16,2,0,2,28,9.499999999999999e-05
G5,C(CO)(C(C=C)C(C(C)=CC=O)O)=O,8,1,0,1,28,4.8e-05
G5,C(CO)(C(C=C)C(C=C(C=O)C)O)=O,8,1,0,1,28,4.8e-05
G5,C(C(C(C(C)=CC=O)O)O)(CC=C)=O,8,2,0,2,28,9.499999999999999e-05
G5,C(C(C(C=C(C=O)C)O)O)(CC=C)=O,8,2,0,2,28,9.499999999999999e-05
G5,C(CC(C(C)=CC=O)O)(C(C=C)O)=O,8,1,0,1,28,4.8e-05
G5,C(CC(C=C(C=O)C)O)(C(C=C)O)=O,8,1,0,1,28,4.8e-05
G5,C(C(C(CO)=C)C(C(C)=CC=O)O)=O,8,1,0,1,28,4.8e-05
G5,C(C(C(CO)=C)C(C=C(C=O)C)O)=O,8,1,0,1,28,4.8e-05
G5,C(C(C=C)C(C(C)=CC=O)O)=O,8,1,0,1,28,4.8e-05
G5,C(C(C=C)C(C=C(C=O)C)O)=O,8,1,0,1,28,4.8e-05
G5,C(C(C=CC=O)C(C(C)=CC=O)O)=O,16,1,0,1,28,4.8e-05
G5,C(C(C=CC=O)C(C=C(C=O)C)O)=O,16,1,0,1,28,4.8e-05
G5,C=CC(C(C(C(C=O)=CC=O)=O)O)O,8,2,0,2,55,9.499999999999999e-05
G5,C=CC(C(C(C(C=O)=C)=O)O)O,4,2,0,2,9,9.499999999999999e-05
G5,C=C(C=O)C(C(C(C=CC)O)O)=O,8,2,0,2,9,9.499999999999999e-05
G5,C(CC(C(C(C(C=O)=C)=O)O)O)=C,4,2,0,2,9,9.499999999999999e-05
G5,C(C(C=C)C(C(C(CO)=O)=C)O)=O,4,1,0,1,9,4.8e-05
G5,C(C(C=C)C(C(C=O)=C)(CO)O)=O,4,1,0,1,9,4.8e-05
G5,C=CC(C(C(C(C=O)=CC)=O)O)O,8,2,0,2,45,9.499999999999999e-05
G5,C(C)=CC(C(C(C(C=O)=CC)=O)O)O,16,2,0,2,45,9.499999999999999e-05
G5,C(CC(C(C(C(C=O)=CC)=O)O)O)=C,8,2,0,2,45,9.499999999999999e-05
G5,C(C(C=C)C(C(C(CO)=O)=CC)O)=O,8,1,0,1,45,4.8e-05
G5,C(C(C=C)C(C(C=O)=CC)(CO)O)=O,8,1,0,1,45,4.8e-05
G5,C(C(C(C(C(C=C)O)O)=O)C=C)=O,8,2,0,2,45,9.499999999999999e-05
G5,C(C(C(C(C(C=CC)O)O)=O)C=C)=O,16,2,0,2,45,9.499999999999999e-05
G5,C(C(C(C(C(CC=C)O)O)=O)C=C)=O,8,2,0,2,45,9.499999999999999e-05
G5,C(C(C=C)C(C(C(CO)=O)C=C)O)=O,8,1,0,1,45,4.8e-05
G5,C(C(C=C)C(CO)(C(C=O)C=C)O)=O,3,1,0,1,45,4.8e-05
G5,C(C(C(CO)=CC=O)C(C=C)O)=O,8,1,0,1,46,4.8e-05
G5,C(C(C(CO)=CC=O)C(C=CC)O)=O,16,1,0,1,46,4.8e-05
G5,C(C(C(CO)=CC=O)C(CC=C)O)=O,8,1,0,1,46,4.8e-05
G5,C(C(C=C)C(C=C(CO)CC=O)O)=O,8,1,0,1,46,4.8e-05
G5,C(C(C=C)C(CC(CO)=CC=O)O)=O,8,1,0,1,46,4.8e-05
G5,C(C(C=C)C(C(C(C=C)=O)O)O)=O,8,1,0,1,0,4.8e-05
G5,C(C(C=C)C(C=C)(C(C=O)O)O)=O,8,1,0,1,0,4.8e-05
G5,C(C(C=C)C(C(C(C=CC)=O)O)O)=O,16,1,0,1,28,4.8e-05
G5,C(C(C=C)C(C=CC)(C(C=O)O)O)=O,16,1,0,1,28,4.8e-05
G5,C(C(C(C(C=O)O)=C)C(C=C)O)=O,8,1,0,1,6,4.8e-05
G5,C(C(C(C(C=O)O)=C)C(C=CC)O)=O,16,1,0,1,6,4.8e-05
G5,C(C(C(C(C=O)O)=C)C(CC=C)O)=O,8,1,0,1,6,4.8e-05
G5,C(C(C=C)C(C(C(CC=O)=C)O)O)=O,8,1,0,1,6,4.8e-05
G5,C(C(C=C)C(CC(C(C=O)O)=C)O)=O,8,1,0,1,6,4.8e-05
G5,C(C(C=C)C(C(C(C)=CC=O)O)O)=O,16,1,0,1,6,4.8e-05
G5,C(C(C=C)C(C=C(C)C(C=O)O)O)=O,16,1,0,1,6,4.8e-05
G5,C(C(CO)O)(C(C=C)C(C=C)O)=O,8,1,0,1,28,4.8e-05
G5,C(C(C(C(CO)O)=C)C(C=C)O)=O,8,1,0,1,27,4.8e-05
G5,C(C(C=C)C(C(C(CO)=C)=O)O)=O,4,1,0,1,49,4.8e-05
G5,C(C(C=C)C(C=O)(C(CO)=C)O)=O,4,1,0,1,49,4.8e-05
G5,C=CC(C(C(C(CO)=C)=O)O)O,4,2,0,2,49,9.499999999999999e-05
G5,C=C(C(C(C(C=CC)O)O)=O)CO,8,2,0,2,49,9.499999999999999e-05
G5,C(CC(C(C(C(CO)=C)=O)O)O)=C,4,2,0,2,49,9.499999999999999e-05
G5,C(C(C=C)C(C(CO)=C)(CO)O)=O,4,1,0,1,49,4.8e-05
G5,C(C(C=C)C(C(C(C=O)=C)O)O)=O,8,1,0,1,16,4.8e-05
G5,C(C(C=C)C(C(C(C=O)O)=C)O)=O,8,1,0,1,16,4.8e-05
G5,C(C(C=C)C(C=C(C=O)CO)O)=O,8,1,0,1,18,4.8e-05
G5,C(C(C=C)C(C(CO)=CC=O)O)=O,8,1,0,1,18,4.8e-05
G5,C(C(C(C=O)=CCO)C(C=C)O)=O,8,1,0,1,3,4.8e-05
G5,C(C(CO)C(C=C)O)(C(C=C)O)=O,8,2,0,2,27,9.499999999999999e-05
G5,C=CC(C(C(C(C(C)O)=C)=O)O)O,8,2,0,2,4,9.499999999999999e-05
G5,C=CC(C(C(C(CO)=CC)=O)O)O,8,2,0,2,27,9.499999999999999e-05
G5,C(C(C(C=C)O)O)(C(C=C)CO)=O,8,2,0,2,28,9.499999999999999e-05
G5,C(C(C(CO)=CCO)C(C=C)O)=O,8,1,0,1,3,4.8e-05
G5,C=CC(C(C(C=C(C)CO)=O)O)O,8,2,0,2,49,9.499999999999999e-05
G5,C(CO)(C(C(CO)=C)C(C=C)O)=O,4,1,0,1,49,4.8e-05
G5,C(C(C(C=C)O)O)(CC(CO)=C)=O,4,2,0,2,49,9.499999999999999e-05
G5,C(CC(C=C)O)(C(C(CO)=C)O)=O,4,1,0,1,49,4.8e-05
G5,C=CC(C(C(C=CC)=O)O)O,8,2,0,2,28,9.499999999999999e-05
G5,C(CO)(C(C=C)C(C=C)O)=O,4,1,0,1,28,4.8e-05
G5,C(C(C(C=C)O)O)(CC=C)=O,4,2,0,2,28,9.499999999999999e-05
G5,C(CC(C=C)O)(C(C=C)O)=O,4,1,0,1,28,4.8e-05
G5,C(C(C(CO)=C)C(C=C)O)=O,4,1,0,1,28,4.8e-05
G5,C(C(C=CC(C=O)O)C(C=C)O)=O,16,1,0,1,43,4.8e-05
G5,C(C(C=C)C(C=C)O)=O,4,1,0,1,45,4.8e-05
G5,C(C(C(CC(C=C)O)=O)(C=C)O)=O,4,1,0,1,27,4.8e-05
G5,C(CC(C=C)O)(C(C=C)(CO)O)=O,4,1,0,1,27,4.8e-05
G5,C(C(C1OCC(C=1)=O)C(C=C)O)=O,4,2,0,2,48,9.499999999999999e-05
G5,C(CC1OC(C(C=1)=O)C(C=C)O)=O,4,2,0,2,48,9.499999999999999e-05
G5,C1(C(C=CC(C(C(C=C)O)O1)=O)O)=O,8,2,0,2,27,9.499999999999999e-05
G5,C(C1C(C(C(O)O1)=O)C(C=C)O)=O,16,2,0,2,0,9.499999999999999e-05
G5,C1(C(O)OC(C)C1C(C=C)O)=O,16,2,0,2,45,9.499999999999999e-05
G5,C1(C(C(C=C)O)OC(C)(C1O)O)=O,16,2,0,2,0,9.499999999999999e-05
G5,C1(C(C(C=C)O)OC(C1O)O)=O,16,2,0,2,5,9.499999999999999e-05
G5,C1(C(C(O)OCC1O)C(C=C)O)=O,16,2,0,2,27,9.499999999999999e-05
G5,C1(C(COC(C1O)O)C(C=C)O)=O,16,2,0,2,27,9.499999999999999e-05
G5,C=CC(C(C(C=O)=O)CCO)O,4,1,0,1,55,4.8e-05
G5,C=CC(C(C(C=O)=O)CCCO)O,4,1,0,1,46,4.8e-05
G5,C=CC(C(C(C=O)=O)CC(C)O)O,8,1,0,1,27,4.8e-05
G5,C(C(C(C=C)O)O)(CCCO)=O,4,2,0,2,55,9.499999999999999e-05
G5,C(CO)(C(CCO)C(C=C)O)=O,4,1,0,1,55,4.8e-05
G5,C(C(C(C=C)O)O)(CCCCO)=O,4,2,0,2,27,9.499999999999999e-05
G5,C(CO)(C(CCCO)C(C=C)O)=O,4,1,0,1,27,4.8e-05
G5,C(C(C(C=C)O)O)(CCC(C)O)=O,8,2,0,2,27,9.499999999999999e-05
G5,C(CO)(C(CC(C)O)C(C=C)O)=O,8,1,0,1,27,4.8e-05
G5,C(C(C(C)O)C(C=O)C(C=C)O)=O,16,1,0,1,27,4.8e-05
G5,C(C(C=CC=O)C(C=C)O)=O,8,1,0,1,28,4.8e-05
G5,C(C(C=C)C(C(C(C(C)O)=C)=O)O)=O,8,1,0,1,4,4.8e-05
G5,C(C(C=C)C(C=O)(C(C(C)O)=C)O)=O,8,1,0,1,4,4.8e-05
G5,C(C(C=C)C(C(C(CO)=CC)=O)O)=O,8,1,0,1,27,4.8e-05
G5,C(C(C=C)C(C=O)(C(CO)=CC)O)=O,8,1,0,1,27,4.8e-05
G5,C(C(C=C)C(C(C(C=C)CO)=O)O)=O,8,1,0,1,28,4.8e-05
G5,C(C(C=C)C(C=O)(C(C=C)CO)O)=O,8,1,0,1,28,4.8e-05
G5,C(C(C(C=O)=CCO)C(C=CC)O)=O,16,1,0,1,3,4.8e-05
G5,C(C(C(C=O)=CCO)C(CC=C)O)=O,8,1,0,1,3,4.8e-05
G5,C(C(C=C)C(C(CC=O)=CCO)O)=O,8,1,0,1,3,4.8e-05
G5,C(C(C=C)C(CC(C=O)=CCO)O)=O,8,1,0,1,3,4.8e-05
G5,C(C(C=C)C(C(CCO)=CC=O)O)=O,8,1,0,1,46,4.8e-05
G5,C(C(C=C)C(C=C(C=O)CCO)O)=O,8,1,0,1,46,4.8e-05
G5,C(C)=CC(C(C(C=CC)=O)O)O,16,2,0,2,28,9.499999999999999e-05
G5,C(CC(C(C(C=CC)=O)O)O)=C,8,2,0,2,28,9.499999999999999e-05
G5,C(C(C=C)C(C=CC)(CO)O)=O,8,1,0,1,28,4.8e-05
G5,C(CC=CC(C(C(C=CC)=O)O)O)=O,16,2,0,2,28,9.499999999999999e-05
G5,C(CC(C(C(C=CC)=O)O)O)=CC=O,16,2,0,2,28,9.499999999999999e-05
G5,C(C(C=CC=O)C(C=CC)(CO)O)=O,16,1,0,1,28,4.8e-05
G5,C(CO)(C(C=C)C(C=CC)O)=O,8,1,0,1,28,4.8e-05
G5,C(C(C(C=CC)O)O)(CC=C)=O,8,2,0,2,28,9.499999999999999e-05
G5,C(CO)(C(C=C)C(CC=C)O)=O,4,1,0,1,28,4.8e-05
G5,C(C(C(CC=C)O)O)(CC=C)=O,4,2,0,2,28,9.499999999999999e-05
G5,C(C(C=C)C(CO)(CC=C)O)=O,4,1,0,1,28,4.8e-05
G5,C(CC=CC(C(C(CO)=O)C=C)O)=O,8,1,0,1,28,4.8e-05
G5,C(CC=CC(C(C(CC=C)=O)O)O)=O,8,2,0,2,28,9.499999999999999e-05
G5,C(CO)(C(C=C)C(CC=CC=O)O)=O,8,1,0,1,28,4.8e-05
G5,C(C(C(CC=CC=O)O)O)(CC=C)=O,8,2,0,2,28,9.499999999999999e-05
G5,C(C(C=CC=O)C(CO)(CC=C)O)=O,8,1,0,1,28,4.8e-05
G5,C(CC(C=CC)O)(C(C=C)O)=O,8,1,0,1,28,4.8e-05
G5,C(CC(CC=C)O)(C(C=C)O)=O,4,1,0,1,28,4.8e-05
G5,C(C(C=C)C(C)(C(C=C)O)O)=O,8,1,0,1,28,4.8e-05
G5,C(CC=CC(CC(C(C=C)O)=O)O)=O,8,1,0,1,28,4.8e-05
G5,C(CC(CC=CC=O)O)(C(C=C)O)=O,8,1,0,1,28,4.8e-05
G5,C(C(C=CC=O)C(C)(C(C=C)O)O)=O,16,1,0,1,28,4.8e-05
G5,C(C(C(CO)=C)C(C=CC)O)=O,8,1,0,1,28,4.8e-05
G5,C(C(C(CO)=C)C(CC=C)O)=O,4,1,0,1,28,4.8e-05
G5,C(C(C=C)C(CC(CO)=C)O)=O,4,1,0,1,28,4.8e-05
G5,C(C(C(CO)=C)C(C=CCC=O)O)=O,8,1,0,1,28,4.8e-05
G5,C(C(C(CO)=C)C(CC=CC=O)O)=O,8,1,0,1,28,4.8e-05
G5,C(C(C=CC=O)C(CC(CO)=C)O)=O,8,1,0,1,28,4.8e-05
G5,C(C(C=C)C(C=C(C)CO)O)=O,8,1,0,1,28,4.8e-05
G5,C(C(C=CC=O)C(C=C(C)CO)O)=O,16,1,0,1,28,4.8e-05
G5,C(C(C=C)C(C=C(C=O)C(C)O)O)=O,16,1,0,1,28,4.8e-05
G5,C(C(C=C)C(C(C(C)O)=CC=O)O)=O,16,1,0,1,28,4.8e-05
G5,C(C(C=C)C(C(C(C=O)=CC)O)O)=O,16,1,0,1,45,4.8e-05
G5,C(C(C=C)C(C(C(C=O)O)=CC)O)=O,16,1,0,1,45,4.8e-05
G5,C(C(C=C)C(C(C(C=O)C=C)O)O)=O,10,1,0,1,45,4.8e-05
G5,C(C(C=C)C(C(C=C)C(C=O)O)O)=O,16,1,0,1,45,4.8e-05
G5,C(C(C=CC(C=O)O)C(C=CC)O)=O,32,1,0,1,43,4.8e-05
G5,C(C(C=CC(C=O)O)C(CC=C)O)=O,16,1,0,1,43,4.8e-05
G5,C(C(C=C)C(C(C=CCC=O)O)O)=O,16,1,0,1,43,4.8e-05
G5,C(C(C=C)C(CC=CC(C=O)O)O)=O,16,1,0,1,43,4.8e-05
G5,C(C(C=C)C(C(CC=CC=O)O)O)=O,16,1,0,1,27,4.8e-05
G5,C(C(C=C)C(C=CCC(C=O)O)O)=O,16,1,0,1,27,4.8e-05
G5,C(C(C=C)C(C=CC)O)=O,8,1,0,1,45,4.8e-05
G5,C(C(C(CC(C=CC)O)=O)(C=C)O)=O,8,1,0,1,27,4.8e-05
G5,C(C(C1OCC(C=1)=O)C(C=CC)O)=O,8,2,0,2,48,9.499999999999999e-05
G5,C(CC1OC(C(C=1)=O)C(C=CC)O)=O,8,2,0,2,48,9.499999999999999e-05
G5,C1(C(O)OC(C)C1C(C=CC)O)=O,32,2,0,2,45,9.499999999999999e-05
G5,C1(C(C(C=CC)O)OC(C1O)O)=O,32,2,0,2,5,9.499999999999999e-05
G5,C(C)=CC(C(C(C=O)=O)CCO)O,8,1,0,1,55,4.8e-05
G5,C(C(C(C=CC)O)O)(CCCO)=O,8,2,0,2,55,9.499999999999999e-05
G5,C(CO)(C(CCO)C(C=CC)O)=O,8,1,0,1,55,4.8e-05
G5,C(C(C=CC=O)C(C=CC)O)=O,16,1,0,1,28,4.8e-05
G5,C(C(C=C)C(CC=C)O)=O,4,1,0,1,45,4.8e-05
G5,C(C(C=C)C(C(C(CO)=C)O)O)=O,8,1,0,1,49,4.8e-05
G5,C(C(C=C)C(C(C=C)(CO)O)O)=O,8,1,0,1,29,4.8e-05
G5,C(C(C=C)C(C(C(C)=O)(C=C)O)O)=O,8,1,0,1,27,4.8e-05
G5,C(C(C=C)C(C)(C(C=O)(C=C)O)O)=O,8,1,0,1,27,4.8e-05
G5,C(C(C(CC(CC=C)O)=O)(C=C)O)=O,4,1,0,1,27,4.8e-05
G5,C(C(C=C)C(C(C=O)(C=C)O)O)=O,8,1,0,1,28,4.8e-05
G5,C(C(C=C)C(CC1OCC(C=1)=O)O)=O,4,1,0,1,48,4.8e-05
G5,C(CC1OCC(C=1)(C(C=O)C=C)O)=O,4,1,0,1,48,4.8e-05
G5,C(C(C1OCC(C=1)=O)C(CC=C)O)=O,4,2,0,2,48,9.499999999999999e-05
G5,C(CC1OC(C(C=1)=O)C(CC=C)O)=O,4,2,0,2,48,9.499999999999999e-05
G5,C(C(C=C)C(C1C(C=C(C)O1)=O)O)=O,8,1,0,1,26,4.8e-05
G5,C(C(C=C)C1(C=C(C)OC1C=O)O)=O,8,1,0,1,26,4.8e-05
G5,C(C(C=C)C(C(C(C=C)O)O)O)=O,16,1,0,1,27,4.8e-05
G5,C(C(C=C)C1(C(O)OC(C)C1)O)=O,16,1,0,1,45,4.8e-05
G5,C1(C(O)OC(C)C1C(CC=C)O)=O,16,2,0,2,45,9.499999999999999e-05
G5,C(C(C=C)C1(C(O)OCC1O)O)=O,16,1,0,1,0,4.8e-05
G5,C(C(C=C)C1(COC(C1O)O)O)=O,16,1,0,1,5,4.8e-05
G5,C1(C(C(CC=C)O)OC(C1O)O)=O,16,2,0,2,5,9.499999999999999e-05
G5,C(C(C=C)C(C(CCCO)=O)O)=O,4,1,0,1,55,4.8e-05
G5,C(C(C=C)C(C=O)(CCCO)O)=O,4,1,0,1,55,4.8e-05
G5,C=CCC(C(C(C=O)=O)CCO)O,4,1,0,1,55,4.8e-05
G5,C(C(C=C)C(CO)(CCCO)O)=O,4,1,0,1,55,4.8e-05
G5,C(C(C(CC=C)O)O)(CCCO)=O,4,2,0,2,55,9.499999999999999e-05
G5,C(CO)(C(C(CC=C)O)CCO)=O,4,1,0,1,55,4.8e-05
G5,C(C(C=C)C1(C=CC(C1O)=O)O)=O,8,1,0,1,47,4.8e-05
G5,C(C(C=C)C(C=CCC=O)O)=O,8,1,0,1,28,4.8e-05
G5,C(C(C=C)C(CC=CC=O)O)=O,8,1,0,1,28,4.8e-05
G5,C(C(C=CC=O)C(CC=C)O)=O,8,1,0,1,28,4.8e-05
G5,C(C(C=CC=O)C(C=CCC=O)O)=O,16,1,0,1,28,4.8e-05
G5,C(C(C=CC=O)C(CC=CC=O)O)=O,16,1,0,1,28,4.8e-05
G5,C(C(C1(C(CC(C1)O)O)O)O)=O,16,2,0,2,45,9.7e-05
G5,C(C(C1(C(C(CC1O)O)O)O)O)=O,32,5,0,5,2,0.000261
G5,C(C(C1(C=CC(C1O)O)O)O)=O,16,3,0,3,28,0.000144
G5,C(C(C1(C=CC(C(C1)O)=O)O)O)=O,8,2,0,2,45,9.7e-05
G5,C(C1(C=CC(C1)(C(C=O)O)O)O)=O,8,2,0,2,45,9.7e-05
G5,C(C(C(C1C=CC(C1O)=O)O)O)=O,16,2,0,2,45,9.7e-05
G5,C(C(C1(C(C=CC(C1)O)=O)O)O)=O,8,2,0,2,27,9.7e-05
G5,C(C(CO)C(C(C=O)O)O)(O)=O,8,6,0,6,18,0.000312
G5,C(C(C(C(C=O)O)O)C(C)O)(O)=O,16,5,0,5,4,0.000252
G5,C(CC(C(O)=O)(C(C=O)O)O)(O)=O,4,5,0,5,17,0.000262
G5,C(C(C(C(O)=O)=O)C(CO)O)(O)=O,4,5,0,5,0,0.000252
G5,C(CC(C(C)=O)(C(C=O)O)O)(O)=O,4,4,0,4,17,0.000204
G5,C(C(C)(C(C=O)O)O)(CC(O)=O)=O,4,4,0,4,17,0.000204
G5,C(CC(C(C=O)O)(CC=O)O)(O)=O,4,3,0,3,17,0.000146
G5,C(CC(C(C=O)O)O)(CC(O)=O)=O,4,5,0,5,17,0.000252
G5,C(C(C(CC(O)=O)=O)C(CO)O)=O,4,4,0,4,17,0.000204
G5,C(C(C(C(C(O)=O)C(C)=O)O)O)=O,8,7,0,7,0,0.000348
G5,C(C(C(C=C)(C(C=O)O)O)O)(O)=O,8,3,0,3,17,0.000145
G5,C(C(C(C(C(CCO)O)O)O)O)=O,16,8,0,8,29,0.000437
G5,C(C(C(C(CO)C(CO)O)O)O)=O,16,8,0,8,29,0.000437
G5,C(C(C(C(CO)CO)O)O)=O,4,3,0,3,18,0.000156
G5,C(C(C(C(CO)C(C)O)O)O)=O,16,3,0,3,18,0.000156
G5,C(CO)(C(CCO)(C(C=O)O)O)=O,4,6,0,6,2,0.00031
G5,C(C)(C(CCO)(C(C=O)O)O)=O,4,6,0,6,14,0.00031
G5,C(C(C)(C(C=O)O)O)(CCO)=O,4,5,0,5,14,0.000252
G5,C(CCO)(CC(C(C=O)O)O)=O,4,6,0,6,2,0.0003
G5,C(C(C(C(C(C)=O)CO)O)O)=O,8,9,0,9,0,0.00045599999999999997
G5,C(C(C1(COC(C1CO)O)O)O)=O,16,3,0,3,27,0.000144
G5,C(C(C1(C(CO)OC(C1)O)O)O)=O,16,3,0,3,27,0.000144
G5,C1(C(CO)OC(C1C(CO)O)O)=O,16,5,0,5,0,0.00024300000000000002
G5,C(C(C(C=C)(C(CO)O)O)O)=O,8,6,0,6,7,0.000309
G5,C(C(C1(C(CO)OCC1O)O)O)=O,16,2,0,2,27,9.7e-05
G5,C(C(C1(C(O)OCC1CO)O)O)=O,16,3,0,3,34,0.000144
G5,C(C(C(CC(CCO)O)O)O)=O,8,4,0,4,18,0.00021400000000000002
G5,C(C(C(CC(CC(C)O)O)O)O)=O,16,3,0,3,28,0.000155
G5,C(C(C(C(C(C)O)C(C)O)O)O)=O,12,2,0,2,4,9.7e-05
G5,C(C(C)(CC(C(C=O)O)O)O)(O)=O,8,6,0,6,28,0.000331
G5,C(C(CC(C)O)(C(C=O)O)O)(O)=O,8,4,0,4,4,0.000204
G5,C(C(C(C(CO)O)C(C)O)=O)(O)=O,8,5,0,5,0,0.00025299999999999997
G5,C(C(C(CC(C(C)=O)(C)O)O)O)=O,8,3,0,3,14,0.000155
G5,C(CC(C)(C(C)(C(C=O)O)O)O)=O,8,4,0,4,14,0.000193
G5,C(C)(C(CC(C)O)(C(C=O)O)O)=O,8,2,0,2,4,9.7e-05
G5,C(C(C)(C(C=O)O)O)(CC(C)O)=O,8,3,0,3,4,0.000146
G5,C(CC(C)(CC(C(C=O)O)O)O)=O,8,5,0,5,6,0.000263
G5,C(C(C(CC(CC(C)=O)O)O)O)=O,8,4,0,4,6,0.00020299999999999997
G5,C(CC(C(C(C)=O)C(CO)O)O)=O,8,3,0,3,6,0.000146
G5,C(CC(C)O)(CC(C(C=O)O)O)=O,8,3,0,3,4,0.000146
G5,C(C(C(CC(C)O)=O)C(CO)O)=O,8,3,0,3,4,0.000146
G5,C(C(C(C(C(C)=O)C(C)O)O)O)=O,16,5,0,5,4,0.00025299999999999997
G5,C(C(C(CC(C(C=C)=O)O)O)O)=O,8,4,0,4,7,0.00021400000000000002
G5,C(CC(C(C=C)(C(C=O)O)O)O)=O,8,5,0,5,7,0.000263
G5,C(C(C=C)(CC(C(C=O)O)O)O)=O,8,6,0,6,7,0.000298
G5,C(C(C(CC(C=C)(CO)O)O)O)=O,8,3,0,3,7,0.000155
G5,C(C(C(C=C)(C(C(C)O)O)O)O)=O,16,2,0,2,4,9.7e-05
G5,C(C(C(CC(C=CC=O)O)O)O)=O,16,7,0,7,43,0.000356
G5,C(C(C(CC(C(C)O)O)O)O)=O,16,3,0,3,11,0.000155
G5,C(C)(C(C(CO)O)C(C(O)=O)O)=O,8,4,0,4,0,0.00021400000000000002
G5,C(CC(C(O)=O)O)(CC(CO)O)=O,4,3,0,3,0,0.000165
G5,C(CO)(C(C(C=O)=O)C(CO)O)=O,4,3,0,3,51,0.000144
G5,C(C(C(CO)O)O)(CC(C=O)=O)=O,4,3,0,3,51,0.000144
G5,C(CC(CO)O)(C(C(C=O)=O)O)=O,4,1,0,1,0,4.8e-05
G5,C(C(C(C(C(C=O)O)O)=O)(C)O)=O,8,5,0,5,0,0.00023999999999999998
G5,C(C(C=O)C(C(C(CO)O)O)=O)=O,4,7,0,7,1,0.00037799999999999997
G5,C(CC(C(C=O)O)(C(C=O)O)O)=O,3,3,0,3,1,0.000144
G5,C(C(C(C(C=O)O)=O)C(CO)O)=O,8,4,0,4,1,0.00021400000000000002
G5,C(C(C(CO)(CC(C)=O)O)O)=O,4,7,0,7,26,0.000357
G5,C(C)(C(C(CO)=O)C(CO)O)=O,4,7,0,7,29,0.000357
G5,C(C)(C(CO)C(CO)O)=O,4,5,0,5,28,0.000261
G5,C(CC(C(C=O)O)(CC=O)O)=O,2,4,0,4,9,0.000193
G5,C(C(C(CC(CC(C)=O)=O)O)O)=O,4,6,0,6,27,0.00032
G5,C(C(C(CC(C)=O)=O)C(CO)O)=O,4,3,0,3,27,0.000155
G5,C(CC=O)(C(C(C)=O)C(CO)O)=O,4,4,0,4,27,0.00021400000000000002
G5,C(CC(CC(CC(CO)O)=O)=O)=O,2,4,0,4,29,0.00022400000000000002
G5,C(C(C(C)(C)O)O)=O,2,2,0,2,27,9.7e-05
G5,C(C)(CC(CO)O)=O,2,10,0,10,17,0.0004980000000000001
G5,C(CCC(CO)(C(C=O)O)O)=O,4,4,0,4,7,0.000192
G5,C(CCC=O)(C(C(CO)O)O)=O,4,7,0,7,7,0.000367
G5,C(C(C(CC(CCC=O)=O)O)O)=O,4,3,0,3,44,0.000155
G5,C(CCC(C(C=O)O)O)(CC=O)=O,4,7,0,7,44,0.000356
G5,C(C(C(CCC=O)=O)C(CO)O)=O,4,3,0,3,44,0.000155
G5,C(C(C(C(CC(C)=O)O)O)O)=O,8,7,0,7,27,0.000356
G5,C(C)(C(C(CO)O)C(C=O)O)=O,8,4,0,4,27,0.00020299999999999997
G5,C(CC(C=O)O)(CC(CO)O)=O,4,4,0,4,29,0.000202
G5,C(C(C(C=CCO)(CO)O)O)=O,8,4,0,4,11,0.00020299999999999997
G5,C(CO)=CC(C(C(CO)O)O)=O,8,7,0,7,29,0.000357
G5,C(C(C(CC(C=CCO)=O)O)O)=O,8,4,0,4,0,0.00021400000000000002
G5,C(C(C(C=CCO)=O)C(CO)O)=O,8,4,0,4,0,0.00021400000000000002
G5,C(OCC(C)(C(C=O)O)O)=O,4,5,0,5,35,0.000239
G5,C(OCC(CC(CO)O)=O)=O,2,5,0,5,0,0.00024900000000000004
G5,C(C(C(CO)(COCC=O)O)O)=O,4,2,0,2,27,9.7e-05
G5,C(C(C(COCC(CO)=O)O)O)=O,4,2,0,2,27,9.7e-05
G5,C(COC(C(CO)=O)C(CO)O)=O,4,2,0,2,27,9.7e-05
G5,C(COCC=O)(C(C(CO)O)O)=O,4,2,0,2,27,9.7e-05
G5,C(C(C(CO)O)OCC(CO)=O)=O,4,2,0,2,27,9.7e-05
G5,C(C(C(C(OCC=O)O)(C)O)O)=O,8,5,0,5,16,0.000239
G5,C(C(C(COC(C(C)=O)O)O)O)=O,8,5,0,5,16,0.000239
G5,C(COC(C(CC(CO)O)=O)O)=O,4,1,0,1,27,4.8e-05
G5,C(C(C(CO)O)OC(C(C)=O)O)=O,8,3,0,3,27,0.000144
G5,C(C(C(C(OCC(C)=O)O)O)O)=O,8,7,0,7,27,0.000334
G5,C(C(C(COC(C=O)O)(C)O)O)=O,8,5,0,5,27,0.000239
G5,C(COC(C=O)O)(CC(CO)O)=O,4,3,0,3,0,0.000143
G5,C(C)(C(C(CO)O)OC(C=O)O)=O,8,3,0,3,27,0.000144
G5,C(OCC(C(C=O)O)O)=O,4,5,0,5,1,0.000239
G5,C(OC(C=O)C(CO)O)=O,4,2,0,2,28,9.7e-05
G5,C(C(C(COC(C)=O)O)O)=O,4,5,0,5,1,0.000239
G5,C(C(C(CO)O)OC(C)=O)=O,4,3,0,3,28,0.000155
G5,C(C(C(CO)(C(CCO)O)O)O)=O,8,8,0,8,29,0.000437
G5,C(CCC(C=O)(C(C=O)O)O)=O,4,4,0,4,20,0.000192
G5,C(CC(C(C=O)=O)C(CO)O)=O,4,4,0,4,29,0.00019099999999999998
G5,C(C(C1(COC(CC1O)O)O)O)=O,16,6,0,6,27,0.000309
G5,C1(C(C(CO)O)OC(CC1O)O)=O,16,4,0,4,27,0.000192
G5,C(C(C=CCO)(C(C=O)O)O)=O,8,4,0,4,55,0.000192
G5,C(C(C(C(CO)O)O)=O)(O)=O,4,4,0,4,33,0.00020299999999999997
G5,C(C(CC(C)=O)(C(C=O)O)O)(O)=O,4,4,0,4,0,0.000204
G5,C(C)(C(C(C(O)=O)=O)C(CO)O)=O,4,3,0,3,0,0.000156
G5,C(CC(CO)O)(CC(C(O)=O)=O)=O,2,2,0,2,0,0.00010700000000000001
G5,C(C(C(C(O)=O)=O)C(CO)O)=O,4,4,0,4,45,0.00020299999999999997
G5,C(C(C(C=CC(O)=O)(CO)O)O)=O,8,3,0,3,18,0.000156
G5,C(C=CC(C(C(CO)O)O)=O)(O)=O,8,3,0,3,18,0.000156
G5,C(C(C=O)(C(CC(CO)O)=O)O)=O,2,3,0,3,1,0.000165
G5,C(C(C(C(CC(CO)O)=O)=O)O)=O,4,1,0,1,25,4.8e-05
G5,C(C(C(C)O)=O)(C(C(CO)O)O)=O,8,4,0,4,0,0.000192
G5,C(C(C(C(CO)=O)(C=C)O)O)=O,4,4,0,4,7,0.000192
G5,C=CC(C(C(C(CO)O)O)=O)=O,4,4,0,4,7,0.000192
G5,C(C(C(C)O)=O)(CC(CO)O)=O,4,3,0,3,49,0.000143
G5,C(C(C)O)(C(C=C)(C(C=O)O)O)=O,8,3,0,3,7,0.000155
G5,C(C(C(C(CO)=O)=O)C(CO)O)=O,4,2,0,2,0,9.7e-05
G5,C(CC(C(C(C(CO)O)O)=O)=O)=O,4,2,0,2,0,9.7e-05
G5,C(C(C=O)(CC(C(C=O)O)O)O)=O,4,8,0,8,1,0.00041500000000000006
G5,C(C(C=O)(C(C=O)C(CO)O)O)=O,4,6,0,6,1,0.000309
G5,C1(C(C(CO)O)CC(C1O)=O)=O,8,4,0,4,29,0.00019099999999999998
G5,C1(CCC(CO1)(C(C=O)O)O)=O,4,3,0,3,7,0.000144
G5,C1(COC(CC1C(CO)O)=O)=O,4,2,0,2,0,9.6e-05
G5,C1(CCC(OC1C(CO)O)=O)=O,4,3,0,3,7,0.000144
G5,C(C(C1(COCC(C1)=O)O)O)=O,4,3,0,3,54,0.000144
G5,C1(C(C(CO)O)OCC(C1)=O)=O,4,4,0,4,54,0.000192
G5,C1(COCC(C1C(CO)O)=O)=O,2,3,0,3,54,0.000144
G5,C(C(C1(COC(CO)C1O)O)O)=O,16,2,0,2,27,9.7e-05
G5,C(C(C1(C(O)OC(CO)C1)O)O)=O,16,3,0,3,27,0.000144
G5,C1(C(O)OC(CO)C1C(CO)O)=O,16,3,0,3,27,0.000144
G5,C(C(C1(COC(CO)(C1)O)O)O)=O,8,5,0,5,27,0.00025
G5,C1(COC(CO)(C1C(CO)O)O)=O,8,3,0,3,27,0.000144
G5,C1(C(C(CO)O)OC(CO)(C1)O)=O,8,3,0,3,27,0.000144
G5,C1(C(CCO1)(C(C=O)O)O)=O,4,4,0,4,28,0.000192
G5,C1(C(C(CO1)C(CO)O)=O)=O,4,4,0,4,28,0.000192
G5,C1(CC(CO1)(C(C=O)O)O)=O,4,3,0,3,28,0.000144
G5,C1(C(C(CO1)=O)C(CO)O)=O,4,4,0,4,28,0.000192
G5,C(C(C1(COCC(C1O)O)O)O)=O,16,2,0,2,27,9.7e-05
G5,C1(C(C(CO)O)OCC(C1O)O)=O,16,2,0,2,27,9.7e-05
G5,C(C(C1(C(O)OCC(C1)O)O)O)=O,16,3,0,3,27,0.000144
G5,C1(C(O)OCC(C1C(CO)O)O)=O,16,3,0,3,27,0.000144
G5,C1(C(CC(CO1)(C(C=O)O)O)O)=O,8,2,0,2,27,9.7e-05
G5,C1(COC(C(C1C(CO)O)O)=O)=O,8,2,0,2,27,9.7e-05
G5,C1(CC(C(OC1C(CO)O)=O)O)=O,8,2,0,2,27,9.7e-05
G5,C(C(C1(C=COC1)O)O)=O,4,3,0,3,28,0.000144
G5,C(C(C1(C=CC(O)OC1)O)O)=O,8,3,0,3,27,0.000144
G5,C1C(OC(C(C=1)=O)C(CO)O)O,8,3,0,3,27,0.000144
G5,C(CCCC(C=O)(C(C=O)O)O)=O,4,3,0,3,7,0.000144
G5,C(CCC(C(C=O)=O)C(CO)O)=O,4,4,0,4,44,0.00020299999999999997
G5,C(CCCC(CO)(C(C=O)O)O)=O,4,3,0,3,27,0.000144
G5,C(CCC(C(CO)=O)C(CO)O)=O,4,3,0,3,0,0.000145
G5,C(C(C)O)(CC(C(C=O)O)O)=O,8,4,0,4,45,0.000192
G5,C(C(C(C(C)O)=O)C(CO)O)=O,8,6,0,6,45,0.000298
G5,C(C(C(C(CC(C)O)O)O)O)=O,16,4,0,4,11,0.00020299999999999997
G5,C(C(C(C(C)O)(C(C)O)O)O)=O,6,4,0,4,49,0.00020299999999999997
G5,C(C(C(C(CC(CO)O)O)O)O)=O,16,5,0,5,0,0.000261
G5,C(C(C=CC(C(C=O)O)O)O)=O,16,8,0,8,20,0.000404
G5,C(C(C(C(C=CC=O)O)O)O)=O,16,7,0,7,20,0.000356
G5,C(C(C(C)(C(CCO)O)O)O)=O,8,4,0,4,45,0.00020299999999999997
G5,C(C(CCO)O)(CC(CO)O)=O,4,2,0,2,0,0.00010700000000000001
G5,C(C(C(C=CC(C)=O)(CO)O)O)=O,8,3,0,3,45,0.000156
G5,C(C(C(C=CC(CO)=O)(C)O)O)=O,8,3,0,3,45,0.000156
G5,C(C=CC(C)=O)(C(C(CO)O)O)=O,8,4,0,4,45,0.00021400000000000002
G5,C(C=CC(CO)=O)(CC(CO)O)=O,4,3,0,3,0,0.000166
G5,C(CC=CC(CO)(C(C=O)O)O)=O,8,3,0,3,29,0.000156
G5,C(C(C(CC=CC(CO)=O)O)O)=O,8,4,0,4,29,0.00021400000000000002
G5,C(CC=CC(C(C(CO)O)O)=O)=O,8,8,0,8,29,0.000437
G5,C(C(C=CC(CO)=O)C(CO)O)=O,8,3,0,3,29,0.000166
G5,C(C(C(C(C=CCCO)=O)O)O)=O,8,3,0,3,29,0.000156
G5,C(C(C=CCCO)(C(C=O)O)O)=O,8,3,0,3,29,0.000156
G5,C(C(C(C(C)=O)(C=CCO)O)O)=O,8,3,0,3,27,0.000156
G5,C(C(C(C(C=CCO)=O)(C)O)O)=O,8,3,0,3,27,0.000156
G5,C(CO)=CC(C(CC(CO)O)=O)=O,4,3,0,3,29,0.000166
G5,C(C(C(C=CC(CCO)=O)O)O)=O,8,3,0,3,27,0.000156
G5,C(C(C(C=CC=O)(CCO)O)O)=O,8,3,0,3,27,0.000156
G5,C(C=CC(C(CO)C(CO)O)=O)=O,8,4,0,4,27,0.00021400000000000002
G5,C(C(C(CO)(CC(C=C)=O)O)O)=O,4,3,0,3,27,0.000156
G5,C(C(C(C=C)(CC(CO)=O)O)O)=O,4,5,0,5,27,0.000262
G5,C(C(C(CO)O)O)(CC(C=C)=O)=O,4,4,0,4,27,0.00021400000000000002
G5,C(CO)(C(C(C=C)=O)C(CO)O)=O,4,3,0,3,27,0.000156
G5,C(C(C(C(C=C)=O)(CCO)O)O)=O,4,4,0,4,45,0.00021400000000000002
G5,C(CCO)(C(C=C)(C(C=O)O)O)=O,4,7,0,7,45,0.00037
G5,C=CC(C(C(CO)C(CO)O)=O)=O,4,3,0,3,45,0.000156
G5,C(C(C(CO)(CC=CC=O)O)O)=O,8,3,0,3,27,0.000156
G5,C(C(C(C=CCC(CO)=O)O)O)=O,8,3,0,3,27,0.000156
G5,C(C(C(CO)O)O)(CC=CC=O)=O,8,8,0,8,27,0.000437
G5,C(CO)(C(C=CC=O)C(CO)O)=O,8,3,0,3,29,0.000166
G5,C(C(C(C(CC=CCO)=O)O)O)=O,8,3,0,3,27,0.000156
G5,C(C(C(C=O)(CC=CCO)O)O)=O,8,3,0,3,27,0.000156
G5,C(C(C(C=O)=O)C(CO)O)=CCO,8,3,0,3,29,0.000166
G5,C(CC(C(C)(C(C=O)O)O)O)(O)=O,8,3,0,3,27,0.000156
G5,C(CC(C(CC(CO)O)=O)O)(O)=O,4,2,0,2,0,0.00010700000000000001
G5,C(C(C=C)(C(C=O)O)O)(O)=O,4,6,0,6,7,0.000298
G5,C(C(C1(COCC1(CO)O)O)O)=O,8,2,0,2,10,9.7e-05
G5,C(C(C1(C(CO)(O)OCC1)O)O)=O,8,2,0,2,34,9.7e-05
G5,C(C(C(C(C)(C(C)O)O)O)O)=O,16,2,0,2,18,9.7e-05
G5,C(C(C1(C(CCC(C1)=O)=O)O)O)=O,4,2,0,2,45,9.7e-05
G5,C1(CCC(C(C1)=O)(C(C=O)O)O)=O,4,3,0,3,45,0.000144
G5,C(C(C1(CCC(C(C1)=O)=O)O)O)=O,4,3,0,3,45,0.000144
G5,C1(CCC(C(C1C(CO)O)=O)=O)=O,4,2,0,2,45,9.7e-05
G5,C1(CC(C(C(C1)=O)=O)C(CO)O)=O,4,1,0,1,45,4.8e-05
G5,C1(C(C(CO)O)CC(C(C1)=O)=O)=O,4,1,0,1,45,4.8e-05
G5,C(C(C(C1C(C(CC1)=O)=O)O)O)=O,8,3,0,3,45,0.000144
G5,C1(C(CCC1C=O)(C(C=O)O)O)=O,8,2,0,2,45,9.7e-05
G5,C(C(C1(C(CCC1C=O)=O)O)O)=O,8,3,0,3,45,0.000144
G5,C(C1C(C(C(C1)C(CO)O)=O)=O)=O,8,1,0,1,45,4.8e-05
G5,C1(CC(C(C=O)O)(CC(C1)=O)O)=O,2,2,0,2,45,9.7e-05
G5,C1(CC(CC(C1C(CO)O)=O)=O)=O,2,2,0,2,45,9.7e-05
G5,C(C(C1(C(C=O)CC(C1)=O)O)O)=O,8,3,0,3,45,0.000144
G5,C1(CC(CC1C=O)(C(C=O)O)O)=O,8,2,0,2,45,9.7e-05
G5,C(C(C(C1C(CC(C1)=O)=O)O)O)=O,8,2,0,2,45,9.7e-05
G5,C1(C(C=O)CC(C1C(CO)O)=O)=O,8,2,0,2,45,9.7e-05
G5,C1(C(C=O)C(C(C1)=O)C(CO)O)=O,8,1,0,1,45,4.8e-05
G5,C1(CC(C=O)CC1(C(C=O)O)O)=O,8,3,0,3,45,0.000144
G5,C(C(C(C1CC(C(C1)=O)=O)O)O)=O,4,3,0,3,45,0.000144
G5,C(C1CC(C(C1C(CO)O)=O)=O)=O,8,2,0,2,0,9.6e-05
G5,C1(CCC(C(C=O)O)(C1C=O)O)=O,8,2,0,2,45,9.7e-05
G5,C(C(C(C1C(CCC1=O)=O)O)O)=O,4,2,0,2,45,9.7e-05
G5,C1(C(C(CO)O)CC(C1C=O)=O)=O,8,1,0,1,45,4.8e-05
G5,C(C(C1(C(C(C=CC1)=O)O)O)O)=O,8,2,0,2,32,9.7e-05
G5,C(C(C1(C=CCC(C1O)=O)O)O)=O,8,2,0,2,32,9.7e-05
G5,C1(C(C(C=CC1C(CO)O)=O)O)=O,8,1,0,1,32,4.8e-05
G5,C(C(C1(C(C=CC(C1)=O)O)O)O)=O,8,2,0,2,45,9.7e-05
G5,C(C(C1(C=CC(C(C1)=O)O)O)O)=O,8,2,0,2,45,9.7e-05
G5,C1(C(C=CC(C1C(CO)O)=O)O)=O,8,2,0,2,45,9.7e-05
G5,C(CO)(C(CC)(C(C=O)O)O)=O,4,3,0,3,42,0.000155
G5,C(C(CO)(C(C=O)O)O)(CC)=O,4,3,0,3,42,0.000144
G5,C(C(C(C(CO)O)O)=O)(CC)=O,4,3,0,3,42,0.000144
G5,C(C(CO)CC(C(C=O)O)O)=O,8,7,0,7,29,0.00036899999999999997
G5,C(C(C(CO)O)C(C=O)CO)=O,8,8,0,8,29,0.000405
G5,C(C(C)CC(C(C(C=O)O)O)=O)=O,8,4,0,4,28,0.000193
G5,C(C(C)CC(C=O)(C(C=O)O)O)=O,8,2,0,2,28,9.7e-05
G5,C(C(C(C(C)CC(C=O)=O)O)O)=O,8,3,0,3,28,0.000145
G5,C(C(C)C(C(C=O)=O)C(CO)O)=O,8,2,0,2,45,9.6e-05
G5,C(C)(CC(C(C)(C(C=O)O)O)=O)=O,4,2,0,2,14,9.7e-05
G5,C(C)(C(C(C(C)=O)=O)C(CO)O)=O,4,2,0,2,14,9.7e-05
G5,C(C)(CC(C(CC(CO)O)=O)=O)=O,2,2,0,2,26,0.00010700000000000001
G5,C(CC(CO)O)(CC(C(C)=O)=O)=O,2,2,0,2,21,0.00010700000000000001
G5,C(C(C(C(C(C(C)=O)=O)C)O)O)=O,8,3,0,3,45,0.000145
G5,C(C(C)(C(C=O)O)O)(C(C=O)C)=O,8,2,0,2,45,9.7e-05
G5,C(C(C(C(C)=O)(C(C=O)C)O)O)=O,8,3,0,3,45,0.000145
G5,C(C(C(C(CC(CO)O)=O)=O)C)=O,4,1,0,1,45,4.8e-05
G5,C(C(C(CC(C(CC)=O)=O)O)O)=O,4,6,0,6,27,0.00032
G5,C(CC(C(CC)=O)(C(C=O)O)O)=O,4,3,0,3,27,0.000146
G5,C(C(CC)(C(C=O)O)O)(CC=O)=O,4,3,0,3,27,0.000155
G5,C(C(C(C(CC)=O)=O)C(CO)O)=O,4,2,0,2,27,9.7e-05
G5,C(CC(C(C(C)C(CO)O)=O)=O)=O,4,2,0,2,29,0.00010700000000000001
G5,C(C)(C(CCC=O)(C(C=O)O)O)=O,4,3,0,3,46,0.000144
G5,C(CCC=O)(C(C)(C(C=O)O)O)=O,4,2,0,2,46,9.7e-05
G5,C(C(C(CCC(C(C)=O)=O)O)O)=O,4,4,0,4,46,0.00021400000000000002
G5,C(CCC(C(CC(CO)O)=O)=O)=O,2,4,0,4,29,0.00022400000000000002
G5,C(CC(C(C(C(C=O)O)O)=O)C)=O,8,6,0,6,0,0.00031
G5,C(CC(C)C(C=O)(C(C=O)O)O)=O,8,3,0,3,45,0.000144
G5,C(C(C(CC(C(C=O)=O)C)O)O)=O,8,2,0,2,45,9.7e-05
G5,C(C(C(CO)O)C(C(C=O)=O)C)=O,8,1,0,1,45,4.8e-05
G5,C(CC(C)C(CO)(C(C=O)O)O)=O,8,3,0,3,0,0.000144
G5,C(C(C(CC(C(CO)=O)C)O)O)=O,8,2,0,2,0,9.7e-05
G5,C(C(C)CC=O)(C(C(CO)O)O)=O,8,2,0,2,0,9.7e-05
G5,C(C(C(CO)O)C(C(CO)=O)C)=O,8,1,0,1,0,4.8e-05
G5,C(C(CC)(C(C=O)O)O)(CCO)=O,4,2,0,2,27,9.7e-05
G5,C(C(CCO)(C(C=O)O)O)(CC)=O,4,2,0,2,27,9.7e-05
G5,C(C(CCO)=O)(C(C)C(CO)O)=O,4,2,0,2,28,9.8e-05
G5,C(C(CC)=O)(C(CO)C(CO)O)=O,4,2,0,2,27,9.7e-05
G5,C(CC(C)(C(C=O)O)O)(CCO)=O,4,4,0,4,27,0.00020299999999999997
G5,C(CCO)(C(C(C)=O)C(CO)O)=O,4,2,0,2,27,9.7e-05
G5,C(C(CO)C(CO)O)(CC(C)=O)=O,4,2,0,2,27,9.7e-05
G5,C(CC(CO)O)(CC(CCO)=O)=O,2,1,0,1,27,4.8e-05
G5,C(C(CCO)CC(C(C=O)O)O)=O,8,4,0,4,46,0.00021400000000000002
G5,C(C(C(CO)O)C(C=O)CCO)=O,8,4,0,4,46,0.00020299999999999997
G5,C(C(C)CC(CO)(C(C=O)O)O)=O,8,2,0,2,28,9.7e-05
G5,C(C(C(C(C)CC(CO)=O)O)O)=O,8,3,0,3,28,0.000145
G5,C(C(C)C(C(CO)=O)C(CO)O)=O,8,2,0,2,28,9.6e-05
G5,C(C(C)CC(C(C(CO)O)O)=O)=O,8,2,0,2,28,9.7e-05
G5,C(C(C)(C(C=O)O)O)(C(CO)C)=O,8,2,0,2,27,9.7e-05
G5,C(C)(C(C(CO)C)(C(C=O)O)O)=O,8,2,0,2,27,9.7e-05
G5,C(C(CC(CO)O)=O)(C(C)CO)=O,4,1,0,1,27,4.8e-05
G5,C(C(C)C(C(C)(C(C=O)O)O)O)=O,16,2,0,2,27,9.7e-05
G5,C(C(C(C(C)C(C(C)=O)O)O)O)=O,16,2,0,2,27,9.7e-05
G5,C(C(C)C(C(CC(CO)O)=O)O)=O,8,1,0,1,27,4.8e-05
G5,C(C(C)(C(C=O)O)O)(CC)=O,4,3,0,3,28,0.000144
G5,C(C)(C(CC)(C(C=O)O)O)=O,4,2,0,2,28,9.7e-05
G5,C(C(CC)=O)(CC(CO)O)=O,2,3,0,3,29,0.000155
G5,C(C(C(C)(CC(C)=O)O)O)=O,4,4,0,4,28,0.000192
G5,C(CC(CO)O)(CC(C)=O)=O,2,4,0,4,29,0.000202
G5,C(C)(C(C(C)=O)C(CO)O)=O,2,4,0,4,28,0.00020299999999999997
G5,C(CC(C)C(C(C=O)O)O)=O,8,3,0,3,28,0.000145
G5,C(C(C)CC(C(C=O)O)O)=O,8,3,0,3,28,0.000144
G5,C(C(C(CO)O)C(C=O)C)=O,8,4,0,4,29,0.000202
G5,C(C(C(C=O)O)O)(C(CO)C)=O,8,5,0,5,28,0.000261
G5,C(C(C(CO)C)(C(C=O)O)O)=O,8,4,0,4,28,0.00021400000000000002
G5,C(C(C)C(C(C(C=O)O)O)O)=O,16,5,0,5,49,0.000261
G5,C(C(C(C(C)C(C=O)O)O)O)=O,16,3,0,3,49,0.000155
G5,C(C(C(C=O)O)O)(CC)=O,4,4,0,4,28,0.00020299999999999997
G5,C(C(CC)(C(C=O)O)O)=O,4,3,0,3,28,0.000155
G5,C(C(C(C=C)(C(C(C)=O)O)O)O)=O,8,6,0,6,9,0.00031
G5,C(CC(CO)O)(C(C(C=C)=O)O)=O,4,2,0,2,7,0.00010700000000000001
G5,C(C(C(C)(C(C=CC=O)O)O)O)=O,16,3,0,3,45,0.000144
G5,C(C(C(C=CC(C(C)=O)O)O)O)=O,16,2,0,2,45,9.7e-05
G5,C(CC(CO)O)(C(C=CC=O)O)=O,8,4,0,4,29,0.00022400000000000002
G5,C(C(C1(C=CC(C1CO)=O)O)O)=O,8,2,0,2,45,9.7e-05
G5,C(C(C(C(C(C)=O)C(C)=O)O)O)=O,4,6,0,6,6,0.000309
G5,C(CC(CO)O)(C(C=O)C(C)=O)=O,4,4,0,4,29,0.00022400000000000002
G5,C(C(C=O)C(C=O)(C(C=O)O)O)=O,4,5,0,5,23,0.000241
G5,C(C(C=O)C(C(C(C=O)O)O)=O)=O,4,4,0,4,23,0.000193
G5,C(C(C(C)(C(C(C)=O)CO)O)O)=O,8,5,0,5,28,0.000251
G5,C(CC(CO)O)(C(C(C)=O)CO)=O,4,1,0,1,28,4.8e-05
G5,C(C(C(C(C(C(O)=O)=O)C)O)O)=O,8,4,0,4,27,0.00020299999999999997
G5,C(C(C(C(O)=O)(C(C=O)C)O)O)=O,8,4,0,4,27,0.000204
G5,C(C(C=O)C(C=O)C(CO)O)=O,4,4,0,4,29,0.000202
G5,C(C(C(C)C(C(C=O)O)O)O)(O)=O,16,4,0,4,49,0.00021400000000000002
G5,C(C(C(CO)C)(C(C=O)O)O)(O)=O,8,2,0,2,28,9.7e-05
G5,C(C)(C(C(C(C=O)O)O)CC=O)=O,8,6,0,6,45,0.00032
G5,C(C(C(CC(C=O)C(C)=O)O)O)=O,8,4,0,4,45,0.00021400000000000002
G5,C(C(C(CO)O)C(C=O)C(C)=O)=O,8,2,0,2,29,0.00010700000000000001
G5,C(CC(CO)O)(C(C=O)CC=O)=O,4,1,0,1,45,4.8e-05
G5,C(C(CC)(C(C=O)O)O)(O)=O,4,3,0,3,28,0.000155
G5,C(C(C1(C=C(C(C1)=O)CO)O)O)=O,4,2,0,2,45,9.7e-05
G5,C(C(C1(C(CO)=CC(C1)=O)O)O)=O,4,2,0,2,45,9.7e-05
G5,C1(C=C(C(C1C(CO)O)=O)CO)=O,4,2,0,2,45,9.7e-05
G5,C(C(C1(C(C(CO)=CC1)=O)O)O)=O,4,2,0,2,45,9.7e-05
G5,C1(CC=C(CO)C1(C(C=O)O)O)=O,4,2,0,2,45,9.7e-05
G5,C1C(C(C(C=1CO)=O)=O)C(CO)O,4,1,0,1,45,4.8e-05
G5,C(C(C1(C(C(C(C1)O)=O)=C)O)O)=O,8,2,0,2,45,9.7e-05
G5,C(C(C1(C(C(CC1O)=O)=C)O)O)=O,8,2,0,2,45,9.7e-05
G5,C=C1C(C(C(CO)O)C(C1=O)O)=O,8,2,0,2,45,9.7e-05
G5,C(C(C1(C(C(C(C1)=C)=O)O)O)O)=O,8,2,0,2,47,9.7e-05
G5,C(C(C1(C(CC(C1O)=O)=C)O)O)=O,8,2,0,2,47,9.7e-05
G5,C1(C(C(C(C1C(CO)O)=C)=O)O)=O,8,1,0,1,47,4.8e-05
G5,C(C(C1(C(C(C(C1)=O)=C)O)O)O)=O,8,2,0,2,45,9.7e-05
G5,C(C(C1(C(C(C(C1)=O)O)=C)O)O)=O,8,2,0,2,45,9.7e-05
G5,C1(C(C(C(C1C(CO)O)=O)=C)O)=O,8,2,0,2,45,9.7e-05
G5,C(C(C1(C(C(C(C1)O)=C)=O)O)O)=O,8,2,0,2,45,9.7e-05
G5,C(C(C1(C(CC(C1=C)O)=O)O)O)=O,8,2,0,2,45,9.7e-05
G5,C=C1C(C(C(C(CO)O)C1O)=O)=O,8,2,0,2,45,9.7e-05
G5,C(C(C1(C=C(C=O)C(C1)O)O)O)=O,8,2,0,2,45,9.7e-05
G5,C(C(C(C1C(CC(C=1)=O)O)O)O)=O,8,2,0,2,45,9.7e-05
G5,C1(C=C(C=O)C(C1C(CO)O)O)=O,8,2,0,2,45,9.7e-05
G5,C(C(C1(C(C(C=O)=CC1)O)O)O)=O,8,2,0,2,27,9.7e-05
G5,C1(C(C(C(C(C=O)O)O)=CC1)O)=O,8,2,0,2,27,9.7e-05
G5,C1(C(C(C=O)=CC1C(CO)O)O)=O,8,1,0,1,27,4.8e-05
G5,C(C(C1(C(C=C(C=O)C1)O)O)O)=O,8,2,0,2,45,9.7e-05
G5,C1(C(C=C(C(C(C=O)O)O)C1)O)=O,8,2,0,2,45,9.7e-05
G5,C1(C(C=C(C=O)C1C(CO)O)O)=O,8,1,0,1,45,4.8e-05
G5,C(C(C1(C(C=O)=CC(C1)O)O)O)=O,8,2,0,2,45,9.7e-05
G5,C(C(C(C1C(CC(C=1)O)=O)O)O)=O,8,2,0,2,45,9.7e-05
G5,C1C(C(C(C=1C=O)=O)C(CO)O)O,8,2,0,2,45,9.7e-05
G5,C(C(C(C(CC(C=C)O)=O)O)O)=O,8,3,0,3,27,0.000144
G5,C(C(CC(C=C)O)(C(C=O)O)O)=O,8,2,0,2,27,9.7e-05
G5,C=CC(C(C(C=O)=O)C(CO)O)O,8,4,0,4,0,0.000192
G5,C(CC(C(C=O)O)O)(C(C=C)O)=O,8,6,0,6,27,0.00032
G5,C(C(C(C(C=C)O)=O)C(CO)O)=O,8,3,0,3,27,0.000144
G5,C(C(C(C(C(CC=C)=O)O)O)O)=O,8,8,0,8,4,0.000426
G5,C(C(C(C(C=O)O)(CC=C)O)O)=O,3,2,0,2,4,9.7e-05
G5,C(C(C=O)O)(C(C=C)C(CO)O)=O,8,3,0,3,29,0.000165
G5,C(C(C(C(CC(C=C)=O)O)O)O)=O,8,2,0,2,27,9.7e-05
G5,C(C(CC(C=C)(C(C=O)O)O)O)=O,8,2,0,2,27,9.7e-05
G5,C(C(C(C(C=C)=O)C(CO)O)O)=O,8,3,0,3,27,0.000155
G5,C1(C(C=CC1C(C(C=O)O)O)O)=O,16,2,0,2,45,9.7e-05
G5,C(C1C=CC(C1(C(C=O)O)O)O)=O,16,2,0,2,45,9.7e-05
G5,C1(CC=CC1(C(C(C=O)O)O)O)=O,8,2,0,2,45,9.7e-05
G5,C(C1(C=CCC1(C(C=O)O)O)O)=O,8,2,0,2,45,9.7e-05
G5,C(C1(C(C(C=C1)C(CO)O)=O)O)=O,8,1,0,1,45,4.8e-05
G5,C(C(C(C)(C1C=CC(O1)=O)O)O)=O,8,2,0,2,48,9.7e-05
G5,C(CC(CO)O)(C1C=CC(O1)=O)=O,4,1,0,1,48,4.8e-05
G5,C(C(C(CC1C=CC(O1)=O)O)O)=O,8,2,0,2,48,9.7e-05
G5,C(C(C(CO)O)C1C=CC(O1)=O)=O,8,2,0,2,48,9.7e-05
G5,C(C(C1(C=COC1C(C)=O)O)O)=O,8,2,0,2,9,9.7e-05
G5,C(C(C(C)(C1C(C=CO1)=O)O)O)=O,8,4,0,4,9,0.000192
G5,C(CC(CO)O)(C1C(C=CO1)=O)=O,4,1,0,1,9,4.8e-05
G5,C(CC1C(C=CO1)(C(C=O)O)O)=O,8,2,0,2,45,9.7e-05
G5,C(C(C(CC1C(C=CO1)=O)O)O)=O,8,2,0,2,45,9.7e-05
G5,C(C(C(CO)O)C1C(C=CO1)=O)=O,8,2,0,2,45,9.7e-05
G5,C(C(C1(C=CC(OCC1)=O)O)O)=O,4,2,0,2,19,9.7e-05
G5,C1(C=CC(C(CO1)C(CO)O)=O)=O,4,2,0,2,19,9.7e-05
G5,C(C(C1(COC(C=CC1)=O)O)O)=O,4,2,0,2,48,9.7e-05
G5,C1(COC(C=CC1C(CO)O)=O)=O,4,1,0,1,48,4.8e-05
G5,C1(C(C(CO)O)OC(C=CC1)=O)=O,4,2,0,2,48,9.7e-05
G5,C1(CCOC=CC1(C(C=O)O)O)=O,4,2,0,2,45,9.7e-05
G5,C(C(C1(C(C=COCC1)=O)O)O)=O,4,2,0,2,45,9.7e-05
G5,C1OCC(C(C(C=1)=O)=O)C(CO)O,4,2,0,2,45,9.7e-05
G5,C(C(C1(C=COCC(C1)=O)O)O)=O,4,2,0,2,38,9.7e-05
G5,C(C(C1(COC=CC(C1)=O)O)O)=O,4,2,0,2,38,9.7e-05
G5,C1(COC=CC(C1C(CO)O)=O)=O,4,2,0,2,38,9.7e-05
G5,C1(C(C(CO)O)OC=CC(C1)=O)=O,4,2,0,2,38,9.7e-05
G5,C1(CC(C=CCO1)(C(C=O)O)O)=O,4,2,0,2,19,9.7e-05
G5,C1(C(C(C=CCO1)=O)C(CO)O)=O,4,2,0,2,19,9.7e-05
G5,C(C(C1(C(C=CCOC1)=O)O)O)=O,4,2,0,2,36,9.7e-05
G5,C(C(C1(C(COCC=C1)=O)O)O)=O,4,2,0,2,36,9.7e-05
G5,C1COC(C(C(C=1)=O)=O)C(CO)O,4,2,0,2,36,9.7e-05
G5,C1(CC=CC(CO1)(C(C=O)O)O)=O,4,2,0,2,48,9.7e-05
G5,C1(CC=CC(C(C(CO)O)O1)=O)=O,4,2,0,2,48,9.7e-05
G5,C(C(C1(C=CC(COC1)=O)O)O)=O,4,2,0,2,45,9.7e-05
G5,C1(C=CC(COC1C(CO)O)=O)=O,4,2,0,2,45,9.7e-05
G5,C(C(C(C=C1C(CCO1)=O)O)O)=O,8,2,0,2,45,9.7e-05
G5,C(C(C1(C(OCC1)=CC=O)O)O)=O,8,2,0,2,45,9.7e-05
G5,C(C=C1C(C(CO1)C(CO)O)=O)=O,8,2,0,2,45,9.7e-05
G5,C(C(C(C=C1CC(CO1)=O)O)O)=O,8,2,0,2,45,9.7e-05
G5,C(C(C1(COC(C1)=CC=O)O)O)=O,8,2,0,2,45,9.7e-05
G5,C1(COC(C1C(CO)O)=CC=O)=O,8,2,0,2,45,9.7e-05
G5,C1(C(C(CO)O)OC(C1)=CC=O)=O,8,2,0,2,45,9.7e-05
G5,C(C(C(C(C1C=CCO1)=O)O)O)=O,8,2,0,2,39,9.7e-05
G5,C(C(C(C=O)(C1C=CCO1)O)O)=O,8,2,0,2,39,9.7e-05
G5,C(C1C=CC(C(C(C=O)O)O)O1)=O,16,2,0,2,40,9.7e-05
G5,C(C(C(C1C(CC(O1)=C)=O)O)O)=O,8,2,0,2,26,9.7e-05
G5,C(C(C1(C(C=O)OC(C1)=C)O)O)=O,8,2,0,2,26,9.7e-05
G5,C1(C(C=O)OC(C1C(CO)O)=C)=O,8,2,0,2,26,9.7e-05
G5,C(C(C(C1CC(C(O1)=C)=O)O)O)=O,8,2,0,2,14,9.7e-05
G5,C(C1CC(C(O1)=C)(C(C=O)O)O)=O,8,2,0,2,14,9.7e-05
G5,C(C1C(C(C(O1)=C)=O)C(CO)O)=O,8,2,0,2,14,9.7e-05
G5,C(C(C(C1OCCC(C=1)=O)O)O)=O,4,2,0,2,30,9.7e-05
G5,C(C(C1(C=C(C=O)OCC1)O)O)=O,4,2,0,2,30,9.7e-05
G5,C(C1OCC(C(C=1)=O)C(CO)O)=O,4,2,0,2,30,9.7e-05
G5,C(C(C(C1OCC(CC=1)=O)O)O)=O,4,2,0,2,12,9.7e-05
G5,C(C(C1(COC(C=O)=CC1)O)O)=O,4,2,0,2,12,9.7e-05
G5,C1(COC(C=O)=CC1C(CO)O)=O,4,1,0,1,12,4.8e-05
G5,C1(C(C(CO)O)OC(C=O)=CC1)=O,4,2,0,2,12,9.7e-05
G5,C(C(C(C1C(CC=CO1)=O)O)O)=O,8,2,0,2,37,9.7e-05
G5,C(C(C1(C(C=O)OC=CC1)O)O)=O,8,2,0,2,37,9.7e-05
G5,C1(C(C=O)OC=CC1C(CO)O)=O,8,1,0,1,37,4.8e-05
G5,C(C(C(C1CC(C=CO1)=O)O)O)=O,8,2,0,2,37,9.7e-05
G5,C(C1CC(C=CO1)(C(C=O)O)O)=O,8,2,0,2,37,9.7e-05
G5,C(C1C(C(C=CO1)=O)C(CO)O)=O,8,2,0,2,37,9.7e-05
G5,C(C(C(C1CC(C(C=1)=O)O)O)O)=O,8,2,0,2,45,9.7e-05
G5,C(C(C1(C=C(C=O)CC1O)O)O)=O,8,2,0,2,45,9.7e-05
G5,C1(C(C=CC1CO)(C(C=O)O)O)=O,8,2,0,2,45,9.7e-05
G5,C(C(C1(C(C=CC1CO)=O)O)O)=O,8,2,0,2,45,9.7e-05
G5,C(C(C(C1C(C(CC=1)O)=O)O)O)=O,8,2,0,2,27,9.7e-05
G5,C(C(C1(C(C=O)=CCC1O)O)O)=O,8,2,0,2,27,9.7e-05
G5,C(C(C(CO)(C(C=C)O)O)O)=O,8,3,0,3,31,0.000144
G5,C(C(C(CO)O)O)(C(C=C)O)=O,8,5,0,5,31,0.000239
G5,C(C(C(C=C(CO)CO)O)O)=O,4,5,0,5,18,0.00025
G5,C(C(C(C=CC(CO)O)O)O)=O,16,3,0,3,46,0.000144
G5,C(C(C(C(C=C(C=O)C)=O)O)O)=O,8,4,0,4,45,0.000193
G5,C(C(C=C(C=O)C)(C(C=O)O)O)=O,8,2,0,2,45,9.7e-05
G5,C(C(C(C(C)=CC(C=O)=O)O)O)=O,8,2,0,2,45,9.7e-05
G5,C(C(C(C(CC(C=O)=C)=O)O)O)=O,4,4,0,4,45,0.000193
G5,C(C(C(C=O)(CC(C=O)=C)O)O)=O,4,2,0,2,45,9.7e-05
G5,C(C(C(C(CC(C=O)=O)=C)O)O)=O,4,2,0,2,45,9.7e-05
G5,C=C(C=O)C(C(C=O)=O)C(CO)O,4,1,0,1,45,4.8e-05
G5,C(C(C=CC=O)(C(C=O)O)O)=O,8,5,0,5,20,0.00023999999999999998
G5,C(C(C(C(C=C(C)CO)=O)O)O)=O,8,4,0,4,49,0.000193
G5,C(C(C=C(CO)C)(C(C=O)O)O)=O,8,2,0,2,49,9.7e-05
G5,C(C(C(C(CC(CO)=C)=O)O)O)=O,4,4,0,4,49,0.000193
G5,C(C(C(C=O)(CC(CO)=C)O)O)=O,4,2,0,2,49,9.7e-05
G5,C=C(CO)C(C(C=O)=O)C(CO)O,4,1,0,1,49,4.8e-05
G5,C(C(C(C(CC(CO)=O)=C)O)O)=O,4,2,0,2,16,9.7e-05
G5,C(C(C(CO)(CC(C=O)=C)O)O)=O,4,2,0,2,16,9.7e-05
G5,C(CO)(C(C(C=O)=C)C(CO)O)=O,4,1,0,1,16,4.8e-05
G5,C(C(C(CO)O)O)(CC(C=O)=C)=O,4,2,0,2,16,9.7e-05
G5,C(C(C(C(C)=CC(CO)=O)O)O)=O,8,2,0,2,16,9.7e-05
G5,C(C(C(C=C(C=O)C)(CO)O)O)=O,8,2,0,2,16,9.7e-05
G5,C(C=C(C=O)C)(C(C(CO)O)O)=O,8,2,0,2,16,9.7e-05
G5,C(C(C(C(C(C(C)=O)O)=C)O)O)=O,8,2,0,2,45,9.7e-05
G5,C(C(C(C)(C(C(C=O)=C)O)O)O)=O,8,2,0,2,45,9.7e-05
G5,C(CC(CO)O)(C(C(C=O)=C)O)=O,4,1,0,1,45,4.8e-05
G5,C(C(C=CC)(C(C=O)O)O)=O,8,3,0,3,28,0.000144
G5,C(C(C(C=O)(CC=C)O)O)=O,4,3,0,3,28,0.000144
G5,C=CC(C(C=O)=O)C(CO)O,4,2,0,2,0,9.6e-05
G5,C(C(C(C=CC=O)(C)O)O)=O,8,4,0,4,28,0.000192
G5,C(C(C(C=CC(C)=O)O)O)=O,8,3,0,3,28,0.000144
G5,C(C=CC(CC(CO)O)=O)=O,4,2,0,2,0,9.6e-05
G5,C(C(C(CC(C=O)=C)O)O)=O,4,3,0,3,28,0.000144
G5,C(C(C(C=O)=C)C(CO)O)=O,4,3,0,3,29,0.000155
G5,C(C(C(C=C(C=O)C)O)O)=O,8,3,0,3,28,0.000144
G5,C(C(C(C(C=O)=C)(CO)O)O)=O,4,8,0,8,29,0.00041500000000000006
G5,C(C(C(C(C(CO)=O)=CC)O)O)=O,8,4,0,4,45,0.00021400000000000002
G5,C(C(C(C(C=O)=CC)(CO)O)O)=O,8,2,0,2,45,9.7e-05
G5,C(C)=C(C(C(C(CO)O)O)=O)C=O,8,6,0,6,45,0.000331
G5,C(C(C(C(C(CO)=O)C=C)O)O)=O,8,5,0,5,45,0.000262
G5,C(C(C=C)C(CO)(C(C=O)O)O)=O,8,3,0,3,45,0.000144
G5,C(C(C(C(C(CO)O)O)=O)C=C)=O,8,6,0,6,45,0.000331
G5,C(CC(CO)=CC(C(C=O)O)O)=O,8,4,0,4,46,0.00021400000000000002
G5,C(C(C(CC(CO)=CC=O)O)O)=O,8,5,0,5,46,0.000272
G5,C(C(C(CO)=CC=O)C(CO)O)=O,8,1,0,1,46,4.8e-05
G5,C(C(C(C=C)(C(C=O)O)O)O)=O,3,4,0,4,0,0.000192
G5,C(C(C(C(C(C=CC)=O)O)O)O)=O,16,8,0,8,28,0.000426
G5,C(C(C(C=CC)(C(C=O)O)O)O)=O,6,2,0,2,28,9.7e-05
G5,C(CC(C(C(C(C=O)O)O)O)=C)=O,8,6,0,6,6,0.000331
G5,C(C(C(CC(C(C=O)O)O)=C)O)=O,8,2,0,2,6,9.7e-05
G5,C(C(C(C(C=O)O)=C)C(CO)O)=O,8,1,0,1,6,4.8e-05
G5,C(C(C(C(C(C)=CC=O)O)O)O)=O,16,6,0,6,6,0.000331
G5,C(C(C(C)=CC(C(C=O)O)O)O)=O,16,2,0,2,6,9.7e-05
G5,C(C(C(C=CC)(C(CO)O)O)O)=O,16,2,0,2,28,9.7e-05
G5,C(C(C(C(CO)O)(CC=C)O)O)=O,8,2,0,2,28,9.7e-05
G5,C(C(CO)O)(C(C=C)C(CO)O)=O,8,1,0,1,28,4.8e-05
G5,C(C(C(CC(C(CO)O)=C)O)O)=O,8,2,0,2,27,9.7e-05
G5,C(C(C(C(CO)O)=C)C(CO)O)=O,8,1,0,1,27,4.8e-05
G5,C(C(C(C=C(C)C(CO)O)O)O)=O,16,2,0,2,46,9.7e-05
G5,C(C(C(C(CO)=C)(CO)O)O)=O,4,8,0,8,49,0.00041500000000000006
G5,C(C(C(C(CO)=CC=O)O)O)=O,8,8,0,8,29,0.00041500000000000006
G5,C(C(C(C(C(C(C)O)=C)=O)O)O)=O,8,7,0,7,4,0.000357
G5,C(C(C(C(C)O)=C)(C(C=O)O)O)=O,8,2,0,2,4,9.7e-05
G5,C(C(C(C(C(CO)=CC)=O)O)O)=O,8,6,0,6,27,0.00031
G5,C(C(C(CO)=CC)(C(C=O)O)O)=O,8,2,0,2,27,9.7e-05
G5,C(C(C(C(C(C=C)CO)=O)O)O)=O,8,7,0,7,28,0.000359
G5,C(C(C(C=O)(C(C=C)CO)O)O)=O,8,2,0,2,28,9.7e-05
G5,C(CC(C(C(C=O)O)O)=CCO)=O,8,4,0,4,3,0.00021400000000000002
G5,C(C(C(CC(C=O)=CCO)O)O)=O,8,2,0,2,3,9.7e-05
G5,C(C(C(C=O)=CCO)C(CO)O)=O,8,1,0,1,3,4.8e-05
G5,C(C(C(C(CCO)=CC=O)O)O)=O,8,5,0,5,46,0.000272
G5,C(C(C(C=C(C=O)CCO)O)O)=O,8,2,0,2,46,9.7e-05
G5,C(C(C(CCO)(C(C=C)O)O)O)=O,8,3,0,3,27,0.000156
G5,C(C(CO)C(CO)O)(C(C=C)O)=O,8,2,0,2,27,9.7e-05
G5,C(C(C(C(C(C)O)=C)(CO)O)O)=O,8,2,0,2,4,9.7e-05
G5,C=C(C(C(C(CO)O)O)=O)C(C)O,8,2,0,2,4,9.7e-05
G5,C(C(C(C(CO)=CC)(CO)O)O)=O,8,2,0,2,27,9.7e-05
G5,C(C)=C(C(C(C(CO)O)O)=O)CO,8,2,0,2,27,9.7e-05
G5,C(C(C(CO)(C(C=C)CO)O)O)=O,8,2,0,2,28,9.7e-05
G5,C(C(C(CO)O)O)(C(C=C)CO)=O,8,2,0,2,28,9.7e-05
G5,C(C(C(CC(CO)=CCO)O)O)=O,8,2,0,2,3,9.7e-05
G5,C(C(C(CO)=CCO)C(CO)O)=O,8,1,0,1,3,4.8e-05
G5,C(C(C(C=C(CO)CCO)O)O)=O,8,2,0,2,46,9.7e-05
G5,C(C(C(C=C(CO)C)(CO)O)O)=O,8,2,0,2,49,9.7e-05
G5,C(CO)(C)=CC(C(C(CO)O)O)=O,8,2,0,2,49,9.7e-05
G5,C(C(C(CO)(CC(CO)=C)O)O)=O,4,2,0,2,49,9.7e-05
G5,C(CO)(C(C(CO)=C)C(CO)O)=O,4,1,0,1,49,4.8e-05
G5,C(C(C(CO)O)O)(CC(CO)=C)=O,4,2,0,2,49,9.7e-05
G5,C(C(C(C)(C(C(CO)=C)O)O)O)=O,8,2,0,2,49,9.7e-05
G5,C(CC(CO)O)(C(C(CO)=C)O)=O,4,1,0,1,49,4.8e-05
G5,C(C(C(C=CC)(CO)O)O)=O,8,3,0,3,28,0.000144
G5,C(C)=CC(C(C(CO)O)O)=O,8,4,0,4,28,0.00020299999999999997
G5,C(C(C(CO)(CC=C)O)O)=O,4,3,0,3,28,0.000144
G5,C(CO)(C(C=C)C(CO)O)=O,4,3,0,3,0,0.000155
G5,C(C(C(CO)O)O)(CC=C)=O,4,5,0,5,28,0.00025
G5,C(C(C(C)(C(C=C)O)O)O)=O,8,3,0,3,28,0.000144
G5,C(CC(CO)O)(C(C=C)O)=O,4,3,0,3,0,0.000155
G5,C(C(C(CC(CO)=C)O)O)=O,4,3,0,3,28,0.000144
G5,C(C(C(CO)=C)C(CO)O)=O,4,3,0,3,49,0.000155
G5,C(C(C(C=C(C)CO)O)O)=O,8,3,0,3,28,0.000144
G5,C(C(C(C=C(C=O)C(C)O)O)O)=O,16,4,0,4,28,0.00021400000000000002
G5,C(C(C(C(C(C)O)=CC=O)O)O)=O,16,4,0,4,28,0.00021400000000000002
G5,C(C(C(C(C(C=O)=CC)O)O)O)=O,16,6,0,6,45,0.000331
G5,C(C(C(C(C(C=O)O)O)=CC)O)=O,16,3,0,3,45,0.000155
G5,C(C(C=C)C(C(C(C=O)O)O)O)=O,16,7,0,7,45,0.000379
G5,C(C(C(C(C=C)C(C=O)O)O)O)=O,16,4,0,4,45,0.00021400000000000002
G5,C(CC=CC(C(C(C=O)O)O)O)=O,16,6,0,6,43,0.000331
G5,C(C(C=CCC(C(C=O)O)O)O)=O,16,2,0,2,43,9.7e-05
G5,C(C(C=CC(C=O)O)C(CO)O)=O,16,2,0,2,29,0.00010700000000000001
G5,C(C(C(C(CC=CC=O)O)O)O)=O,16,7,0,7,27,0.000389
G5,C(C(C(C=CCC(C=O)O)O)O)=O,16,3,0,3,27,0.000155
G5,C(C(C(C=CC)O)O)=O,8,3,0,3,45,0.000144
G5,C(C(C(CC=C)O)O)=O,4,3,0,3,45,0.000144
G5,C(C(C=C)C(CO)O)=O,4,3,0,3,29,0.000155
G5,C(C(C(C(C(CO)=C)O)O)O)=O,8,7,0,7,29,0.000367
G5,C(C(C(C(C=C)(CO)O)O)O)=O,8,6,0,6,29,0.000298
G5,C(C(C(C(C(C)=O)(C=C)O)O)O)=O,8,6,0,6,27,0.00032
G5,C(C(C=C)(C(C)(C(C=O)O)O)O)=O,8,4,0,4,27,0.000192
G5,C(C(C(CC(CO)O)=O)(C=C)O)=O,4,4,0,4,29,0.00022400000000000002
G5,C(C(C(C)(C(C=C)(CO)O)O)O)=O,8,3,0,3,27,0.000144
G5,C(CC(CO)O)(C(C=C)(CO)O)=O,4,1,0,1,27,4.8e-05
G5,C(C(C=C)(C(C(C=O)O)O)O)=O,8,7,0,7,28,0.00034500000000000004
G5,C(C(C(C(C(C=O)O)O)=C)O)(O)=O,8,5,0,5,29,0.000273
G5,C(C(C(CC1OCC(C=1)=O)O)O)=O,4,2,0,2,48,9.7e-05
G5,C(CC1OCC(C=1)(C(C=O)O)O)=O,4,2,0,2,48,9.7e-05
G5,C(C(C1OCC(C=1)=O)C(CO)O)=O,4,2,0,2,48,9.7e-05
G5,C(CC1OC(C(C=1)=O)C(CO)O)=O,4,2,0,2,48,9.7e-05
G5,C(C(C(C1C(C=C(C)O1)=O)O)O)=O,8,2,0,2,26,9.7e-05
G5,C(C1C(C=C(C)O1)(C(C=O)O)O)=O,8,2,0,2,26,9.7e-05
G5,C(C(C(C(C(C=C)O)O)O)O)=O,16,5,0,5,27,0.000261
G5,C(C(C1(C(OC(C=O)C1)O)O)O)=O,16,3,0,3,0,0.000144
G5,C1(C(OC(C=O)C1C(CO)O)O)=O,16,3,0,3,0,0.000144
G5,C(C(C1(C(O)OC(C)C1)O)O)=O,16,3,0,3,45,0.000144
G5,C1(C(O)OC(C)C1C(CO)O)=O,16,3,0,3,45,0.000144
G5,C(C(C(C1COC(C1O)O)O)O)=O,32,4,0,4,27,0.00020299999999999997
G5,C(C(C(C1C(CC(O)O1)O)O)O)=O,32,5,0,5,0,0.00025
G5,C(C(C1(COC(C)(C1O)O)O)O)=O,16,6,0,6,0,0.000309
G5,C1(C(C(CO)O)OC(C)(C1O)O)=O,16,3,0,3,0,0.000144
G5,C(C(C1(COC(C1O)O)O)O)=O,16,6,0,6,5,0.000309
G5,C(C(C(C1CC(C(O)O1)O)O)O)=O,32,5,0,5,27,0.00025
G5,C(C(C1(C(C)OC(C1O)O)O)O)=O,32,3,0,3,0,0.000144
G5,C(C(C(C1(COC(C1)O)O)O)O)=O,16,7,0,7,27,0.000367
G5,C(C(C1(C(COC(C1)O)O)O)O)=O,16,3,0,3,27,0.000144
G5,C1(C(COC(C1C(CO)O)O)O)=O,16,3,0,3,27,0.000144
G5,C(C(C1(C(C(O)OCC1)O)O)O)=O,16,3,0,3,27,0.000144
G5,C(C(CCCO)(C(C=O)O)O)=O,4,2,0,2,55,9.7e-05
G5,C(C(C(CCO)C(CO)O)=O)=O,4,3,0,3,0,0.000144
G5,C(C(CCCCO)(C(C=O)O)O)=O,4,2,0,2,46,9.7e-05
G5,C(C(C(CCCO)C(CO)O)=O)=O,4,2,0,2,0,9.6e-05
G5,C(C(CCC(C)O)(C(C=O)O)O)=O,8,2,0,2,27,9.7e-05
G5,C(C(C(CC(C)O)C(CO)O)=O)=O,8,2,0,2,0,9.6e-05
G5,C(C(C(CO)(CCCO)O)O)=O,4,2,0,2,55,9.7e-05
G5,C(CO)(C(C(CO)O)CCO)=O,4,4,0,4,29,0.000213
G5,C(C(C(CO)(CCCCO)O)O)=O,4,2,0,2,27,9.7e-05
G5,C(CO)(C(C(CO)O)CCCO)=O,4,2,0,2,0,9.6e-05
G5,C(C(C(CO)(CCC(C)O)O)O)=O,8,2,0,2,27,9.7e-05
G5,C(CO)(C(C(CO)O)CC(C)O)=O,8,2,0,2,0,9.6e-05
G5,C(C(C(C)O)CC(C(C=O)O)O)=O,16,5,0,5,27,0.000263
G5,C(C(C(CO)O)C(C=O)C(C)O)=O,16,5,0,5,28,0.000251
G5,C(C(C1(C=CC(C1O)=O)O)O)=O,8,3,0,3,47,0.000144
G5,C(CC=CC(C(C=O)O)O)=O,8,3,0,3,28,0.000144
G5,C(C(C(CC=CC=O)O)O)=O,8,3,0,3,28,0.000144
G5,C(C(C=CC=O)C(CO)O)=O,8,2,0,2,6,9.6e-05
G5,C(C)(CC(C(C(CO)O)O)O)=O,8,3,0,3,6,0.000165
G5,C(C(C=C)C(C(C(CO)O)O)O)=O,16,1,0,1,0,4.8e-05
G5,C(C(C(CC(CO)(CO)O)=O)=O)=O,1,1,0,1,25,4.8e-05
G5,C(CO)(C(C(C)(CCO)O)O)=O,4,4,0,4,5,0.000202
G5,C(CC(CO)(CO)O)(CCO)=O,1,4,0,4,29,0.000213
G5,C(C)(C(CO)C(CO)(CO)O)=O,2,3,0,3,5,0.000154
G5,C(CO)(C(C(C)(C)O)O)=O,2,2,0,2,5,9.6e-05
G5,C(C)(CC(CO)(CO)O)=O,1,1,0,1,5,4.8e-05
G5,C(OCC(C)(C(C(CO)=O)O)O)=O,4,2,0,2,35,9.6e-05
G5,C(OCC(CC(CO)(CO)O)=O)=O,1,3,0,3,5,0.000143
G5,C(OC(C(C)=O)C(CO)(CO)O)=O,2,3,0,3,35,0.000143
G5,C(OCC(C(C(CO)=O)O)O)=O,4,4,0,4,5,0.00019099999999999998
G5,C(OC(C=O)C(CO)(CO)O)=O,2,2,0,2,5,9.6e-05
G5,C(C)(OCC(C(C(CO)=O)O)O)=O,4,2,0,2,28,9.6e-05
G5,C(C(C(CO)(CO)O)OC(C)=O)=O,2,2,0,2,28,9.6e-05
G5,C(CCC(C(C(CO)=O)O)O)=O,4,5,0,5,27,0.00024900000000000004
G5,C(CO)(C(C(C=CCO)O)O)=O,8,5,0,5,28,0.00024900000000000004
G5,C(C(C(C(CO)(CO)O)O)=O)(O)=O,2,4,0,4,33,0.000202
G5,C(CC(C)(C(C(CO)=O)O)O)(O)=O,4,4,0,4,6,0.000202
G5,C(CC(CC(CO)(CO)O)=O)(O)=O,1,3,0,3,29,0.000165
G5,C(C(C(C)=O)C(CO)(CO)O)(O)=O,2,3,0,3,5,0.000154
G5,C(CO)(C(C(C=CC(O)=O)O)O)=O,8,3,0,3,18,0.000154
G5,C1(C(CCO1)(C(C(CO)=O)O)O)=O,4,3,0,3,5,0.000143
G5,C1(C(C(CO1)C(CO)(CO)O)=O)=O,2,2,0,2,28,9.6e-05
G5,C1(CC(CO1)(C(C(CO)=O)O)O)=O,4,2,0,2,28,9.6e-05
G5,C1(C(C(CO1)=O)C(CO)(CO)O)=O,2,2,0,2,28,9.6e-05
G5,C1(CC(C(C(CO)(CO)O)O1)=O)=O,2,2,0,2,28,9.6e-05
G5,C(CO)(C(C(C(C=C)O)O)O)=O,8,4,0,4,28,0.00019099999999999998
G5,C(C(C1(C=COC1)O)O)(CO)=O,4,3,0,3,5,0.000143
G5,C1OC(C(C=1)=O)C(CO)(CO)O,2,3,0,3,28,0.000143
G5,C(C(C=C)(C(C(CO)=O)O)O)(O)=O,4,4,0,4,7,0.000202
G5,C(C(C)(C(C(CO)=O)O)O)(CC)=O,4,2,0,2,28,9.6e-05
G5,C(C)(C(CC)(C(C(CO)=O)O)O)=O,4,2,0,2,28,9.6e-05
G5,C(C(CC)=O)(CC(CO)(CO)O)=O,1,1,0,1,28,4.8e-05
G5,C(C(C)=O)(C(C)C(CO)(CO)O)=O,2,1,0,1,28,4.8e-05
G5,C(C)(CC(C)(C(C(CO)=O)O)O)=O,4,3,0,3,28,0.000143
G5,C(CC(CO)(CO)O)(CC(C)=O)=O,1,1,0,1,28,4.8e-05
G5,C(C)(C(C(C)=O)C(CO)(CO)O)=O,1,2,0,2,28,9.6e-05
G5,C(CC(C)C(C(C(CO)=O)O)O)=O,8,3,0,3,28,0.000143
G5,C(C(C)CC(C(C(CO)=O)O)O)=O,8,2,0,2,28,9.6e-05
G5,C(C(C(CO)(CO)O)C(C=O)C)=O,4,2,0,2,28,9.499999999999999e-05
G5,C(C(C(C(CC)=O)O)O)(CO)=O,4,3,0,3,28,0.000143
G5,C(C(CC)(C(C(CO)=O)O)O)=O,4,2,0,2,28,9.6e-05
G5,C(C(C(C)C(CO)(CO)O)=O)=O,2,3,0,3,29,0.000154
G5,C(C(CC)(C(C(CO)=O)O)O)(O)=O,4,2,0,2,28,9.6e-05
G5,C(C(C(C)C(CO)(CO)O)=O)(O)=O,2,1,0,1,28,4.8e-05
G5,C(CO)(C(C(C(C=CC)=O)O)O)=O,8,4,0,4,28,0.00019099999999999998
G5,C(C(C=CC)(C(C(CO)=O)O)O)=O,8,2,0,2,28,9.6e-05
G5,C(C(C(C(CO)=O)O)O)(CC=C)=O,4,4,0,4,28,0.00019099999999999998
G5,C(C(CC=C)(C(C(CO)=O)O)O)=O,4,2,0,2,28,9.6e-05
G5,C=CC(C(C=O)=O)C(CO)(CO)O,2,1,0,1,28,4.8e-05
G5,C(C(C(C=CC=O)(C)O)O)(CO)=O,8,2,0,2,28,9.6e-05
G5,C(CO)(C(C(C=CC(C)=O)O)O)=O,8,2,0,2,28,9.6e-05
G5,C(C=CC(CC(CO)(CO)O)=O)=O,2,1,0,1,28,4.8e-05
G5,C(CC(C(C(C(CO)=O)O)O)=C)=O,4,2,0,2,28,9.6e-05
G5,C(CO)(C(C(CC(C=O)=C)O)O)=O,4,2,0,2,28,9.6e-05
G5,C(C(C(C=O)=C)C(CO)(CO)O)=O,2,1,0,1,28,4.8e-05
G5,C(CO)(C(C(C(C)=CC=O)O)O)=O,8,2,0,2,28,9.6e-05
G5,C(CO)(C(C(C=C(C=O)C)O)O)=O,8,2,0,2,28,9.6e-05
G5,C(C(C(C=CC)(CO)O)O)(CO)=O,8,2,0,2,28,9.6e-05
G5,C(C)=CC(C(C(CO)(CO)O)O)=O,4,2,0,2,28,9.6e-05
G5,C(CO)(C(C(CO)(CC=C)O)O)=O,4,2,0,2,28,9.6e-05
G5,C(CO)(C(C=C)C(CO)(CO)O)=O,2,1,0,1,28,4.8e-05
G5,C(C(C(CO)(CO)O)O)(CC=C)=O,2,2,0,2,28,9.6e-05
G5,C(CO)(C(C(C)(C(C=C)O)O)O)=O,8,2,0,2,28,9.6e-05
G5,C(CC(CO)(CO)O)(C(C=C)O)=O,2,1,0,1,28,4.8e-05
G5,C(CO)(C(C(CC(CO)=C)O)O)=O,4,2,0,2,28,9.6e-05
G5,C(C(C(CO)=C)C(CO)(CO)O)=O,2,1,0,1,28,4.8e-05
G5,C(CO)(C(C(C=C(C)CO)O)O)=O,8,2,0,2,28,9.6e-05
G5,C(CO)(C(C(C=CC)O)O)=O,8,3,0,3,5,0.000143
G5,C(CO)(C(C(CC=C)O)O)=O,4,3,0,3,5,0.000143
G5,C(C(C=C)C(CO)(CO)O)=O,2,2,0,2,5,9.499999999999999e-05
G5,C(CC=CC(C(C(CO)=O)O)O)=O,8,3,0,3,5,0.000154
G5,C(CO)(C(C(CC=CC=O)O)O)=O,8,3,0,3,28,0.000154
G5,C(C(C=CC=O)C(CO)(CO)O)=O,4,1,0,1,28,4.8e-05
G5,C(C(C(CC(C(CO)O)O)=O)=O)=O,4,1,0,1,25,4.8e-05
G5,C(CC(C(CO)O)O)(CCO)=O,4,2,0,2,41,0.00010700000000000001
G5,C(C)(C(CO)C(C(CO)O)O)=O,8,3,0,3,28,0.000154
G5,C(C)(CC(C(CO)O)O)=O,4,6,0,6,29,0.000319
G5,C(OCC(CC(C(CO)O)O)=O)=O,4,3,0,3,35,0.000143
G5,C(OC(C(C)=O)C(C(CO)O)O)=O,8,3,0,3,35,0.000143
G5,C(OC(C=O)C(C(CO)O)O)=O,8,2,0,2,41,9.6e-05
G5,C(C(C(C(CO)O)O)OC(C)=O)=O,8,2,0,2,28,9.6e-05
G5,C(CC(CC(C(CO)O)O)=O)(O)=O,4,2,0,2,41,0.00010700000000000001
G5,C(C(C(C)=O)C(C(CO)O)O)(O)=O,8,3,0,3,6,0.000154
G5,C1(C(C(CO1)C(C(CO)O)O)=O)=O,8,5,0,5,28,0.00023799999999999998
G5,C1(C(C(CO1)=O)C(C(CO)O)O)=O,8,2,0,2,28,9.6e-05
G5,C1(CC(C(C(C(CO)O)O)O1)=O)=O,8,2,0,2,28,9.6e-05
G5,C1OC(C(C=1)=O)C(C(CO)O)O,8,3,0,3,28,0.000143
G5,C(C(CC)=O)(CC(C(CO)O)O)=O,4,1,0,1,28,4.8e-05
G5,C(C(C)=O)(C(C)C(C(CO)O)O)=O,8,1,0,1,28,4.8e-05
G5,C(CC(C(CO)O)O)(CC(C)=O)=O,4,1,0,1,28,4.8e-05
G5,C(C)(C(C(C)=O)C(C(CO)O)O)=O,4,2,0,2,28,9.6e-05
G5,C(C(C(C(CO)O)O)C(C=O)C)=O,16,2,0,2,28,9.6e-05
G5,C(C(C(C)C(C(CO)O)O)=O)=O,8,5,0,5,29,0.000271
G5,C(C(C(C)C(C(CO)O)O)=O)(O)=O,8,1,0,1,28,4.8e-05
G5,C=CC(C(C=O)=O)C(C(CO)O)O,8,5,0,5,29,0.00028199999999999997
G5,C(C=CC(CC(C(CO)O)O)=O)=O,8,7,0,7,29,0.000399
G5,C(C(C(C=O)=C)C(C(CO)O)O)=O,8,1,0,1,28,4.8e-05
G5,C(C)=CC(C(C(C(CO)O)O)O)=O,16,2,0,2,28,9.6e-05
G5,C(CO)(C(C=C)C(C(CO)O)O)=O,8,1,0,1,28,4.8e-05
G5,C(C(C(C(CO)O)O)O)(CC=C)=O,8,2,0,2,28,9.6e-05
G5,C(CC(C(CO)O)O)(C(C=C)O)=O,8,1,0,1,28,4.8e-05
G5,C(C(C(CO)=C)C(C(CO)O)O)=O,8,1,0,1,28,4.8e-05
G5,C(C(C=C)C(C(CO)O)O)=O,8,2,0,2,41,9.499999999999999e-05
G5,C(C(C=CC=O)C(C(CO)O)O)=O,16,2,0,2,4,9.499999999999999e-05
G5,C(C(CC1(CC(CC1O)O)O)=O)=O,8,1,0,1,45,4.8e-05
G5,C1C(C(C(C=1)(CC(C=O)=O)O)O)O,8,1,0,1,28,4.8e-05
G5,C1C(CC(C(C=1)=O)O)(CC(C=O)=O)O,4,1,0,1,45,4.8e-05
G5,C(C1(C=CC(C1)(CC(C=O)=O)O)O)=O,4,1,0,1,45,4.8e-05
G5,C1C(C(CC(C=O)=O)O)C(C(C=1)=O)O,8,1,0,1,45,4.8e-05
G5,C1C(CC(C(C=1)=O)(CC(C=O)=O)O)O,4,1,0,1,27,4.8e-05
G5,C(CC(C=O)(CC(C=O)=O)O)(O)=O,2,2,0,2,29,0.00010700000000000001
G5,C(C)(C(CCO)(CC(C=O)=O)O)=O,2,3,0,3,29,0.000165
G5,C(C(C)(CC(C=O)=O)O)(CCO)=O,2,3,0,3,45,0.000156
G5,C(C(C(C(C(C)=O)=O)CO)O)(C)=O,4,5,0,5,14,0.000254
G5,C(C(C)(C(C(C(C)=O)=O)CO)O)=O,4,5,0,5,45,0.000254
G5,C(C(CC(C(CCO)=O)=O)O)(C)=O,2,3,0,3,45,0.000156
G5,C(C(C)(CC(C(CCO)=O)=O)O)=O,2,3,0,3,45,0.000156
G5,C(CCO)(CC(CC(C=O)=O)O)=O,2,4,0,4,23,0.000204
G5,C(C(CO)C(C(C)=O)O)(CC=O)=O,4,5,0,5,45,0.000242
G5,C(C(CO)C(C=O)(C)O)(CC=O)=O,4,4,0,4,45,0.000195
G5,C(CCO)(C(C=O)C(C(C)=O)O)=O,4,4,0,4,2,0.000193
G5,C(CCO)(C(C=O)C(C=O)(C)O)=O,4,3,0,3,2,0.000146
G5,C(C)(C(CO)C(CC(C=O)=O)O)=O,4,7,0,7,23,0.000349
G5,C(CC(C(C)=O)O)(C(C=O)CO)=O,4,3,0,3,45,0.000147
G5,C(C(C)(CC(C(C=O)CO)=O)O)=O,4,3,0,3,45,0.000147
G5,C(C(C(CO)O)(CC(C=O)=O)O)=C,4,5,0,5,29,0.00028199999999999997
G5,C(C(CC(CC(C(C)O)O)O)=O)=O,8,1,0,1,11,4.8e-05
G5,C(C(CC(C(C(C)=O)=O)O)=O)=O,2,4,0,4,29,0.00018999999999999998
G5,C(C=O)(C(C)(CC(C=O)=O)O)=O,2,3,0,3,29,0.000143
G5,C(C)(C(CC(C(C=O)=O)=O)O)=O,2,3,0,3,29,0.000143
G5,C(C(C)(CC(C(C=O)=O)=O)O)=O,2,2,0,2,16,9.6e-05
G5,C(C(CC(C(C=O)=O)O)=O)=O,2,3,0,3,29,0.000143
G5,C(C(C(C(CC(C=O)=O)O)=O)O)=O,4,2,0,2,23,9.499999999999999e-05
G5,C(CO)(CC(CC(C(C)=O)O)=O)=O,2,2,0,2,45,0.00010700000000000001
G5,C(C(C)(CC(CC(CO)=O)=O)O)=O,2,2,0,2,45,0.00010700000000000001
G5,C(C)(C(C(CO)=O)C(C(C)=O)O)=O,4,3,0,3,26,0.000155
G5,C(C(C)(C(C(C)=O)C(CO)=O)O)=O,4,3,0,3,26,0.000155
G5,C(C)(C(C(CC(C(C)=O)O)=O)O)=O,4,1,0,1,49,4.8e-05
G5,C(C(C)(CC(C(C(C)=O)O)=O)O)=O,4,1,0,1,49,4.8e-05
G5,C(C(CC(C)(CCO)O)=O)=O,2,3,0,3,29,0.000154
G5,C(CC(C(C)=O)O)(CCO)=O,2,3,0,3,29,0.000154
G5,C(C(C)(CC(CCO)=O)O)=O,2,3,0,3,29,0.000154
G5,C(C)(C(CO)C(C(C)=O)O)=O,4,4,0,4,28,0.000202
G5,C(C(C)(C(C(C)=O)CO)O)=O,4,4,0,4,28,0.000202
G5,C(CC(CC=O)(CC(C=O)=O)O)=O,1,2,0,2,27,9.7e-05
G5,C(C(C(CC=O)=O)C(C(C)=O)O)=O,4,2,0,2,9,9.6e-05
G5,C(CC(C(C=O)C(C=O)(C)O)=O)=O,4,2,0,2,9,9.6e-05
G5,C(C(CC(C)(C)O)=O)=O,1,1,0,1,27,4.8e-05
G5,C(C)(C(CC(C)=O)O)=O,2,3,0,3,25,0.000143
G5,C(C(C)(CC(C)=O)O)=O,2,2,0,2,11,9.6e-05
G5,C(CCC(CO)(CC(C=O)=O)O)=O,2,2,0,2,0,9.6e-05
G5,C(CCC(C(C(C(C)=O)O)O)=O)=O,4,6,0,6,20,0.000309
G5,C(CCC(C(C(C=O)(C)O)O)=O)=O,4,3,0,3,7,0.000144
G5,C(C)(CC(C(CC(C=O)=O)O)O)=O,4,3,0,3,12,0.000154
G5,C(C(CC(C)(CC(C=O)=O)O)O)=O,4,2,0,2,26,9.499999999999999e-05
G5,C(C(C(C(C)=O)C(C(C)=O)O)O)=O,8,2,0,2,27,9.6e-05
G5,C(C(C(C(C)=O)C(C=O)(C)O)O)=O,8,2,0,2,27,9.6e-05
G5,C(C(CC(CC(C(C)=O)O)=O)O)=O,4,2,0,2,45,0.00010700000000000001
G5,C(CC(C=O)(C)O)(CC(C=O)O)=O,4,1,0,1,27,4.8e-05
G5,C(CO)=CC(CO)(CC(C=O)=O)O,4,2,0,2,45,0.00010700000000000001
G5,C(C)(C(C(C(C=CCO)=O)O)O)=O,8,5,0,5,55,0.000251
G5,C(C(C)(C(C(C=CCO)=O)O)O)=O,8,4,0,4,11,0.00020299999999999997
G5,C(OCC(C)(CC(C=O)=O)O)=O,2,1,0,1,35,4.8e-05
G5,C(OCC(CC(C(C)=O)O)=O)=O,2,3,0,3,35,0.000143
G5,C(C(C)(CC(COC=O)=O)O)=O,2,3,0,3,45,0.000143
G5,C(OC(C(C)=O)C(C(C)=O)O)=O,4,4,0,4,35,0.00019099999999999998
G5,C(C(C)(C(C(C)=O)OC=O)O)=O,4,3,0,3,35,0.000144
G5,C(OCC(CC(C=O)=O)O)=O,2,2,0,2,2,9.499999999999999e-05
G5,C(OC(C=O)C(C(C)=O)O)=O,4,3,0,3,28,0.000144
G5,C(C(C)(C(C=O)OC=O)O)=O,4,2,0,2,28,9.6e-05
G5,C(CO)(OCC(CC(C=O)=O)O)=O,2,1,0,1,40,4.8e-05
G5,C(CO)(OC(C=O)C(C(C)=O)O)=O,4,2,0,2,40,9.6e-05
G5,C(CO)(OC(C=O)C(C=O)(C)O)=O,4,2,0,2,40,9.6e-05
G5,C(C)(OCC(CC(C=O)=O)O)=O,2,1,0,1,28,4.8e-05
G5,C(C)(OC(C=O)C(C(C)=O)O)=O,4,2,0,2,28,9.6e-05
G5,C(C)(OC(C=O)C(C=O)(C)O)=O,4,2,0,2,28,9.6e-05
G5,C(CCC(C(CC(C=O)=O)O)=O)=O,2,1,0,1,20,4.8e-05
G5,C(CCC(C=O)(CC(C=O)=O)O)=O,2,2,0,2,0,9.6e-05
G5,C(CC(C(C=O)=O)C(C(C)=O)O)=O,4,2,0,2,20,9.6e-05
G5,C(CC(C(C=O)=O)C(C=O)(C)O)=O,4,2,0,2,20,9.6e-05
G5,C(C(CC(C=O)=O)C(C(C)=O)O)=O,4,2,0,2,20,9.6e-05
G5,C(C(C)(C(C=O)CC(C=O)=O)O)=O,4,2,0,2,20,9.6e-05
G5,C(CCC(CC(C=O)=O)O)=O,2,3,0,3,29,0.000143
G5,C(CO)=CC(C(CC(C=O)=O)O)=O,4,1,0,1,55,4.8e-05
G5,C(C(C=CCO)(CC(C=O)=O)O)=O,4,1,0,1,55,4.8e-05
G5,C(C(CC(C=O)=O)O)=CCO,4,4,0,4,29,0.000202
G5,C(C(CO)(CC(C=O)=O)O)(O)=O,2,5,0,5,29,0.000262
G5,C(C(C)(C(C(C(O)=O)=O)O)O)=O,4,3,0,3,33,0.000155
G5,C(C(CC=O)(CC(C=O)=O)O)(O)=O,2,2,0,2,29,0.00010700000000000001
G5,C(C(C(C(O)=O)=O)C(C(C)=O)O)=O,4,3,0,3,45,0.000155
G5,C(C(C(C(O)=O)=O)C(C=O)(C)O)=O,4,3,0,3,45,0.000155
G5,C(CC(C)(CC(C=O)=O)O)(O)=O,2,3,0,3,29,0.000154
G5,C(CC(CC(C(C)=O)O)=O)(O)=O,2,4,0,4,29,0.000202
G5,C(C(C)(CC(CC(O)=O)=O)O)=O,2,4,0,4,29,0.000202
G5,C(C(C(C)=O)C(C(C)=O)O)(O)=O,4,4,0,4,6,0.000202
G5,C(C(C)(C(C(O)=O)C(C)=O)O)=O,4,4,0,4,6,0.000202
G5,C(C(CC(C=O)=O)O)=CC(O)=O,4,4,0,4,29,0.000202
G5,C(CO)(C(CO)(CC(C=O)=O)O)=O,2,4,0,4,29,0.00020299999999999997
G5,C(C)(C(C(C(C(CO)=O)=O)O)O)=O,4,3,0,3,5,0.000144
G5,C(C(C)(C(C(C(CO)=O)=O)O)O)=O,4,3,0,3,5,0.000144
G5,C=CC(C(CO)(CC(C=O)=O)O)=O,2,2,0,2,7,9.7e-05
G5,C(CO)(C(C=C)(CC(C=O)=O)O)=O,2,2,0,2,45,9.499999999999999e-05
G5,C(C)(C(C(C(C(C=C)=O)=O)O)O)=O,4,2,0,2,7,9.6e-05
G5,C(C(C)(C(C(C(C=C)=O)=O)O)O)=O,4,2,0,2,7,9.6e-05
G5,C(C(C)(CC(C=O)=O)O)(C(C)O)=O,4,2,0,2,49,9.499999999999999e-05
G5,C(C(CC(C(C(C)O)=O)=O)O)(C)=O,4,3,0,3,22,0.000143
G5,C(C(C)(CC(C(C(C)O)=O)=O)O)=O,4,1,0,1,49,4.8e-05
G5,C1(C(C(CC1)(CC(C=O)=O)O)O)=O,4,2,0,2,23,9.499999999999999e-05
G5,C1(CC(C(C1O)=O)C(C(C)=O)O)=O,8,2,0,2,47,9.6e-05
G5,C(C(C)(C1C(C(C(C1)=O)O)=O)O)=O,8,2,0,2,47,9.6e-05
G5,C1(CCC(CO1)(CC(C=O)=O)O)=O,2,1,0,1,7,4.8e-05
G5,C1(CC(C(CO1)=O)C(C(C)=O)O)=O,4,1,0,1,7,4.8e-05
G5,C1(CC(C(CO1)=O)C(C=O)(C)O)=O,4,1,0,1,7,4.8e-05
G5,C1(CCC(C(C(C(C)=O)O)O1)=O)=O,4,2,0,2,7,9.6e-05
G5,C1(CCC(C(C(C=O)(C)O)O1)=O)=O,4,2,0,2,7,9.6e-05
G5,C1(COCC(CC(C=O)=O)(C1)O)=O,2,1,0,1,54,4.8e-05
G5,C1(COC(C(C1)=O)C(C(C)=O)O)=O,4,2,0,2,54,9.6e-05
G5,C(C(C)(C1C(CC(CO1)=O)=O)O)=O,4,2,0,2,54,9.6e-05
G5,C1(COCC(C1C(C(C)=O)O)=O)=O,2,2,0,2,54,9.6e-05
G5,C(C(C)(C1C(COCC1=O)=O)O)=O,2,2,0,2,54,9.6e-05
G5,C1(C(CCO1)(CC(C=O)=O)O)=O,2,2,0,2,29,9.499999999999999e-05
G5,C(C(C1C(C(OC1)=O)=O)O)(C)=O,4,3,0,3,28,0.000144
G5,C(C(C)(C1C(C(OC1)=O)=O)O)=O,4,3,0,3,28,0.000144
G5,C1(CC(CO1)(CC(C=O)=O)O)=O,2,2,0,2,29,9.499999999999999e-05
G5,C1(C(C(CO1)=O)C(C(C)=O)O)=O,4,4,0,4,28,0.00019099999999999998
G5,C(C(C)(C1C(OCC1=O)=O)O)=O,4,4,0,4,28,0.00019099999999999998
G5,C1(CC(C(C(C(C)=O)O)O1)=O)=O,4,3,0,3,28,0.000144
G5,C(C(C)(C1C(CC(O1)=O)=O)O)=O,4,3,0,3,28,0.000144
G5,C=CC(C(CC(C=O)=O)O)O,4,3,0,3,29,0.000143
G5,C1C(COC=1)(CC(C=O)=O)O,2,2,0,2,45,9.499999999999999e-05
G5,C(C)(C(C1C(C=CO1)=O)O)=O,4,3,0,3,28,0.000144
G5,C(C(C)(C1C(C=CO1)=O)O)=O,4,3,0,3,28,0.000144
G5,C1C(COC(C=1)O)(CC(C=O)=O)O,4,1,0,1,27,4.8e-05
G5,C(C)(C(C1C(C=CC(O)O1)=O)O)=O,8,2,0,2,27,9.6e-05
G5,C(C(C)(C1C(C=CC(O1)O)=O)O)=O,8,2,0,2,27,9.6e-05
G5,C(C(C)O)(CC(CC(C=O)=O)O)=O,4,2,0,2,22,9.499999999999999e-05
G5,C(C(C)O)(C(C=O)C(C(C)=O)O)=O,8,3,0,3,45,0.000144
G5,C(C(C)O)(C(C=O)C(C=O)(C)O)=O,8,3,0,3,45,0.000144
G5,C(C(CC(C(CC(C)O)O)O)=O)=O,8,2,0,2,46,0.00010700000000000001
G5,C(C(CC(C(C)O)(C(C)O)O)=O)=O,3,2,0,2,46,0.00010700000000000001
G5,C(C(C(C)O)(CC(C=O)=O)O)(O)=O,4,3,0,3,4,0.000156
G5,C(C(C=CC(CC(C=O)=O)O)O)=O,8,2,0,2,45,9.499999999999999e-05
G5,C(C(C(CC(C=O)=O)O)O)=CC=O,8,1,0,1,20,4.8e-05
G5,C(C(CC(C)(C(CCO)O)O)=O)=O,4,2,0,2,4,0.00010700000000000001
G5,C(C(C)(CC(C(CCO)O)=O)O)=O,4,2,0,2,4,0.00010700000000000001
G5,C(C(C=C)(CC(C=O)=O)O)(O)=O,2,3,0,3,29,0.000154
G5,C(C(CC(C(C)(CO)O)O)=O)=O,4,3,0,3,49,0.000154
G5,C(C(CC(C(C)(C(C)O)O)O)=O)=O,8,1,0,1,18,4.8e-05
G5,C1(CCC(C(C1)(CC(C=O)=O)O)=O)=O,2,1,0,1,45,4.8e-05
G5,C1(CCC(C(C1)=O)(CC(C=O)=O)O)=O,2,2,0,2,45,9.499999999999999e-05
G5,C(C(CC1(CCC(C(C1)=O)=O)O)=O)=O,2,2,0,2,45,9.499999999999999e-05
G5,C1(CCC(C(C1C(C(C)=O)O)=O)=O)=O,4,2,0,2,45,9.6e-05
G5,C(C(C)(C1C(CCC(C1=O)=O)=O)O)=O,4,2,0,2,45,9.6e-05
G5,C1(CC(C(C(C1)=O)=O)C(C(C)=O)O)=O,4,1,0,1,45,4.8e-05
G5,C(C(C)(C1C(C(CC(C1)=O)=O)=O)O)=O,4,1,0,1,45,4.8e-05
G5,C1(C(CC(C(C1)=O)=O)C(C(C)=O)O)=O,4,1,0,1,45,4.8e-05
G5,C(C(C)(C1C(CC(C(C1)=O)=O)=O)O)=O,4,1,0,1,45,4.8e-05
G5,C1(C(CCC1C(CC(C=O)=O)O)=O)=O,4,2,0,2,45,9.499999999999999e-05
G5,C1(C(CCC1C=O)(CC(C=O)=O)O)=O,4,1,0,1,45,4.8e-05
G5,C(C1CCC(C1(CC(C=O)=O)O)=O)=O,4,2,0,2,45,9.499999999999999e-05
G5,C(C1C(C(C(C1)C(C(C)=O)O)=O)=O)=O,8,1,0,1,45,4.8e-05
G5,C(C1C(C(C(C1)C(C=O)(C)O)=O)=O)=O,8,1,0,1,45,4.8e-05
G5,C1(CC(CC(C1)=O)(CC(C=O)=O)O)=O,1,1,0,1,45,4.8e-05
G5,C1(CC(CC(C1C(C(C)=O)O)=O)=O)=O,2,2,0,2,45,9.6e-05
G5,C1(CC(C(C(C1)=O)C(C=O)(C)O)=O)=O,2,2,0,2,45,9.6e-05
G5,C(C1C(CC(C1)=O)(CC(C=O)=O)O)=O,4,2,0,2,45,9.499999999999999e-05
G5,C(C1C(CC(C1)(CC(C=O)=O)O)=O)=O,4,1,0,1,45,4.8e-05
G5,C1(C(C(CC(C=O)=O)O)CC(C1)=O)=O,4,1,0,1,45,4.8e-05
G5,C(C1C(C(C(C1)=O)C(C(C)=O)O)=O)=O,8,2,0,2,45,9.6e-05
G5,C(C1C(C(C(C1)=O)C(C=O)(C)O)=O)=O,8,2,0,2,45,9.6e-05
G5,C(C1C(CC(C1C(C(C)=O)O)=O)=O)=O,8,1,0,1,45,4.8e-05
G5,C(C(C)(C1C(CC(C1C=O)=O)=O)O)=O,8,1,0,1,45,4.8e-05
G5,C(C1CC(C(C1)=O)(CC(C=O)=O)O)=O,4,2,0,2,45,9.499999999999999e-05
G5,C(C(CC(C1CC(C(C1)=O)=O)O)=O)=O,2,2,0,2,45,9.499999999999999e-05
G5,C(C1CC(C(C1C(C(C)=O)O)=O)=O)=O,8,2,0,2,45,9.499999999999999e-05
G5,C(C(C)(C1C(C(CC1C=O)=O)=O)O)=O,8,2,0,2,45,9.499999999999999e-05
G5,C(C1C(CCC1(CC(C=O)=O)O)=O)=O,4,1,0,1,45,4.8e-05
G5,C1(CCC(C1C(CC(C=O)=O)O)=O)=O,2,1,0,1,45,4.8e-05
G5,C(C1C(CC(C1=O)C(C(C)=O)O)=O)=O,8,1,0,1,45,4.8e-05
G5,C(C(C)(C1C(C(C(C1)=O)C=O)=O)O)=O,8,1,0,1,45,4.8e-05
G5,C1CC(C(C(C=1)=O)O)(CC(C=O)=O)O,4,1,0,1,32,4.8e-05
G5,C1(C(C(C=CC1)(CC(C=O)=O)O)O)=O,4,1,0,1,32,4.8e-05
G5,C1(C(C(C=CC1C(C(C)=O)O)=O)O)=O,8,1,0,1,32,4.8e-05
G5,C1(C(C=CC(C1O)=O)C(C=O)(C)O)=O,8,1,0,1,32,4.8e-05
G5,C1C(C(CC(C=O)=O)(CC(C=1)=O)O)O,4,1,0,1,45,4.8e-05
G5,C1(CC(C=CC1O)(CC(C=O)=O)O)=O,4,1,0,1,45,4.8e-05
G5,C1(C(C=CC(C1C(C(C)=O)O)=O)O)=O,8,2,0,2,45,9.6e-05
G5,C1(C(C(C=CC1O)=O)C(C=O)(C)O)=O,8,2,0,2,45,9.6e-05
G5,C(CO)(C(CC)(CC(C=O)=O)O)=O,2,2,0,2,12,0.00010700000000000001
G5,C(C(CO)(CC(C=O)=O)O)(CC)=O,2,1,0,1,42,4.8e-05
G5,C(C(C(C(C(CO)=O)=O)C)O)(C)=O,4,1,0,1,42,4.8e-05
G5,C(C(C)(C(C(C(CO)=O)=O)C)O)=O,4,1,0,1,42,4.8e-05
G5,C(C(C(C(C(CC)=O)=O)O)O)(C)=O,4,2,0,2,42,9.6e-05
G5,C(C(C)(C(C(C(CC)=O)=O)O)O)=O,4,2,0,2,42,9.6e-05
G5,C(CC(CO)C(CC(C=O)=O)O)=O,4,6,0,6,29,0.000319
G5,C(C(CO)CC(CC(C=O)=O)O)=O,4,1,0,1,55,4.8e-05
G5,C(C(C(C=O)C(C=O)CO)O)(C)=O,8,4,0,4,55,0.000193
G5,C(C(CO)C(C=O)C(C=O)(C)O)=O,8,4,0,4,55,0.000193
G5,C(C(C)(CC(C=O)=O)O)(CC)=O,2,2,0,2,45,9.499999999999999e-05
G5,C(C)(C(CC)(CC(C=O)=O)O)=O,2,1,0,1,28,4.8e-05
G5,C(C(CC(C(CC)=O)=O)O)(C)=O,2,2,0,2,45,9.499999999999999e-05
G5,C(C(C)(CC(C(CC)=O)=O)O)=O,2,2,0,2,4,9.499999999999999e-05
G5,C(C(C(C(C(C)=O)=O)C)O)(C)=O,4,1,0,1,28,4.8e-05
G5,C(C(C)(C(C(C(C)=O)=O)C)O)=O,4,1,0,1,28,4.8e-05
G5,C(C)(CC(C)(CC(C=O)=O)O)=O,2,3,0,3,45,0.000143
G5,C(C)(CC(CC(C(C)=O)O)=O)=O,2,3,0,3,29,0.000143
G5,C(C(C)(CC(CC(C)=O)=O)O)=O,2,3,0,3,29,0.000143
G5,C(C)(C(C(C)=O)C(C(C)=O)O)=O,2,3,0,3,28,0.000144
G5,C(C(C)(C(C(C)=O)C(C)=O)O)=O,2,3,0,3,28,0.000144
G5,C(CC(C)C(CC(C=O)=O)O)=O,4,2,0,2,3,9.6e-05
G5,C(C(C)CC(CC(C=O)=O)O)=O,4,2,0,2,45,9.499999999999999e-05
G5,C(C(C(C=O)C(C=O)C)O)(C)=O,8,3,0,3,49,0.000143
G5,C(C(C)C(C=O)C(C=O)(C)O)=O,8,3,0,3,49,0.000143
G5,C(C(C(C(CC(C=O)=O)O)=O)C)=O,4,1,0,1,49,4.8e-05
G5,C(C(C)C(C=O)(CC(C=O)=O)O)=O,4,1,0,1,49,4.8e-05
G5,C(C=O)(C(C)C(CC(C=O)=O)O)=O,4,2,0,2,49,9.6e-05
G5,C(C(CC(C=O)=O)O)(C(CO)C)=O,4,1,0,1,28,4.8e-05
G5,C(C(C(CO)C)(CC(C=O)=O)O)=O,4,1,0,1,28,4.8e-05
G5,C(C(C)C(C(CC(C=O)=O)O)O)=O,8,1,0,1,49,4.8e-05
G5,C(C(C(C(CC(C=O)=O)O)C)O)=O,8,2,0,2,22,0.00010700000000000001
G5,C(C(CC(C=O)=O)O)(CC)=O,2,2,0,2,45,9.499999999999999e-05
G5,C(C(CC)(CC(C=O)=O)O)=O,2,1,0,1,28,4.8e-05
G5,C(C(C)(C(C(C=O)=O)C)O)=O,4,2,0,2,11,9.499999999999999e-05
G5,C1C(CC(C=O)=O)(C(C(C=1)=O)CO)O,4,1,0,1,45,4.8e-05
G5,C(C(C=O)C(CC(C(C)=O)O)=O)=O,2,1,0,1,6,4.8e-05
G5,C(C(C)(CC(C(C=O)C=O)=O)O)=O,2,1,0,1,6,4.8e-05
G5,C(C(C=O)CC(CC(C=O)=O)O)=O,2,1,0,1,43,4.8e-05
G5,C(C(C=O)C(C=O)C(C(C)=O)O)=O,4,1,0,1,43,4.8e-05
G5,C(C(C)(C(C=O)C(C=O)C=O)O)=O,4,1,0,1,43,4.8e-05
G5,C(C(CC)(CC(C=O)=O)O)(O)=O,2,1,0,1,28,4.8e-05
G5,C(C(C(C(C(O)=O)=O)C)O)(C)=O,4,3,0,3,29,0.000154
G5,C(C(C)(C(C(C(O)=O)=O)C)O)=O,4,2,0,2,11,9.499999999999999e-05
G5,C1C(CC(C=O)=O)(CC(C=1CO)=O)O,2,1,0,1,45,4.8e-05
G5,C1(CO)C(CC(C=O)=O)(CC(C=1)=O)O,2,1,0,1,45,4.8e-05
G5,C(C)(C(C1C(C(CO)=CC1=O)=O)O)=O,4,2,0,2,45,9.6e-05
G5,C(C(C)(C1C(C=C(C1=O)CO)=O)O)=O,4,2,0,2,45,9.6e-05
G5,C1CC(C(C=1CO)=O)(CC(C=O)=O)O,2,1,0,1,45,4.8e-05
G5,C1(CC=C(CO)C1(CC(C=O)=O)O)=O,2,1,0,1,45,4.8e-05
G5,C(C)(C(C1C=C(C(C1=O)=O)CO)O)=O,4,1,0,1,45,4.8e-05
G5,C(C(C)(C1C=C(C(C1=O)=O)CO)O)=O,4,1,0,1,45,4.8e-05
G5,C=C1C(C(CC1(CC(C=O)=O)O)O)=O,4,1,0,1,45,4.8e-05
G5,C=C1C(CC(C1(CC(C=O)=O)O)O)=O,4,1,0,1,45,4.8e-05
G5,C(C)(C(C1C(C(C(C1O)=O)=C)=O)O)=O,8,2,0,2,45,9.6e-05
G5,C(C(C)(C1C(C(C(C1O)=O)=C)=O)O)=O,8,2,0,2,45,9.6e-05
G5,C=C1C(C(C(CC(C=O)=O)(C1)O)O)=O,4,1,0,1,47,4.8e-05
G5,C1(C(C(C(C1)=C)(CC(C=O)=O)O)O)=O,4,1,0,1,47,4.8e-05
G5,C1(C(C(C(C1C(C(C)=O)O)=C)=O)O)=O,8,1,0,1,47,4.8e-05
G5,C1(C(C(C(C1O)=O)=C)C(C=O)(C)O)=O,8,1,0,1,47,4.8e-05
G5,C=C1C(CC(C1O)(CC(C=O)=O)O)=O,4,1,0,1,45,4.8e-05
G5,C1(CC(C(C1O)=C)(CC(C=O)=O)O)=O,4,1,0,1,45,4.8e-05
G5,C1(C(C(C(C1C(C(C)=O)O)=O)=C)O)=O,8,2,0,2,45,9.6e-05
G5,C1(C(C(C(C1O)=C)=O)C(C=O)(C)O)=O,8,2,0,2,45,9.6e-05
G5,C=C1C(C(CC1O)(CC(C=O)=O)O)=O,4,1,0,1,45,4.8e-05
G5,C1(CC(C(C1(CC(C=O)=O)O)=C)O)=O,4,1,0,1,45,4.8e-05
G5,C(C)(C(C1C(C(C(C1O)=C)=O)=O)O)=O,8,2,0,2,45,9.6e-05
G5,C(C(C)(C1C(C(C(C1O)=C)=O)=O)O)=O,8,2,0,2,45,9.6e-05
G5,C1C(CC(C=1C=O)O)(CC(C=O)=O)O,4,1,0,1,45,4.8e-05
G5,C1(C(CC(C=O)=O)O)C(CC(C=1)=O)O,4,1,0,1,45,4.8e-05
G5,C(C)(C(C1C(C=C(C=O)C1O)=O)O)=O,8,2,0,2,45,9.6e-05
G5,C(C(C)(C1C(C=C(C=O)C1O)=O)O)=O,8,2,0,2,45,9.6e-05
G5,C1CC(C(C=1C=O)O)(CC(C=O)=O)O,4,1,0,1,27,4.8e-05
G5,C1(C(C(C(CC(C=O)=O)O)=CC1)O)=O,4,1,0,1,27,4.8e-05
G5,C1(C(C(C=O)=CC1C(C(C)=O)O)O)=O,8,1,0,1,27,4.8e-05
G5,C1(C(C=C(C=O)C1O)C(C=O)(C)O)=O,8,1,0,1,27,4.8e-05
G5,C1C(C(CC(C=O)=O)(CC=1C=O)O)O,4,1,0,1,45,4.8e-05
G5,C1(C(C=C(C(CC(C=O)=O)O)C1)O)=O,4,1,0,1,45,4.8e-05
G5,C1(C(C=C(C=O)C1C(C(C)=O)O)O)=O,8,1,0,1,45,4.8e-05
G5,C1(C(C(C=O)=CC1O)C(C=O)(C)O)=O,8,1,0,1,45,4.8e-05
G5,C1C(CC(C=1C=O)(CC(C=O)=O)O)O,4,1,0,1,45,4.8e-05
G5,C1C(CC(C=1C(CC(C=O)=O)O)=O)O,4,1,0,1,45,4.8e-05
G5,C(C)(C(C1C(C(C=O)=CC1O)=O)O)=O,8,2,0,2,45,9.6e-05
G5,C(C(C)(C1C(C(C=O)=CC1O)=O)O)=O,8,2,0,2,45,9.6e-05
G5,C1(C(C=CC1C(CC(C=O)=O)O)O)=O,8,1,0,1,45,4.8e-05
G5,C(C1C=CC(C1(CC(C=O)=O)O)O)=O,8,1,0,1,45,4.8e-05
G5,C1(CC=CC1(C(CC(C=O)=O)O)O)=O,4,1,0,1,45,4.8e-05
G5,C(C1(C=CCC1(CC(C=O)=O)O)O)=O,4,1,0,1,45,4.8e-05
G5,C(C1(C(C(C=C1)C(C(C)=O)O)=O)O)=O,8,1,0,1,45,4.8e-05
G5,C(C1(C(C(C=C1)C(C=O)(C)O)=O)O)=O,8,1,0,1,45,4.8e-05
G5,C1C(C(C)(CC(C=O)=O)O)OC(C=1)=O,4,1,0,1,48,4.8e-05
G5,C(CC(C(C)=O)O)(C1C=CC(O1)=O)=O,4,1,0,1,48,4.8e-05
G5,C(C(C)(CC(C1C=CC(O1)=O)=O)O)=O,4,1,0,1,48,4.8e-05
G5,C1C(CC(CC(C=O)=O)O)OC(C=1)=O,4,1,0,1,48,4.8e-05
G5,C(C(C1C=CC(O1)=O)C(C(C)=O)O)=O,8,2,0,2,48,9.6e-05
G5,C(C(C)(C(C=O)C1C=CC(O1)=O)O)=O,8,2,0,2,48,9.6e-05
G5,C(C)(C1C(C=CO1)(CC(C=O)=O)O)=O,4,1,0,1,9,4.8e-05
G5,C1OC(C(C=1)=O)C(C)(CC(C=O)=O)O,4,3,0,3,26,0.000143
G5,C(CC(C(C)=O)O)(C1C(C=CO1)=O)=O,4,1,0,1,9,4.8e-05
G5,C(C(C)(CC(C1C(C=CO1)=O)=O)O)=O,4,1,0,1,9,4.8e-05
G5,C(CC1C(C=CO1)(CC(C=O)=O)O)=O,4,1,0,1,45,4.8e-05
G5,C1OC(C(C=1)=O)CC(CC(C=O)=O)O,4,1,0,1,45,4.8e-05
G5,C(C(C1C(C=CO1)=O)C(C(C)=O)O)=O,8,2,0,2,45,9.6e-05
G5,C(C(C)(C(C=O)C1C(C=CO1)=O)O)=O,8,2,0,2,45,9.6e-05
G5,C1C(CCOC(C=1)=O)(CC(C=O)=O)O,2,1,0,1,19,4.8e-05
G5,C(C(C1C(C=CC(OC1)=O)=O)O)(C)=O,4,2,0,2,19,9.6e-05
G5,C(C(C)(C1C(C=CC(OC1)=O)=O)O)=O,4,2,0,2,19,9.6e-05
G5,C1CC(COC(C=1)=O)(CC(C=O)=O)O,2,1,0,1,48,4.8e-05
G5,C1(COC(C=CC1C(C(C)=O)O)=O)=O,4,1,0,1,48,4.8e-05
G5,C(C(C)(C1C(COC(C=C1)=O)=O)O)=O,4,1,0,1,48,4.8e-05
G5,C1(C(C(C(C)=O)O)OC(C=CC1)=O)=O,4,2,0,2,48,9.6e-05
G5,C(C(C)(C1C(CC=CC(O1)=O)=O)O)=O,4,2,0,2,48,9.6e-05
G5,C1(CCOC=CC1(CC(C=O)=O)O)=O,2,1,0,1,45,4.8e-05
G5,C1OCCC(C(C=1)=O)(CC(C=O)=O)O,2,1,0,1,45,4.8e-05
G5,C(C(C1C(C(C=COC1)=O)=O)O)(C)=O,4,2,0,2,45,9.6e-05
G5,C(C(C)(C1C(C(C=COC1)=O)=O)O)=O,4,2,0,2,45,9.6e-05
G5,C1(COC=CC(CC(C=O)=O)(C1)O)=O,2,1,0,1,38,4.8e-05
G5,C1OCC(CC(C=O)=O)(CC(C=1)=O)O,2,1,0,1,38,4.8e-05
G5,C1(COC=CC(C1C(C(C)=O)O)=O)=O,4,2,0,2,38,9.6e-05
G5,C(C(C)(C1C(COC=CC1=O)=O)O)=O,4,2,0,2,38,9.6e-05
G5,C1(C(C(C(C)=O)O)OC=CC(C1)=O)=O,4,2,0,2,38,9.6e-05
G5,C(C(C)(C1C(CC(C=CO1)=O)=O)O)=O,4,2,0,2,38,9.6e-05
G5,C1(CC(C=CCO1)(CC(C=O)=O)O)=O,2,1,0,1,19,4.8e-05
G5,C1(C(C(C=CCO1)=O)C(C(C)=O)O)=O,4,2,0,2,19,9.6e-05
G5,C(C(C)(C1C(OCC=CC1=O)=O)O)=O,4,2,0,2,19,9.6e-05
G5,C1COCC(C(C=1)=O)(CC(C=O)=O)O,2,1,0,1,36,4.8e-05
G5,C1(COCC=CC1(CC(C=O)=O)O)=O,2,1,0,1,36,4.8e-05
G5,C(C)(C(C1C(C(C=CCO1)=O)=O)O)=O,4,2,0,2,36,9.6e-05
G5,C(C(C)(C1C(C(C=CCO1)=O)=O)O)=O,4,2,0,2,36,9.6e-05
G5,C1(CC=CC(CO1)(CC(C=O)=O)O)=O,2,1,0,1,48,4.8e-05
G5,C1(CC=CC(C(C(C(C)=O)O)O1)=O)=O,4,2,0,2,48,9.6e-05
G5,C(C(C)(C1C(C=CCC(O1)=O)=O)O)=O,4,2,0,2,48,9.6e-05
G5,C1C(COCC(C=1)=O)(CC(C=O)=O)O,2,1,0,1,45,4.8e-05
G5,C(C)(C(C1C(C=CC(CO1)=O)=O)O)=O,4,2,0,2,45,9.6e-05
G5,C(C(C)(C1C(C=CC(CO1)=O)=O)O)=O,4,2,0,2,45,9.6e-05
G5,C(C(CC(C=O)=O)O)=C1C(CCO1)=O,4,1,0,1,45,4.8e-05
G5,C1(C(CCO1)(CC(C=O)=O)O)=CC=O,4,1,0,1,45,4.8e-05
G5,C(C(C1C(C(OC1)=CC=O)=O)O)(C)=O,8,2,0,2,45,9.6e-05
G5,C(C(C)(C1C(C(OC1)=CC=O)=O)O)=O,8,2,0,2,45,9.6e-05
G5,C1(COC(C1)=CC(CC(C=O)=O)O)=O,4,1,0,1,45,4.8e-05
G5,C1(CC(CO1)(CC(C=O)=O)O)=CC=O,4,1,0,1,45,4.8e-05
G5,C1(COC(C1C(C(C)=O)O)=CC=O)=O,8,2,0,2,45,9.6e-05
G5,C(C(C)(C1C(COC1=CC=O)=O)O)=O,8,2,0,2,45,9.6e-05
G5,C1(C(C(C(C)=O)O)OC(C1)=CC=O)=O,8,2,0,2,45,9.6e-05
G5,C(C(C)(C1C(CC(O1)=CC=O)=O)O)=O,8,2,0,2,45,9.6e-05
G5,C(C(CC(C=O)=O)O)(C1C=CCO1)=O,4,1,0,1,39,4.8e-05
G5,C(C(C1C=CCO1)(CC(C=O)=O)O)=O,4,1,0,1,39,4.8e-05
G5,C(C1C=CC(C(CC(C=O)=O)O)O1)=O,8,1,0,1,40,4.8e-05
G5,C1(C(C(CC(C=O)=O)O)OC(C1)=C)=O,4,1,0,1,26,4.8e-05
G5,C(C1C(CC(O1)=C)(CC(C=O)=O)O)=O,4,1,0,1,26,4.8e-05
G5,C1(C(C=O)OC(C1C(C(C)=O)O)=C)=O,8,2,0,2,26,9.6e-05
G5,C1(C(C=O)OC(C1C(C=O)(C)O)=C)=O,8,2,0,2,26,9.6e-05
G5,C=C1C(CC(C(CC(C=O)=O)O)O1)=O,4,1,0,1,14,4.8e-05
G5,C(C1CC(C(O1)=C)(CC(C=O)=O)O)=O,4,1,0,1,14,4.8e-05
G5,C(C1C(C(C(O1)=C)=O)C(C(C)=O)O)=O,8,2,0,2,14,9.6e-05
G5,C(C(C)(C1C(C(OC1C=O)=C)=O)O)=O,8,2,0,2,14,9.6e-05
G5,C1(C(CC(C=O)=O)O)OCCC(C=1)=O,2,1,0,1,30,4.8e-05
G5,C1C(CCOC=1C=O)(CC(C=O)=O)O,2,1,0,1,30,4.8e-05
G5,C(C(C1C(C=C(C=O)OC1)=O)O)(C)=O,4,2,0,2,30,9.6e-05
G5,C(C(C)(C1C(C=C(C=O)OC1)=O)O)=O,4,2,0,2,30,9.6e-05
G5,C1(COC(C(CC(C=O)=O)O)=CC1)=O,2,1,0,1,12,4.8e-05
G5,C1CC(COC=1C=O)(CC(C=O)=O)O,2,1,0,1,12,4.8e-05
G5,C1(COC(C=O)=CC1C(C(C)=O)O)=O,4,1,0,1,12,4.8e-05
G5,C(C(C)(C1C(COC(C=O)=C1)=O)O)=O,4,1,0,1,12,4.8e-05
G5,C1(C(C(C(C)=O)O)OC(C=O)=CC1)=O,4,2,0,2,12,9.6e-05
G5,C(C(C)(C1C(CC=C(C=O)O1)=O)O)=O,4,2,0,2,12,9.6e-05
G5,C1(C(C(CC(C=O)=O)O)OC=CC1)=O,4,1,0,1,37,4.8e-05
G5,C(C1C(CC=CO1)(CC(C=O)=O)O)=O,4,1,0,1,37,4.8e-05
G5,C1(C(C=O)OC=CC1C(C(C)=O)O)=O,8,1,0,1,37,4.8e-05
G5,C1(C(C=O)OC=CC1C(C=O)(C)O)=O,8,1,0,1,37,4.8e-05
G5,C1OC(C(CC(C=O)=O)O)CC(C=1)=O,4,1,0,1,37,4.8e-05
G5,C(C1CC(C=CO1)(CC(C=O)=O)O)=O,4,1,0,1,37,4.8e-05
G5,C(C1C(C(C=CO1)=O)C(C(C)=O)O)=O,8,2,0,2,37,9.6e-05
G5,C(C(C)(C1C(C=COC1C=O)=O)O)=O,8,2,0,2,37,9.6e-05
G5,C1(CC(C(C=1)=O)O)C(CC(C=O)=O)O,4,1,0,1,45,4.8e-05
G5,C1C(C(CC=1C=O)O)(CC(C=O)=O)O,4,1,0,1,45,4.8e-05
G5,C1(C(C=CC1CO)(CC(C=O)=O)O)=O,4,1,0,1,45,4.8e-05
G5,C1C(CO)C(C(C=1)=O)(CC(C=O)=O)O,4,1,0,1,45,4.8e-05
G5,C1CC(C(C=1C(CC(C=O)=O)O)=O)O,4,1,0,1,27,4.8e-05
G5,C1CC(C(C=1C=O)(CC(C=O)=O)O)O,4,1,0,1,27,4.8e-05
G5,C=CC(C(CO)(CC(C=O)=O)O)O,4,1,0,1,31,4.8e-05
G5,C(C(C(C(C)=O)O)O)(C(C=C)O)=O,8,3,0,3,31,0.000144
G5,C(C(C)(C(C(C(C=C)O)=O)O)O)=O,8,2,0,2,31,9.6e-05
G5,C(C(CC(C=O)=O)O)=C(CO)CO,2,1,0,1,18,4.8e-05
G5,C(C(CO)O)=CC(CC(C=O)=O)O,8,2,0,2,13,0.00010700000000000001
G5,C(C(C)=CC(C(CC(C=O)=O)O)=O)=O,4,1,0,1,45,4.8e-05
G5,C(C(C=C(C=O)C)(CC(C=O)=O)O)=O,4,1,0,1,45,4.8e-05
G5,C(C)(C(CC(C=O)=O)O)=CC(C=O)=O,4,1,0,1,45,4.8e-05
G5,C(C(CC(C=O)=O)O)(CC(C=O)=C)=O,2,1,0,1,45,4.8e-05
G5,C(C(CC(C=O)=O)(CC(C=O)=C)O)=O,2,1,0,1,45,4.8e-05
G5,C=C(C(CC(C=O)=O)O)CC(C=O)=O,2,1,0,1,45,4.8e-05
G5,C(C)(C(C(C(C=O)=O)C(C=O)=C)O)=O,4,1,0,1,45,4.8e-05
G5,C(C(C)(C(C(C=O)=O)C(C=O)=C)O)=O,4,1,0,1,45,4.8e-05
G5,C(C(CC(C(C=CC=O)=O)O)=O)=O,4,1,0,1,20,4.8e-05
G5,C(C(C=CC=O)(CC(C=O)=O)O)=O,4,1,0,1,20,4.8e-05
G5,C(C(CC(C=O)=O)O)=CC(C=O)=O,4,1,0,1,20,4.8e-05
G5,C(C(C=CC)(CC(C=O)=O)O)=O,4,2,0,2,45,9.499999999999999e-05
G5,C(C(CC(C=O)=O)(CC=C)O)=O,2,2,0,2,45,9.499999999999999e-05
G5,C(C(C)(C(C=C)C(C=O)=O)O)=O,4,2,0,2,4,9.499999999999999e-05
G5,C(C(C)(CC(C=O)=O)O)=CC=O,4,2,0,2,4,9.499999999999999e-05
G5,C(C(CC(C=O)=O)O)=CC(C)=O,4,2,0,2,22,9.499999999999999e-05
G5,C(C(C)(CC(C=CC=O)=O)O)=O,4,2,0,2,4,9.499999999999999e-05
G5,C=C(C=O)CC(CC(C=O)=O)O,2,2,0,2,22,9.499999999999999e-05
G5,C(C(C(C=O)=C)C(C(C)=O)O)=O,4,2,0,2,45,9.499999999999999e-05
G5,C(C(C(C=O)=C)C(C=O)(C)O)=O,4,2,0,2,45,9.499999999999999e-05
G5,C(C(CC(C=O)=O)O)=C(C=O)C,4,2,0,2,22,9.499999999999999e-05
G5,C=C(C(CO)=O)C(CC(C=O)=O)O,2,1,0,1,9,4.8e-05
G5,C=C(C=O)C(CO)(CC(C=O)=O)O,2,1,0,1,9,4.8e-05
G5,C(C)(C(C(C(C(C=O)=C)=O)O)O)=O,4,2,0,2,9,9.6e-05
G5,C(C(C)(C(C(C(C=O)=C)=O)O)O)=O,4,2,0,2,9,9.6e-05
G5,C=C(C(C(CC(C=O)=O)O)=O)CO,2,1,0,1,49,4.8e-05
G5,C(C(C(CO)=C)(CC(C=O)=O)O)=O,2,1,0,1,49,4.8e-05
G5,C(CO)(C(CO)(CC(C=O)=O)O)=C,2,1,0,1,49,4.8e-05
G5,C(C)(C(C(C(C(CO)=C)=O)O)O)=O,4,4,0,4,49,0.000192
G5,C(C(C)(C(C(C(CO)=C)=O)O)O)=O,4,3,0,3,49,0.000144
G5,C=C(C=O)C(C(CC(C=O)=O)O)O,4,1,0,1,16,4.8e-05
G5,C(C(C(C(CC(C=O)=O)O)=C)O)=O,4,1,0,1,16,4.8e-05
G5,C(C(CC(C=O)=O)O)=C(C=O)CO,4,1,0,1,18,4.8e-05
G5,C(CO)(C(CC(C=O)=O)O)=CC=O,4,1,0,1,18,4.8e-05
G5,C(C)=CC(CO)(CC(C=O)=O)O,4,2,0,2,45,9.499999999999999e-05
G5,C(C)(C(C(C(C=CC)=O)O)O)=O,8,5,0,5,28,0.000239
G5,C(C(C)(C(C(C=CC)=O)O)O)=O,8,4,0,4,28,0.00019099999999999998
G5,C=CCC(CO)(CC(C=O)=O)O,2,2,0,2,45,9.499999999999999e-05
G5,C(CO)(C(C=C)C(C(C)=O)O)=O,4,3,0,3,29,0.000154
G5,C(C(C)(C(C(CO)=O)C=C)O)=O,4,2,0,2,45,9.499999999999999e-05
G5,C(C(C(C(C)=O)O)O)(CC=C)=O,4,5,0,5,28,0.000239
G5,C(C(C)(C(C(CC=C)=O)O)O)=O,4,4,0,4,28,0.00019099999999999998
G5,C=CC(C(C)(CC(C=O)=O)O)O,4,2,0,2,45,9.499999999999999e-05
G5,C(CC(C(C)=O)O)(C(C=C)O)=O,4,3,0,3,29,0.000143
G5,C(C(C)(CC(C(C=C)O)=O)O)=O,4,2,0,2,4,9.499999999999999e-05
G5,C=C(CO)CC(CC(C=O)=O)O,2,2,0,2,45,9.499999999999999e-05
G5,C(C(C(CO)=C)C(C(C)=O)O)=O,4,2,0,2,49,9.499999999999999e-05
G5,C(C(C)(C(C=O)C(CO)=C)O)=O,4,2,0,2,49,9.499999999999999e-05
G5,C(C(CC(C=O)=O)O)=C(C)CO,4,2,0,2,45,9.499999999999999e-05
G5,C(C(CC(C=O)=O)O)=CC,4,2,0,2,3,9.499999999999999e-05
G5,C=CCC(CC(C=O)=O)O,2,2,0,2,3,9.499999999999999e-05
G5,C(C(C=C)C(C(C)=O)O)=O,4,4,0,4,29,0.00018999999999999998
G5,C(C(C=C)C(C=O)(C)O)=O,4,3,0,3,29,0.000143
G5,C=C(CO)C(C(CC(C=O)=O)O)O,4,1,0,1,49,4.8e-05
G5,C(C(CO)(C(CC(C=O)=O)O)O)=C,4,3,0,3,29,0.000165
G5,C(C(C=C)(C(CC(C=O)=O)O)O)=O,4,2,0,2,28,9.6e-05
G5,C1(CC(CC(C=O)=O)O)OCC(C=1)=O,2,1,0,1,48,4.8e-05
G5,C(CC1OCC(C=1)(CC(C=O)=O)O)=O,2,1,0,1,48,4.8e-05
G5,C(C(C1OCC(C=1)=O)C(C(C)=O)O)=O,4,2,0,2,48,9.6e-05
G5,C(C(C)(C(C=O)C1OCC(C=1)=O)O)=O,4,2,0,2,48,9.6e-05
G5,C(CC1OC(C(C=1)=O)C(C(C)=O)O)=O,4,2,0,2,48,9.6e-05
G5,C(C(C)(C1C(C=C(CC=O)O1)=O)O)=O,4,2,0,2,48,9.6e-05
G5,C1(C)OC(C(C=1)=O)C(CC(C=O)=O)O,4,1,0,1,26,4.8e-05
G5,C(C1C(C=C(C)O1)(CC(C=O)=O)O)=O,4,1,0,1,26,4.8e-05
G5,C=CC(C(C(CC(C=O)=O)O)O)O,8,3,0,3,22,0.000165
G5,C(C(CC1(C(O)OC(C)C1)O)=O)=O,8,2,0,2,45,9.499999999999999e-05
G5,C(C(C)(C1C(C(O)OC1C)=O)O)=O,16,3,0,3,45,0.000144
G5,C(C(CC1(C(O)OCC1O)O)=O)=O,8,2,0,2,0,9.499999999999999e-05
G5,C(C(CC1(COC(C1O)O)O)=O)=O,8,2,0,2,51,9.499999999999999e-05
G5,C(C(C1C(C(C(O1)O)O)=O)O)(C)=O,16,3,0,3,5,0.000144
G5,C(C(C)(C1C(C(C(O1)O)O)=O)O)=O,16,3,0,3,5,0.000144
G5,C(C(CC(C=O)=O)O)(CCCO)=O,2,3,0,3,22,0.000154
G5,C(C(CCCO)(CC(C=O)=O)O)=O,2,1,0,1,55,4.8e-05
G5,C(C(C(C(C=O)=O)CCO)O)(C)=O,4,3,0,3,45,0.000154
G5,C(C(C)(C(C(C=O)=O)CCO)O)=O,4,2,0,2,29,9.6e-05
G5,C(C(CC(CO)(CCCO)O)=O)=O,2,1,0,1,55,4.8e-05
G5,C(C(C(C(CCCO)=O)O)O)(C)=O,4,5,0,5,55,0.00023999999999999998
G5,C(C(C)(C(C(CCCO)=O)O)O)=O,4,4,0,4,55,0.000192
G5,C(CO)(C(CCO)C(C(C)=O)O)=O,4,3,0,3,45,0.000155
G5,C(C(C)(C(C(CO)=O)CCO)O)=O,4,3,0,3,3,0.000155
G5,C1C(CC(C=O)=O)(C(C(C=1)=O)O)O,4,1,0,1,47,4.8e-05
G5,C(C(C=CC=O)C(C(C)=O)O)=O,8,3,0,3,29,0.000143
G5,C(C(C=CC=O)C(C=O)(C)O)=O,8,3,0,3,29,0.000143
G5,C(CC(C(C=O)C(CO)=O)O)(O)=O,4,3,0,3,49,0.000154
G5,C(CC(C(C(CC=O)=O)O)O)(O)=O,4,3,0,3,28,0.000154
G5,C(C(C(CO)=O)C(C=O)(C=O)O)=O,2,2,0,2,1,9.6e-05
G5,C(C(C(CO)=O)C(C(C=O)=O)O)=O,4,2,0,2,1,9.6e-05
G5,C(C(C(CO)=O)C(C)(CCO)O)=O,4,3,0,3,49,0.000154
G5,C(CCO)(CC(CC(CO)=O)O)=O,2,4,0,4,49,0.000204
G5,C(C)(C(CO)C(CC(CO)=O)O)=O,4,6,0,6,6,0.000301
G5,C(CC(CO)(C(C(C)=O)CO)O)=O,4,4,0,4,49,0.00020299999999999997
G5,C(C(C(CO)=O)C(C)(C)O)=O,2,2,0,2,49,9.6e-05
G5,C(CC(C(C(C)(C)O)O)=O)=O,2,2,0,2,49,9.6e-05
G5,C(CC(CO)(CC(C)=O)O)=O,2,6,0,6,4,0.000298
G5,C(OCC(C(C=O)C(CO)=O)O)=O,4,2,0,2,49,9.6e-05
G5,C(OCC(C(C(CC=O)=O)O)O)=O,4,2,0,2,49,9.6e-05
G5,C(C(C(CC(CO)=O)O)OC=O)=O,4,6,0,6,1,0.000285
G5,C(CC(CO)(C(C=O)OC=O)O)=O,4,2,0,2,49,9.6e-05
G5,C(CCC(C(C=O)C(CO)=O)O)=O,4,3,0,3,27,0.000143
G5,C(CCC(C(C(CC=O)=O)O)O)=O,4,7,0,7,27,0.000366
G5,C(C(C(CO)=O)C(C=CCO)O)=O,8,3,0,3,28,0.000154
G5,C(CC(C(C(C=CCO)O)O)=O)=O,8,5,0,5,28,0.00026000000000000003
G5,C(C(C(CO)=O)C(C(C=C)O)O)=O,8,2,0,2,28,9.6e-05
G5,C(CC(C(C(C(C=C)O)O)O)=O)=O,8,4,0,4,28,0.000213
G5,C(C(C(CO)=O)C1(C=COC1)O)=O,4,2,0,2,49,9.6e-05
G5,C(CC(C(C1(C=COC1)O)O)=O)=O,4,2,0,2,49,9.6e-05
G5,C(CO)(CC(C1C(C=CO1)=O)O)=O,4,2,0,2,49,9.6e-05
G5,C(CC(CO)(C1C(C=CO1)=O)O)=O,4,2,0,2,49,9.6e-05
G5,C(CO)(C(C=O)C(C(CC)=O)O)=O,4,2,0,2,49,9.6e-05
G5,C(CC(C(C(C(CC)=O)O)O)=O)=O,4,3,0,3,49,0.000154
G5,C(C(CC)(C(C=O)C(CO)=O)O)=O,4,2,0,2,49,9.6e-05
G5,C(C(CC)(C(C(CC=O)=O)O)O)=O,4,3,0,3,28,0.000154
G5,C(CO)(CC(C(C(C=O)=O)C)O)=O,4,2,0,2,49,9.6e-05
G5,C(CC(CO)(C(C(C=O)=O)C)O)=O,4,1,0,1,49,4.8e-05
G5,C(C(C(CO)=O)C(C=C)O)=O,4,4,0,4,49,0.00019099999999999998
G5,C(CC(C(C(C=C)O)O)=O)=O,4,4,0,4,49,0.00019099999999999998
G5,C(C(C(CO)=O)C(C=CC)O)=O,8,3,0,3,49,0.000143
G5,C(CC(C(C(C=CC)O)O)=O)=O,8,3,0,3,49,0.000143
G5,C(C(C(CO)=O)C(CC=C)O)=O,4,3,0,3,49,0.000143
G5,C(CC(C(C(CC=C)O)O)=O)=O,4,3,0,3,49,0.000143
G5,C(C(C=C)C(CC(CO)=O)O)=O,4,3,0,3,29,0.000154
G5,C(C(C=C)C(CO)(CC=O)O)=O,4,3,0,3,4,0.000144
G5,C(C(C(CC(CC(O)=O)O)=O)O)=O,4,2,0,2,55,0.00010700000000000001
G5,C(C(C=O)(CC(C(C=O)O)=O)O)=O,2,1,0,1,1,4.8e-05
G5,C(C(C(CC(C(C=O)=O)O)=O)O)=O,4,1,0,1,1,4.8e-05
G5,C(CCO)(CC(C(C(C)=O)O)O)=O,4,5,0,5,2,0.000252
G5,C(C)(C(CO)C(C(C(C)=O)O)O)=O,8,7,0,7,49,0.000349
G5,C(C(C(CC(C)(C)O)=O)O)=O,2,1,0,1,1,4.8e-05
G5,C(OCC(CC(C(C=O)O)=O)O)=O,4,1,0,1,1,4.8e-05
G5,C(C(C(C(C(C)=O)O)O)OC=O)=O,8,6,0,6,1,0.000285
G5,C(C(C(C)(C(C=O)OC=O)O)O)=O,8,5,0,5,1,0.00023799999999999998
G5,C(C(C(CC(CCC=O)O)=O)O)=O,4,3,0,3,44,0.000154
G5,C(C(C(CC(C=CCO)O)=O)O)=O,8,2,0,2,1,0.00010700000000000001
G5,C(CC(C(C=C)O)O)(C(C=O)O)=O,8,2,0,2,4,0.000106
G5,C(C(C(CC1(C=COC1)O)=O)O)=O,4,1,0,1,1,4.8e-05
G5,C(C)(C(C(C1C(C=CO1)=O)O)O)=O,8,2,0,2,1,9.6e-05
G5,C(CC(C(CC)=O)O)(C(C=O)O)=O,4,1,0,1,1,4.8e-05
G5,C(C(CC)(CC(C(C=O)O)=O)O)=O,4,2,0,2,46,0.000106
G5,C(C)(C(C(C(C(C=O)=O)C)O)O)=O,8,3,0,3,49,0.000144
G5,C(C(C(C)(C(C(C=O)=O)C)O)O)=O,8,1,0,1,1,4.8e-05
G5,C(C(C(CC(C=C)O)=O)O)=O,4,3,0,3,29,0.000143
G5,C(C(C(CC(C=CC)O)=O)O)=O,8,2,0,2,1,9.499999999999999e-05
G5,C(C(C(CC(CC=C)O)=O)O)=O,4,2,0,2,1,9.499999999999999e-05
G5,C(C(C=C)C(C(C(C)=O)O)O)=O,8,2,0,2,1,9.499999999999999e-05
G5,C(C(C=C)C(C)(C(C=O)O)O)=O,8,2,0,2,1,9.499999999999999e-05
G5,C(C(C(C(O)=O)=O)C(C=O)O)(O)=O,4,5,0,5,17,0.000251
G5,C(C(C(CC(O)=O)=O)C(C=O)O)=O,4,6,0,6,17,0.000298
G5,C(C(CC(C(C(CO)O)=O)=O)O)=O,4,5,0,5,5,0.00025299999999999997
G5,C(C(C(C(C(CCO)=O)=O)O)O)=O,4,4,0,4,2,0.000193
G5,C(C(C(C(C(CO)=O)=O)CO)O)=O,4,5,0,5,5,0.00024300000000000002
G5,C(C(C1C(C(C(O1)O)CO)=O)O)=O,16,5,0,5,0,0.000242
G5,C1(C(CO)OC(C1C(C=O)O)O)=O,16,5,0,5,0,0.000242
G5,C(C(C(C(C(O)=O)=O)C(C)O)O)=O,8,5,0,5,17,0.000252
G5,C(C)(C(C(CC=O)O)C(C=O)O)=O,8,7,0,7,6,0.000336
G5,C(CC(C)O)(C(C=O)C(C=O)O)=O,8,5,0,5,4,0.00023999999999999998
G5,C(C(C(C(C)=O)C(C=O)O)O)(O)=O,8,6,0,6,0,0.000309
G5,C(C(CC(CC(C=O)O)=O)O)(O)=O,4,4,0,4,0,0.000213
G5,C(C(CC(C(C=O)=O)=O)O)=O,2,4,0,4,29,0.00018999999999999998
G5,C(C(C(C(CO)=O)C(C=O)=O)O)=O,4,3,0,3,51,0.000144
G5,C(C(C(C(CC(C=O)=O)=O)O)O)=O,4,2,0,2,51,9.6e-05
G5,C(C(CC(C(C(C=O)=O)O)=O)O)=O,4,1,0,1,0,4.8e-05
G5,C(C(C(C(C=O)O)=O)C(C=O)O)=O,8,2,0,2,1,9.6e-05
G5,C(C)(C(CO)C(C=O)O)=O,4,12,0,12,2,0.000586
G5,C(C(C(CC(C)=O)=O)C(C=O)O)=O,4,2,0,2,27,9.6e-05
G5,C(CC=O)(C(C(C)=O)C(C=O)O)=O,4,2,0,2,27,9.6e-05
G5,C(CC(CC(CC(C=O)O)=O)=O)=O,2,1,0,1,27,4.8e-05
G5,C(C(C(CCC=O)=O)C(C=O)O)=O,4,2,0,2,44,9.6e-05
G5,C(C(C(C(C)=O)C(C=O)O)O)=O,3,5,0,5,27,0.000239
G5,C(C(CC(CC(C=O)O)=O)O)=O,3,3,0,3,51,0.000143
G5,C(C(C(C=CCO)=O)C(C=O)O)=O,8,3,0,3,0,0.000155
G5,C(OCC(CC(C=O)O)=O)=O,2,3,0,3,0,0.000143
G5,C(OC(C(C)=O)C(C=O)O)=O,4,3,0,3,35,0.000144
G5,C(COC(C(CO)=O)C(C=O)O)=O,4,2,0,2,27,9.6e-05
G5,C(COCC(C(C(C=O)O)O)=O)=O,4,2,0,2,27,9.6e-05
G5,C(C(C(C=O)OCC(CO)=O)O)=O,4,2,0,2,27,9.6e-05
G5,C(COC(C(CC(C=O)O)=O)O)=O,4,3,0,3,0,0.000143
G5,C(C(C(C=O)OC(C(C)=O)O)O)=O,8,7,0,7,45,0.000333
G5,C(C(CC(COC(C=O)O)=O)O)=O,4,5,0,5,51,0.00023799999999999998
G5,C(C(C(C(C)=O)OC(C=O)O)O)=O,8,6,0,6,0,0.000286
G5,C(OC(C=O)C(C=O)O)=O,4,2,0,2,28,9.6e-05
G5,C(CO)(OC(C=O)C(C=O)O)=O,4,4,0,4,40,0.00019099999999999998
G5,C(C)(OC(C=O)C(C=O)O)=O,4,2,0,2,28,9.6e-05
G5,C(CC(C(C=O)=O)C(C=O)O)=O,4,3,0,3,0,0.000144
G5,C(C(C1C(C(CC(O1)O)O)=O)O)=O,16,4,0,4,27,0.00019099999999999998
G5,C(C(C(C(C(O)=O)=O)O)O)=O,4,4,0,4,33,0.000202
G5,C(C(C(C(C)=O)C(C(O)=O)=O)O)=O,4,3,0,3,0,0.000155
G5,C(C(CC(CC(C(O)=O)=O)=O)O)=O,2,2,0,2,0,0.00010700000000000001
G5,C(C(C(C(O)=O)=O)C(C=O)O)=O,4,4,0,4,45,0.000202
G5,C(C(C(C)=O)C(C=O)O)(O)=O,4,9,0,9,27,0.00044100000000000004
G5,C(C(C(C(C=CC(O)=O)=O)O)O)=O,8,3,0,3,18,0.000155
G5,C(C(C(C(C(CO)=O)=O)O)O)=O,4,4,0,4,5,0.00019099999999999998
G5,C(C(C=O)(C(CC(C=O)O)=O)O)=O,2,1,0,1,1,4.8e-05
G5,C(C(C(C(CC(C=O)O)=O)=O)O)=O,4,1,0,1,25,4.8e-05
G5,C(C(C(C(C(C(C)O)=O)=O)O)O)=O,8,3,0,3,0,0.000144
G5,C(C(C(C(C(C=C)=O)=O)O)O)=O,4,2,0,2,7,9.6e-05
G5,C(C(CC(C(C(C)O)=O)=O)O)=O,4,4,0,4,29,0.000202
G5,C(C(C(C(CO)=O)=O)C(C=O)O)=O,4,2,0,2,0,9.6e-05
G5,C(CC(C(C(C(C=O)O)O)=O)=O)=O,4,2,0,2,0,9.6e-05
G5,C(C(C=O)(C(C=O)C(C=O)O)O)=O,4,4,0,4,1,0.000192
G5,C(C(C1C(C(C(C1)=O)O)=O)O)=O,8,4,0,4,29,0.00019099999999999998
G5,C1(CC(C(CO1)=O)C(C=O)O)=O,4,2,0,2,0,9.6e-05
G5,C1(CCC(C(C(C=O)O)O1)=O)=O,4,3,0,3,7,0.000144
G5,C(C(C1C(CC(CO1)=O)=O)O)=O,4,3,0,3,54,0.000144
G5,C(C(C1C(COCC1=O)=O)O)=O,2,3,0,3,54,0.000144
G5,C(C(C1C(C(C(CO)O1)O)=O)O)=O,16,2,0,2,27,9.6e-05
G5,C1(C(O)OC(CO)C1C(C=O)O)=O,16,3,0,3,27,0.000144
G5,C1(COC(CO)(C1C(C=O)O)O)=O,8,3,0,3,27,0.000144
G5,C(C(C1C(CC(CO)(O1)O)=O)O)=O,8,3,0,3,27,0.000144
G5,C(C(C1C(C(OC1)=O)=O)O)=O,4,3,0,3,28,0.000144
G5,C1(C(C(CO1)=O)C(C=O)O)=O,4,4,0,4,28,0.00019099999999999998
G5,C1(CC(C(C(C=O)O)O1)=O)=O,4,4,0,4,28,0.00019099999999999998
G5,C(C(C1C(C(C(CO1)O)O)=O)O)=O,16,2,0,2,27,9.6e-05
G5,C1(C(O)OCC(C1C(C=O)O)O)=O,16,3,0,3,27,0.000144
G5,C1(C(C(C(CO1)=O)C(C=O)O)O)=O,8,2,0,2,27,9.6e-05
G5,C1(C(CC(C(C(C=O)O)O1)=O)O)=O,8,2,0,2,27,9.6e-05
G5,C(C(C1C(C=CO1)=O)O)=O,4,3,0,3,28,0.000144
G5,C(C(C1C(C=CC(O)O1)=O)O)=O,8,3,0,3,27,0.000144
G5,C(CCC(C(C=O)=O)C(C=O)O)=O,4,3,0,3,0,0.000145
G5,C(CO)(C(CCC=O)C(C=O)O)=O,4,5,0,5,4,0.000239
G5,C(CC(C=O)O)(C(CCO)O)=O,4,5,0,5,0,0.00026000000000000003
G5,C(C(CC(C=CC(CO)=O)=O)O)=O,4,2,0,2,0,0.00010700000000000001
G5,C(C(C=CC(CO)=O)C(C=O)O)=O,8,2,0,2,45,0.00010700000000000001
G5,C(C(CC(C(C=CCO)=O)=O)O)=O,4,2,0,2,0,0.00010700000000000001
G5,C(C(C(C(C=CC=O)=O)CO)O)=O,8,3,0,3,27,0.000155
G5,C(C(C(C(CO)=O)C(C=C)=O)O)=O,4,3,0,3,27,0.000155
G5,C(C(C(C(C(C=C)=O)=O)CO)O)=O,4,5,0,5,0,0.000254
G5,C(C(C(C(CO)=O)C=CC=O)O)=O,8,2,0,2,0,0.00010700000000000001
G5,C(C(C(C=CCO)C(C=O)=O)O)=O,8,2,0,2,0,0.00010700000000000001
G5,C(CC(C(CC(C=O)O)=O)O)(O)=O,4,2,0,2,20,0.00010700000000000001
G5,C(C(C1C(C(CO)(CO1)O)=O)O)=O,8,4,0,4,10,0.000195
G5,C1(C(CO)(O)OCC1C(C=O)O)=O,8,3,0,3,34,0.000146
G5,C(C(C1C(CCC(C1=O)=O)=O)O)=O,4,2,0,2,45,9.6e-05
G5,C(C(C1C(C(CC(C1)=O)=O)=O)O)=O,4,1,0,1,45,4.8e-05
G5,C(C(C1C(CC(C(C1)=O)=O)=O)O)=O,4,1,0,1,45,4.8e-05
G5,C(C1C(C(C(C1)C(C=O)O)=O)=O)=O,8,1,0,1,45,4.8e-05
G5,C1(CC(CC(C1C(C=O)O)=O)=O)=O,2,2,0,2,45,9.6e-05
G5,C(C1C(C(C(C1)=O)C(C=O)O)=O)=O,8,2,0,2,45,9.6e-05
G5,C(C1C(CC(C1C(C=O)O)=O)=O)=O,8,1,0,1,45,4.8e-05
G5,C(C(C1C(C(CC1C=O)=O)=O)O)=O,8,2,0,2,0,9.6e-05
G5,C(C1C(CC(C1=O)C(C=O)O)=O)=O,8,1,0,1,45,4.8e-05
G5,C1(C(C(C=CC1C(C=O)O)=O)O)=O,8,1,0,1,32,4.8e-05
G5,C1(C(C=CC(C1C(C=O)O)=O)O)=O,8,2,0,2,45,9.6e-05
G5,C(C(C(C(C(CC)=O)=O)O)O)=O,4,3,0,3,42,0.000144
G5,C(C(C(C(C=O)=O)C(C=O)C)O)=O,8,2,0,2,28,9.6e-05
G5,C(C(C(C(C)=O)C(C(C)=O)=O)O)=O,4,2,0,2,14,9.6e-05
G5,C(C(CC(C(CC(C)=O)=O)=O)O)=O,2,1,0,1,14,4.8e-05
G5,C(C(CC(CC(C(C)=O)=O)=O)O)=O,2,1,0,1,14,4.8e-05
G5,C(C(C(C(CC(C=O)O)=O)=O)C)=O,4,1,0,1,45,4.8e-05
G5,C(C(C(C(CC)=O)=O)C(C=O)O)=O,4,2,0,2,27,9.6e-05
G5,C(CC(C(C(C)C(C=O)O)=O)=O)=O,4,1,0,1,27,4.8e-05
G5,C(CCC(C(CC(C=O)O)=O)=O)=O,2,1,0,1,46,4.8e-05
G5,C(C(C(C=O)C(C(C=O)=O)C)O)=O,8,1,0,1,45,4.8e-05
G5,C(CO)(C(C)C(C=O)C(C=O)O)=O,8,1,0,1,0,4.8e-05
G5,C(C(C(C(C(CCO)=O)=O)C)O)=O,4,2,0,2,0,9.8e-05
G5,C(C(C(C(C(CC)=O)=O)CO)O)=O,4,4,0,4,0,0.000195
G5,C(C)(C(C(CCO)=O)C(C=O)O)=O,4,4,0,4,27,0.000204
G5,C(C)(CC(C(CO)C(C=O)O)=O)=O,4,4,0,4,49,0.000195
G5,C(CC(C=O)O)(CC(CCO)=O)=O,2,3,0,3,30,0.000156
G5,C(C(C(C=O)C(C=O)CCO)O)=O,8,5,0,5,45,0.000251
G5,C(C(C(C(CO)=O)C(C=O)C)O)=O,8,2,0,2,28,9.6e-05
G5,C(C(CC(C(C(CO)C)=O)=O)O)=O,4,2,0,2,0,9.8e-05
G5,C(C(C)C(C(CC(C=O)O)=O)O)=O,8,1,0,1,27,4.8e-05
G5,C(C(CC(C(C(C=C)=O)O)=O)O)=O,4,1,0,1,9,4.8e-05
G5,C(C(CC(C(C=CC=O)O)=O)O)=O,8,1,0,1,45,4.8e-05
G5,C(C(C(CC(C=O)O)=O)C(C)=O)=O,4,1,0,1,6,4.8e-05
G5,C(C)(C(C(CC(C=O)O)=O)CO)=O,4,4,0,4,49,0.000205
G5,C(C(C=O)C(C=O)C(C=O)O)=O,4,3,0,3,29,0.000143
G5,C(C(C(C)=O)C(C=O)C(C=O)O)=O,8,1,0,1,45,4.8e-05
G5,C(C(C(CC(C=O)O)=O)CC=O)=O,4,1,0,1,45,4.8e-05
G5,C(C(C1C(C(CO)=CC1=O)=O)O)=O,4,2,0,2,45,9.6e-05
G5,C(C(C1C=C(C(C1=O)=O)CO)O)=O,4,1,0,1,45,4.8e-05
G5,C(C(C1C(C(C(C1O)=O)=C)=O)O)=O,8,2,0,2,45,9.6e-05
G5,C1(C(C(C(C1C(C=O)O)=C)=O)O)=O,8,1,0,1,47,4.8e-05
G5,C1(C(C(C(C1C(C=O)O)=O)=C)O)=O,8,2,0,2,45,9.6e-05
G5,C(C(C1C(C(C(C1O)=C)=O)=O)O)=O,8,2,0,2,45,9.6e-05
G5,C(C(C1C(C=C(C=O)C1O)=O)O)=O,8,2,0,2,45,9.6e-05
G5,C1(C(C(C=O)=CC1C(C=O)O)O)=O,8,1,0,1,27,4.8e-05
G5,C1(C(C=C(C=O)C1C(C=O)O)O)=O,8,1,0,1,45,4.8e-05
G5,C(C(C1C(C(C=O)=CC1O)=O)O)=O,8,2,0,2,45,9.6e-05
G5,C(C(C(C(C=O)=O)C(C=C)O)O)=O,8,4,0,4,0,0.000192
G5,C(C(C(C(C=C)O)=O)C(C=O)O)=O,8,3,0,3,27,0.000144
G5,C(C(C=O)O)(C(C=C)C(C=O)O)=O,8,1,0,1,4,4.8e-05
G5,C(C(C(C(C=C)=O)C(C=O)O)O)=O,3,2,0,2,27,9.6e-05
G5,C(C1(C(C(C=C1)C(C=O)O)=O)O)=O,8,1,0,1,45,4.8e-05
G5,C(C(CC(C1C=CC(O1)=O)=O)O)=O,4,1,0,1,48,4.8e-05
G5,C(C(C(C=O)C1C=CC(O1)=O)O)=O,8,2,0,2,48,9.6e-05
G5,C(C(CC(C1C(C=CO1)=O)=O)O)=O,4,1,0,1,9,4.8e-05
G5,C(C(C(C=O)C1C(C=CO1)=O)O)=O,8,2,0,2,45,9.6e-05
G5,C(C(C1C(C=CC(OC1)=O)=O)O)=O,4,2,0,2,19,9.6e-05
G5,C(C(C1C(COC(C=C1)=O)=O)O)=O,4,1,0,1,48,4.8e-05
G5,C(C(C1C(CC=CC(O1)=O)=O)O)=O,4,2,0,2,48,9.6e-05
G5,C(C(C1C(C(C=COC1)=O)=O)O)=O,4,2,0,2,45,9.6e-05
G5,C(C(C1C(COC=CC1=O)=O)O)=O,4,2,0,2,38,9.6e-05
G5,C(C(C1C(CC(C=CO1)=O)=O)O)=O,4,2,0,2,38,9.6e-05
G5,C1(C(C(C=CCO1)=O)C(C=O)O)=O,4,2,0,2,19,9.6e-05
G5,C(C(C1C(C(C=CCO1)=O)=O)O)=O,4,2,0,2,36,9.6e-05
G5,C1(CC=CC(C(C(C=O)O)O1)=O)=O,4,2,0,2,48,9.6e-05
G5,C(C(C1C(C=CC(CO1)=O)=O)O)=O,4,2,0,2,45,9.6e-05
G5,C(C(C1C(C(OC1)=CC=O)=O)O)=O,8,2,0,2,45,9.6e-05
G5,C(C(C1C(COC1=CC=O)=O)O)=O,8,2,0,2,45,9.6e-05
G5,C(C(C1C(CC(O1)=CC=O)=O)O)=O,8,2,0,2,45,9.6e-05
G5,C1(C(C=O)OC(C1C(C=O)O)=C)=O,8,2,0,2,26,9.6e-05
G5,C(C1C(C(C(O1)=C)=O)C(C=O)O)=O,8,2,0,2,14,9.6e-05
G5,C(C(C1C(C=C(C=O)OC1)=O)O)=O,4,2,0,2,30,9.6e-05
G5,C(C(C1C(COC(C=O)=C1)=O)O)=O,4,1,0,1,12,4.8e-05
G5,C(C(C1C(CC=C(C=O)O1)=O)O)=O,4,2,0,2,12,9.6e-05
G5,C1(C(C=O)OC=CC1C(C=O)O)=O,8,1,0,1,37,4.8e-05
G5,C(C1C(C(C=CO1)=O)C(C=O)O)=O,8,2,0,2,37,9.6e-05
G5,C(C(C(C(C(C=C)O)=O)O)O)=O,8,5,0,5,31,0.000239
G5,C(C(C(C(C=O)=O)C(C=O)=C)O)=O,4,1,0,1,45,4.8e-05
G5,C(C(C(C(CO)=C)C(C=O)=O)O)=O,4,1,0,1,49,4.8e-05
G5,C(C(C(C(CO)=O)C(C=O)=C)O)=O,4,1,0,1,16,4.8e-05
G5,C(C(CC(C(C(C=O)=C)O)=O)O)=O,4,1,0,1,45,4.8e-05
G5,C(C(C(C=C)C(C=O)=O)O)=O,4,2,0,2,0,9.6e-05
G5,C(C(CC(C=CC=O)=O)O)=O,4,2,0,2,20,9.6e-05
G5,C(C(C(C(C(C=O)=C)=O)O)O)=O,4,3,0,3,9,0.000144
G5,C(C(C(C(C(C=O)=CC)=O)O)O)=O,8,2,0,2,45,9.6e-05
G5,C(C(C(C(C(C=O)O)O)=O)C=C)=O,8,2,0,2,45,9.6e-05
G5,C(C(C(CO)=CC=O)C(C=O)O)=O,8,1,0,1,46,4.8e-05
G5,C(C(C(C(C=O)O)=C)C(C=O)O)=O,8,1,0,1,6,4.8e-05
G5,C(C(CO)O)(C(C=C)C(C=O)O)=O,8,5,0,5,11,0.000264
G5,C(C(C(C(CO)O)=C)C(C=O)O)=O,8,1,0,1,27,4.8e-05
G5,C(C(C(C=O)=CCO)C(C=O)O)=O,8,1,0,1,3,4.8e-05
G5,C(C(CO)C(C=O)O)(C(C=C)O)=O,8,4,0,4,0,0.000195
G5,C(C(C(CO)=CCO)C(C=O)O)=O,8,1,0,1,3,4.8e-05
G5,C(C(C(C(CO)=O)C(CO)=C)O)=O,4,1,0,1,49,4.8e-05
G5,C(C(CC(C(C(CO)=C)O)=O)O)=O,4,1,0,1,49,4.8e-05
G5,C(C(C=CC(C=O)O)C(C=O)O)=O,16,1,0,1,43,4.8e-05
G5,C(C(C(CC(C=O)O)=O)(C=C)O)=O,4,1,0,1,27,4.8e-05
G5,C(CC(C=O)O)(C(C=C)(CO)O)=O,4,4,0,4,29,0.000215
G5,C(C(C1OCC(C=1)=O)C(C=O)O)=O,4,2,0,2,48,9.6e-05
G5,C(CC1OC(C(C=1)=O)C(C=O)O)=O,4,2,0,2,48,9.6e-05
G5,C(C1C(C(C(O)O1)=O)C(C=O)O)=O,16,3,0,3,0,0.000144
G5,C1(C(O)OC(C)C1C(C=O)O)=O,16,3,0,3,45,0.000144
G5,C(C(C1C(C(C(C)(O1)O)O)=O)O)=O,16,3,0,3,0,0.000144
G5,C(C(C1C(C(C(O1)O)O)=O)O)=O,16,3,0,3,5,0.000144
G5,C1(C(C(O)OCC1O)C(C=O)O)=O,16,3,0,3,27,0.000144
G5,C1(C(COC(C1O)O)C(C=O)O)=O,16,3,0,3,27,0.000144
G5,C(C(C(C(C=O)=O)CCO)O)=O,4,3,0,3,27,0.000143
G5,C(C(C(C(C=O)=O)CCCO)O)=O,4,2,0,2,0,9.6e-05
G5,C(C(C(C(C=O)=O)CC(C)O)O)=O,8,2,0,2,0,9.6e-05
G5,C(CO)(C(CCO)C(C=O)O)=O,4,7,0,7,55,0.00035499999999999996
G5,C(CO)(C(CCCO)C(C=O)O)=O,4,4,0,4,46,0.00019099999999999998
G5,C(CO)(C(CC(C)O)C(C=O)O)=O,8,4,0,4,46,0.00019099999999999998
G5,C(C(C(C=O)C(C=O)C(C)O)O)=O,16,4,0,4,43,0.000193
G5,C(C(C=CC=O)C(C=O)O)=O,8,4,0,4,29,0.00018999999999999998
G5,C(CC(CC(C(CO)O)=O)O)(O)=O,4,4,0,4,28,0.000205
G5,C(C(C=O)(CC(C(CO)O)=O)O)=O,2,5,0,5,1,0.000264
G5,C(C(CO)O)(CC(C)(CCO)O)=O,4,3,0,3,29,0.000165
G5,C(CC(C)(C(CO)O)O)(CCO)=O,4,2,0,2,6,0.00010700000000000001
G5,C(C)(C(CO)C(C)(C(CO)O)O)=O,8,3,0,3,28,0.000154
G5,C(C(CO)O)(CC(C)(C)O)=O,2,1,0,1,28,4.8e-05
G5,C(C)(CC(C)(C(CO)O)O)=O,4,1,0,1,28,4.8e-05
G5,C(OC(C=O)C(C)(C(CO)O)O)=O,8,2,0,2,28,9.6e-05
G5,C(CCC(CC(C(CO)O)=O)O)=O,4,2,0,2,2,9.6e-05
G5,C(C(C(C)(C(CO)O)O)CC=O)=O,8,4,0,4,45,0.000213
G5,C(CC(C=CCO)O)(C(CO)O)=O,8,2,0,2,43,0.00010700000000000001
G5,C(C(CO)O)(CC(C(C=C)O)O)=O,8,1,0,1,28,4.8e-05
G5,C(CC1(C=COC1)O)(C(CO)O)=O,4,1,0,1,28,4.8e-05
G5,C1OC(C(C=1)=O)C(C)(C(CO)O)O,8,2,0,2,28,9.6e-05
G5,C(CC(C(CC)=O)O)(C(CO)O)=O,4,1,0,1,28,4.8e-05
G5,C(C(CC)(CC(C(CO)O)=O)O)=O,4,1,0,1,28,4.8e-05
G5,C(C(C(C)C(C)(C(CO)O)O)=O)=O,8,1,0,1,28,4.8e-05
G5,C(CC(C=C)O)(C(CO)O)=O,4,3,0,3,11,0.000143
G5,C(CC(C=CC)O)(C(CO)O)=O,8,2,0,2,28,9.499999999999999e-05
G5,C(C(CO)O)(CC(CC=C)O)=O,4,2,0,2,28,9.499999999999999e-05
G5,C(C(C=C)C(C)(C(CO)O)O)=O,8,2,0,2,28,9.499999999999999e-05
G5,C(CO)(C(C(C)(C)O)C(C=O)O)=O,4,2,0,2,27,9.499999999999999e-05
G5,C(CC(C=O)O)(C(C(C)(C)O)O)=O,4,2,0,2,27,9.499999999999999e-05
G5,C(C)(CC(C(CC(CO)=O)O)O)=O,4,2,0,2,27,9.6e-05
G5,C(C(CC(CO)(CC(C)=O)O)O)=O,4,1,0,1,27,4.8e-05
G5,C(C(C(C(CO)=O)C(C=C)O)O)=O,8,2,0,2,27,9.499999999999999e-05
G5,C(C(CC(C(C(C=C)O)O)=O)O)=O,8,3,0,3,27,0.000154
G5,C(C(CO)C(C(C=O)CO)O)=O,3,5,0,5,18,0.000242
G5,C(C(CO)C(C(CCO)=O)(C)O)=O,4,4,0,4,14,0.000204
G5,C(C(C)=O)(C(CO)C(CCO)O)=O,4,5,0,5,18,0.00025299999999999997
G5,C(C(CO)C(C)(C(C=O)CO)O)=O,3,4,0,4,6,0.000195
G5,C(CC(C(CO)C(CCO)O)=O)=O,4,4,0,4,18,0.000195
G5,C(C(C(CC(CCO)O)=O)CO)=O,4,3,0,3,18,0.000147
G5,C(C(C(CCO)=O)C(CCO)O)=O,4,3,0,3,2,0.000145
G5,C(C(CO)C(C(C=O)C(C)O)O)=O,16,8,0,8,4,0.000388
G5,C(C(C(C(CCO)=O)=O)O)(O)=O,2,8,0,8,2,0.000394
G5,C(CC(C(C(CO)O)=O)=O)(O)=O,2,7,0,7,17,0.000359
G5,C(C(C(C(CO)=O)=O)CO)(O)=O,2,6,0,6,17,0.00029
G5,C(C(C=O)C(C(C=O)CO)O)=O,4,8,0,8,45,0.00038500000000000003
G5,C(C(C=O)C(C(CCO)=O)(C)O)=O,2,4,0,4,14,0.000204
G5,C(CC(C(C(C(C)=O)=O)CO)O)=O,4,7,0,7,14,0.00035
G5,C(C(C=O)C(C)(C(C=O)CO)O)=O,4,6,0,6,6,0.00029
G5,C(C(CO)C(CC(CC=O)=O)O)=O,4,5,0,5,45,0.00024300000000000002
G5,C(C(CO)C(CC=O)O)(CC=O)=O,4,4,0,4,45,0.000195
G5,C(C(C(CC(CC=O)O)=O)CO)=O,4,3,0,3,45,0.000147
G5,C(C(CO)C(C(C=O)C(C)=O)O)=O,8,6,0,6,6,0.00029
G5,C(C(C(CCO)=O)C(CC=O)O)=O,4,3,0,3,2,0.000145
G5,C(C(CO)C(C(C(C=C)=O)O)O)=O,8,7,0,7,45,0.000338
G5,C(C(C(O)=O)C(C(CO)O)=O)(O)=O,2,5,0,5,17,0.000254
G5,C(C(C(C(C(O)=O)O)=O)CO)(O)=O,4,8,0,8,17,0.00040899999999999997
G5,C(CC(O)=O)(C(C(C=O)=O)CO)=O,2,6,0,6,2,0.000301
G5,C(C(C(C(CC(O)=O)=O)=O)CO)=O,2,5,0,5,17,0.000242
G5,C(C(C(C(C)=O)=O)CO)(O)=O,2,9,0,9,17,0.000455
G5,C(C(C(CC=O)=O)CO)(O)=O,2,6,0,6,17,0.00029
G5,C(C(C(CC(O)=O)=O)CO)=O,2,5,0,5,17,0.000242
G5,C(C(C=O)C(CCO)=O)(O)=O,2,6,0,6,2,0.000288
G5,C(C1C(C(CO)OC1O)=O)(O)=O,8,5,0,5,17,0.00024300000000000002
G5,C(C1C(C(CO)C(O1)O)=O)(O)=O,8,5,0,5,17,0.00024300000000000002
G5,C(CCO)(C(C=O)C(C(O)=O)O)=O,4,4,0,4,2,0.000204
G5,C(C(C)=O)(C(CO)C(C(C)O)O)=O,8,5,0,5,11,0.00025299999999999997
G5,C(C(CCO)=O)(CC(C(C)O)O)=O,4,3,0,3,11,0.000156
G5,C(CC(C(CO)C(C(C)O)O)=O)=O,8,4,0,4,11,0.000195
G5,C(C(C(CC(C(C)O)O)=O)CO)=O,8,3,0,3,11,0.000147
G5,C(C(C(CCO)=O)C(C(C)O)O)=O,8,3,0,3,2,0.000145
G5,C(CC(C(CO)CO)=O)=O,1,5,0,5,2,0.000241
G5,C(C(C(CCO)=O)CO)=O,2,7,0,7,2,0.000338
G5,C1(C(CO)OC(C1CO)O)=O,8,6,0,6,2,0.000293
G5,C(C(C(C(CO)CO)=O)(CO)O)=O,2,4,0,4,2,0.000198
G5,C(C(CO)(CO)O)(C(CO)CO)=O,1,4,0,4,2,0.000198
G5,C(C(C=CC(C(CO)CO)=O)=O)=O,2,2,0,2,2,9.9e-05
G5,C(C(C=CC=O)=O)(C(CO)CO)=O,2,2,0,2,14,9.9e-05
G5,C(C(C)(CC(CO)=O)O)(CCO)=O,2,3,0,3,14,0.000156
G5,C(C(C)(C(C(C)=O)O)O)(CCO)=O,4,4,0,4,14,0.000204
G5,C(C(C)=O)(C(CO)C(C)(CO)O)=O,4,5,0,5,49,0.000254
G5,C(C(CCO)=O)(CC(C)(CO)O)=O,2,3,0,3,49,0.000156
G5,C(C(CO)C(C)(CC(CO)=O)O)=O,4,6,0,6,6,0.000301
G5,C(C(CO)C(C)(C(C(C)=O)O)O)=O,8,6,0,6,6,0.000291
G5,C(CC(C(CO)C(C)(CO)O)=O)=O,4,4,0,4,49,0.000195
G5,C(C(C(CC(C)(CO)O)=O)CO)=O,4,3,0,3,49,0.000147
G5,C(C(C(CCO)=O)C(C)(CO)O)=O,4,3,0,3,2,0.000145
G5,C(C(C)(CC=O)O)(C(CO)O)=O,4,6,0,6,25,0.000301
G5,C(C(C(C(C)O)O)=O)(CCO)=O,4,8,0,8,2,0.000395
G5,C(C(C(CO)O)=O)(CC(C)O)=O,4,6,0,6,4,0.000301
G5,C(C(CO)=O)(C(CO)C(C)O)=O,4,6,0,6,4,0.000291
G5,C(CC(C(C(C(C)=O)CO)=O)O)=O,4,4,0,4,26,0.000206
G5,C(C)(C(CO)C(C=O)(CC=O)O)=O,4,7,0,7,23,0.000349
G5,C(CC(C)O)(C(C(C=O)=O)CO)=O,4,5,0,5,2,0.00024300000000000002
G5,C(C(C)(CC=O)O)(C(C=O)CO)=O,4,3,0,3,14,0.000148
G5,C(C(C(C(CC(C)O)=O)=O)CO)=O,4,5,0,5,4,0.00024300000000000002
G5,C(C(C)(CC=O)O)(CCO)=O,2,4,0,4,14,0.000204
G5,C(C(C)=O)(C(CO)C(C)O)=O,4,8,0,8,4,0.000398
G5,C(C(CCO)=O)(CC(C)O)=O,2,7,0,7,2,0.00034700000000000003
G5,C(CC(CC(CCO)=O)O)=O,2,5,0,5,29,0.000252
G5,C(CC(C(C(C)=O)CO)O)=O,4,7,0,7,6,0.00035
G5,C(CC(C(CO)C(C)O)=O)=O,4,6,0,6,4,0.000291
G5,C(C(C(CC(C)O)=O)CO)=O,4,6,0,6,4,0.00029
G5,C(C(C(CCO)=O)C(C)O)=O,4,6,0,6,2,0.00028900000000000003
G5,C1(C(CO)OC(C1C(C)O)O)=O,16,5,0,5,4,0.000244
G5,C1(C(C(C)O)OC(C1CO)O)=O,16,5,0,5,4,0.000244
G5,C(C)(C(CO)C(C(O)=O)O)=O,4,10,0,10,2,0.000513
G5,C(C(CO)C(C(O)=O)O)(C(C)O)=O,8,5,0,5,24,0.000263
G5,C(C(CO)C(C(C(O)=O)(C)O)O)=O,8,6,0,6,25,0.000301
G5,C(C(CO)C(C(O)=O)(C(C)O)O)=O,8,7,0,7,4,0.000361
G5,C(C(C(C(C(C)=O)CO)O)O)(O)=O,8,8,0,8,17,0.00041799999999999997
G5,C(CCO)(CC(C(C(O)=O)O)O)=O,4,6,0,6,2,0.000321
G5,C(C(CO)CC(C(O)=O)(CO)O)=O,4,2,0,2,29,0.00010800000000000001
G5,C(C(CO)CC(C(C(O)=O)O)O)=O,8,4,0,4,5,0.00021400000000000002
G5,C(C(C=CC(CCO)=O)O)(O)=O,4,4,0,4,29,0.00021400000000000002
G5,C(C(C=CC(C(O)=O)O)CO)=O,8,4,0,4,29,0.00021400000000000002
G5,C(C(C(C(C=C)=O)CO)O)(O)=O,4,5,0,5,2,0.000263
G5,C(C(C=C)(C(C=O)CO)O)(O)=O,4,7,0,7,7,0.000359
G5,C(C(C(CCO)=O)=O)=O,1,10,0,10,0,0.00047699999999999994
G5,C(C)(C(C(C(C=O)=O)=O)CO)=O,2,5,0,5,27,0.000241
G5,C(CCO)(CC(C(C=O)=O)=O)=O,1,4,0,4,29,0.000192
G5,C(CC(C(C(C=O)=O)=O)CO)=O,2,4,0,4,29,0.000192
G5,C(C(CO)CC(C(C=O)=O)=O)=O,2,3,0,3,29,0.000144
G5,C(C(C(C(C(C)=O)=O)CO)=O)=O,2,6,0,6,29,0.00028900000000000003
G5,C(C(CC(C(CCO)=O)=O)=O)=O,1,4,0,4,29,0.000192
G5,C(C(C(CC(C=O)=O)=O)CO)=O,2,7,0,7,29,0.000336
G5,C(C(C=CC(C(CO)O)=O)=O)=O,4,5,0,5,12,0.000241
G5,C(C(CO)C(C(C=O)=O)(CO)O)=O,4,2,0,2,29,9.9e-05
G5,C(C(C=O)C(C(CO)=O)CO)=O,2,5,0,5,2,0.000239
G5,C(CCO)(CCO)=O,1,8,0,8,2,0.000393
G5,C(C)(C(CO)CO)=O,1,6,0,6,28,0.0003
G5,C(C(C(CC=O)=O)CO)=O,2,6,0,6,29,0.00028900000000000003
G5,C(C(C(CC(C)=O)=O)CO)=O,2,8,0,8,29,0.000395
G5,C(CC=O)(C(C(C)=O)CO)=O,2,7,0,7,29,0.00034700000000000003
G5,C(CC(CC(CCO)=O)=O)=O,1,6,0,6,29,0.000298
G5,C(C(C(CCC=O)=O)CO)=O,2,6,0,6,29,0.0003
G5,C(C(C(C=CCO)=O)CO)=O,4,8,0,8,29,0.00040599999999999995
G5,C(OCC(CCO)=O)=O,1,7,0,7,0,0.000334
G5,C(OC(C(C)=O)CO)=O,2,8,0,8,35,0.000384
G5,C(COCC=O)(C(CO)O)=O,2,7,0,7,2,0.00034700000000000003
G5,C(COC(C(CCO)=O)O)=O,2,6,0,6,2,0.00028700000000000004
G5,C(COC(C=O)O)(CCO)=O,2,7,0,7,2,0.00034500000000000004
G5,C(OC(C=O)CO)=O,2,5,0,5,49,0.000241
G5,C(C(CO)OC(CO)=O)=O,2,4,0,4,40,0.000194
G5,C(C(CO)OC(C)=O)=O,2,4,0,4,1,0.000194
G5,C(C(CO)O)(C(COCC=O)O)=O,4,5,0,5,36,0.000241
G5,C(C(CO)OCC(C(CO)=O)O)=O,4,3,0,3,36,0.000146
G5,C(OCCC(C(C(CO)O)=O)O)=O,4,5,0,5,19,0.000241
G5,C(CC(OCC(C(CO)O)=O)O)=O,4,7,0,7,38,0.000336
G5,C(CC(OC(C(CO)=O)CO)O)=O,4,7,0,7,38,0.000336
G5,C(C(C(OCC(CO)=O)O)CO)=O,4,6,0,6,5,0.00028900000000000003
G5,C(C)(C(C(C(O)=O)=O)CO)=O,2,6,0,6,2,0.0003
G5,C(C(C(C(O)=O)=O)CO)=O,2,5,0,5,45,0.00025299999999999997
G5,C(CC(CCO)=O)(O)=O,1,10,0,10,17,0.0005
G5,C(C(C(C)=O)CO)(O)=O,2,8,0,8,6,0.000408
G5,C(C(C(C(CO)O)=O)(CO)O)=O,4,7,0,7,2,0.000362
G5,C(C(C=O)(C(C(CO)O)=O)O)=O,2,4,0,4,4,0.000205
G5,C(C(CO)C(C(CO)=O)(CO)O)=O,4,10,0,10,2,0.000504
G5,C(C(C(C(CO)=O)=O)CO)=O,2,4,0,4,0,0.000194
G5,C(C(C=O)CO)(OCC(C)=O)=O,2,7,0,7,48,0.000336
G5,C(CC=O)(OC(C(C)=O)CO)=O,2,8,0,8,48,0.000384
G5,C(CC=O)(OCC(CCO)=O)=O,1,8,0,8,2,0.00038199999999999996
G5,C(COC(C(C=O)=O)CO)(C)=O,2,5,0,5,2,0.000241
G5,C(C)(C(CO)OCC(C=O)=O)=O,2,7,0,7,17,0.000336
G5,C(COCC(C=O)=O)(CCO)=O,1,6,0,6,2,0.00028700000000000004
G5,C(OC(C(CCO)=O)C(C)=O)=O,2,5,0,5,9,0.000239
G5,C(CC(C(CCO)=O)OC=O)=O,2,4,0,4,2,0.000192
G5,C(C(CO)C(C(C)=O)OC=O)=O,4,3,0,3,17,0.000146
G5,C1(COC(CC1CO)=O)=O,2,4,0,4,2,0.000192
G5,C1(COCC(C1CO)=O)=O,1,5,0,5,2,0.000241
G5,C(C)(C(C(OCC=O)=O)CO)=O,2,4,0,4,19,0.000194
G5,C(CCO)(CC(OCC=O)=O)=O,1,4,0,4,19,0.000192
G5,C(C(CO)OC(CC(C)=O)=O)=O,2,3,0,3,19,0.000146
G5,C(COC(C(C(C)=O)=O)CO)=O,2,3,0,3,36,0.000146
G5,C(COCC(C(CCO)=O)=O)=O,1,4,0,4,36,0.000192
G5,C(C(CO)OCC(C(C)=O)=O)=O,2,4,0,4,36,0.000194
G5,C(OCCC(C(CCO)=O)=O)=O,1,4,0,4,2,0.000192
G5,C(OCC(C(C(C)=O)=O)CO)=O,2,3,0,3,17,0.000146
G5,C(OCC(CC(CCO)=O)=O)=O,1,4,0,4,2,0.000192
G5,C(OCC(C(C(C)=O)CO)=O)=O,2,4,0,4,38,0.000194
G5,C(OC(C(CC(C)=O)=O)CO)=O,2,3,0,3,38,0.000146
G5,C(C(C(CO)OC(C=O)CO)O)=O,8,6,0,6,26,0.00028900000000000003
G5,C(C(CO)OC(CO)=O)(CCO)=O,2,4,0,4,2,0.000192
G5,C1(COC(CO)(C1CO)O)=O,4,6,0,6,2,0.00028900000000000003
G5,C1(C(C(CO1)CO)=O)=O,2,5,0,5,28,0.000241
G5,C1(C(C(CO1)=O)CO)=O,2,7,0,7,2,0.000336
G5,C1(CC(C(CO)O1)=O)=O,2,8,0,8,2,0.000384
G5,C(CC(C=O)OC(C=O)CO)=O,4,6,0,6,40,0.00028900000000000003
G5,C(COC(C=O)C(C=O)CO)=O,4,3,0,3,40,0.000146
G5,C(CCO)(C(C=O)OC(C)=O)=O,2,3,0,3,26,0.000144
G5,C(C(CO)OC(C(C=O)=O)C)=O,4,6,0,6,29,0.00028900000000000003
G5,C(C(C(COC(C=O)CO)O)O)=O,8,5,0,5,37,0.000241
G5,C(C(CO)O)(C(CO)OCC=O)=O,4,5,0,5,2,0.000241
G5,C(C(CO)(OCC=O)O)(CCO)=O,2,3,0,3,2,0.000144
G5,C(C(COC(CO)=O)O)(CCO)=O,2,4,0,4,2,0.000192
G5,C(C(CO)O)(CCOC(CO)=O)=O,2,6,0,6,2,0.00028900000000000003
G5,C(CO)(C(CO)COC(CO)=O)=O,2,5,0,5,2,0.000241
G5,C(C(CO)(OCC(CCO)=O)O)=O,2,3,0,3,2,0.000144
G5,C(CCOC(C=O)=O)(CCO)=O,1,3,0,3,2,0.000144
G5,C(C)(C(COC(C=O)=O)CO)=O,2,3,0,3,30,0.000146
G5,C(C)(C(CO)C(C=O)OC=O)=O,4,3,0,3,37,0.000146
G5,C(CC(C=O)OC=O)(CCO)=O,2,3,0,3,2,0.000144
G5,C(C(C=O)O)(OC(C(C)=O)CO)=O,4,6,0,6,2,0.00028900000000000003
G5,C(C(C=O)O)(OCC(CCO)=O)=O,2,5,0,5,2,0.000239
G5,C(C(CO)OC(C(CCO)=O)=O)=O,2,3,0,3,50,0.000144
G5,C(C(CO)OC(C=O)=O)(CCO)=O,2,3,0,3,2,0.000144
G5,C1(COC(C(C1CO)O)=O)=O,4,6,0,6,2,0.00028900000000000003
G5,C(C(COC(C(CCO)=O)=O)O)=O,2,3,0,3,27,0.000144
G5,C(CO)(C(C(OCC=O)=O)CO)=O,2,4,0,4,2,0.000194
G5,C(C(CO)O)(CC(OCC=O)=O)=O,2,5,0,5,2,0.000241
G5,C(C(CO)OC(CC(CO)=O)=O)=O,2,2,0,2,2,9.9e-05
G5,C(CCO)(C(C(OCC=O)=O)O)=O,2,3,0,3,2,0.000144
G5,C(C(CO)OC(C(C(C)=O)O)=O)=O,4,2,0,2,2,9.9e-05
G5,C(C(COC(C=O)=O)O)(CCO)=O,2,3,0,3,2,0.000144
G5,C(C(CO)O)(CCOC(C=O)=O)=O,2,5,0,5,2,0.000241
G5,C(CO)(C(CO)COC(C=O)=O)=O,2,4,0,4,2,0.000194
G5,C1OC(C(C=1)=O)CO,2,6,0,6,9,0.00028900000000000003
G5,C(COC=CC(C(CO)O)=O)=O,4,6,0,6,38,0.00028900000000000003
G5,C(C(CO)OC=CC(CO)=O)=O,4,3,0,3,38,0.000146
G5,C(OCC=CC(C(CO)O)=O)=O,4,6,0,6,19,0.00028900000000000003
G5,C(C(CO)OC(CO)=CC=O)=O,4,6,0,6,40,0.00028900000000000003
G5,C(C(C(OC(C=O)CO)=C)O)=O,4,6,0,6,26,0.00028900000000000003
G5,C(C(CO)OC(C=CC=O)O)=O,8,6,0,6,37,0.00028900000000000003
G5,C(C(C=COC(C=O)CO)O)=O,8,6,0,6,37,0.00028900000000000003
G5,C(C(CO)C(CO)OC(C=O)O)=O,8,2,0,2,41,9.9e-05
G5,C(C(CO)O)(OC(C(C)=O)CO)=O,4,4,0,4,2,0.000196
G5,C(C(CO)O)(OCC(CCO)=O)=O,2,3,0,3,2,0.000144
G5,C(CCO)(OC(C(CO)=O)CO)=O,2,5,0,5,2,0.000241
G5,C(CCO)(OCC(C(CO)O)=O)=O,2,5,0,5,2,0.000241
G5,C(OC(C(C(CO)O)=O)CCO)=O,4,5,0,5,2,0.000241
G5,C(C(CO)C(COC(C=O)O)O)=O,8,2,0,2,30,9.9e-05
G5,C(CC(C(OC(C=O)CO)O)O)=O,8,7,0,7,37,0.000336
G5,C(C(CO)C(C(OCC=O)O)O)=O,8,2,0,2,37,9.9e-05
G5,C(C(C)(OC(C(CO)=O)CO)O)=O,4,4,0,4,24,0.000194
G5,C(C(C)(OCC(C(CO)O)=O)O)=O,4,5,0,5,24,0.000241
G5,C(C(CO)O)(C(C)OC(C=O)O)=O,8,5,0,5,24,0.000241
G5,C(CC(C=O)O)(OC(C=O)CO)=O,4,5,0,5,8,0.000241
G5,C(CCC(C(C=O)=O)CO)=O,2,3,0,3,7,0.000146
G5,C(CCCC(C(CO)O)=O)=O,2,4,0,4,27,0.000195
G5,C(CCC(C(CO)=O)CO)=O,2,3,0,3,27,0.000146
G5,C1(C(CO)CC(C(C1O)=O)O)=O,8,4,0,4,2,0.000192
G5,C1(C(CC(C(C1CO)=O)O)O)=O,3,4,0,4,32,0.000194
G5,C(C(C(C(C)O)=O)CO)=O,4,5,0,5,45,0.000241
G5,C(C(CO)O)(C(C=O)C(CO)=O)=O,4,5,0,5,2,0.000252
G5,C(C(CO)C(C(C(C=O)O)=O)O)=O,8,6,0,6,5,0.00029
G5,C(C(C(C(C(CO)=O)O)=O)CO)=O,4,3,0,3,2,0.000146
G5,C(CC(C(C(C(CO)O)=O)O)=O)=O,4,4,0,4,2,0.000205
G5,C(C(C=O)O)(C(C(CO)=O)CO)=O,4,4,0,4,15,0.000194
G5,C(C(C=O)O)(CC(C(CO)O)=O)=O,4,5,0,5,15,0.000252
G5,C(C(CC(C)O)O)(C(CO)O)=O,8,5,0,5,11,0.00025299999999999997
G5,C(C(C(C(C(CO)CO)=O)=O)O)=O,2,3,0,3,2,0.000146
G5,C(C(C(C(C(CCO)=O)O)=O)O)=O,4,2,0,2,3,9.7e-05
G5,C(COC(C(C(CO)O)=O)O)(C)=O,4,3,0,3,2,0.000146
G5,C(C)(C(CO)OC(C(CO)=O)O)=O,4,4,0,4,2,0.000194
G5,C(COC(C(CO)=O)O)(CCO)=O,2,2,0,2,2,9.7e-05
G5,C(CO)(COC(C(CO)=O)CO)=O,2,3,0,3,36,0.000146
G5,C(COCC(CO)=O)(C(CO)O)=O,2,3,0,3,36,0.000146
G5,C(CO)(COC(C(CCO)=O)O)=O,2,6,0,6,5,0.00028700000000000004
G5,C(COC(C(C)=O)O)(C(CO)O)=O,4,6,0,6,2,0.00028900000000000003
G5,C(CO)(C(CO)OC(C(C)=O)O)=O,4,5,0,5,2,0.000241
G5,C(C(CO)OC(C(C(C)O)=O)O)=O,8,3,0,3,19,0.000146
G5,C(C(C)O)(C(CO)OC(C=O)O)=O,8,2,0,2,2,9.9e-05
G5,C(C(CO)OC(C(CO)=O)(C)O)=O,4,3,0,3,2,0.000146
G5,C(C(C)(OCC=O)O)(C(CO)O)=O,4,2,0,2,2,9.9e-05
G5,C(C(C(CO)O)=O)(C(C(C)O)O)=O,8,6,0,6,4,0.000302
G5,C=CC(C(C(C(CO)O)=O)=O)O,4,4,0,4,32,0.000194
G5,C(C(CC(C(CO)=O)CO)O)=O,4,6,0,6,29,0.00031
G5,C(C(CO)O)(CCC(C=O)O)=O,4,6,0,6,7,0.000301
G5,C(C(C(CCO)O)=O)(CCO)=O,2,7,0,7,29,0.000357
G5,C(C(C(C)O)=O)(C(CO)CO)=O,2,5,0,5,9,0.00025299999999999997
G5,C(CC(C(C(CO)O)=O)O)(C)=O,4,8,0,8,5,0.000395
G5,C(C)(C(CO)C(C(CO)=O)O)=O,4,9,0,9,5,0.000455
G5,C(CC(C(CO)=O)O)(CCO)=O,2,8,0,8,29,0.00041600000000000003
G5,C(CCC(C(C(CO)O)=O)O)=O,4,4,0,4,27,0.000194
G5,C(C(CO)CC(C(CO)=O)O)=O,4,5,0,5,29,0.000262
G5,C(C(C(CO)O)=O)(CCCO)=O,2,7,0,7,55,0.000359
G5,C(C(CO)O)(C(C=CCO)O)=O,8,5,0,5,29,0.00025299999999999997
G5,C(C(CC(C(C(O)=O)=O)CO)O)=O,4,3,0,3,29,0.000156
G5,C(C(C)O)(C(C(C(O)=O)=O)CO)=O,4,4,0,4,29,0.000205
G5,C(CC(C(C(CCO)=O)=O)O)(O)=O,2,3,0,3,29,0.000156
G5,C(C(C(C(C(C)O)=O)=O)CO)(O)=O,4,7,0,7,17,0.00036
G5,C(C)(C(CO)C(C(C(O)=O)=O)O)=O,4,4,0,4,29,0.000205
G5,C(CC(C(C(O)=O)=O)O)(CCO)=O,2,3,0,3,30,0.000156
G5,C(C(CO)CC(C(C(O)=O)=O)O)=O,4,3,0,3,29,0.000156
G5,C(CCC(C(C(CO)O)=O)=O)(O)=O,2,3,0,3,29,0.00015800000000000002
G5,C(CC(C(C(CO)=O)=O)CO)(O)=O,2,3,0,3,29,0.000156
G5,C(C(CO)O)(C(C=CC(O)=O)O)=O,8,3,0,3,29,0.00015800000000000002
G5,C(CCO)(C(C=O)(C(CO)=O)O)=O,2,2,0,2,0,9.7e-05
G5,C(C(CO)O)(C(C=O)(C(C)=O)O)=O,4,4,0,4,0,0.000205
G5,C(C(C(C(CO)O)=O)(C(C)O)O)=O,8,6,0,6,5,0.000302
G5,C(C(CO)O)(C(C=O)(CC=O)O)=O,4,4,0,4,0,0.000205
G5,C(C(CO)C(C=O)(C(CO)=O)O)=O,4,3,0,3,0,0.000146
G5,C1(C(C(C(CO)C1CO)O)=O)=O,8,4,0,4,2,0.000192
G5,C(CCO)(C1C(C(CO1)O)=O)=O,4,3,0,3,10,0.000144
G5,C1(C(CC(C(CCO)=O)O1)O)=O,4,3,0,3,2,0.000144
G5,C(C(CO)C1CC(C(O1)=O)O)=O,8,4,0,4,23,0.000194
G5,C1(CCC(C(C(CO)O1)=O)O)=O,4,3,0,3,4,0.000146
G5,C1(C(C(C(CCO1)O)=O)CO)=O,4,4,0,4,19,0.000194
G5,C1(C(C(COCC1CO)O)=O)=O,4,3,0,3,36,0.000146
G5,C1(C(C(CO)OCCC1O)=O)=O,4,3,0,3,36,0.000146
G5,C1(C(CO)C(C(OCC1)=O)O)=O,4,5,0,5,30,0.000241
G5,C1(CC(C(OCC1CO)=O)O)=O,4,4,0,4,30,0.000194
G5,C1(C(CC(C(CO1)=O)CO)O)=O,4,3,0,3,2,0.000144
G5,C1(C(CCC(C(CO)O1)=O)O)=O,4,4,0,4,12,0.000194
G5,C1(C(CC(C(C(CO)O1)=O)O)O)=O,8,2,0,2,2,9.9e-05
G5,C(C(C(C=C)O)O)(C(CO)O)=O,8,6,0,6,27,0.00028900000000000003
G5,C1(C(CO)OC(C=CC1O)O)=O,8,4,0,4,38,0.000194
G5,C1C(COC=1C(C(CO)O)=O)O,4,3,0,3,36,0.000146
G5,C(C(CO)O)(C1(C=CCO1)O)=O,4,3,0,3,2,0.000146
G5,C(C(CO)O)(C1C=CC(O1)O)=O,8,4,0,4,38,0.000194
G5,C(C1C(C=CO1)O)(C(CO)O)=O,8,3,0,3,38,0.000146
G5,C(C1(C(CCO1)O)O)(C(CO)O)=O,8,3,0,3,2,0.000146
G5,C1(CC(C(C(C(CO)O)=O)O1)O)=O,8,2,0,2,2,9.9e-05
G5,C(C(CCO)O)(C(CO)CO)=O,2,5,0,5,29,0.000264
G5,C(C)(C(CO)OC(C(CO)O)O)=O,8,3,0,3,29,0.00015800000000000002
G5,C(COC(C(CO)O)O)(CCO)=O,4,2,0,2,29,0.00010800000000000001
G5,C(CO)(C(CO)OC(CO)CO)=O,2,3,0,3,2,0.00015800000000000002
G5,C(COC(CO)CO)(C(CO)O)=O,2,3,0,3,2,0.00015800000000000002
G5,C(C(O)OC(CO)CO)(CCO)=O,2,2,0,2,29,0.00010800000000000001
G5,C(C(CO)OC(CO)O)(CCO)=O,4,2,0,2,2,0.00010800000000000001
G5,C(CO)(C(CO)OCC(CO)O)=O,4,3,0,3,36,0.00015800000000000002
G5,C(COCC(CO)O)(C(CO)O)=O,4,3,0,3,36,0.00015800000000000002
G5,C(C(O)OCC(CO)O)(CCO)=O,4,2,0,2,41,0.00010800000000000001
G5,C(CO)(C(C(O)OCCO)CO)=O,4,3,0,3,38,0.00015800000000000002
G5,C(C(CO)O)(CC(O)OCCO)=O,4,3,0,3,38,0.00015800000000000002
G5,C(C(C(O)OCCO)O)(CCO)=O,4,2,0,2,29,0.00010800000000000001
G5,C(C(COC(CO)O)O)(CCO)=O,4,2,0,2,29,0.00010800000000000001
G5,C(C(CO)O)(CCOC(CO)O)=O,4,3,0,3,2,0.00015800000000000002
G5,C(CO)(C(COC(CO)O)CO)=O,4,3,0,3,2,0.00015800000000000002
G5,C(C(CO)C(CO)(O)OCCO)=O,4,3,0,3,29,0.00015800000000000002
G5,C(C(CO)OC(CO)(CCO)O)=O,4,3,0,3,29,0.00015800000000000002
G5,C(C(CO)OC(C)(C(CO)O)O)=O,8,3,0,3,29,0.00015800000000000002
G5,C(C(CO)OC(CC(CO)O)O)=O,8,3,0,3,29,0.00015800000000000002
G5,C(C(C(CO)CC(CO)O)=O)=O,4,6,0,6,29,0.000321
G5,C(C(CO)O)(C(CO)CCO)=O,4,5,0,5,29,0.000273
G5,C(CCO)(C(CO)C(CO)O)=O,4,5,0,5,29,0.000275
G5,C(CC(CO)O)(C(CO)CO)=O,2,5,0,5,29,0.000264
G5,C(CC(C(C(CO)=O)CO)O)(O)=O,4,6,0,6,28,0.000312
G5,C(C(C(C(CCO)O)=O)CO)(O)=O,4,7,0,7,29,0.00037200000000000004
G5,C(CC(C(C(CO)CO)=O)O)(O)=O,2,4,0,4,29,0.00021600000000000002
G5,C(C(C(C(CO)CCO)=O)O)(O)=O,4,3,0,3,29,0.000167
G5,C(CC(C(CO)C(CO)O)=O)(O)=O,4,4,0,4,29,0.00021600000000000002
G5,C(C(C(CC(CO)O)=O)CO)(O)=O,4,7,0,7,29,0.00037200000000000004
G5,C1(C(CO)(C(CC1CO)O)O)=O,8,4,0,4,2,0.00020299999999999997
G5,C1(CC(C(CO)(C1CO)O)O)=O,8,3,0,3,17,0.00015800000000000002
G5,C1(C(CO)OC(CCO)C1O)=O,8,3,0,3,29,0.00015800000000000002
G5,C1(C(O)OC(CCO)C1CO)=O,8,4,0,4,4,0.000205
G5,C1(C(CCO)OC(C1CO)O)=O,8,5,0,5,4,0.00025299999999999997
G5,C(CC=CC(C(CO)O)=O)=O,4,6,0,6,29,0.0003
G5,C(C(C=CC(CO)=O)CO)=O,4,5,0,5,29,0.000262
G5,C(CO)=CC(C(CCO)=O)=O,2,3,0,3,29,0.000156
G5,C(C=CC(C(CO)CO)=O)=O,2,6,0,6,29,0.0003
G5,C(C(CO)O)(CC(C=C)=O)=O,2,6,0,6,29,0.0003
G5,C(CO)(C(C(C=C)=O)CO)=O,2,6,0,6,29,0.0003
G5,C=CC(C(C(CO)CO)=O)=O,1,5,0,5,45,0.00025299999999999997
G5,C(C(CO)O)(CC=CC=O)=O,4,5,0,5,27,0.00025299999999999997
G5,C(CO)(C(C=CC=O)CO)=O,4,3,0,3,29,0.000156
G5,C(C(C(C=O)=O)CO)=CCO,4,3,0,3,29,0.000156
G5,C1(C(CCO)(O)OCC1CO)=O,4,6,0,6,2,0.00031099999999999997
G5,C1(COC(CCO)(C1CO)O)=O,4,5,0,5,30,0.00025299999999999997
G5,C1(C(CO)OC(CCO)(C1)O)=O,4,6,0,6,30,0.00031099999999999997
G5,C(C1CC(CO1)O)(C(CO)O)=O,8,2,0,2,4,9.9e-05
G5,C1(C(CO)OC(C)(C1CO)O)=O,8,5,0,5,26,0.00025299999999999997
G5,C1(C(C)(O)OC(CO)C1CO)=O,8,5,0,5,14,0.00025299999999999997
G5,C1(CCOC(CO)(C1CO)O)=O,4,5,0,5,30,0.00025299999999999997
G5,C1(CC(CO)(O)OCC1CO)=O,4,5,0,5,30,0.000264
G5,C1(COC(CO)(CC1CO)O)=O,4,4,0,4,29,0.00020299999999999997
G5,C1(C(CO)OC(CO)(CC1)O)=O,4,5,0,5,29,0.00025299999999999997
G5,C1(C(CO)OC(CC1CO)O)=O,8,3,0,3,2,0.000156
G5,C1(CC(O)OC(CO)C1CO)=O,8,5,0,5,44,0.000264
G5,C1(CC(CO)OC(C1CO)O)=O,8,6,0,6,44,0.00031099999999999997
G5,C1(C(CO)C(C(O)=O)C(C1O)O)=O,16,2,0,2,29,0.00010800000000000001
G5,C(CC(C(C(CCO)=O)O)O)(O)=O,4,4,0,4,3,0.000204
G5,C(C(CC(C(C=O)=O)CO)O)(O)=O,4,5,0,5,29,0.000273
G5,C(C1(C(C(CO)CC1O)=O)O)(O)=O,8,4,0,4,17,0.00020299999999999997
G5,C1(C(CO)C(C(O)=O)(C(C1)O)O)=O,8,4,0,4,29,0.000205
G5,C(C(CO)C(C(O)=O)(CO)O)=O,4,8,0,8,2,0.00040899999999999997
G5,C(CC1C(C(C(CO)O1)=O)O)(O)=O,8,3,0,3,29,0.00015800000000000002
G5,C(CC1C(C(C(O)O1)=O)CO)(O)=O,8,4,0,4,29,0.000205
G5,C(CC1C(C(CO)C(O1)O)=O)(O)=O,8,4,0,4,29,0.000205
G5,C(C(C=CC(CCO)=O)=O)(O)=O,2,3,0,3,29,0.000156
G5,C(C(C=CC(C(O)=O)=O)CO)=O,4,3,0,3,29,0.000156
G5,C(C(C=CC(O)=O)=O)(CCO)=O,2,3,0,3,14,0.000156
G5,C(C(C(C=CC(O)=O)=O)CO)=O,4,7,0,7,29,0.00034700000000000003
G5,C(C(C(C=CC=O)=O)CO)(O)=O,4,9,0,9,29,0.000455
G5,C=CC(C(C(C(O)=O)=O)CO)=O,2,5,0,5,29,0.00025299999999999997
G5,C(C(C(C(C=C)=O)=O)CO)(O)=O,2,8,0,8,29,0.000408
G5,C(C(C(C(O)=O)=O)CO)=CC=O,4,4,0,4,29,0.00020299999999999997
G5,C(C(C(C=O)=O)CO)=CC(O)=O,4,3,0,3,29,0.000156
G5,C(CC1(C(C(CO)CO1)=O)O)(O)=O,4,4,0,4,29,0.000205
G5,C(CC1(C(C(CO1)=O)CO)O)(O)=O,4,4,0,4,29,0.000205
G5,C(CC1(CC(C(CO)O1)=O)O)(O)=O,4,4,0,4,29,0.000205
G5,C(C1C(C(CO)C(C)(O1)O)=O)(O)=O,8,4,0,4,26,0.000205
G5,C1(C(C)(OC(C(O)=O)C1CO)O)=O,8,4,0,4,29,0.000205
G5,C1(C(CO)C(C(O)=O)(O)OCC1)=O,4,4,0,4,2,0.000205
G5,C1(CC(C(O)=O)(O)OCC1CO)=O,4,4,0,4,2,0.000205
G5,C(C1(CC(C(CO1)=O)CO)O)(O)=O,4,3,0,3,12,0.000156
G5,C1(C(CO)OC(C(O)=O)(CC1)O)=O,4,4,0,4,29,0.000205
G5,C(C1C(C(CO)CC(O1)O)=O)(O)=O,8,3,0,3,2,0.000156
G5,C1(C(CO)C(C(O)=O)OC(C1)O)=O,8,4,0,4,2,0.000205
G5,C1(CC(C(O)=O)OC(C1CO)O)=O,8,4,0,4,2,0.000205
G5,C1(C(CO)(C(C(C1CO)=O)O)O)=O,8,4,0,4,2,0.000194
G5,C(CCO)(C1(C(O)OCC1O)O)=O,8,4,0,4,19,0.000192
G5,C(C(C=O)(C(C(CO)O)=O)O)(O)=O,4,5,0,5,17,0.00024300000000000002
G5,C(C(C(O)=O)(C(CCO)=O)O)(O)=O,1,4,0,4,17,0.000205
G5,C(C1(C(C(CO)OC1)=O)O)(O)=O,4,4,0,4,17,0.000195
G5,C1(C(CO)OCC1(C(CO)O)O)=O,8,4,0,4,0,0.000196
G5,C1(C(COC1CO)(C(C=O)O)O)=O,8,4,0,4,10,0.000195
G5,C(C(C(C(CO)O)=O)(CO)CO)=O,2,3,0,3,2,0.000148
G5,C(C(C(C(CO)(CO)O)=O)CO)=O,2,4,0,4,2,0.000198
G5,C(C(CO)O)(C(CO)(CO)CO)=O,2,3,0,3,2,0.000148
G5,C1(C(CO)OCC1(CO)O)=O,4,5,0,5,2,0.000245
G5,C(C(C=O)(C(C(C=O)CO)O)O)=O,4,6,0,6,1,0.00029
G5,C1(C(CO)OCC1(C(C)O)O)=O,8,4,0,4,4,0.000196
G5,C(C1(C(C(CO1)O)O)O)(CCO)=O,8,3,0,3,41,0.000144
G5,C1(C(C(C(C1CO)O)(C)O)=O)=O,8,4,0,4,4,0.000194
G5,C1(C2(C(CC(C1CO)O2)O)O)=O,16,3,0,3,23,0.000146
G5,C(C(CO)C(C(O)=O)(C(C)=O)O)=O,4,4,0,4,29,0.000206
G5,C(C(C(C(CO)O)=O)(C)O)(O)=O,4,6,0,6,17,0.000312
G5,C(C(CO)C(C(C=O)(C)O)O)=O,8,4,0,4,11,0.000194
G5,C(C(C(O)=O)(C(C=O)CO)O)(O)=O,2,4,0,4,17,0.000206
G5,C(C1(C(C(CO)CO1)=O)O)(O)=O,4,3,0,3,17,0.000147
G5,C(C(C)(C(C=O)(C)O)O)(CCO)=O,4,3,0,3,11,0.000156
G5,C(C(CO)C(C)(C(C=O)(C)O)O)=O,8,3,0,3,11,0.000147
G5,C(C(C)(C(CC(CCO)=O)O)O)=O,4,2,0,2,11,9.7e-05
G5,C(C(C(C(C(C)=O)CO)O)(C)O)=O,8,3,0,3,11,0.000147
G5,C1(C(C(CO)O)(O)OCC1CO)=O,8,5,0,5,2,0.00025299999999999997
G5,C(C(C1(C(C(CO)CO1)=O)O)O)=O,8,3,0,3,34,0.000147
G5,C1(C(CO)(O)OCC1CO)=O,4,5,0,5,2,0.00024300000000000002
G5,C(C(CO)C(C(C)=O)(C(C)O)O)=O,8,5,0,5,4,0.00024300000000000002
G5,C(C(CO)O)(C(C)(C(C)O)O)=O,8,4,0,4,4,0.000206
G5,C1(C(C(C)O)(O)OCC1CO)=O,8,3,0,3,4,0.000148
G5,C(C(C)(C(C(O)=O)O)O)(CCO)=O,4,3,0,3,14,0.000156
G5,C(CCO)(C(C=O)OC(CO)=O)=O,2,2,0,2,2,9.7e-05
G5,C(CO)(OC(C=O)C(C=O)CO)=O,4,3,0,3,27,0.000146
G5,C(CO)(OCC(C(C=O)=O)CO)=O,2,3,0,3,2,0.000146
G5,C(CO)(OCC(C(C=O)CO)=O)=O,2,3,0,3,2,0.000146
G5,C(C(CO)OC(CO)=O)(CC=O)=O,2,3,0,3,2,0.000146
G5,C1(CCC(C(C1CO)=O)=O)=O,2,5,0,5,45,0.000241
G5,C1(CC(C(C(C1)=O)=O)CO)=O,2,3,0,3,29,0.000144
G5,C1(C(CO)CC(C(C1)=O)=O)=O,2,4,0,4,29,0.000192
G5,C(C1C(C(C(C1)CO)=O)=O)=O,4,4,0,4,2,0.000192
G5,C1(CC(CC(C1CO)=O)=O)=O,1,5,0,5,29,0.000241
G5,C1(C(C=O)CC(C1CO)=O)=O,4,6,0,6,29,0.00028900000000000003
G5,C1(C(C=O)C(C(C1)=O)CO)=O,4,4,0,4,29,0.000192
G5,C(C1CC(C(C1CO)=O)=O)=O,4,4,0,4,14,0.000192
G5,C1(C(CO)CC(C1C=O)=O)=O,4,6,0,6,29,0.00028700000000000004
G5,C1(C(C(C=CC1CO)=O)O)=O,4,3,0,3,29,0.000144
G5,C1(C(C=CC(C1CO)=O)O)=O,4,4,0,4,45,0.000194
G5,C(C(CO)C(C=O)CO)=O,3,3,0,3,5,0.000145
G5,C(C(CO)C(C=O)CC(C=O)=O)=O,4,3,0,3,43,0.000145
G5,C(CC=O)(C(C(C(C)=O)=O)CO)=O,2,2,0,2,2,9.9e-05
G5,C(CC=O)(CC(C(CCO)=O)=O)=O,1,1,0,1,2,4.9e-05
G5,C(C(C(CC(C(C)=O)=O)=O)CO)=O,2,2,0,2,2,9.9e-05
G5,C(CC(C(C(C(C)=O)CO)=O)=O)=O,2,2,0,2,26,9.9e-05
G5,C(CC(C(CC(CCO)=O)=O)=O)=O,1,1,0,1,26,4.9e-05
G5,C(C(C(C(CC(C)=O)=O)=O)CO)=O,2,2,0,2,26,9.9e-05
G5,C(C(C(C(C(C=O)CO)=O)=O)C)=O,4,2,0,2,42,9.9e-05
G5,C(CC(C)=O)(C(C(C=O)=O)CO)=O,2,2,0,2,26,9.9e-05
G5,C(CC(C=O)=O)(C(C(C)=O)CO)=O,2,2,0,2,26,9.9e-05
G5,C(CC(CCO)=O)(CC(C=O)=O)=O,1,1,0,1,26,4.9e-05
G5,C(C(CC(C(C=O)=O)CO)=O)(C)=O,2,1,0,1,12,4.9e-05
G5,C(C(C(CO)CC(C=O)=O)=O)(C)=O,2,1,0,1,12,4.9e-05
G5,C(C(CCC(C=O)=O)=O)(CCO)=O,1,2,0,2,34,9.7e-05
G5,C(C(C(C)C(C(C=O)=O)CO)=O)=O,4,1,0,1,29,4.9e-05
G5,C(CO)(C(C)C(C(C=O)=O)CO)=O,4,1,0,1,52,4.9e-05
G5,C(C(C)CC(C=O)=O)(C(CO)O)=O,4,2,0,2,52,9.9e-05
G5,C(C(CCO)C(C(C=O)=O)CO)=O,4,5,0,5,29,0.000251
G5,C(CCO)(C(C(C(C)=O)=O)CO)=O,2,3,0,3,2,0.000148
G5,C(CCO)(CC(C(CCO)=O)=O)=O,1,2,0,2,2,9.9e-05
G5,C(C(CO)CO)(CC(C(C)=O)=O)=O,1,2,0,2,2,9.9e-05
G5,C(C)(C(C(C(CCO)=O)=O)CO)=O,2,3,0,3,2,0.000148
G5,C(C)(CC(C(C(CO)CO)=O)=O)=O,1,2,0,2,2,9.9e-05
G5,C(C(C(C(C(CO)CO)=O)=O)C)=O,2,2,0,2,29,9.9e-05
G5,C(CCC(C(C(C=O)=O)CO)=O)=O,2,2,0,2,20,9.9e-05
G5,C(C(CO)CC=O)(CC(C=O)=O)=O,2,1,0,1,20,4.9e-05
G5,C(C(CO)CC(CC(C=O)=O)=O)=O,2,1,0,1,20,4.9e-05
G5,C(CC(CC(C(C=O)=O)CO)=O)=O,2,1,0,1,20,4.9e-05
G5,C(C(CO)CC(C=O)=O)(CC=O)=O,2,1,0,1,20,4.9e-05
G5,C(C(C(CCC(C=O)=O)=O)CO)=O,2,2,0,2,20,9.9e-05
G5,C(C(C(C(CC=O)=O)=O)CO)=O,2,4,0,4,2,0.000194
G5,C(C(CO)O)(C(C=O)C(C=O)C)=O,8,2,0,2,49,9.9e-05
G5,C(C(C(C(C(C)CO)=O)=O)CO)=O,4,2,0,2,42,9.9e-05
G5,C(C(C)C(C(C(C=O)CO)=O)O)=O,8,2,0,2,49,9.9e-05
G5,C(C)(CC(C(C(CO)=O)CO)=O)=O,2,2,0,2,49,9.9e-05
G5,C(C)(C(C(CC(CO)=O)=O)CO)=O,2,2,0,2,49,9.9e-05
G5,C(C(CO)O)(CC(CC(C)=O)=O)=O,2,3,0,3,49,0.000157
G5,C(CCO)(CC(CC(CO)=O)=O)=O,1,1,0,1,49,4.9e-05
G5,C(CO)(C(CO)CC(C(C)=O)=O)=O,2,1,0,1,49,4.9e-05
G5,C(CCC(C(C)=O)=O)(C(CO)O)=O,2,3,0,3,49,0.000157
G5,C(CCC(C(CCO)=O)=O)(CO)=O,1,2,0,2,34,9.7e-05
G5,C(CC(C(C(C)=O)=O)CO)(CO)=O,2,1,0,1,49,4.9e-05
G5,C(C(CO)C(C(C(C)=O)=O)CO)=O,4,4,0,4,55,0.000194
G5,C(CC(C(C(CCO)=O)=O)CO)=O,2,2,0,2,55,9.7e-05
G5,C(C(C(C(CC)=O)=O)CO)=O,2,3,0,3,27,0.000146
G5,C(C(C(C(CO)C(C=O)C)=O)O)=O,8,2,0,2,49,9.7e-05
G5,C(CO)(C(CO)C(C(C=O)=O)C)=O,4,1,0,1,52,4.9e-05
G5,C(CC(C(C=O)=O)C)(C(CO)O)=O,4,2,0,2,52,9.9e-05
G5,C(C(C(C)=O)O)(C(C(C)=O)CO)=O,4,2,0,2,49,9.9e-05
G5,C(CCO)(CC(C(C(C)=O)O)=O)=O,2,1,0,1,49,4.9e-05
G5,C(C(C(CCO)=O)O)(CC(C)=O)=O,2,1,0,1,49,4.9e-05
G5,C(C(C(C(C=O)=O)C)O)(CCO)=O,4,2,0,2,28,9.7e-05
G5,C(CCC(C(CCO)=O)=O)=O,1,3,0,3,29,0.000144
G5,C(C(CO)C(C(C=O)=O)C)=O,4,2,0,2,6,9.7e-05
G5,C(C(C(C(C(CO)O)=O)=O)CO)=O,4,2,0,2,2,9.9e-05
G5,C(C(CO)C(C=O)C)(C(CO)O)=O,8,4,0,4,2,0.000196
G5,C(C(C)CC(CO)=O)(C(CO)O)=O,4,2,0,2,52,9.9e-05
G5,C(CO)(C(CO)C(C(CO)=O)C)=O,4,1,0,1,52,4.9e-05
G5,C(CO)(C(C)CC(C(CO)O)=O)=O,4,2,0,2,52,9.9e-05
G5,C(C(C)C(C(C)=O)O)(C(CO)O)=O,8,2,0,2,2,9.9e-05
G5,C(CO)(C(C)C(C(CCO)=O)O)=O,4,1,0,1,2,4.9e-05
G5,C(C(C)CC=O)(C(CO)O)=O,4,4,0,4,0,0.000205
G5,C(C(CO)C(C(CO)=O)C)=O,4,2,0,2,18,9.7e-05
G5,C(C(CO)CC(CO)=O)(CC=O)=O,2,3,0,3,47,0.000144
G5,C(C(C(CCC(CO)=O)=O)CO)=O,2,2,0,2,21,9.9e-05
G5,C(CO)(C(CO)CC(CC=O)=O)=O,2,3,0,3,47,0.000144
G5,C(CC(CCC(C(CO)O)=O)=O)=O,2,7,0,7,21,0.00035800000000000003
G5,C(CO)(CC(C(CO)CC=O)=O)=O,2,1,0,1,21,4.9e-05
G5,C(CO)(C(C(CCC=O)=O)CO)=O,2,2,0,2,21,9.9e-05
G5,C(C(CO)O)(CC(CCC=O)=O)=O,2,4,0,4,21,0.00021600000000000002
G5,C(C(CO)CC(CC(CO)=O)=O)=O,2,1,0,1,21,4.9e-05
G5,C(C(CC(C=O)C(C=O)CO)O)=O,8,3,0,3,18,0.000145
G5,C(C(C(CC(CC=O)=O)=O)CO)=O,2,2,0,2,2,9.9e-05
G5,C(CC=O)(C(C(CC=O)=O)CO)=O,1,2,0,2,2,9.9e-05
G5,C(C(C(C=CC(C=O)O)=O)CO)=O,8,2,0,2,29,9.9e-05
G5,C(C(C=CC(C(CCO)=O)=O)O)=O,4,1,0,1,29,4.9e-05
G5,C(C(C(C(CCO)=O)=O)CCO)=O,2,3,0,3,29,0.000156
G5,C(C(C(C)CO)=O)(C(CO)CO)=O,2,2,0,2,2,9.9e-05
G5,C(C(C)C(C(C(CO)CO)=O)O)=O,4,2,0,2,3,9.9e-05
G5,C(C(CCO)C(C(CO)=O)CO)=O,4,7,0,7,46,0.000346
G5,C(C(CCO)C(C(CCO)=O)O)=O,4,3,0,3,3,0.000156
G5,C(C(CCO)=O)(C(CO)CCO)=O,2,1,0,1,29,4.9e-05
G5,C(C(CC)=O)(C(CO)CO)=O,1,3,0,3,27,0.000146
G5,C(CCO)(C(C(C)=O)CO)=O,2,5,0,5,2,0.00024300000000000002
G5,C(C(CO)CO)(CC(C)=O)=O,1,3,0,3,27,0.000146
G5,C(CCO)(CC(CCO)=O)=O,1,2,0,2,3,9.7e-05
G5,C(C(CCO)C(C=O)CO)=O,4,5,0,5,18,0.000251
G5,C(C)(C(C(C(CO)CC=O)=O)O)=O,4,1,0,1,49,4.9e-05
G5,C(CCO)(C(C(CCC=O)=O)O)=O,2,2,0,2,7,0.00010800000000000001
G5,C(C(CO)CC(C(C(C)=O)O)=O)=O,4,1,0,1,49,4.9e-05
G5,C(C(C(C(C)C(C=O)CO)=O)O)=O,8,1,0,1,16,4.9e-05
G5,C(C(CCC(C(CCO)=O)=O)O)=O,2,4,0,4,0,0.000215
G5,C(C(CC(C(C(C)=O)=O)CO)O)=O,4,1,0,1,49,4.9e-05
G5,C(C(C)C(C=O)CO)=O,4,3,0,3,49,0.000145
G5,C(C(C)C(C=O)O)(C(CO)O)=O,8,5,0,5,28,0.000264
G5,C(C(C(CO)CC(CO)O)=O)(O)=O,4,1,0,1,29,4.9e-05
G5,C(C(C(CCO)=O)=O)(CCO)=O,1,2,0,2,2,9.7e-05
G5,C(C(C(C)=O)=O)(C(CO)CO)=O,1,4,0,4,2,0.000194
G5,C(C(C(C(CO)CCO)=O)=O)=O,2,2,0,2,3,9.7e-05
G5,C(C)(C(C(C(CCO)=O)=O)O)=O,2,6,0,6,29,0.00028700000000000004
G5,C(C(C(C(C(CO)C)=O)=O)O)=O,4,2,0,2,49,9.7e-05
G5,C(CCO)(C(C(C=C)=O)O)=O,2,5,0,5,29,0.000251
G5,C(CCO)(C(C=CC=O)O)=O,4,3,0,3,3,0.000144
G5,C(C(CO)C1(CC(CO1)O)O)=O,8,5,0,5,44,0.00025299999999999997
G5,C(C1(CC(CO1)O)O)(CCO)=O,4,2,0,2,14,9.7e-05
G5,C(C(CO)C1C(CC(O)O1)O)=O,16,5,0,5,43,0.00025299999999999997
G5,C(C1C(CC(O1)O)O)(CCO)=O,8,2,0,2,3,9.7e-05
G5,C(C(C=O)(C(C(CO)CO)=O)O)=O,1,2,0,2,1,9.9e-05
G5,C(C(C=O)(C(C(CO)=O)CO)O)=O,2,4,0,4,1,0.000195
G5,C(C(C(C(C=O)(CO)O)=O)CO)=O,4,4,0,4,2,0.000198
G5,C(C(C(C)=O)C(C(CCO)=O)=O)=O,2,1,0,1,29,4.9e-05
G5,C(CCO)(C(C=O)C(C(C)=O)=O)=O,2,1,0,1,29,4.9e-05
G5,C(C(C(CCO)=O)C(C=O)=O)=O,2,4,0,4,29,0.000192
G5,C(C(C=O)C(CCO)=O)=O,1,4,0,4,29,0.000192
G5,C(CCO)(C(C=O)(C(C=O)C)O)=O,4,1,0,1,29,4.9e-05
G5,C(CCO)(C(C=O)C(C)=O)=O,2,7,0,7,29,0.00034500000000000004
G5,C(C(C)C(C(CCO)=O)(CO)O)=O,4,2,0,2,2,9.9e-05
G5,C(C(C(C(C=O)CO)=O)C(C)=O)=O,4,2,0,2,1,9.9e-05
G5,C(C(C(CC=O)=O)C(CCO)=O)=O,2,1,0,1,1,4.9e-05
G5,C(C(C=O)C(C(C(C)=O)CO)=O)=O,2,2,0,2,1,9.9e-05
G5,C(C(C=O)C(CC(CCO)=O)=O)=O,1,1,0,1,1,4.9e-05
G5,C(C(CO)CC=O)(C(C=O)C=O)=O,2,1,0,1,29,4.9e-05
G5,C(C(CO)CC(C(C=O)C=O)=O)=O,2,1,0,1,29,4.9e-05
G5,C(C(C=O)(C(C(C=O)CO)=O)O)=O,2,2,0,2,1,9.9e-05
G5,C(C(C=O)(C(C(C=O)=O)CO)O)=O,2,4,0,4,1,0.000195
G5,C(C(C(CCO)=O)C(CO)O)(O)=O,4,6,0,6,29,0.000322
G5,C1(C(CO)C(C(C1(C)O)=O)O)=O,8,3,0,3,45,0.000146
G5,C(C(C(C(CCO)=O)=O)CC=O)=O,2,2,0,2,34,9.7e-05
G5,C(C(CO)C(C=O)C(C(C)=O)=O)=O,4,1,0,1,29,4.9e-05
G5,C(C(C(C=O)C(C=O)CO)O)(O)=O,8,4,0,4,29,0.000204
G5,C(C(CO)C(C(C(O)=O)=O)CO)=O,4,2,0,2,29,0.00010800000000000001
G5,C(C(C(C=O)=O)C(C=O)CO)=O,4,3,0,3,29,0.000144
G5,C(C(C)C(C(O)=O)O)(C(CO)O)=O,8,2,0,2,28,9.9e-05
G5,C(C)(C(C=O)C(C(CO)=O)CO)=O,4,1,0,1,41,4.9e-05
G5,C(C)(C(C=O)CC(C(CO)O)=O)=O,4,7,0,7,41,0.00035800000000000003
G5,C(CCO)(C(C=O)CC(CO)=O)=O,2,1,0,1,41,4.9e-05
G5,C(C(C=O)C(C=O)CO)=O,2,3,0,3,29,0.000144
G5,C(C(C(C)=O)C(C(C=O)=O)CO)=O,4,1,0,1,29,4.9e-05
G5,C(CCO)(C(C=O)CC(C=O)=O)=O,2,1,0,1,29,4.9e-05
G5,C(C(C(C(C=O)CC=O)=O)CO)=O,4,2,0,2,2,9.9e-05
G5,C(CC(C(C=O)C(C=O)CO)=O)=O,4,1,0,1,2,4.9e-05
G5,C(C(C=O)C(C(C(C)=O)=O)CO)=O,2,1,0,1,14,4.9e-05
G5,C(C(C=O)CC(C(CCO)=O)=O)=O,1,1,0,1,14,4.9e-05
G5,C(CC(C(CO)C(C=O)C=O)=O)=O,2,1,0,1,2,4.9e-05
G5,C(C(C(CC(C=O)C=O)=O)CO)=O,2,2,0,2,2,9.9e-05
G5,C(C(C=O)C=CC(C(CO)O)=O)=O,4,2,0,2,43,9.9e-05
G5,C(C(CO)C(C=O)(C(C=O)C)O)=O,8,4,0,4,49,0.000195
G5,C(C(CO)C(C=O)C(C)=O)=O,4,4,0,4,29,0.000192
G5,C(CCO)(C(C=O)CC=O)=O,2,6,0,6,29,0.000298
G5,C(C1C(C(CO)C(CO)O1)=O)=O,8,3,0,3,26,0.000146
G5,C1(C(CO)C(C=O)OC1CO)=O,8,3,0,3,2,0.000146
G5,C(C1C(C(CO)C(CO1)O)=O)=O,8,3,0,3,37,0.000146
G5,C1(C(CO)C(C=O)OCC1O)=O,8,3,0,3,37,0.000146
G5,C1(C(C(C=O)OCC1CO)O)=O,8,3,0,3,37,0.000146
G5,C(C1C(C(C(CO1)=O)CO)O)=O,8,3,0,3,37,0.000146
G5,C1(C(CO)OC(C=O)C(C1)O)=O,8,3,0,3,37,0.000146
G5,C1(C(C(CO)OCC1CO)=O)=O,4,3,0,3,2,0.000146
G5,C(C1C(C(C(O1)=O)=O)CO)(C)=O,4,4,0,4,27,0.000194
G5,C(C1CC(C(O1)=O)=O)(CCO)=O,2,3,0,3,29,0.000144
G5,C(CC1C(C(C(O1)=O)=O)CO)=O,4,4,0,4,27,0.000194
G5,C(C(C1CC(C(O1)=O)=O)CO)=O,4,4,0,4,27,0.000194
G5,C1(C(C(C(C(C)=O)O1)=O)CO)=O,4,5,0,5,27,0.000241
G5,C1(CC(C(C(CCO)=O)O1)=O)=O,2,3,0,3,29,0.000144
G5,C(CC1C(C(C(O1)=O)CO)=O)=O,4,5,0,5,27,0.000241
G5,C(C(CO)C1C(CC(O1)=O)=O)=O,4,4,0,4,27,0.000194
G5,C1(CCOC(C(C1CO)=O)=O)=O,2,5,0,5,29,0.000241
G5,C1(C(COC(C(C1)=O)=O)CO)=O,2,4,0,4,27,0.000194
G5,C1(CC(C(C(OC1)=O)=O)CO)=O,2,3,0,3,29,0.000144
G5,C1(COC(C(CC1CO)=O)=O)=O,2,3,0,3,29,0.000144
G5,C1(CCC(C(OC1CO)=O)=O)=O,2,4,0,4,27,0.000194
G5,C1(C(C(C(CCO1)=O)=O)CO)=O,2,5,0,5,27,0.000241
G5,C1(CC(C(C(CO1)CO)=O)=O)=O,2,4,0,4,27,0.000194
G5,C1(C(C(CC(CO1)=O)=O)CO)=O,2,5,0,5,27,0.000241
G5,C1(CC(OCC(C1CO)=O)=O)=O,2,5,0,5,27,0.000241
G5,C1(CC(CC(C(CO)O1)=O)=O)=O,2,4,0,4,27,0.000194
G5,C1(C=C(C(C1CO)=O)CO)=O,2,5,0,5,45,0.000241
G5,C1C(C(C(C=1CO)=O)=O)CO,2,2,0,2,2,9.7e-05
G5,C1(C(C(C(C1CO)=C)=O)O)=O,4,2,0,2,2,9.7e-05
G5,C1(C(C(C(C1CO)=O)=C)O)=O,4,4,0,4,45,0.000194
G5,C1(C=C(C=O)C(C1CO)O)=O,4,4,0,4,45,0.000194
G5,C1(C(C(C=O)=CC1CO)O)=O,4,3,0,3,29,0.000144
G5,C1(C(C=C(C=O)C1CO)O)=O,4,3,0,3,29,0.000144
G5,C1C(C(C(C=1C=O)=O)CO)O,4,3,0,3,45,0.000146
G5,C(C=CC(C(CO)CO)=O)(O)=O,2,3,0,3,46,0.000146
G5,C(CO)(C(C=CC(O)=O)CO)=O,4,2,0,2,12,9.7e-05
G5,C(C(CO)O)(CC=CC(O)=O)=O,4,3,0,3,12,0.000146
G5,C(CCO)(C(C=CC(O)=O)O)=O,4,2,0,2,2,9.7e-05
G5,C(C(CO)C(C=CC(O)=O)O)=O,8,7,0,7,18,0.000348
G5,C=CC(C(C(C=O)=O)CO)O,4,6,0,6,27,0.00028900000000000003
G5,C(C(C(C(C=C)O)=O)CO)=O,4,6,0,6,27,0.00028900000000000003
G5,C(C(C=O)O)(C(C=C)CO)=O,4,3,0,3,29,0.000144
G5,C(C(C(C(C=C)=O)CO)O)=O,4,4,0,4,27,0.000205
G5,C(C1(C(C(C=C1)CO)=O)O)=O,4,2,0,2,43,9.7e-05
G5,C(CCO)(C1C=CC(O1)=O)=O,2,2,0,2,2,9.7e-05
G5,C(C(CO)C1C=CC(O1)=O)=O,4,3,0,3,48,0.000146
G5,C(CCO)(C1C(C=CO1)=O)=O,2,2,0,2,2,9.7e-05
G5,C(C(CO)C1C(C=CO1)=O)=O,4,3,0,3,45,0.000146
G5,C1(C=CC(C(CO1)CO)=O)=O,2,3,0,3,19,0.000146
G5,C1(COC(C=CC1CO)=O)=O,2,2,0,2,2,9.7e-05
G5,C1(C(CO)OC(C=CC1)=O)=O,2,3,0,3,48,0.000146
G5,C1OCC(C(C(C=1)=O)=O)CO,2,3,0,3,45,0.000146
G5,C1(COC=CC(C1CO)=O)=O,2,4,0,4,38,0.000194
G5,C1(C(CO)OC=CC(C1)=O)=O,2,3,0,3,38,0.000146
G5,C1(C(C(C=CCO1)=O)CO)=O,2,4,0,4,19,0.000194
G5,C1COC(C(C(C=1)=O)=O)CO,2,3,0,3,36,0.000146
G5,C1(CC=CC(C(CO)O1)=O)=O,2,4,0,4,48,0.000194
G5,C1(C=CC(COC1CO)=O)=O,2,5,0,5,45,0.000241
G5,C(C=C1C(C(CO1)CO)=O)=O,4,3,0,3,45,0.000146
G5,C1(COC(C1CO)=CC=O)=O,4,3,0,3,45,0.000146
G5,C1(C(CO)OC(C1)=CC=O)=O,4,3,0,3,45,0.000146
G5,C1(C(C=O)OC(C1CO)=C)=O,4,3,0,3,26,0.000146
G5,C(C1C(C(C(O1)=C)=O)CO)=O,4,3,0,3,14,0.000146
G5,C(C1OCC(C(C=1)=O)CO)=O,2,3,0,3,30,0.000146
G5,C1(COC(C=O)=CC1CO)=O,2,2,0,2,12,9.7e-05
G5,C1(C(CO)OC(C=O)=CC1)=O,2,3,0,3,12,0.000146
G5,C1(C(C=O)OC=CC1CO)=O,4,2,0,2,2,9.7e-05
G5,C(C1C(C(C=CO1)=O)CO)=O,4,3,0,3,37,0.000146
G5,C1(C2(CC(C(C1CO)O2)O)O)=O,16,3,0,3,14,0.000146
G5,C1(C2C(C(C(O2)O)C1CO)O)=O,32,4,0,4,2,0.000192
G5,C(C1C(C(C(O1)O)=O)O)(CCO)=O,8,2,0,2,1,9.7e-05
G5,C(C(CO)C1C(C(C(O)O1)=O)O)=O,16,3,0,3,5,0.000146
G5,C(C1(C(C(CO)C(CO)O1)=O)O)=O,8,3,0,3,0,0.000146
G5,C1(C(CO)C(C=O)(OC1CO)O)=O,8,3,0,3,2,0.000146
G5,C1(CC(C(CO)=O)OC1CO)=O,4,3,0,3,32,0.000146
G5,C1(COC(C(CO)=O)C1CO)=O,4,3,0,3,32,0.000146
G5,C1(CC(C(C(CO)O)=O)OC1)=O,4,3,0,3,32,0.000146
G5,C1(CC(C(C)=O)(OC1CO)O)=O,4,4,0,4,24,0.000194
G5,C1(COC(C(C)=O)(C1CO)O)=O,4,4,0,4,24,0.000194
G5,C1(CC(C(CCO)=O)(OC1)O)=O,2,2,0,2,24,9.7e-05
G5,C1(CCC(C(C(CO)O)=O)O1)=O,4,3,0,3,32,0.000146
G5,C1(C(C(CO)OC1CCO)=O)=O,4,3,0,3,4,0.000146
G5,C1(C(C(C(CCO)O1)=O)CO)=O,4,3,0,3,2,0.000146
G5,C(C(C1C(C(CO)CO1)=O)O)=O,8,2,0,2,4,9.9e-05
G5,C(C(C1C(C(CO1)=O)CO)O)=O,8,2,0,2,4,9.9e-05
G5,C(C(C1CC(C(CO)O1)=O)O)=O,8,2,0,2,4,9.9e-05
G5,C1(C(CC(C(C(CO)O)=O)O1)O)=O,8,2,0,2,2,9.9e-05
G5,C1(C(CC(C(CCO)=O)(O)O1)O)=O,4,2,0,2,14,9.7e-05
G5,C(C(CO)C1(CC(C(O1)=O)O)O)=O,8,3,0,3,2,0.000146
G5,C1(C(C(CO)C(CCO)(O)O1)=O)=O,4,3,0,3,2,0.000146
G5,C1(C(C(C(CCO)(O)O1)=O)CO)=O,4,3,0,3,2,0.000146
G5,C(C(CO)C1(C(O)OCC1O)O)=O,16,5,0,5,0,0.000242
G5,C1(C2C(CC(O2)O)OC1CO)=O,16,3,0,3,9,0.000146
G5,C1(C2(CC(CO2)OC1CO)O)=O,8,3,0,3,54,0.000146
G5,C1(C2(COCC(C1CO)O2)O)=O,8,3,0,3,36,0.000146
G5,C1(C2COCC(C1CO)(O2)O)=O,8,4,0,4,36,0.000194
G5,C1(C2CC(C(O2)OC1CO)O)=O,16,2,0,2,4,9.9e-05
G5,C1(C2OCCC(C1CO)(O2)O)=O,8,4,0,4,30,0.000194
G5,C1(C2(CCOC(C1CO)O2)O)=O,8,3,0,3,17,0.000146
G5,C1(C(C(O)OC(CO)C1CO)=O)=O,8,3,0,3,0,0.000146
G5,C1(C(CO)OC(C(C1CO)=O)O)=O,8,3,0,3,2,0.000146
G5,C(C1(C(C(CO)C(CO1)O)=O)O)=O,8,3,0,3,15,0.000146
G5,C1(C(CO)C(C=O)(O)OCC1O)=O,8,3,0,3,2,0.000146
G5,C1(C(C(C=O)(O)OCC1CO)O)=O,8,3,0,3,2,0.000146
G5,C(C1(C(C(C(CO1)=O)CO)O)O)=O,8,3,0,3,15,0.000146
G5,C1(C(CO)OC(C=O)(C(C1)O)O)=O,8,3,0,3,15,0.000146
G5,C(C1CC(C(C(CO)O1)=O)O)=O,8,4,0,4,4,0.000194
G5,C(C1CC(C(C(O1)O)=O)CO)=O,8,3,0,3,20,0.000144
G5,C1(C(C(CO)OC(C)(C1)O)=O)=O,4,4,0,4,26,0.000194
G5,C1(C(COC(C)(C1CO)O)=O)=O,4,4,0,4,26,0.000194
G5,C1(C(CO)OC(C(C1)=O)(C)O)=O,4,4,0,4,24,0.000194
G5,C1(C(C)(OCC(C1CO)=O)O)=O,4,4,0,4,24,0.000194
G5,C1(C(CO)OC(C(C1O)=O)C)=O,8,3,0,3,24,0.000146
G5,C1(C(C)OC(C(C1CO)=O)O)=O,8,4,0,4,24,0.000194
G5,C1(C(C(C)OC(C1CO)O)=O)=O,8,4,0,4,4,0.000194
G5,C1(C(C(C)(O)OCC1CO)O)=O,8,4,0,4,9,0.000205
G5,C1(C(COC(C)(C1CO)O)O)=O,8,4,0,4,26,0.000194
G5,C1(C(C)(O)OCC(C1CO)O)=O,8,4,0,4,14,0.000194
G5,C1(C(C(CO)CC(CO)(O)O1)=O)=O,4,2,0,2,17,9.7e-05
G5,C1(C(C(CC(CO)(O)O1)=O)CO)=O,4,3,0,3,17,0.000146
G5,C1(CC(C(CO)C(CO)(O)O1)=O)=O,4,3,0,3,17,0.000146
G5,C1(C(C(CO)C(C(C)(O)O1)O)=O)=O,8,3,0,3,14,0.000146
G5,C1(C(C(C(C(C)(O)O1)O)=O)CO)=O,8,3,0,3,17,0.000146
G5,C1(C(C(C(CO)C(C)(O)O1)=O)O)=O,8,3,0,3,14,0.000146
G5,C1(C(C)(O)OC(C(C1CO)O)=O)=O,8,3,0,3,14,0.000146
G5,C1(C2(COC(CO2)C1CO)O)=O,8,3,0,3,54,0.000146
G5,C1(C2COC(CO2)(C1CO)O)=O,8,4,0,4,54,0.000194
G5,C1(C(C(O)OCC(C1CO)O)=O)=O,8,3,0,3,2,0.000146
G5,C1(C(COC(C(C1CO)=O)O)O)=O,8,3,0,3,2,0.000146
G5,C1(C(CO)COC(C(C1O)=O)O)=O,8,3,0,3,2,0.000146
G5,C1(COC(C(C(C1CO)O)=O)O)=O,8,3,0,3,2,0.000146
G5,C1(CC(C(C(OC1CO)O)=O)O)=O,8,3,0,3,2,0.000146
G5,C1(C(C(CO)OC(CC1)O)=O)=O,4,4,0,4,17,0.000194
G5,C1(C(COC(CC1CO)O)=O)=O,4,3,0,3,5,0.000144
G5,C1(C(CO)OC(CC(C1)O)O)=O,8,3,0,3,17,0.000146
G5,C1(COC(CC(C1CO)O)O)=O,8,3,0,3,17,0.000146
G5,C1(C(CC(O)OCC1CO)O)=O,8,4,0,4,4,0.000205
G5,C1(C(COC(CC1CO)O)O)=O,8,2,0,2,7,9.7e-05
G5,C1(CC(O)OCC(C1CO)O)=O,8,4,0,4,44,0.000205
G5,C1(CC(COC(C1CO)O)O)=O,8,5,0,5,44,0.00025299999999999997
G5,C1(C(CO)OCCC(C1O)O)=O,8,2,0,2,4,9.9e-05
G5,C1(C(O)OCCC(C1CO)O)=O,8,3,0,3,4,0.000146
G5,C1(C(CCOC(C1CO)O)O)=O,8,4,0,4,4,0.000194
G5,C1(C(C(O)OCCC1CO)O)=O,8,2,0,2,29,9.7e-05
G5,C1(CCOC(C(C1CO)O)O)=O,8,4,0,4,29,0.000205
G5,C1(CC(C(O)OCC1CO)O)=O,8,4,0,4,29,0.000205
G5,C1(C(C(CO)C(CC(O)O1)O)=O)=O,8,3,0,3,45,0.000146
G5,C1(C(C(C(CC(O)O1)O)=O)CO)=O,8,3,0,3,45,0.000146
G5,C1(C(C(C(CO)CC(O)O1)=O)O)=O,8,2,0,2,17,9.7e-05
G5,C1(C(CO)C(C(OC(C1)O)=O)O)=O,8,3,0,3,2,0.000146
G5,C1(CC(C(OC(C1CO)O)=O)O)=O,8,3,0,3,2,0.000146
G5,C1(CC(C(C(C(CO)O1)=O)O)O)=O,8,2,0,2,2,9.9e-05
G5,C1(CC(C(C(C(O)O1)=O)CO)O)=O,8,3,0,3,28,0.000146
G5,C1(CC(C(C(CO)C(O)O1)=O)O)=O,8,3,0,3,29,0.000146
G5,C1(C(CO)CC(OC(C1O)O)=O)=O,8,2,0,2,29,9.7e-05
G5,C1(CC(C(CO)C(C(O)O1)O)=O)=O,8,3,0,3,17,0.000146
G5,C1(C(C(CC(C(O)O1)O)=O)CO)=O,8,3,0,3,17,0.000146
G5,C1(C2OC(CC(C1CO)O2)O)=O,16,3,0,3,23,0.000146
G5,C1(C2CC(O)OC(C1CO)O2)=O,16,3,0,3,17,0.000146
G5,C1(C2C(CC(O2)OC1CO)O)=O,16,2,0,2,17,9.9e-05
G5,C1(C(CO)CC(OC1C=O)=O)=O,4,2,0,2,29,9.7e-05
G5,C1(C(CO)C(C=O)OC(C1)=O)=O,4,3,0,3,27,0.000146
G5,C1(CC(C=O)OC(C1CO)=O)=O,4,4,0,4,27,0.000194
G5,C(CO)(C(C=CC(C=O)=O)CO)=O,4,1,0,1,20,4.9e-05
G5,C(C(CO)O)(CC=CC(C=O)=O)=O,4,2,0,2,20,9.9e-05
G5,C(C(C(C=O)=O)CO)=CC(CO)=O,4,1,0,1,20,4.9e-05
G5,C(CC(C=O)=O)=CC(C(CO)O)=O,4,2,0,2,20,9.9e-05
G5,C(C(C(CO)=CC(C=O)=O)CO)=O,4,1,0,1,29,4.9e-05
G5,C(CO)(C(C(C=O)=O)CO)=CC=O,4,1,0,1,29,4.9e-05
G5,C(C(C(CO)=O)=CC(CCO)=O)=O,2,1,0,1,55,4.9e-05
G5,C(C(C=O)=CC(C)=O)(C(CO)O)=O,4,2,0,2,55,9.9e-05
G5,C(C(C(C(CO)O)=O)C(C=O)=C)=O,4,2,0,2,55,9.9e-05
G5,C(C(C=O)=C(C=O)C)(C(CO)O)=O,4,2,0,2,49,9.9e-05
G5,C(C(C(C(C(C=O)=C)O)=O)CO)=O,4,2,0,2,23,9.9e-05
G5,C(CCO)(C(C=CC(C=O)=O)O)=O,4,1,0,1,49,4.9e-05
G5,C(C(C(C(C(C=O)=O)CO)=C)O)=O,4,1,0,1,29,4.9e-05
G5,C(C(C(C=CC(CCO)=O)=O)O)=O,4,1,0,1,29,4.9e-05
G5,C(C(C=O)O)(C(C(C=O)=C)CO)=O,4,1,0,1,16,4.9e-05
G5,C=C(C(CO)O)C(C(C=O)=O)CO,4,1,0,1,29,4.9e-05
G5,C(C=CC(C(CO)O)=O)(CCO)=O,4,3,0,3,2,0.000148
G5,C(C(CO)O)(C(C(C=O)=C)CO)=O,4,3,0,3,2,0.000148
G5,C(CO)=C(C=O)C(C(C=O)=O)CO,4,1,0,1,29,4.9e-05
G5,C(C(C(CO)=CC(CCO)=O)=O)=O,2,1,0,1,29,4.9e-05
G5,C(CCO)(C(C(C(C=O)=O)=C)O)=O,2,1,0,1,45,4.9e-05
G5,C(CO)=C(CO)C(C(C=O)=O)CO,4,1,0,1,29,4.9e-05
G5,C(C(CO)CO)(C(C(C=O)=C)O)=O,2,2,0,2,2,9.9e-05
G5,C(C=C(C(CO)=O)CO)(CCO)=O,2,1,0,1,45,4.9e-05
G5,C(C=C(C(C(CO)O)=O)CO)(C)=O,4,2,0,2,45,9.9e-05
G5,C(CCO)(C(C(C(CO)=O)=C)O)=O,2,1,0,1,45,4.9e-05
G5,C(C)(C(C(C(C(CO)O)=O)=C)O)=O,4,2,0,2,45,9.9e-05
G5,C(C(CO)=C(C=O)C)(C(CO)O)=O,4,2,0,2,3,9.9e-05
G5,C(C(C(C(C(CO)O)=O)=C)(C)O)=O,4,2,0,2,3,9.9e-05
G5,C(C(CO)C(C=CC(C=O)=O)O)=O,8,4,0,4,20,0.000195
G5,C(C(C=CC(C(C=O)=O)CO)O)=O,8,1,0,1,20,4.9e-05
G5,C(C(C(C=O)=CC(CCO)=O)O)=O,4,1,0,1,55,4.9e-05
G5,C(CCO)(C(C(C=O)=CC=O)O)=O,4,1,0,1,55,4.9e-05
G5,C(C(C(C=O)=C)CO)=O,2,2,0,2,45,9.7e-05
G5,C(C(C(C(CO)O)=O)=CC=O)=O,4,3,0,3,55,0.000146
G5,C=C(C=O)C(C(CO)O)=O,2,6,0,6,9,0.00028900000000000003
G5,C(CO)(C)=C(C(C(CO)O)=O)C=O,4,2,0,2,49,9.9e-05
G5,C(C(CO)O)(C(C=O)C(CO)=C)=O,4,2,0,2,49,9.9e-05
G5,C(C(C(C(C(CO)=C)O)=O)CO)=O,4,2,0,2,29,9.9e-05
G5,C(CO)(CC=CC(C(CO)O)=O)=O,4,2,0,2,49,9.9e-05
G5,C(CO)(C(C=CC(CO)=O)CO)=O,4,1,0,1,49,4.9e-05
G5,C(C(CO)O)(CC=CC(CO)=O)=O,4,3,0,3,49,0.000157
G5,C(CO)(C(C(CO)=CC=O)CO)=O,4,1,0,1,55,4.9e-05
G5,C(C(CO)O)(CC(CO)=CC=O)=O,4,3,0,3,55,0.000157
G5,C(C(C(CO)=CC(CO)=O)CO)=O,4,1,0,1,49,4.9e-05
G5,C(CC(CO)=CC(C(CO)O)=O)=O,4,3,0,3,49,0.000157
G5,C(C)(C(C=CC(C(CO)O)=O)O)=O,8,2,0,2,49,9.9e-05
G5,C(CCO)(C(C=CC(CO)=O)O)=O,4,1,0,1,49,4.9e-05
G5,C(CCO)(C(C(CO)=CC=O)O)=O,4,1,0,1,49,4.9e-05
G5,C(C)=C(C(C(CO)O)=O)C=O,4,3,0,3,45,0.000146
G5,C(C(C(C(CO)O)=O)C=C)=O,4,3,0,3,45,0.000146
G5,C(C(C(CO)=CC=O)CO)=O,4,2,0,2,49,9.7e-05
G5,C(C(C=O)O)(C(C(CO)=C)CO)=O,4,1,0,1,49,4.9e-05
G5,C(C(C(C(C(CO)=O)CO)=C)O)=O,4,1,0,1,55,4.9e-05
G5,C(C(C(CC(C(CO)O)=O)=C)O)=O,4,2,0,2,55,9.9e-05
G5,C(C(C(C)=CC(C(CO)O)=O)O)=O,8,2,0,2,0,9.9e-05
G5,C(C(C(C(C(CCO)=O)O)=C)O)=O,4,1,0,1,49,4.9e-05
G5,C(C(C(C(C=O)O)=C)CO)=O,4,2,0,2,6,9.7e-05
G5,C(C(CO)O)(C(C(CO)=C)CO)=O,4,3,0,3,2,0.000148
G5,C(CO)(C(C(C(CO)O)=C)CO)=O,4,1,0,1,52,4.9e-05
G5,C(C(CO)O)(CC(C(CO)O)=C)=O,4,2,0,2,52,9.9e-05
G5,C(C)(C(CO)O)=CC(C(CO)O)=O,8,2,0,2,52,9.9e-05
G5,C(CCO)(C(C(C(CO)O)=C)O)=O,4,1,0,1,29,4.9e-05
G5,C(C(CO)O)(C(C=C)CO)=O,4,4,0,4,2,0.000196
G5,C(C(C(C(CO)O)=C)CO)=O,4,2,0,2,18,9.7e-05
G5,C(C=C(C(C(CO)O)=O)C(C)O)=O,8,5,0,5,11,0.000263
G5,C(C(C(C(C(CO)O)=O)=CC)O)=O,8,4,0,4,11,0.00021600000000000002
G5,C(C(C(CO)=CC(C=O)O)CO)=O,8,1,0,1,21,4.9e-05
G5,C=C(C(C(CO)O)=O)CO,2,5,0,5,49,0.000241
G5,C=C(C(C(CO)CO)=O)C(C=O)=O,1,2,0,2,2,9.9e-05
G5,C=C(C(C(C(C=O)=O)CO)=O)CO,2,2,0,2,29,9.9e-05
G5,C(CO)(C(C(C(C=O)=O)=C)CO)=O,2,1,0,1,12,4.9e-05
G5,C(C(CO)O)(CC(C(C=O)=O)=C)=O,2,2,0,2,12,9.9e-05
G5,C=C(C(CO)=O)C(C(C=O)=O)CO,2,1,0,1,12,4.9e-05
G5,C=C(C(C(CO)O)=O)CC(C=O)=O,2,2,0,2,12,9.9e-05
G5,C(C(CO)C(C(C(C=O)=O)=C)O)=O,4,2,0,2,29,9.9e-05
G5,C(C(C=C(C(C=O)=O)CO)CO)=O,4,1,0,1,29,4.9e-05
G5,C=C(C=O)C(C(C(C=O)=O)CO)O,4,2,0,2,29,9.9e-05
G5,C(C(C(C=O)=O)CO)=C(C=O)CO,4,1,0,1,29,4.9e-05
G5,C=C(C=O)C(C(C(CO)CO)=O)=O,1,2,0,2,2,9.9e-05
G5,C(C(C(C(C(CO)=C)=O)=O)CO)=O,2,2,0,2,2,9.9e-05
G5,C(CO)(C(C(C(C=O)=C)=O)CO)=O,2,2,0,2,2,9.9e-05
G5,C(C(CO)O)(CC(C(C=O)=C)=O)=O,2,2,0,2,2,9.9e-05
G5,C(C(C(C(C(CO)=O)=C)=O)CO)=O,2,2,0,2,2,9.9e-05
G5,C(CC(C(C(C(CO)O)=O)=C)=O)=O,2,2,0,2,2,9.9e-05
G5,C(CCO)(C(C(C(C=O)=C)=O)O)=O,2,1,0,1,9,4.9e-05
G5,C(C(C(C(C(C=C)=O)O)=O)CO)=O,4,2,0,2,9,9.9e-05
G5,C(C(CO)C(C(C(C=O)=C)=O)O)=O,4,2,0,2,9,9.9e-05
G5,C(C(C(C=C(C=O)CO)=O)CO)=O,4,2,0,2,2,9.9e-05
G5,C(C(C(C(C(CCO)=O)=C)=O)O)=O,2,1,0,1,29,4.9e-05
G5,C(C(C=O)O)(C(C(C=C)=O)CO)=O,4,2,0,2,2,9.9e-05
G5,C(C(C(C(C(C=O)O)=O)=C)CO)=O,4,1,0,1,29,4.9e-05
G5,C(C(C(C(C(CCO)=O)=O)=C)O)=O,2,1,0,1,14,4.9e-05
G5,C(C(C(CO)=CC=O)=O)(CCO)=O,2,1,0,1,14,4.9e-05
G5,C(C(C(C(C(C=O)O)=C)=O)CO)=O,4,2,0,2,2,9.9e-05
G5,C(C(C(C(CO)=CC=O)=O)CO)=O,4,2,0,2,2,9.9e-05
G5,C(C(C(C(C(C=O)=C)=O)CO)O)=O,4,2,0,2,2,9.9e-05
G5,C(C=CC(CO)=O)(C(CO)CO)=O,2,2,0,2,2,9.9e-05
G5,C(CO)(C(C(C=O)=CCO)CO)=O,4,1,0,1,3,4.9e-05
G5,C(C(CO)O)(CC(C=O)=CCO)=O,4,2,0,2,3,9.9e-05
G5,C(C(CCO)=CC(C(CO)O)=O)=O,4,2,0,2,3,9.9e-05
G5,C(CCO)(C(C(C=O)=CCO)O)=O,4,1,0,1,3,4.9e-05
G5,C(C(C(C=O)=CCO)CO)=O,4,2,0,2,3,9.7e-05
G5,C(C(CO)CO)(C(C(CO)=C)O)=O,2,2,0,2,29,9.9e-05
G5,C=C(C(C(CO)O)=O)C(CO)(C)O,4,2,0,2,49,9.9e-05
G5,C(CO)(C)=C(C(C(CO)O)=O)CO,4,2,0,2,49,9.9e-05
G5,C(CO)(C(C(CO)=CCO)CO)=O,4,1,0,1,29,4.9e-05
G5,C(C(CO)O)(CC(CO)=CCO)=O,4,2,0,2,29,9.9e-05
G5,C(CO)(CCO)=CC(C(CO)O)=O,4,2,0,2,2,9.9e-05
G5,C(CCO)(C(C(CO)=CCO)O)=O,4,1,0,1,3,4.9e-05
G5,C(C(CO)CO)(C(C=C)O)=O,2,3,0,3,27,0.000146
G5,C=C(C(C(CO)O)=O)C(C)O,4,3,0,3,4,0.000146
G5,C(C)=C(C(C(CO)O)=O)CO,4,3,0,3,27,0.000146
G5,C(C(C(CO)=CCO)CO)=O,4,2,0,2,3,9.7e-05
G5,C(C(C(C(C(C=O)O)O)=C)CO)=O,8,1,0,1,28,4.9e-05
G5,C(C(CC=CC(C(CO)O)=O)O)=O,8,3,0,3,21,0.000157
G5,C(C(C=CC(C(CO)=O)CO)O)=O,8,1,0,1,21,4.9e-05
G5,C(C(C=CCC(C(CO)O)=O)O)=O,8,2,0,2,21,9.9e-05
G5,C(C(C=CC(C(CCO)=O)O)O)=O,8,1,0,1,49,4.9e-05
G5,C(C(C(CO)=C)CO)=O,2,2,0,2,49,9.7e-05
G5,C(C(C=CC(C=O)O)CO)=O,8,2,0,2,43,9.7e-05
G5,C(C(C=C)CO)=O,2,2,0,2,18,9.7e-05
G5,C(CO)=C(C(C(CO)O)=O)C=O,4,5,0,5,55,0.000241
G5,C(C(C(C(O)=O)=CCO)CO)=O,4,2,0,2,7,9.7e-05
G5,C(C(C(CCO)=O)(C(C=O)=C)O)=O,2,1,0,1,25,4.9e-05
G5,C(CCO)(C(C(C=O)=C)(CO)O)=O,2,2,0,2,2,9.9e-05
G5,C(CCO)(C(C=O)(C(CO)=C)O)=O,2,1,0,1,29,4.9e-05
G5,C(C(C(CCO)=O)(C=C)O)=O,2,2,0,2,4,9.7e-05
G5,C(CCO)(C(C(CO)=C)(CO)O)=O,2,2,0,2,2,9.9e-05
G5,C(CCO)(C(C=C)(CO)O)=O,2,3,0,3,2,0.000146
G5,C(C(CO)O)(C(C=C)(CO)O)=O,4,7,0,7,2,0.000349
G5,C(C(C(C=O)=C)(C(C=O)CO)O)=O,4,2,0,2,23,9.9e-05
G5,C(C(C(C)O)=CC(C(CO)O)=O)=O,8,5,0,5,41,0.000263
G5,C(C(C=C(C(CCO)=O)CO)=O)=O,2,1,0,1,29,4.9e-05
G5,C(C(C=C(C=O)CO)=O)(CCO)=O,2,1,0,1,2,4.9e-05
G5,C(C(CO)C(C=O)(C(CO)=C)O)=O,4,4,0,4,29,0.000195
G5,C(C(C1OCC(C=1)=O)CO)=O,2,3,0,3,48,0.000146
G5,C(CC1OC(C(C=1)=O)CO)=O,2,3,0,3,48,0.000146
G5,C1C(CO)(OC(C(C=1)=O)CO)O,4,4,0,4,32,0.000194
G5,C1(C(C=CC(C(CO)O1)=O)O)=O,4,3,0,3,27,0.000146
G5,C1(C(CO)O)OC(C(C=1)=O)CO,4,3,0,3,2,0.000146
G5,C1(C(CO)OC(C1O)=CCO)=O,8,3,0,3,2,0.000146
G5,C1(C(C(C=C)(OC1CO)O)O)=O,8,4,0,4,32,0.000194
G5,C1(C(CO)OC(CO)=CC1O)=O,4,3,0,3,32,0.000146
G5,C1(C(C(C(OC1CO)=C)O)O)=O,8,3,0,3,24,0.000146
G5,C1(C(C(C=COC1CO)O)O)=O,8,3,0,3,38,0.000146
G5,C(C(CO)C1CC(C(O)O1)O)=O,16,3,0,3,43,0.000146
G5,C(C(CO)C1(COC(C1O)O)O)=O,16,5,0,5,5,0.000242
G5,C1(C(CO)OC(C1O)O)=O,8,3,0,3,5,0.000146
G5,C(C(CO)OC1(COC(C1)O)O)=O,8,3,0,3,40,0.000146
G5,C(C(CO)OC1CC(C(O)O1)O)=O,16,3,0,3,37,0.000146
G5,C1(C(CO)OC(C(C)O)(C1O)O)=O,16,3,0,3,2,0.000146
G5,C1(C(CO)C(C=O)(OC1C)O)=O,8,3,0,3,24,0.000146
G5,C(C(CO)C1(C(CCO1)O)O)=O,8,3,0,3,4,0.000146
G5,C(C(CO)C1(C(CC(O1)=O)O)O)=O,8,3,0,3,29,0.000146
G5,C1(C2(COC(C2)(C1CO)O)O)=O,8,4,0,4,2,0.000194
G5,C(C1C(C(CO)OC(C1O)O)=O)=O,16,3,0,3,15,0.000146
G5,C1(C(C(C=O)OC(C1CO)O)O)=O,16,3,0,3,2,0.000146
G5,C1(C(COC(C1CO)O)O)=O,8,4,0,4,27,0.000194
G5,C1(C(C(C)OC(C1CO)O)O)=O,16,3,0,3,4,0.000146
G5,C(C1C(C(CO)C(C(O1)O)O)=O)=O,16,3,0,3,15,0.000146
G5,C1(C(CO)C(C=O)OC(C1O)O)=O,16,3,0,3,15,0.000146
G5,C1(C(C(O)OCC1CO)O)=O,8,3,0,3,27,0.000146
G5,C1(C(C(O)OC(C)C1CO)O)=O,16,3,0,3,4,0.000146
G5,C1(COC(C(CO)(C1CO)O)O)=O,8,3,0,3,2,0.000146
G5,C(C(CO)C1(C(OCC1)=O)O)=O,4,5,0,5,28,0.000242
G5,C(C(CO)C1(COC(C1O)=O)O)=O,8,2,0,2,29,9.9e-05
G5,C1(C(C(C(CC1CO)O)O)O)=O,16,2,0,2,49,9.7e-05
G5,C(C(CO)C(CCC(C=O)=O)O)=O,4,5,0,5,7,0.00024300000000000002
G5,C(CC(CC(C(C=O)=O)CO)O)=O,4,3,0,3,55,0.000146
G5,C(C(CC(C(C=O)=O)CO)CO)=O,4,2,0,2,7,9.7e-05
G5,C(C(CO)C(CCC(CO)=O)O)=O,4,5,0,5,7,0.00024300000000000002
G5,C(CC(CC(C(CO)=O)CO)O)=O,4,3,0,3,2,0.000146
G5,C(C(CCC(C(CO)O)=O)CO)=O,4,3,0,3,7,0.000147
G5,C(C(CO)CC(C(CO)=O)CO)=O,4,2,0,2,7,9.7e-05
G5,C(CC(C(C=O)C(C=O)CO)O)=O,8,3,0,3,18,0.000145
G5,C(C(CO)C(C=O)C(C=O)CO)=O,3,2,0,2,18,9.7e-05
G5,C(C(C=O)CC(C(C=O)=O)CO)=O,2,2,0,2,45,9.7e-05
G5,C(C(C=O)CCC(C(CO)O)=O)=O,2,3,0,3,45,0.000147
G5,C(C(C=O)CC(C(CO)=O)CO)=O,2,2,0,2,45,9.7e-05
G5,C(C(CO)C(C=O)C(C=O)C=O)=O,4,2,0,2,29,9.7e-05
G5,C(C(CO)C(C(CO)=O)CCO)=O,4,3,0,3,46,0.000156
G5,C(C(C(C)O)C(C(CO)=O)CO)=O,8,6,0,6,46,0.00028900000000000003
G5,C(C(CO)C(C(CO)=O)C(C)O)=O,8,4,0,4,46,0.000194
G5,C(C(CCC(C(C=O)=O)CO)O)=O,4,3,0,3,7,0.000145
G5,C(C(CC(C(C=O)=O)CO)(C)O)=O,4,2,0,2,29,9.7e-05
G5,C(C(C(CO)CCCO)=O)=O,2,2,0,2,46,9.7e-05
G5,C(C(C(CO)CC(C)O)=O)=O,4,3,0,3,0,0.000145
G5,C(CCC(C(C=O)=O)CO)(O)=O,2,3,0,3,18,0.000145
G5,C(C(CO)O)(CCCC(C=O)O)=O,4,4,0,4,11,0.000194
G5,C(C(CCC(C(CO)=O)CO)O)=O,4,3,0,3,11,0.000145
G5,C(C(CCC(C(CO)O)=O)(C)O)=O,4,3,0,3,11,0.000147
G5,C(C(CC(C(CO)=O)CO)(C)O)=O,4,2,0,2,11,9.7e-05
G5,C(CO)(C(CO)CCO)=O,2,6,0,6,29,0.000321
G5,C(C(CO)O)(CCCCO)=O,2,3,0,3,27,0.000147
G5,C(CO)(C(CO)CCCO)=O,2,2,0,2,27,9.7e-05
G5,C(C(CO)O)(CCC(C)O)=O,4,3,0,3,27,0.000147
G5,C(CO)(C(CO)CC(C)O)=O,4,2,0,2,27,9.7e-05
G5,C(CCCC(C(CO)O)=O)(O)=O,2,4,0,4,18,0.000194
G5,C(CCC(C(CO)=O)CO)(O)=O,2,3,0,3,18,0.000145
G5,C(C(C(C)O)C(C=O)CO)=O,8,6,0,6,5,0.00028900000000000003
G5,C(CC(C=O)C(C=O)CO)(O)=O,4,5,0,5,18,0.000251
G5,C(C)(C(CO)C(C(C=O)=O)CO)=O,4,4,0,4,55,0.000194
G5,C(CC(C(C=O)=O)CO)(CCO)=O,2,2,0,2,55,9.7e-05
G5,C(C(CO)CC(C=O)=O)(CCO)=O,2,2,0,2,55,9.7e-05
G5,C(CC(CO)C(C(C=O)=O)CO)=O,4,6,0,6,55,0.0003
G5,C(C(CO)C(CO)CC(C=O)=O)=O,4,4,0,4,55,0.000193
G5,C(C(CO)CC(C(CCO)=O)=O)=O,2,2,0,2,55,9.7e-05
G5,C(CC(C(CO)C(C=O)CO)=O)=O,4,4,0,4,55,0.000194
G5,C(C(CO)CC(C(C=O)CO)=O)=O,4,3,0,3,55,0.000147
G5,C(C(CO)CC=O)(C(C=O)CO)=O,4,3,0,3,29,0.000147
G5,C(CCCO)(C(C(C=O)=O)CO)=O,2,3,0,3,55,0.000147
G5,C(C(CO)CCO)(CC(C=O)=O)=O,2,3,0,3,29,0.000156
G5,C(C(C(C(CCCO)=O)=O)CO)=O,2,3,0,3,55,0.000147
G5,C(CC(C(C(CO)CCO)=O)=O)=O,2,3,0,3,2,0.000156
G5,C(C)(C(CC(C(C=O)=O)CO)O)=O,4,2,0,2,7,9.7e-05
G5,C(C(CO)O)(CCC(C(C)=O)O)=O,4,3,0,3,7,0.000147
G5,C(C)(C(CC(C(CO)=O)CO)O)=O,4,2,0,2,7,9.7e-05
G5,C(C(CO)O)(CCC(CO)O)=O,4,3,0,3,46,0.000147
G5,C(CO)(C(CO)CC(CO)O)=O,4,2,0,2,46,9.7e-05
G5,C(C(OC(C(C=C)=O)CO)O)=O,4,5,0,5,4,0.000241
G5,C(C(C=O)O)(C(C=CC=O)CO)=O,8,1,0,1,55,4.9e-05
G5,C(C(C=CC(C(C=O)O)=O)CO)=O,8,1,0,1,55,4.9e-05
G5,C(C(C=CC=O)CO)=O,4,2,0,2,18,9.7e-05
G5,C(C=O)(C(CO)C(C(C=O)=O)O)=O,4,2,0,2,3,9.6e-05
G5,C(C(C(CO)C(C)(CCO)O)=O)=O,4,3,0,3,3,0.000154
G5,C(CC(C(CCO)=O)O)(CCO)=O,2,4,0,4,29,0.000213
G5,C(C)(C(CO)C(C(CCO)=O)O)=O,4,3,0,3,3,0.000154
G5,C(C(CCO)(C(C(C)=O)CO)O)=O,4,3,0,3,3,0.000154
G5,C(C(C(CO)C(C)(C)O)=O)=O,2,2,0,2,3,9.6e-05
G5,C(CC(C(CCO)=O)O)(C)=O,2,2,0,2,11,9.499999999999999e-05
G5,C(C(CCO)(CC(C)=O)O)=O,2,4,0,4,29,0.00020099999999999998
G5,C(OCC(C(C(C=O)=O)CO)O)=O,4,2,0,2,3,9.6e-05
G5,C(C(C(C=O)OC=O)O)(CCO)=O,4,2,0,2,3,9.6e-05
G5,C(C(CCO)(C(C=O)OC=O)O)=O,4,2,0,2,3,9.6e-05
G5,C(CCC(C(C(C=O)=O)CO)O)=O,4,3,0,3,3,0.000143
G5,C(CO)=CC(C(C(C=O)=O)CO)O,8,3,0,3,3,0.000154
G5,C=CC(C(C(C(C=O)=O)CO)O)O,8,2,0,2,3,9.6e-05
G5,C1OCC(C=1)(C(C(C=O)=O)CO)O,4,2,0,2,3,9.6e-05
G5,C(C(C1C(C=CO1)=O)O)(CCO)=O,4,2,0,2,3,9.6e-05
G5,C(C(CCO)(C1C(C=CO1)=O)O)=O,4,2,0,2,3,9.6e-05
G5,C(C(C(C(C=O)=O)CO)O)(CC)=O,4,2,0,2,3,9.6e-05
G5,C(C(CC)(C(C(C=O)=O)CO)O)=O,4,2,0,2,3,9.6e-05
G5,C(C(CCO)(C(C(C=O)=O)C)O)=O,4,1,0,1,3,4.8e-05
G5,C(C)=CC(C(C(C=O)=O)CO)O,8,3,0,3,3,0.000143
G5,C=CCC(C(C(C=O)=O)CO)O,4,3,0,3,3,0.000143
G5,C(C(C=C)C(C(CCO)=O)O)=O,4,4,0,4,29,0.00020099999999999998
G5,C(C(C=C)C(C=O)(CCO)O)=O,4,3,0,3,7,0.000143
G5,C(C(C(C)(CCO)O)O)(CCO)=O,4,4,0,4,3,0.000213
G5,C(CO)(C(CO)C(C)(CCO)O)=O,4,3,0,3,3,0.000154
G5,C(CC(CO)(CCO)O)(CCO)=O,2,4,0,4,29,0.00022400000000000002
G5,C(C)(C(CO)C(CO)(CCO)O)=O,4,3,0,3,3,0.000154
G5,C(C(C(C)(C)O)O)(CCO)=O,2,2,0,2,3,9.6e-05
G5,C(CO)(C(CO)C(C)(C)O)=O,2,2,0,2,3,9.6e-05
G5,C(C)(CC(CO)(CCO)O)=O,2,1,0,1,3,4.8e-05
G5,C(OC(C=O)C(CO)(CCO)O)=O,4,2,0,2,3,9.6e-05
G5,C(CCC(C(C(CCO)=O)O)O)=O,4,3,0,3,3,0.000143
G5,C(CCC(C(C(CO)=O)CO)O)=O,4,3,0,3,27,0.000143
G5,C(C(C(CO)(CCO)O)CC=O)=O,4,4,0,4,29,0.000213
G5,C(C(C(C=CCO)O)O)(CCO)=O,8,3,0,3,28,0.000154
G5,C(CO)(C(CO)C(C=CCO)O)=O,8,3,0,3,28,0.000154
G5,C(C(C(C(C=C)O)O)O)(CCO)=O,8,2,0,2,28,9.6e-05
G5,C(CO)(C(CO)C(C(C=C)O)O)=O,8,2,0,2,28,9.6e-05
G5,C(C(C1(C=COC1)O)O)(CCO)=O,4,2,0,2,3,9.6e-05
G5,C(CO)(C(CO)C1(C=COC1)O)=O,4,2,0,2,3,9.6e-05
G5,C1OC(C(C=1)=O)C(CO)(CCO)O,4,2,0,2,3,9.6e-05
G5,C(C(C(C(CC)=O)O)O)(CCO)=O,4,2,0,2,3,9.6e-05
G5,C(CO)(C(CO)C(C(CC)=O)O)=O,4,2,0,2,3,9.6e-05
G5,C(C(CC)(C(C(CCO)=O)O)O)=O,4,2,0,2,3,9.6e-05
G5,C(C(CC)(C(C(CO)=O)CO)O)=O,4,2,0,2,3,9.6e-05
G5,C(C(C(C)C(CO)(CCO)O)=O)=O,4,1,0,1,3,4.8e-05
G5,C(C(C(C=C)O)O)(CCO)=O,4,4,0,4,3,0.00018999999999999998
G5,C(CO)(C(CO)C(C=C)O)=O,4,4,0,4,3,0.00018999999999999998
G5,C(C(C(C=CC)O)O)(CCO)=O,8,3,0,3,3,0.000143
G5,C(CO)(C(CO)C(C=CC)O)=O,8,3,0,3,3,0.000143
G5,C(C(C(CC=C)O)O)(CCO)=O,4,3,0,3,3,0.000143
G5,C(CO)(C(CO)C(CC=C)O)=O,4,3,0,3,3,0.000143
G5,C(C(C=C)C(CO)(CCO)O)=O,4,2,0,2,3,9.499999999999999e-05
G5,C(C(C(C=O)O)O)(CC(C)(C)O)=O,4,1,0,1,0,4.8e-05
G5,C(C)(CC(C(C(C(C)=O)O)O)O)=O,8,5,0,5,27,0.00025
G5,C(C(C(C(C)(CC(C)=O)O)O)O)=O,8,1,0,1,0,4.8e-05
G5,C(C(C(CC(C(C=O)=O)=O)O)O)=O,4,1,0,1,25,4.8e-05
G5,C(C(C(CC(COC=O)=O)O)O)=O,4,6,0,6,1,0.000285
G5,C(C(C(C(C(C)=O)OC=O)O)O)=O,8,6,0,6,1,0.000285
G5,C(C(C(C(C=O)OC=O)O)O)=O,8,5,0,5,1,0.00023799999999999998
G5,C(C(C(C(C=O)OC(C)=O)O)O)=O,8,5,0,5,1,0.00023799999999999998
G5,C(C(C(C(C(C(O)=O)=O)O)O)O)=O,8,4,0,4,33,0.000202
G5,C(C(C(C1C(C(OC1)=O)=O)O)O)=O,8,2,0,2,28,9.6e-05
G5,C(C(C(C1C(OCC1=O)=O)O)O)=O,8,2,0,2,1,9.6e-05
G5,C(C(C(C1C(CC(O1)=O)=O)O)O)=O,8,2,0,2,1,9.6e-05
G5,C(C(C(C1C(C=CO1)=O)O)O)=O,8,3,0,3,28,0.000143
G5,C(C(C(C(C=O)C(C=O)C)O)O)=O,16,2,0,2,1,9.6e-05
G5,C(C(C(C(C=C)C(C=O)=O)O)O)=O,8,1,0,1,28,4.8e-05
G5,C(C(C(C=O)=C)C(C(C=O)O)O)=O,8,1,0,1,28,4.8e-05
G5,C(C(C(C(C=O)C(CO)=C)O)O)=O,8,1,0,1,28,4.8e-05
G5,C(C(C=C)C(C(C=O)O)O)=O,8,2,0,2,0,9.499999999999999e-05
G5,C(C(C=CC=O)C(C(C=O)O)O)=O,16,1,0,1,28,4.8e-05
G5,C(CO)(CC1(C(CC(C1)O)O)O)=O,8,1,0,1,45,4.8e-05
G5,C(C)(C(C1(C(CC(C1)O)O)O)O)=O,16,2,0,2,45,9.6e-05
G5,C1(C(CC(C1)(CC(CO)=O)O)O)=O,4,1,0,1,26,4.8e-05
G5,C1(C(CC(C(C(C)=O)O)(C1)O)O)=O,8,2,0,2,26,9.6e-05
G5,C(CC1(C=CC(C1O)O)O)(CO)=O,8,1,0,1,28,4.8e-05
G5,C(C(C1(C=CC(C1O)O)O)O)(C)=O,16,2,0,2,28,9.6e-05
G5,C(C(CO)C(CC(CO)=O)O)(O)=O,4,6,0,6,29,0.000321
G5,C(C(CO)C(C(C(C)=O)O)O)(O)=O,8,6,0,6,18,0.00031099999999999997
G5,C(CC(C=O)(CC(CO)=O)O)(O)=O,2,2,0,2,51,0.00010700000000000001
G5,C(CO)(CC(C(CO)CO)O)=O,2,4,0,4,29,0.000213
G5,C(C)(C(C(C(CO)CO)O)O)=O,4,4,0,4,18,0.000202
G5,C(CO)(CC(C(CO)C(C)O)O)=O,8,3,0,3,29,0.000165
G5,C(C)(C(C(C(CO)C(C)O)O)O)=O,16,3,0,3,18,0.000155
G5,C(C)(C(CCO)(CC(CO)=O)O)=O,2,3,0,3,29,0.000154
G5,C(C)(C(CCO)(C(C(C)=O)O)O)=O,4,4,0,4,14,0.00020299999999999997
G5,C(CC(C=C)(C(CO)O)O)(CO)=O,4,1,0,1,7,4.8e-05
G5,C(C(C(C=C)(C(CO)O)O)O)(C)=O,8,2,0,2,7,9.6e-05
G5,C(CO)(CC(CC(CCO)O)O)=O,4,3,0,3,29,0.000165
G5,C(C)(C(C(CC(CCO)O)O)O)=O,8,3,0,3,18,0.000155
G5,C(CO)(CC(CC(C(C)O)O)O)=O,8,1,0,1,11,4.8e-05
G5,C(C)(C(C(CC(C(C)O)O)O)O)=O,16,2,0,2,11,9.6e-05
G5,C(CC(C(C=O)=O)(C)O)(CO)=O,2,6,0,6,26,0.000296
G5,C(C(C(CC(C)(CO)O)=O)=O)=O,2,2,0,2,49,9.499999999999999e-05
G5,C(C(C(C(CC(CO)=O)O)=O)O)=O,4,6,0,6,0,0.000285
G5,C(CO)(CC(C)(CC(CO)=O)O)=O,1,2,0,2,26,0.00010700000000000001
G5,C(C)(C(C(C)(CC(CO)=O)O)O)=O,4,4,0,4,49,0.00020299999999999997
G5,C(C)(CC(CO)(CC(CO)=O)O)=O,2,3,0,3,27,0.000154
G5,C(C)(CC(CO)(C(C(C)=O)O)O)=O,4,4,0,4,26,0.000202
G5,C(CC(CO)(C)O)(CC(CO)=O)=O,2,2,0,2,49,0.00010700000000000001
G5,C(C)(C(C(CO)=O)C(CO)(C)O)=O,4,3,0,3,26,0.000155
G5,C(C(C(CO)(C)O)O)(CC(C)=O)=O,4,3,0,3,26,0.000155
G5,C(C)(C(C(C)(C(C(C)=O)O)O)O)=O,3,2,0,2,49,9.6e-05
G5,C(CC(CO)(C)O)(C(C(C)=O)O)=O,4,1,0,1,49,4.8e-05
G5,C(CO)(CC(C)(CCO)O)=O,2,2,0,2,6,0.00010700000000000001
G5,C(C)(C(C(C)(CCO)O)O)=O,4,3,0,3,28,0.000155
G5,C(CC(C)(CO)O)(CCO)=O,2,2,0,2,49,0.00010700000000000001
G5,C(C)(C(CO)C(C)(CO)O)=O,4,3,0,3,28,0.000155
G5,C(C(C(CC=O)=O)C(C)(CO)O)=O,4,2,0,2,9,9.6e-05
G5,C(CO)(CC(C)(C)O)=O,1,1,0,1,49,4.8e-05
G5,C(C)(C(C(C)(C)O)O)=O,2,2,0,2,49,9.6e-05
G5,C(C)(CC(C)(CO)O)=O,2,1,0,1,49,4.8e-05
G5,C(CCC(CO)(CC(CO)=O)O)=O,2,2,0,2,0,9.6e-05
G5,C(CCC(CO)(C(C(C)=O)O)O)=O,4,3,0,3,7,0.000144
G5,C(CCC=O)(C(C(CO)(C)O)O)=O,4,2,0,2,7,9.6e-05
G5,C(CO)(C(C(CO)(C)O)CC=O)=O,4,3,0,3,7,0.000154
G5,C(C(C(CO)(C)O)CC(CO)=O)=O,4,3,0,3,11,0.000154
G5,C(C(CC(C)(CC(CO)=O)O)O)=O,4,1,0,1,27,4.8e-05
G5,C(C(CC(C)(C(C(C)=O)O)O)O)=O,8,2,0,2,27,9.6e-05
G5,C(C)(C(C(CO)(C)O)C(C=O)O)=O,8,2,0,2,27,9.6e-05
G5,C(CC(C=O)O)(CC(CO)(C)O)=O,4,1,0,1,27,4.8e-05
G5,C(CC(C=CCO)(CO)O)(CO)=O,4,2,0,2,49,0.00010700000000000001
G5,C(C(C(C=CCO)(CO)O)O)(C)=O,8,3,0,3,11,0.000155
G5,C(CO)=CC(C(C(CO)(C)O)O)=O,8,3,0,3,11,0.000155
G5,C(OCC(C)(CC(CO)=O)O)=O,2,5,0,5,49,0.00023799999999999998
G5,C(OCC(C)(C(C(C)=O)O)O)=O,4,6,0,6,49,0.000286
G5,C(OCC(CC(C)(CO)O)=O)=O,2,3,0,3,49,0.000143
G5,C(OC(C(C)=O)C(C)(CO)O)=O,4,3,0,3,35,0.000143
G5,C(OC(C=O)C(C)(CO)O)=O,4,2,0,2,28,9.6e-05
G5,C(CO)(CC(COC(CO)=O)O)=O,2,1,0,1,40,4.8e-05
G5,C(C)(C(C(COC(CO)=O)O)O)=O,4,2,0,2,40,9.6e-05
G5,C(C(C(CO)(C)O)OC(CO)=O)=O,4,2,0,2,40,9.6e-05
G5,C(C)(OCC(CC(CO)=O)O)=O,2,1,0,1,28,4.8e-05
G5,C(C)(C(C(COC(C)=O)O)O)=O,4,2,0,2,28,9.6e-05
G5,C(C(C(C)(CO)O)OC(C)=O)=O,4,2,0,2,28,9.6e-05
G5,C(CCC(C(CC(CO)=O)O)=O)=O,2,2,0,2,32,0.00010700000000000001
G5,C(CCC(C=O)(CC(CO)=O)O)=O,2,2,0,2,20,9.6e-05
G5,C(CCC(C=O)(C(C(C)=O)O)O)=O,4,3,0,3,20,0.000144
G5,C(CC(C(C=O)=O)C(C)(CO)O)=O,4,2,0,2,11,9.6e-05
G5,C(C(C(C)(CO)O)CC(C=O)=O)=O,4,2,0,2,11,9.6e-05
G5,C(CCC(CC(CO)=O)O)=O,2,3,0,3,29,0.000143
G5,C(CCC(C(C(C)=O)O)O)=O,4,4,0,4,27,0.00019099999999999998
G5,C(C(C(C)(CO)O)CC=O)=O,4,5,0,5,29,0.00024900000000000004
G5,C(CO)(CC(C(C=CCO)=O)O)=O,4,1,0,1,55,4.8e-05
G5,C(C(C=CCO)(CC(CO)=O)O)=O,4,1,0,1,55,4.8e-05
G5,C(C(C=CCO)(C(C(C)=O)O)O)=O,8,2,0,2,55,9.6e-05
G5,C(CO)(CC(C=CCO)O)=O,4,4,0,4,29,0.000202
G5,C(C)(C(C(C=CCO)O)O)=O,8,5,0,5,28,0.00025
G5,C(C(C(C(CO)(C)O)O)=O)(O)=O,4,3,0,3,33,0.000155
G5,C(C(CC=O)(CC(CO)=O)O)(O)=O,2,2,0,2,51,0.00010700000000000001
G5,C(C(C(C(O)=O)=O)C(C)(CO)O)=O,4,3,0,3,45,0.000155
G5,C(CC(C)(CC(CO)=O)O)(O)=O,2,2,0,2,6,0.00010700000000000001
G5,C(CC(C)(C(C(C)=O)O)O)(O)=O,4,3,0,3,6,0.000155
G5,C(CC(CC(C)(CO)O)=O)(O)=O,2,3,0,3,49,0.000154
G5,C(C(C(C)=O)C(C)(CO)O)(O)=O,4,4,0,4,6,0.000202
G5,C(CO)(CC(C=CC(O)=O)O)=O,4,4,0,4,29,0.000202
G5,C(C)(C(C(C=CC(O)=O)O)O)=O,8,5,0,5,18,0.00025
G5,C(C(CO)=O)(C(C(CO)(C)O)O)=O,4,4,0,4,5,0.00019099999999999998
G5,C(CC(C(C=C)=O)(CO)O)(CO)=O,2,2,0,2,7,9.7e-05
G5,C(C(C(C(C=C)=O)(CO)O)O)(C)=O,4,6,0,6,7,0.000291
G5,C(CO)(C(C=C)(CC(CO)=O)O)=O,2,1,0,1,7,4.8e-05
G5,C(CO)(C(C=C)(C(C(C)=O)O)O)=O,4,3,0,3,7,0.000144
G5,C=CC(C(C(C(CO)(C)O)O)=O)=O,4,2,0,2,7,9.6e-05
G5,C(C(C)(CC(CO)=O)O)(C(C)O)=O,4,1,0,1,49,4.8e-05
G5,C(C(C)(C(C(C)=O)O)O)(C(C)O)=O,8,3,0,3,49,0.000144
G5,C(C(C(C)O)=O)(CC(CO)(C)O)=O,4,1,0,1,49,4.8e-05
G5,C1(C(C(CC1)(CC(CO)=O)O)O)=O,4,2,0,2,49,9.499999999999999e-05
G5,C1(C(C(CC1)(C(C(C)=O)O)O)O)=O,8,3,0,3,47,0.000143
G5,C1(C(C(CO)(C)O)CC(C1O)=O)=O,8,2,0,2,47,9.6e-05
G5,C1(CCC(CO1)(CC(CO)=O)O)=O,2,1,0,1,7,4.8e-05
G5,C1(CCC(CO1)(C(C(C)=O)O)O)=O,4,2,0,2,7,9.6e-05
G5,C1(COC(CC1C(C)(CO)O)=O)=O,4,1,0,1,7,4.8e-05
G5,C1(CCC(OC1C(C)(CO)O)=O)=O,4,2,0,2,7,9.6e-05
G5,C(CO)(CC1(COCC(C1)=O)O)=O,2,1,0,1,54,4.8e-05
G5,C(C)(C(C1(COCC(C1)=O)O)O)=O,4,2,0,2,54,9.6e-05
G5,C1(C(C(CO)(C)O)OCC(C1)=O)=O,4,2,0,2,54,9.6e-05
G5,C1(COCC(C1C(CO)(C)O)=O)=O,2,2,0,2,54,9.6e-05
G5,C1(C(CCO1)(CC(CO)=O)O)=O,2,2,0,2,29,9.499999999999999e-05
G5,C1(C(CCO1)(C(C(C)=O)O)O)=O,4,4,0,4,28,0.00019099999999999998
G5,C1(C(C(CO1)C(C)(CO)O)=O)=O,4,3,0,3,28,0.000143
G5,C1(CC(CO1)(CC(CO)=O)O)=O,2,2,0,2,29,9.499999999999999e-05
G5,C1(CC(CO1)(C(C(C)=O)O)O)=O,4,3,0,3,28,0.000143
G5,C1(C(C(CO1)=O)C(C)(CO)O)=O,4,4,0,4,28,0.00019099999999999998
G5,C1(CC(C(C(C)(CO)O)O1)=O)=O,4,3,0,3,28,0.000143
G5,C(CO)(CC(C(C=C)O)O)=O,4,3,0,3,29,0.000143
G5,C(C)(C(C(C(C=C)O)O)O)=O,8,4,0,4,28,0.00019099999999999998
G5,C(CC1(C=COC1)O)(CO)=O,2,2,0,2,49,9.499999999999999e-05
G5,C(C(C1(C=COC1)O)O)(C)=O,4,3,0,3,28,0.000143
G5,C1OC(C(C=1)=O)C(C)(CO)O,4,3,0,3,28,0.000143
G5,C(CC1(C=CC(O)OC1)O)(CO)=O,4,1,0,1,27,4.8e-05
G5,C(C(C1(C=CC(O)OC1)O)O)(C)=O,8,2,0,2,27,9.6e-05
G5,C1C(OC(C(C=1)=O)C(CO)(C)O)O,8,2,0,2,27,9.6e-05
G5,C(CC(C(C)O)(CC(CO)=O)O)=O,4,3,0,3,45,0.000155
G5,C(CC(C(C)O)(C(C(C)=O)O)O)=O,8,4,0,4,45,0.00020299999999999997
G5,C(C(C)O)(CC(CC(CO)=O)O)=O,4,2,0,2,49,9.499999999999999e-05
G5,C(C(C)O)(CC(C(C(C)=O)O)O)=O,8,3,0,3,45,0.000143
G5,C(C(C(C(C)O)=O)C(CO)(C)O)=O,8,3,0,3,45,0.000143
G5,C(CO)(CC(C(CC(C)O)O)O)=O,8,1,0,1,11,4.8e-05
G5,C(C)(C(C(C(CC(C)O)O)O)O)=O,16,4,0,4,11,0.000202
G5,C(CO)(CC(C(C)O)(C(C)O)O)=O,3,1,0,1,49,4.8e-05
G5,C(C)(C(C(C(C)O)(C(C)O)O)O)=O,6,2,0,2,49,9.6e-05
G5,C(C(C=CC(CC(CO)=O)O)O)=O,8,2,0,2,49,9.499999999999999e-05
G5,C(C(C=CC(C(C(C)=O)O)O)O)=O,16,5,0,5,20,0.00024900000000000004
G5,C(CO)(CC(C(C=CC=O)O)O)=O,8,4,0,4,29,0.00022400000000000002
G5,C(C)(C(C(C(C=CC=O)O)O)O)=O,16,8,0,8,20,0.000425
G5,C(CO)(CC(C)(C(CCO)O)O)=O,4,2,0,2,4,0.00010700000000000001
G5,C(C)(C(C(C)(C(CCO)O)O)O)=O,8,3,0,3,45,0.000155
G5,C(C(CCO)O)(CC(CO)(C)O)=O,4,2,0,2,49,0.00010700000000000001
G5,C(CO)(CC(C(C)(CCO)O)O)=O,4,3,0,3,29,0.000165
G5,C(C)(C(C(C(C)(CCO)O)O)O)=O,8,3,0,3,29,0.000155
G5,C(C(C=C)(CC(CO)=O)O)(O)=O,2,4,0,4,29,0.000202
G5,C(C(C=C)(C(C(C)=O)O)O)(O)=O,4,6,0,6,7,0.000298
G5,C(CO)(CC(C(CO)(C)O)O)=O,4,3,0,3,29,0.000154
G5,C(C)(C(C(C(CO)(C)O)O)O)=O,8,6,0,6,11,0.000308
G5,C(CO)(CC(C(C)(C(C)O)O)O)=O,8,1,0,1,18,4.8e-05
G5,C(C)(C(C(C(C)(C(C)O)O)O)O)=O,16,2,0,2,18,9.6e-05
G5,C(CO)(C(CC)(CC(CO)=O)O)=O,2,1,0,1,42,4.8e-05
G5,C(CO)(C(CC)(C(C(C)=O)O)O)=O,4,2,0,2,42,9.6e-05
G5,C(C(CO)(CC(CO)=O)O)(CC)=O,2,1,0,1,42,4.8e-05
G5,C(C(CO)(C(C(C)=O)O)O)(CC)=O,4,2,0,2,42,9.6e-05
G5,C(C(CO)=O)(C(C)C(CO)(C)O)=O,4,1,0,1,42,4.8e-05
G5,C(C(C(C(CO)(C)O)O)=O)(CC)=O,4,2,0,2,42,9.6e-05
G5,C(CC(CO)C(CC(CO)=O)O)=O,4,4,0,4,43,0.000202
G5,C(CC(CO)C(C(C(C)=O)O)O)=O,8,5,0,5,55,0.00025
G5,C(C(CO)CC(CC(CO)=O)O)=O,4,1,0,1,55,4.8e-05
G5,C(C(CO)CC(C(C(C)=O)O)O)=O,8,2,0,2,55,9.6e-05
G5,C(C(C(C)(CO)O)C(C=O)CO)=O,8,3,0,3,55,0.000143
G5,C(C(C)(CC(CO)=O)O)(CC)=O,2,2,0,2,49,9.499999999999999e-05
G5,C(C(C)(C(C(C)=O)O)O)(CC)=O,4,3,0,3,28,0.000143
G5,C(C)(C(CC)(CC(CO)=O)O)=O,2,1,0,1,28,4.8e-05
G5,C(C)(C(CC)(C(C(C)=O)O)O)=O,4,2,0,2,28,9.6e-05
G5,C(C(CC)=O)(CC(C)(CO)O)=O,2,2,0,2,49,9.499999999999999e-05
G5,C(C(C)=O)(C(C)C(C)(CO)O)=O,4,1,0,1,28,4.8e-05
G5,C(CC(C)(CO)O)(CC(C)=O)=O,2,3,0,3,29,0.000143
G5,C(C)(C(C(C)=O)C(C)(CO)O)=O,2,3,0,3,28,0.000143
G5,C(CC(C)C(CC(CO)=O)O)=O,4,2,0,2,3,9.6e-05
G5,C(CC(C)C(C(C(C)=O)O)O)=O,8,3,0,3,28,0.000144
G5,C(C(C)CC(CC(CO)=O)O)=O,4,2,0,2,49,9.499999999999999e-05
G5,C(C(C)CC(C(C(C)=O)O)O)=O,8,3,0,3,28,0.000143
G5,C(C(C(C)(CO)O)C(C=O)C)=O,8,3,0,3,49,0.000143
G5,C(CC(C(C(C=O)C)=O)O)(CO)=O,4,1,0,1,49,4.8e-05
G5,C(C(C(C(C(C(C)=O)O)O)=O)C)=O,8,2,0,2,49,9.6e-05
G5,C(CC(C=O)(C(C=O)C)O)(CO)=O,4,1,0,1,49,4.8e-05
G5,C(C(C(C=O)(C(C=O)C)O)O)(C)=O,8,3,0,3,49,0.000144
G5,C(CC(C(C(CO)C)=O)O)(CO)=O,4,1,0,1,28,4.8e-05
G5,C(C(C(C(C(CO)C)=O)O)O)(C)=O,8,2,0,2,28,9.6e-05
G5,C(C(C(CO)C)(CC(CO)=O)O)=O,4,1,0,1,28,4.8e-05
G5,C(C(C(CO)C)(C(C(C)=O)O)O)=O,8,2,0,2,28,9.6e-05
G5,C(C(C)C(C(CC(CO)=O)O)O)=O,8,1,0,1,49,4.8e-05
G5,C(C(C)C(C(C(C(C)=O)O)O)O)=O,16,2,0,2,49,9.6e-05
G5,C(C(C(C(CC(CO)=O)O)C)O)=O,8,1,0,1,49,4.8e-05
G5,C(C(C(C)C(C(C(C)=O)O)O)O)=O,16,2,0,2,49,9.6e-05
G5,C(CC(C(CC)=O)O)(CO)=O,2,2,0,2,49,9.499999999999999e-05
G5,C(C(C(C(CC)=O)O)O)(C)=O,4,3,0,3,28,0.000143
G5,C(C(CC)(CC(CO)=O)O)=O,2,1,0,1,28,4.8e-05
G5,C(C(CC)(C(C(C)=O)O)O)=O,4,2,0,2,28,9.6e-05
G5,C(C(C(C)C(C)(CO)O)=O)=O,4,1,0,1,28,4.8e-05
G5,C(C(C=O)C(C)(CC(CO)=O)O)=O,2,6,0,6,26,0.000297
G5,C(C(C=O)C(C)(C(C(C)=O)O)O)=O,4,5,0,5,49,0.000239
G5,C(C(C=O)C(CC(C)(CO)O)=O)=O,2,1,0,1,6,4.8e-05
G5,C(C(C=O)CC(CC(CO)=O)O)=O,2,1,0,1,43,4.8e-05
G5,C(C(C=O)CC(C(C(C)=O)O)O)=O,4,2,0,2,43,9.6e-05
G5,C(C(C=O)C(C=O)C(C)(CO)O)=O,4,1,0,1,43,4.8e-05
G5,C(C(CC)(CC(CO)=O)O)(O)=O,2,1,0,1,28,4.8e-05
G5,C(C(CC)(C(C(C)=O)O)O)(O)=O,4,2,0,2,28,9.6e-05
G5,C(C(C(C)C(C)(CO)O)=O)(O)=O,4,1,0,1,28,4.8e-05
G5,C(CO)(CC(CO)(C(C=C)O)O)=O,4,1,0,1,31,4.8e-05
G5,C(C)(C(C(CO)(C(C=C)O)O)O)=O,8,2,0,2,31,9.6e-05
G5,C(C(C(CO)(C)O)O)(C(C=C)O)=O,8,2,0,2,31,9.6e-05
G5,C(CO)(CC(C=C(CO)CO)O)=O,2,1,0,1,18,4.8e-05
G5,C(C)(C(C(C=C(CO)CO)O)O)=O,4,2,0,2,18,9.6e-05
G5,C(CC(C=CC(CO)O)O)(CO)=O,8,1,0,1,46,4.8e-05
G5,C(C(C(C=CC(CO)O)O)O)(C)=O,16,2,0,2,46,9.6e-05
G5,C(CO)(CC(C(C=CC=O)=O)O)=O,4,1,0,1,20,4.8e-05
G5,C(C(C=CC=O)(CC(CO)=O)O)=O,4,1,0,1,20,4.8e-05
G5,C(C(C=CC=O)(C(C(C)=O)O)O)=O,8,3,0,3,20,0.000144
G5,C(CO)(CC(C=CC(C=O)=O)O)=O,4,1,0,1,20,4.8e-05
G5,C(C)(C(C(C=CC(C=O)=O)O)O)=O,8,2,0,2,20,9.6e-05
G5,C(CO)(CC(C(C=CC)=O)O)=O,4,3,0,3,29,0.000154
G5,C(C(C=CC)(CC(CO)=O)O)=O,4,2,0,2,49,9.499999999999999e-05
G5,C(C(C=CC)(C(C(C)=O)O)O)=O,8,3,0,3,28,0.000143
G5,C(C(CC(CO)=O)O)(CC=C)=O,2,3,0,3,29,0.000154
G5,C(C(CC=C)(CC(CO)=O)O)=O,2,2,0,2,49,9.499999999999999e-05
G5,C(C(CC=C)(C(C(C)=O)O)O)=O,4,3,0,3,28,0.000143
G5,C=CC(C(C=O)=O)C(C)(CO)O,4,2,0,2,49,9.499999999999999e-05
G5,C(CC(C=CC=O)(C)O)(CO)=O,4,2,0,2,4,9.499999999999999e-05
G5,C(C(C(C=CC=O)(C)O)O)(C)=O,8,3,0,3,28,0.000143
G5,C(CO)(CC(C=CC(C)=O)O)=O,4,2,0,2,49,9.499999999999999e-05
G5,C(C)(C(C(C=CC(C)=O)O)O)=O,8,3,0,3,28,0.000143
G5,C(C=CC(CC(C)(CO)O)=O)=O,4,2,0,2,49,9.499999999999999e-05
G5,C(CC(C(CC(CO)=O)O)=C)=O,2,3,0,3,29,0.000154
G5,C(CC(C(C(C(C)=O)O)O)=C)=O,4,3,0,3,28,0.000143
G5,C(CO)(CC(CC(C=O)=C)O)=O,2,2,0,2,49,9.499999999999999e-05
G5,C(C)(C(C(CC(C=O)=C)O)O)=O,4,3,0,3,28,0.000143
G5,C(C(C(C=O)=C)C(C)(CO)O)=O,4,2,0,2,49,9.499999999999999e-05
G5,C(CO)(CC(C(C)=CC=O)O)=O,4,3,0,3,22,0.000154
G5,C(C)(C(C(C(C)=CC=O)O)O)=O,8,3,0,3,28,0.000143
G5,C(CO)(CC(C=C(C=O)C)O)=O,4,2,0,2,49,9.499999999999999e-05
G5,C(C)(C(C(C=C(C=O)C)O)O)=O,8,3,0,3,28,0.000143
G5,C(CO)(CC(C(C(CO)=O)=C)O)=O,2,1,0,1,9,4.8e-05
G5,C(C)(C(C(C(C(CO)=O)=C)O)O)=O,4,2,0,2,9,9.6e-05
G5,C(CC(C(C=O)=C)(CO)O)(CO)=O,2,1,0,1,9,4.8e-05
G5,C(C(C(C(C=O)=C)(CO)O)O)(C)=O,4,2,0,2,9,9.6e-05
G5,C=C(C=O)C(C(C(CO)(C)O)O)=O,4,2,0,2,9,9.6e-05
G5,C(CO)(CC(C(C(CO)=C)=O)O)=O,2,1,0,1,49,4.8e-05
G5,C(C(C(CO)=C)(CC(CO)=O)O)=O,2,1,0,1,49,4.8e-05
G5,C(C(C(CO)=C)(C(C(C)=O)O)O)=O,4,3,0,3,49,0.000144
G5,C(CC(C(CO)=C)(CO)O)(CO)=O,2,1,0,1,49,4.8e-05
G5,C(C(C(C(CO)=C)(CO)O)O)(C)=O,4,2,0,2,49,9.6e-05
G5,C=C(C(C(C(CO)(C)O)O)=O)CO,4,2,0,2,49,9.6e-05
G5,C(CO)(CC(C(C(C=O)=C)O)O)=O,4,1,0,1,16,4.8e-05
G5,C(C)(C(C(C(C(C=O)=C)O)O)O)=O,8,3,0,3,16,0.000143
G5,C(C(C(C(CC(CO)=O)O)=C)O)=O,4,1,0,1,16,4.8e-05
G5,C(C(C(C(C(C(C)=O)O)O)=C)O)=O,8,2,0,2,16,9.6e-05
G5,C(CO)(CC(C=C(C=O)CO)O)=O,4,1,0,1,18,4.8e-05
G5,C(C)(C(C(C=C(C=O)CO)O)O)=O,8,2,0,2,18,9.6e-05
G5,C(CO)(CC(C(CO)=CC=O)O)=O,4,1,0,1,18,4.8e-05
G5,C(C)(C(C(C(CO)=CC=O)O)O)=O,8,2,0,2,18,9.6e-05
G5,C(CO)(CC(C=C)O)=O,2,5,0,5,29,0.00024900000000000004
G5,C(C)(C(C(C=C)O)O)=O,4,5,0,5,49,0.00023799999999999998
G5,C(CC(C=CC)(CO)O)(CO)=O,4,2,0,2,49,9.499999999999999e-05
G5,C(C(C(C=CC)(CO)O)O)(C)=O,8,3,0,3,28,0.000143
G5,C(C)=CC(C(C(CO)(C)O)O)=O,8,3,0,3,28,0.000143
G5,C(CO)(CC(CO)(CC=C)O)=O,2,2,0,2,49,9.499999999999999e-05
G5,C(C)(C(C(CO)(CC=C)O)O)=O,4,3,0,3,28,0.000143
G5,C(CO)(C(C=C)C(CO)(C)O)=O,4,2,0,2,49,9.499999999999999e-05
G5,C(C(C(CO)(C)O)O)(CC=C)=O,4,3,0,3,28,0.000143
G5,C(CO)(CC(C)(C(C=C)O)O)=O,4,2,0,2,49,9.499999999999999e-05
G5,C(C)(C(C(C)(C(C=C)O)O)O)=O,8,3,0,3,28,0.000143
G5,C(CC(CO)(C)O)(C(C=C)O)=O,4,2,0,2,49,9.499999999999999e-05
G5,C(CO)(CC(CC(CO)=C)O)=O,2,2,0,2,49,9.499999999999999e-05
G5,C(C)(C(C(CC(CO)=C)O)O)=O,4,3,0,3,28,0.000143
G5,C(C(C(CO)=C)C(CO)(C)O)=O,4,2,0,2,49,9.499999999999999e-05
G5,C(CO)(CC(C=C(C)CO)O)=O,4,2,0,2,49,9.499999999999999e-05
G5,C(C)(C(C(C=C(C)CO)O)O)=O,8,3,0,3,28,0.000143
G5,C(CO)(CC(C=CC)O)=O,4,2,0,2,28,9.499999999999999e-05
G5,C(C)(C(C(C=CC)O)O)=O,8,3,0,3,45,0.000143
G5,C(CO)(CC(CC=C)O)=O,2,2,0,2,28,9.499999999999999e-05
G5,C(C)(C(C(CC=C)O)O)=O,4,3,0,3,45,0.000143
G5,C(C(C=C)C(C)(CO)O)=O,4,2,0,2,49,9.499999999999999e-05
G5,C(CO)(CC(C(C(CO)=C)O)O)=O,4,1,0,1,49,4.8e-05
G5,C(C)(C(C(C(C(CO)=C)O)O)O)=O,8,2,0,2,49,9.6e-05
G5,C(CO)(CC(C(C=C)(CO)O)O)=O,4,1,0,1,29,4.8e-05
G5,C(C)(C(C(C(C=C)(CO)O)O)O)=O,8,4,0,4,29,0.000202
G5,C(C(C=C)(C(CC(CO)=O)O)O)=O,4,4,0,4,32,0.000213
G5,C(C(C=C)(C(C(C(C)=O)O)O)O)=O,8,7,0,7,28,0.000367
G5,C(CO)(CC(C(C(C=C)O)O)O)=O,8,1,0,1,27,4.8e-05
G5,C(C)(C(C(C(C(C=C)O)O)O)O)=O,16,2,0,2,27,9.6e-05
G5,C(CO)(CC1(C(O)OC(C)C1)O)=O,8,2,0,2,49,9.499999999999999e-05
G5,C(C)(C(C1(C(O)OC(C)C1)O)O)=O,16,3,0,3,45,0.000143
G5,C1(C(O)OC(C)C1C(CO)(C)O)=O,16,3,0,3,45,0.000143
G5,C(CO)(CC1(COC(C1O)O)O)=O,8,4,0,4,12,0.00020099999999999998
G5,C(C)(C(C1(COC(C1O)O)O)O)=O,16,6,0,6,5,0.000308
G5,C1(C(C(CO)(C)O)OC(C1O)O)=O,16,3,0,3,5,0.000143
G5,C(CC(C(CCCO)=O)O)(CO)=O,2,2,0,2,7,9.6e-05
G5,C(C(CCCO)(CC(CO)=O)O)=O,2,1,0,1,55,4.8e-05
G5,C(C(CCCO)(C(C(C)=O)O)O)=O,4,2,0,2,55,9.6e-05
G5,C(C(C(CCO)C(C)(CO)O)=O)=O,4,2,0,2,49,9.6e-05
G5,C(CO)(CC(CO)(CCCO)O)=O,2,1,0,1,55,4.8e-05
G5,C(C)(C(C(CO)(CCCO)O)O)=O,4,2,0,2,55,9.6e-05
G5,C(C(C(CO)(C)O)O)(CCCO)=O,4,3,0,3,55,0.000144
G5,C(CO)(C(CCO)C(CO)(C)O)=O,4,2,0,2,49,9.6e-05
G5,C(CO)(CC1(C=CC(C1O)=O)O)=O,4,1,0,1,47,4.8e-05
G5,C(C)(C(C1(C=CC(C1O)=O)O)O)=O,8,2,0,2,47,9.6e-05
G5,C(CC=CC(CC(CO)=O)O)=O,4,3,0,3,29,0.000154
G5,C(CC=CC(C(C(C)=O)O)O)=O,8,3,0,3,28,0.000143
G5,C(CO)(CC(CC=CC=O)O)=O,4,3,0,3,29,0.000154
G5,C(C)(C(C(CC=CC=O)O)O)=O,8,3,0,3,28,0.000143
G5,C(C(C=CC=O)C(C)(CO)O)=O,8,2,0,2,49,9.499999999999999e-05
G5,C(CC(C(C=O)C(C=O)O)O)(O)=O,8,3,0,3,28,0.000154
G5,C(C(C(C=O)C(C(C=O)=O)O)O)=O,8,2,0,2,43,9.6e-05
G5,C(C(C(C)(CCO)O)C(C=O)O)=O,8,3,0,3,43,0.000154
G5,C(CC(CC(C=O)O)O)(CCO)=O,4,2,0,2,6,0.00010700000000000001
G5,C(CC(C(C(C(C)=O)CO)O)O)=O,8,3,0,3,43,0.000154
G5,C(C(CC(C(C(C)=O)CO)O)O)=O,8,3,0,3,43,0.000154
G5,C(C(C(C)(C)O)C(C=O)O)=O,4,2,0,2,43,9.6e-05
G5,C(CC(C(CC(C)=O)O)O)=O,4,3,0,3,29,0.000144
G5,C(C(CC(CC(C)=O)O)O)=O,4,2,0,2,6,9.499999999999999e-05
G5,C(C(C(COC=O)O)C(C=O)O)=O,8,2,0,2,43,9.6e-05
G5,C(CC(C(C(C=O)OC=O)O)O)=O,8,2,0,2,43,9.6e-05
G5,C(C(CC(C(C=O)OC=O)O)O)=O,8,2,0,2,43,9.6e-05
G5,C(CCC(C(C=O)C(C=O)O)O)=O,8,3,0,3,43,0.000143
G5,C(C(C(C=O)C(C=CCO)O)O)=O,16,3,0,3,43,0.000154
G5,C(C(C(C(C=C)O)O)C(C=O)O)=O,16,2,0,2,43,9.6e-05
G5,C(C(C(C=O)C1(C=COC1)O)O)=O,8,2,0,2,43,9.6e-05
G5,C(CC(C(C1C(C=CO1)=O)O)O)=O,8,2,0,2,43,9.6e-05
G5,C(C(CC(C1C(C=CO1)=O)O)O)=O,8,2,0,2,43,9.6e-05
G5,C(C(C(C=O)C(C=O)O)O)(CC)=O,8,2,0,2,43,9.6e-05
G5,C(C(C(C=O)C(C=O)(CC)O)O)=O,8,2,0,2,43,9.6e-05
G5,C(CC(C(C(C(C=O)=O)C)O)O)=O,8,2,0,2,28,9.7e-05
G5,C(C(CC(C(C(C=O)=O)C)O)O)=O,8,1,0,1,43,4.8e-05
G5,C(C(C(C=O)C(C=C)O)O)=O,8,4,0,4,43,0.00019099999999999998
G5,C(C(C(C=O)C(C=CC)O)O)=O,16,3,0,3,43,0.000143
G5,C(C(C(CC=C)O)C(C=O)O)=O,8,3,0,3,43,0.000143
G5,C(C(C=C)C(C(CC=O)O)O)=O,8,3,0,3,43,0.000144
G5,C(C(C=C)C(CC(C=O)O)O)=O,8,2,0,2,43,9.499999999999999e-05
G5,C(CC1(C(C(C(C1O)O)O)O)O)=O,10,3,0,3,5,0.000166
G5,C(CC1(CC(C(C)(C1O)O)O)O)=O,16,1,0,1,45,4.9e-05
G5,C(CC1(CC(CO)(CC1O)O)O)=O,8,2,0,2,22,0.00010700000000000001
G5,C(CC1(CC(C)(C(C1O)O)O)O)=O,16,1,0,1,16,4.9e-05
G5,C(CC1(CC(CC1O)O)O)=O,8,1,0,1,45,4.9e-05
G5,C(CC1(CC(CC(C1O)O)O)O)=O,16,1,0,1,2,4.9e-05
G5,C(CC1(C(CC(C1CO)O)O)O)=O,16,2,0,2,13,0.00010700000000000001
G5,C(CC(C1C(C(CC1O)O)O)O)=O,32,1,0,1,43,4.9e-05
G5,C(CC1(C(C(CC1O)O)O)O)=O,16,1,0,1,2,4.9e-05
G5,C(CC1(C=CC(C1O)O)O)=O,8,2,0,2,4,9.6e-05
G5,C1(C(CC(CC1O)O)(CC=O)O)=O,8,2,0,2,49,9.6e-05
G5,C(CC1(CC(C(C(C1)O)=O)O)O)=O,3,2,0,2,32,9.6e-05
G5,C1(C(C(C(CC1)O)O)(CC=O)O)=O,8,2,0,2,7,9.6e-05
G5,C(CC(C1CC(C(C1O)=O)O)O)=O,16,2,0,2,18,9.6e-05
G5,C(CC1(C(C(C=CC1O)O)O)O)=O,16,1,0,1,32,4.9e-05
G5,C(CC1(C=CC(CO)(C1O)O)O)=O,8,1,0,1,32,4.9e-05
G5,C(CC1(CCC(CO)(C1O)O)O)=O,8,2,0,2,29,0.00010700000000000001
G5,C(CC1(CC(C(C1CO)O)O)O)=O,16,2,0,2,4,0.00010700000000000001
G5,C(CC1(C2C(C(CO2)(C1)O)O)O)=O,16,1,0,1,17,4.9e-05
G5,C(CC1(C2C(CC(C1O)O2)O)O)=O,32,1,0,1,9,4.9e-05
G5,C(CC1(C2CC(C(O)O2)(C1)O)O)=O,16,3,0,3,22,0.000144
G5,C(CC1(C2CC(C1C(O)O2)O)O)=O,32,3,0,3,13,0.000144
G5,C(CC1(C=CC(C(C1)O)=O)O)=O,4,2,0,2,22,9.6e-05
G5,C(C1(C=CC(C1)(CC=O)O)O)=O,4,3,0,3,29,0.000144
G5,C(CC(C1C=CC(C1O)=O)O)=O,8,2,0,2,4,9.6e-05
G5,C(CC1(C(C=CC(C1)O)=O)O)=O,4,2,0,2,21,9.6e-05
G5,C(CC1(C2(CC(C1CO2)O)O)O)=O,16,3,0,3,4,0.000144
G5,C(CC1(C2C(CC(C1)(O)O2)O)O)=O,16,2,0,2,48,9.6e-05
G5,C(CC1(CC2(C(C1CO2)O)O)O)=O,16,3,0,3,30,0.000144
G5,C(CC1(CC2C(C1C(O)O2)O)O)=O,32,3,0,3,4,0.000144
G5,C(CC(C(CO)C(CCO)O)O)=O,8,1,0,1,18,4.9e-05
G5,C(CC(C(CO)C(CC=O)O)O)=O,3,1,0,1,18,4.9e-05
G5,C(C(CO)C(CC(CC=O)O)O)=O,8,3,0,3,45,0.000145
G5,C(C(C(CC=O)O)C(CCO)O)=O,8,5,0,5,45,0.00023999999999999998
G5,C(C(CO)C(CC=O)O)(O)=O,4,3,0,3,18,0.000155
G5,C(CC(C(CO)C(C(C)O)O)O)=O,16,1,0,1,11,4.9e-05
G5,C(C(C(CC=O)O)C(C)O)(O)=O,8,3,0,3,4,0.000155
G5,C(C(C(CC=O)O)C(CO)O)(O)=O,8,4,0,4,29,0.00021400000000000002
G5,C(C(C)(CC=O)O)(C(C(O)=O)O)=O,4,3,0,3,25,0.000145
G5,C(C(C(C(CC(C)O)=O)=O)O)(O)=O,4,3,0,3,4,0.000145
G5,C(CC(C(CO)=O)(CC=O)O)(O)=O,2,1,0,1,17,4.9e-05
G5,C(CC(C(C(C(C)O)O)=O)=O)(O)=O,4,3,0,3,17,0.000146
G5,C(C(C(C(CO)=O)=O)C(C)O)(O)=O,4,5,0,5,4,0.000241
G5,C(CC(C(C)O)(C(C(O)=O)O)O)=O,8,3,0,3,45,0.000155
G5,C(C(C(CC=O)O)C(CC=O)O)=O,3,3,0,3,45,0.000145
G5,C(C(C=O)C(CC(CC=O)O)O)=O,4,3,0,3,45,0.000145
G5,C(C(C=O)C(C(C=O)C(C)O)O)=O,8,6,0,6,4,0.00028900000000000003
G5,C(C(C=O)C(CC=O)O)(O)=O,4,8,0,8,45,0.000395
G5,C(C(C(CC=O)O)C(C(C)O)O)=O,16,5,0,5,11,0.00023999999999999998
G5,C(CC(C(O)=O)(CC=O)O)(O)=O,2,2,0,2,17,0.00010700000000000001
G5,C(C(C(C(O)=O)=O)C(C)O)(O)=O,4,6,0,6,4,0.0003
G5,C(C(C=O)C(C=O)(CC=O)O)(O)=O,4,6,0,6,23,0.0003
G5,C(CC(C(C)=O)(CC=O)O)(O)=O,2,2,0,2,4,0.00010800000000000001
G5,C(C(C)(CC=O)O)(CC(O)=O)=O,2,4,0,4,29,0.00020299999999999997
G5,C(C(C(C(C)=O)=O)C(C)O)(O)=O,4,7,0,7,4,0.000348
G5,C(CC(C(CC(C)O)=O)=O)(O)=O,2,5,0,5,29,0.000251
G5,C(CC(CC=O)(CC=O)O)(O)=O,1,1,0,1,17,4.9e-05
G5,C(CC(CC(CC=O)O)=O)(O)=O,2,4,0,4,45,0.000204
G5,C(C(C(CC=O)=O)C(C)O)(O)=O,4,6,0,6,4,0.00028900000000000003
G5,C(C(C(CC(O)=O)=O)C(C)O)=O,4,5,0,5,17,0.000241
G5,C(C(C=O)C(C)(CC=O)O)(O)=O,4,8,0,8,6,0.000395
G5,C(CC(C(C(O)=O)C(C)=O)O)=O,4,7,0,7,6,0.00034700000000000003
G5,C(C(C=O)C(CC(C)O)=O)(O)=O,4,5,0,5,4,0.00023999999999999998
G5,C(C1C(O)OCC1(CC=O)O)(O)=O,8,2,0,2,49,9.6e-05
G5,C(C1C(C(C(C)O)OC1O)=O)(O)=O,16,5,0,5,17,0.000241
G5,C(CC1(CC(OC1C(O)=O)O)O)=O,8,1,0,1,17,4.9e-05
G5,C(C1C(C(C(O1)O)C(C)O)=O)(O)=O,16,5,0,5,4,0.000241
G5,C(C(C(C=C)(CC=O)O)O)(O)=O,4,1,0,1,17,4.9e-05
G5,C(CC1(C(COC1C(O)=O)O)O)=O,8,1,0,1,17,4.9e-05
G5,C(C1COC(C1(CC=O)O)O)(O)=O,8,1,0,1,17,4.9e-05
G5,C(CC(C(C(CCO)O)O)O)=O,8,3,0,3,29,0.000166
G5,C(CC(C(CO)C(CO)O)O)=O,8,3,0,3,29,0.000166
G5,C(CC(C(C(CC(C)O)O)O)O)=O,16,2,0,2,28,0.00010700000000000001
G5,C(CC(C(C(CO)O)C(C)O)O)=O,16,2,0,2,4,0.00010700000000000001
G5,C(C(CC(CO)O)(CC=O)O)(O)=O,4,3,0,3,0,0.000166
G5,C(CC(C(C(C(C)=O)(C)O)O)O)=O,8,2,0,2,14,0.00010700000000000001
G5,C(CC(C(C(CC(C)=O)O)O)O)=O,8,3,0,3,6,0.000155
G5,C(C(C=C)(C(C(CC=O)O)O)O)=O,8,6,0,6,29,0.000331
G5,C(CC(C(C(C=C)(CO)O)O)O)=O,8,2,0,2,29,0.00010700000000000001
G5,C(CC(C(C(C(C)O)O)O)O)=O,16,3,0,3,11,0.000166
G5,C(CC(C(CO)C(C(C)=O)O)O)=O,8,2,0,2,45,0.00010800000000000001
G5,C(C(C)(C(CO)C(CC=O)O)O)=O,8,2,0,2,45,0.00010700000000000001
G5,C(CC(C=O)(CC=O)O)(O)=O,2,3,0,3,29,0.000155
G5,C(C(CC(C=O)(CC=O)O)O)(O)=O,4,4,0,4,29,0.000225
G5,C(C(CC(C(C)O)O)(CC=O)O)=O,8,1,0,1,11,4.9e-05
G5,C(CC(C(C(O)=O)O)(CC=O)O)=O,2,2,0,2,17,9.7e-05
G5,C(C(CC(C=O)O)(CC=O)O)(O)=O,4,3,0,3,29,0.000166
G5,C(CC(C(CO)O)(CC=O)O)(O)=O,4,3,0,3,4,0.000166
G5,C(CC(C(CO)CO)O)=O,2,2,0,2,18,0.00010800000000000001
G5,C(CC(C(CO)C(C)(CO)O)O)=O,8,2,0,2,49,0.00010700000000000001
G5,C(CC(C(CO)C(C)O)O)=O,8,2,0,2,4,0.00010800000000000001
G5,C(CO)(C(CCO)(CC=O)O)=O,2,2,0,2,0,9.6e-05
G5,C(CC(C(CO)O)(C(C)O)O)=O,8,4,0,4,29,0.000225
G5,C(C(CO)C(CO)(CC=O)O)(O)=O,4,5,0,5,29,0.000263
G5,C(CC(CCO)(C(C(O)=O)O)O)=O,4,3,0,3,0,0.000155
G5,C(C)(C(CCO)(CC=O)O)=O,2,4,0,4,29,0.000202
G5,C(CC(CCO)(CC=O)O)=O,1,2,0,2,29,9.6e-05
G5,C(CC1(COC(C1CO)O)O)=O,8,2,0,2,49,9.6e-05
G5,C(CC1(C(CO)OC(C1)O)O)=O,8,2,0,2,4,9.6e-05
G5,C(CC(C=C)(C(CO)O)O)=O,4,2,0,2,29,9.6e-05
G5,C(CC1(C(CO)OCC1O)O)=O,8,1,0,1,27,4.9e-05
G5,C(CC1(C(O)OCC1CO)O)=O,8,2,0,2,29,9.6e-05
G5,C(C(CO)C(C=O)(CC=O)O)(O)=O,4,3,0,3,23,0.000155
G5,C(CC(CO)(CC(CCO)O)O)=O,4,3,0,3,29,0.000166
G5,C(CC(C)(C(C(CCO)O)O)O)=O,8,2,0,2,4,0.00010800000000000001
G5,C(CC(CO)(CC(C(C)O)O)O)=O,8,1,0,1,11,4.9e-05
G5,C(CC(C)(C(C(C(C)O)O)O)O)=O,16,1,0,1,11,4.9e-05
G5,C(CC(CC(CCO)O)O)=O,4,1,0,1,18,4.9e-05
G5,C(CC(CC(CC(C)O)O)O)=O,8,1,0,1,28,4.9e-05
G5,C(CC(C(C(C)O)C(C)O)O)=O,6,1,0,1,4,4.9e-05
G5,C(CC(CC(C(C(C)O)O)O)O)=O,16,1,0,1,28,4.9e-05
G5,C(CC(CC(CC(CO)O)O)O)=O,8,2,0,2,4,0.00010700000000000001
G5,C(CC(CC(C(C)=O)(CO)O)O)=O,4,2,0,2,45,9.8e-05
G5,C(CC(C)(C(CO)(CC=O)O)O)=O,4,4,0,4,4,0.000215
G5,C(C(CO)(CC=O)O)(CC(C)O)=O,4,3,0,3,4,0.000147
G5,C(CC(CC(C(CO)=O)(C)O)O)=O,4,2,0,2,4,9.6e-05
G5,C(C(C)(CC=O)O)(C(C(C)O)O)=O,8,4,0,4,4,0.000194
G5,C(C(C(C(C)O)O)=O)(CC(C)O)=O,8,3,0,3,4,0.000146
G5,C(CO)(C(CC(C)O)(CC=O)O)=O,4,2,0,2,4,9.6e-05
G5,C(C(CO)=O)(C(C(C)O)C(C)O)=O,3,3,0,3,4,0.000145
G5,C(CC(CC(C(C(C)O)=O)O)O)=O,8,3,0,3,4,0.000144
G5,C(CC(CC(CO)(C(C)O)O)O)=O,8,2,0,2,4,0.00010700000000000001
G5,C(CC(C(C(C)O)O)(C(C)O)O)=O,16,1,0,1,4,4.9e-05
G5,C(CC(CC(CC=O)O)O)=O,3,2,0,2,29,9.6e-05
G5,C(CC(CC(C(CCO)O)O)O)=O,8,2,0,2,4,0.00010700000000000001
G5,C(C(C)(CC(CC=O)O)O)(O)=O,4,3,0,3,18,0.000166
G5,C(C(CC(C)O)(CC=O)O)(O)=O,4,3,0,3,29,0.000166
G5,C(C(C(C(C)O)C(C)O)=O)(O)=O,3,3,0,3,4,0.000156
G5,C(CC(CC=O)O)(O)=O,2,5,0,5,29,0.00025
G5,C(CC(CC(C(C(O)=O)O)O)O)=O,8,3,0,3,45,0.000155
G5,C(CC(CC(C(C)=O)(C)O)O)=O,4,2,0,2,4,9.6e-05
G5,C(CC(C)(C(C)(CC=O)O)O)=O,3,1,0,1,14,4.9e-05
G5,C(C(C)(CC=O)O)(CC(C)O)=O,4,2,0,2,4,9.8e-05
G5,C(C)(C(CC(C)O)(CC=O)O)=O,4,2,0,2,4,9.6e-05
G5,C(C(C)=O)(C(C(C)O)C(C)O)=O,3,3,0,3,4,0.000145
G5,C(C(CC(C)O)=O)(CC(C)O)=O,3,2,0,2,11,9.6e-05
G5,C(CC(C)(CC(CC=O)O)O)=O,4,3,0,3,4,0.000145
G5,C(CC(CC(CC(C)O)=O)O)=O,4,2,0,2,4,9.8e-05
G5,C(CC(C(C(C)=O)C(C)O)O)=O,8,3,0,3,4,0.000146
G5,C(CC(CC(C)O)(CC=O)O)=O,2,2,0,2,4,9.6e-05
G5,C(CC(C(C(C)O)C(C)O)=O)=O,3,3,0,3,4,0.000145
G5,C(C(C(CC(C)O)=O)C(C)O)=O,8,6,0,6,4,0.00028900000000000003
G5,C(CC(CC1(COC(C1)O)O)O)=O,8,2,0,2,4,9.6e-05
G5,C(CC1(COC(C1C(C)O)O)O)=O,16,2,0,2,4,9.6e-05
G5,C1(C(C(C)O)OC(C1C(C)O)O)=O,32,5,0,5,4,0.000242
G5,C(CC1(C(C(C)O)OC(C1)O)O)=O,16,2,0,2,4,9.6e-05
G5,C(CC(CC(C(C=C)=O)O)O)=O,4,2,0,2,4,9.6e-05
G5,C(CC(C(C=C)(CC=O)O)O)=O,4,5,0,5,4,0.00023999999999999998
G5,C(C(C=C)(CC(CC=O)O)O)=O,4,3,0,3,4,0.000144
G5,C(CC(CC(C=C)(CO)O)O)=O,4,2,0,2,4,9.6e-05
G5,C(CC(C=C)(C(C(C)O)O)O)=O,8,2,0,2,4,9.6e-05
G5,C(CC(CC(C=CC=O)O)O)=O,8,3,0,3,29,0.000144
G5,C(CC(C=CC(CC=O)O)O)=O,6,3,0,3,29,0.000144
G5,C(CC(CC(C(C)O)O)O)=O,8,1,0,1,11,4.9e-05
G5,C(CC(CC1(COCC1O)O)O)=O,8,1,0,1,10,4.9e-05
G5,C(CC1(C(C(C)O)OCC1O)O)=O,16,1,0,1,4,4.9e-05
G5,C(CC(CC1(C(O)OCC1)O)O)=O,8,2,0,2,4,9.6e-05
G5,C(CC1(C(O)OCC1C(C)O)O)=O,16,2,0,2,4,9.6e-05
G5,C(CC(C)(CC(C(O)=O)O)O)=O,4,4,0,4,29,0.000213
G5,C(C)(C(C(C)O)C(C(O)=O)O)=O,8,4,0,4,4,0.000215
G5,C(CC(C(O)=O)O)(CC(C)O)=O,4,3,0,3,4,0.000166
G5,C(C(C=CC(C)(CC=O)O)O)(O)=O,8,3,0,3,29,0.000166
G5,C(C(C=CC(CC(C)O)=O)O)(O)=O,8,3,0,3,4,0.000166
G5,C(C(C=CCC(CC=O)O)O)(O)=O,8,3,0,3,29,0.000166
G5,C(C(C=CC(C(O)=O)O)C(C)O)=O,16,3,0,3,46,0.000166
G5,C(CC(C=CC(C(O)=O)(C)O)O)=O,8,2,0,2,29,0.00010700000000000001
G5,C(C(CC(C=C)(CC=O)O)O)(O)=O,4,3,0,3,29,0.000166
G5,C(C(C(C(C=C)=O)C(C)O)O)(O)=O,8,4,0,4,4,0.000215
G5,C(C(C=C)(CC(CC=O)O)O)(O)=O,4,2,0,2,29,0.00010700000000000001
G5,C(C(C=C)(C(C=O)C(C)O)O)(O)=O,8,6,0,6,7,0.00031
G5,C(C(CC=CC(CC=O)O)O)(O)=O,8,3,0,3,29,0.000166
G5,C(CC(C(C=O)=O)(C)O)=O,2,5,0,5,4,0.000239
G5,C(C(C(CC(C)O)=O)=O)=O,2,4,0,4,4,0.00019099999999999998
G5,C(CO)(C(C(C=O)=O)C(C)O)=O,4,5,0,5,51,0.00023999999999999998
G5,C(C(C(C)O)O)(CC(C=O)=O)=O,4,7,0,7,29,0.000346
G5,C(CC(C)O)(C(C(C=O)=O)O)=O,4,3,0,3,29,0.000144
G5,C(CC(C(C=O)=O)O)=O,2,15,0,15,0,0.000724
G5,C(C(C(CC(C)=O)=O)(CC=O)O)=O,2,1,0,1,27,4.9e-05
G5,C(CC(C(C(CC(C)=O)=O)=O)O)=O,2,1,0,1,27,4.9e-05
G5,C(CC(C(C=O)=O)(CC(C)=O)O)=O,2,1,0,1,27,4.9e-05
G5,C(CC(C)(CC(C(C=O)=O)=O)O)=O,2,2,0,2,27,9.7e-05
G5,C(C)(C(C(C(C=O)=O)=O)C(C)O)=O,4,2,0,2,27,9.8e-05
G5,C(CC(C)O)(CC(C(C=O)=O)=O)=O,2,1,0,1,27,4.9e-05
G5,C(C(C(CCC=O)=O)(CC=O)O)=O,2,1,0,1,27,4.9e-05
G5,C(CCC(C(C(CC=O)O)=O)=O)=O,2,1,0,1,27,4.9e-05
G5,C(CCC(C(C=O)=O)(CC=O)O)=O,2,1,0,1,27,4.9e-05
G5,C(CC(CCC(C(C=O)=O)=O)O)=O,2,1,0,1,27,4.9e-05
G5,C(CC(C(C(C=O)=O)=O)C(C)O)=O,4,1,0,1,27,4.9e-05
G5,C(C(C(C)O)CC(C(C=O)=O)=O)=O,4,1,0,1,27,4.9e-05
G5,C(CC(C(CC(C(C)=O)=O)=O)O)=O,2,2,0,2,14,9.6e-05
G5,C(C(C)(CC=O)O)(CC(C=O)=O)=O,2,1,0,1,27,4.9e-05
G5,C(C(C(C(C(C)=O)=O)C(C)O)=O)=O,4,2,0,2,27,9.8e-05
G5,C(C(CC(C(CC(C)O)=O)=O)=O)=O,2,1,0,1,27,4.9e-05
G5,C(CC(CC(C(CC=O)O)=O)=O)=O,2,2,0,2,23,9.6e-05
G5,C(CC=O)(C(C(C=O)=O)C(C)O)=O,4,2,0,2,27,9.8e-05
G5,C(C(C(CC(C=O)=O)=O)C(C)O)=O,4,2,0,2,27,9.8e-05
G5,C(C(C(C=CCO)=O)(CC=O)O)=O,4,1,0,1,17,4.9e-05
G5,C(CC(C(C(C=CCO)=O)=O)O)=O,4,1,0,1,17,4.9e-05
G5,C(CC(C=CCO)(C(C=O)=O)O)=O,4,1,0,1,17,4.9e-05
G5,C(CC(C(C(C(C=C)=O)O)=O)O)=O,4,2,0,2,23,9.6e-05
G5,C(CC(C=C)(C(C(C=O)=O)O)O)=O,4,1,0,1,33,4.9e-05
G5,C(C(C=CC(CO)=O)(CC=O)O)=O,4,1,0,1,12,4.9e-05
G5,C(CC(C(C=CC(CO)=O)=O)O)=O,4,1,0,1,12,4.9e-05
G5,C(CC(C=CC(C=O)=O)(CO)O)=O,4,1,0,1,12,4.9e-05
G5,C(C(C=CC(C(C(C)O)O)=O)=O)=O,8,2,0,2,12,9.8e-05
G5,C(CC(C(C(C=CC=O)O)=O)O)=O,8,3,0,3,43,0.000144
G5,C(CC(C=CC(C(C=O)=O)O)O)=O,8,1,0,1,43,4.9e-05
G5,C(C(C=O)CC(CO)(CC=O)O)=O,2,1,0,1,2,4.9e-05
G5,C(C(C=O)CC(C(C(C)O)O)=O)=O,4,5,0,5,4,0.00023999999999999998
G5,C(C(C=O)C(C(CO)=O)C(C)O)=O,4,3,0,3,4,0.000144
G5,C(C(C(C)O)O)(C(C(CO)=O)O)=O,8,5,0,5,5,0.000251
G5,C(C(C=O)C(C(C(C)O)O)=O)=O,4,6,0,6,1,0.000298
G5,C(C(C(C(C=O)O)=O)C(C)O)=O,8,4,0,4,1,0.000192
G5,C(CC(C)O)(CC(CO)=O)=O,2,9,0,9,4,0.00044
G5,C(C)(C(C(CO)=O)C(C)O)=O,4,9,0,9,4,0.00044100000000000004
G5,C(C(C(C)O)O)(CC(C)=O)=O,4,9,0,9,26,0.00043
G5,C(CC(C)O)(C(C(C)=O)O)=O,4,6,0,6,9,0.000286
G5,C(CC(C)(CCO)O)=O,2,3,0,3,29,0.000155
G5,C(CC(C)O)(CCO)=O,2,4,0,4,4,0.000202
G5,C(C)(C(CO)C(C)O)=O,4,4,0,4,28,0.000204
G5,C(CC(CC=O)(CC=O)O)=O,1,2,0,2,4,9.6e-05
G5,C(C(C(CC=O)=O)C(C)O)=O,4,6,0,6,29,0.00028700000000000004
G5,C(CC(CC(CC(C)=O)=O)O)=O,2,5,0,5,29,0.000239
G5,C(C(C(CC(C)=O)=O)C(C)O)=O,4,7,0,7,29,0.000335
G5,C(CC=O)(C(C(C)=O)C(C)O)=O,4,6,0,6,29,0.00028700000000000004
G5,C(CC(CC(CC(C)O)=O)=O)=O,2,5,0,5,29,0.000239
G5,C(CC(C)(C)O)=O,1,1,0,1,27,4.9e-05
G5,C(C)(CC(C)O)=O,2,4,0,4,1,0.00019099999999999998
G5,C(CCC(CO)(CC=O)O)=O,2,3,0,3,4,0.000144
G5,C(CCC=O)(C(C(C)O)O)=O,4,6,0,6,4,0.00028700000000000004
G5,C(CC(CC(CCC=O)=O)O)=O,2,3,0,3,29,0.000144
G5,C(CC(CCC=O)(CC=O)O)=O,1,4,0,4,29,0.00019099999999999998
G5,C(CC(CCC(CC=O)O)=O)=O,2,3,0,3,29,0.000144
G5,C(C(C(CCC=O)=O)C(C)O)=O,4,5,0,5,44,0.00023999999999999998
G5,C(CC(C)(CC(C=O)O)O)=O,4,3,0,3,52,0.000144
G5,C(C)(C(C(C)O)C(C=O)O)=O,8,3,0,3,27,0.000145
G5,C(CC(C=O)O)(CC(C)O)=O,4,3,0,3,4,0.000144
G5,C(CC(C=CCO)(CO)O)=O,4,3,0,3,29,0.000155
G5,C(CO)=CC(C(C(C)O)O)=O,8,7,0,7,4,0.000346
G5,C(CC(CC(C=CCO)=O)O)=O,4,5,0,5,29,0.00025
G5,C(CC(C=CCO)(CC=O)O)=O,2,5,0,5,29,0.00025
G5,C(C(C(C=CCO)=O)C(C)O)=O,8,7,0,7,29,0.000346
G5,C(OCC(C)(CC=O)O)=O,2,1,0,1,35,4.9e-05
G5,C(OCC(CC(C)O)=O)=O,2,3,0,3,4,0.000144
G5,C(OC(C(C)=O)C(C)O)=O,4,3,0,3,35,0.000145
G5,C(CC(CO)(COCC=O)O)=O,2,1,0,1,27,4.9e-05
G5,C(CC(COCC(CO)=O)O)=O,2,1,0,1,27,4.9e-05
G5,C(COC(C(CO)=O)C(C)O)=O,4,2,0,2,27,9.8e-05
G5,C(COCC=O)(C(C(C)O)O)=O,4,2,0,2,27,9.8e-05
G5,C(C(C(C)O)OCC(CO)=O)=O,4,2,0,2,27,9.8e-05
G5,C(CC(C)(C(OCC=O)O)O)=O,4,1,0,1,27,4.9e-05
G5,C(CC(COC(C(C)=O)O)O)=O,4,1,0,1,27,4.9e-05
G5,C(COC(C(CC(C)O)=O)O)=O,4,1,0,1,27,4.9e-05
G5,C(C(C(C)O)OC(C(C)=O)O)=O,8,2,0,2,27,9.8e-05
G5,C(CC(C(OCC(C)=O)O)O)=O,4,5,0,5,49,0.000239
G5,C(CC(COC(C=O)O)(C)O)=O,4,3,0,3,49,0.000144
G5,C(COC(C=O)O)(CC(C)O)=O,4,3,0,3,27,0.000144
G5,C(C)(C(C(C)O)OC(C=O)O)=O,8,3,0,3,27,0.000145
G5,C(OCC(CC=O)O)=O,2,1,0,1,28,4.9e-05
G5,C(OC(C=O)C(C)O)=O,4,2,0,2,28,9.8e-05
G5,C(CC(COC(CO)=O)O)=O,2,6,0,6,40,0.000286
G5,C(C(C(C)O)OC(CO)=O)=O,4,2,0,2,40,9.8e-05
G5,C(CC(COC(C)=O)O)=O,2,1,0,1,28,4.9e-05
G5,C(C(C(C)O)OC(C)=O)=O,4,2,0,2,28,9.8e-05
G5,C(CC(C(C(CCO)O)=O)O)=O,4,4,0,4,49,0.00019099999999999998
G5,C(CC(CO)(C(CCO)O)O)=O,4,3,0,3,29,0.000166
G5,C(C(CCO)O)(C(C(C)O)O)=O,8,5,0,5,31,0.000251
G5,C(CC(C(CO)(CC=O)O)O)(O)=O,4,2,0,2,29,0.00010700000000000001
G5,C(CC(C(C(C(C)O)O)=O)O)(O)=O,8,4,0,4,2,0.000204
G5,C(CCC(C(CC=O)O)=O)=O,2,5,0,5,4,0.000239
G5,C(CCC(C=O)(CC=O)O)=O,2,3,0,3,4,0.000144
G5,C(CC(C(C=O)=O)C(C)O)=O,4,5,0,5,4,0.000239
G5,C(C(C(C)O)CC(C=O)=O)=O,4,5,0,5,46,0.000239
G5,C(CCC(CC=O)O)=O,2,4,0,4,27,0.000192
G5,C(CC1(COC(CC1O)O)O)=O,8,2,0,2,29,9.6e-05
G5,C1(C(C(C)O)OC(CC1O)O)=O,16,3,0,3,27,0.000145
G5,C(CC(C(C=CCO)=O)O)=O,4,4,0,4,4,0.00019099999999999998
G5,C(C(C=CCO)(CC=O)O)=O,4,3,0,3,43,0.000144
G5,C(CC(C=CCO)O)=O,4,5,0,5,29,0.00025
G5,C(C(C(C(C)O)O)=O)(O)=O,4,6,0,6,33,0.00031
G5,C(C)(C(C(C(O)=O)=O)C(C)O)=O,4,4,0,4,0,0.000204
G5,C(CC(C)O)(CC(C(O)=O)=O)=O,2,4,0,4,29,0.000202
G5,C(C(CC=O)(CC=O)O)(O)=O,1,4,0,4,29,0.000213
G5,C(C(C(C(O)=O)=O)C(C)O)=O,4,4,0,4,45,0.000204
G5,C(CC(C)(CC=O)O)(O)=O,2,3,0,3,29,0.000155
G5,C(CC(CC(C)O)=O)(O)=O,2,3,0,3,33,0.000155
G5,C(C(C(C)=O)C(C)O)(O)=O,4,4,0,4,6,0.000204
G5,C(CC(C=CC(O)=O)(CO)O)=O,4,3,0,3,29,0.000155
G5,C(C=CC(C(C(C)O)O)=O)(O)=O,8,4,0,4,18,0.000204
G5,C(C(C=O)(C(C(C(C)O)O)=O)O)=O,4,4,0,4,4,0.00020299999999999997
G5,C(C(C=O)(C(CC(C)O)=O)O)=O,2,2,0,2,1,9.6e-05
G5,C(C(C)(CC=O)O)(C(C=O)O)=O,4,4,0,4,29,0.000202
G5,C(C(C(C(CC(C)O)=O)=O)O)=O,4,2,0,2,5,9.6e-05
G5,C(C(C(C)O)=O)(C(C(C)O)O)=O,8,4,0,4,0,0.000192
G5,C(CC(C(C=C)=O)(CO)O)=O,2,5,0,5,29,0.000241
G5,C(CC(C(CO)=O)(C=C)O)=O,2,2,0,2,4,9.6e-05
G5,C=CC(C(C(C(C)O)O)=O)=O,4,2,0,2,7,9.8e-05
G5,C(C(C)(CC=O)O)(C(C)O)=O,4,3,0,3,49,0.000144
G5,C(C(C(C)O)=O)(CC(C)O)=O,4,2,0,2,25,9.6e-05
G5,C(CC(C(C=C)=O)(C(C)O)O)=O,4,4,0,4,4,0.000192
G5,C(C(C)O)(C(C=C)(CC=O)O)=O,4,1,0,1,7,4.9e-05
G5,C(CC(C(C=O)(CC(C)=O)O)O)=O,4,4,0,4,26,0.000192
G5,C(C(C=O)(CC(C)(CC=O)O)O)=O,2,1,0,1,17,4.9e-05
G5,C(C(C=O)(C(C(C)=O)C(C)O)O)=O,4,3,0,3,17,0.000145
G5,C(C(C=O)(CC(CC(C)O)=O)O)=O,2,3,0,3,17,0.000144
G5,C(C(C(C)O)O)(C(CO)(C)O)=O,8,4,0,4,49,0.000194
G5,C(CC(C(CO)=O)(CC=O)O)=O,1,2,0,2,0,9.6e-05
G5,C(C(C(C(CO)=O)=O)C(C)O)=O,4,3,0,3,0,0.000145
G5,C(CC(C(C(C(C)O)O)=O)=O)=O,4,6,0,6,0,0.000298
G5,C(C(C=O)(CC(CC=O)O)O)=O,2,1,0,1,1,4.9e-05
G5,C(C(C=O)(C(C=O)C(C)O)O)=O,4,5,0,5,1,0.000241
G5,C1(C(C(C)O)CC(C1O)=O)=O,8,10,0,10,2,0.00047599999999999997
G5,C(CC(CC=O)O)(OCC(C)=O)=O,2,2,0,2,26,9.6e-05
G5,C(CC=O)(OCC(C)(CC=O)O)=O,2,1,0,1,48,4.9e-05
G5,C(C(C=O)C(C)O)(OCC(C)=O)=O,4,6,0,6,48,0.00028700000000000004
G5,C(CC=O)(OC(C(C)=O)C(C)O)=O,4,7,0,7,48,0.000335
G5,C(CC=O)(OCC(CC(C)O)=O)=O,2,7,0,7,4,0.000333
G5,C(C(COCC(C)=O)(CC=O)O)=O,2,4,0,4,17,0.00019099999999999998
G5,C(CC(C(COCC(C)=O)=O)O)=O,2,1,0,1,17,4.9e-05
G5,C(CC(C)(COCC(C=O)=O)O)=O,2,1,0,1,17,4.9e-05
G5,C(COC(C(C=O)=O)C(C)O)(C)=O,4,5,0,5,4,0.00023999999999999998
G5,C(C)(C(C(C)O)OCC(C=O)=O)=O,4,6,0,6,4,0.00028700000000000004
G5,C(COCC(C=O)=O)(CC(C)O)=O,2,5,0,5,4,0.000239
G5,C(CC(C)(C(C(C)=O)OC=O)O)=O,4,4,0,4,35,0.000192
G5,C(OC(C(CC(C)O)=O)C(C)=O)=O,4,4,0,4,9,0.00019099999999999998
G5,C(OC(C(C)(CC=O)O)CC=O)=O,4,1,0,1,17,4.9e-05
G5,C(CC(CC(C(C)=O)OC=O)O)=O,4,2,0,2,13,9.6e-05
G5,C(CC(C(CC(C)O)=O)OC=O)=O,4,3,0,3,4,0.000144
G5,C(C(C(C)O)C(C(C)=O)OC=O)=O,8,3,0,3,17,0.000145
G5,C1(CCC(CO1)(CC=O)O)=O,2,2,0,2,27,9.6e-05
G5,C1(COC(CC1C(C)O)=O)=O,4,4,0,4,46,0.00019099999999999998
G5,C1(CCC(OC1C(C)O)=O)=O,4,6,0,6,4,0.00028700000000000004
G5,C(CC1(COCC(C1)=O)O)=O,2,4,0,4,54,0.00019099999999999998
G5,C1(C(C(C)O)OCC(C1)=O)=O,4,8,0,8,54,0.00038199999999999996
G5,C1(COCC(C1C(C)O)=O)=O,2,5,0,5,4,0.00023999999999999998
G5,C(CC(C)(CC=O)O)(OCC=O)=O,2,2,0,2,8,9.6e-05
G5,C(CC(COC(CC(C)=O)=O)O)=O,2,1,0,1,19,4.9e-05
G5,C(C)(C(C(OCC=O)=O)C(C)O)=O,4,3,0,3,19,0.000145
G5,C(CC(C)O)(CC(OCC=O)=O)=O,2,3,0,3,19,0.000144
G5,C(C(C(C)O)OC(CC(C)=O)=O)=O,4,2,0,2,19,9.8e-05
G5,C(C)(C(COCC=O)(CC=O)O)=O,2,2,0,2,4,9.6e-05
G5,C(COCC=O)(C(C)(CC=O)O)=O,2,1,0,1,36,4.9e-05
G5,C(CC(COCC(C(C)=O)=O)O)=O,2,1,0,1,36,4.9e-05
G5,C(COC(C(C(C)=O)=O)C(C)O)=O,4,3,0,3,36,0.000145
G5,C(COCC(C(CC(C)O)=O)=O)=O,2,3,0,3,36,0.000144
G5,C(C(C(C)O)OCC(C(C)=O)=O)=O,4,2,0,2,36,9.8e-05
G5,C(C(C)(CC=O)O)(CCOC=O)=O,2,1,0,1,17,4.9e-05
G5,C(C)(C(CCOC=O)(CC=O)O)=O,2,2,0,2,53,9.6e-05
G5,C(OCCC(C(CC(C)O)=O)=O)=O,2,3,0,3,4,0.000144
G5,C(OCC(C(C(C)=O)=O)C(C)O)=O,4,3,0,3,17,0.000145
G5,C(CC(C)(CC(COC=O)=O)O)=O,2,4,0,4,35,0.000192
G5,C(CC(COC=O)(CC(C)=O)O)=O,2,2,0,2,26,9.6e-05
G5,C(OCC(CC(CC(C)O)=O)=O)=O,2,3,0,3,4,0.000144
G5,C(OCC(C(C(C)=O)C(C)O)=O)=O,4,3,0,3,38,0.000145
G5,C(OC(C(CC(C)=O)=O)C(C)O)=O,4,3,0,3,38,0.000145
G5,C(CC1(COC(CO)C1O)O)=O,8,1,0,1,27,4.9e-05
G5,C1(C(C(C)O)OC(CO)C1O)=O,16,2,0,2,27,9.8e-05
G5,C(CC1(C(O)OC(CO)C1)O)=O,8,2,0,2,4,9.6e-05
G5,C1(C(O)OC(CO)C1C(C)O)=O,16,3,0,3,27,0.000145
G5,C1(COC(CO)(C1C(C)O)O)=O,8,3,0,3,27,0.000145
G5,C1(C(C(C)O)OC(CO)(C1)O)=O,8,3,0,3,27,0.000145
G5,C1(C(C(CO1)C(C)O)=O)=O,4,4,0,4,4,0.000192
G5,C1(CC(CO1)(CC=O)O)=O,2,4,0,4,4,0.00019099999999999998
G5,C1(C(C(CO1)=O)C(C)O)=O,4,5,0,5,4,0.00023999999999999998
G5,C1(CC(C(C(C)O)O1)=O)=O,4,5,0,5,4,0.00023999999999999998
G5,C(CC(C=O)OCC(CC=O)O)=O,4,1,0,1,40,4.9e-05
G5,C(CC(CC(C=O)OCC=O)O)=O,4,1,0,1,40,4.9e-05
G5,C(CC(C(CC=O)OCC=O)O)=O,4,3,0,3,40,0.000144
G5,C(CC(C=O)OC(C=O)C(C)O)=O,8,5,0,5,40,0.00023999999999999998
G5,C(COC(C=O)C(C=O)C(C)O)=O,8,2,0,2,40,9.8e-05
G5,C(CC(C(C(C)=O)OC(C)=O)O)=O,4,2,0,2,26,9.6e-05
G5,C(CC(C)(C(C=O)OC(C)=O)O)=O,4,3,0,3,28,0.000144
G5,C(CC(C)O)(C(C=O)OC(C)=O)=O,4,3,0,3,26,0.000144
G5,C(CC(COC(C(C=O)=O)C)O)=O,4,1,0,1,29,4.9e-05
G5,C(COC(C(C(CC=O)O)=O)C)=O,4,1,0,1,29,4.9e-05
G5,C(C(C(C)OCC=O)(CC=O)O)=O,4,3,0,3,29,0.000144
G5,C(C(C(C)O)OC(C(C=O)=O)C)=O,8,5,0,5,29,0.00023999999999999998
G5,C(CC1(COCC(C1O)O)O)=O,8,1,0,1,27,4.9e-05
G5,C1(C(C(C)O)OCC(C1O)O)=O,16,2,0,2,27,9.8e-05
G5,C(CC1(C(O)OCC(C1)O)O)=O,8,2,0,2,4,9.6e-05
G5,C1(C(O)OCC(C1C(C)O)O)=O,16,3,0,3,27,0.000145
G5,C(C)(CCOC(C(CC=O)O)=O)=O,2,2,0,2,30,9.6e-05
G5,C(CC(C)(CCOC(C=O)=O)O)=O,2,1,0,1,30,4.9e-05
G5,C(CC(C)O)(CCOC(C=O)=O)=O,2,3,0,3,30,0.000144
G5,C(C)(C(COC(C=O)=O)C(C)O)=O,4,3,0,3,30,0.000145
G5,C(CC(C(CC(C)=O)OC=O)O)=O,4,2,0,2,6,9.6e-05
G5,C(CC(C)(CC(C=O)OC=O)O)=O,4,1,0,1,37,4.9e-05
G5,C(C)(C(C(C)O)C(C=O)OC=O)=O,8,3,0,3,37,0.000145
G5,C(CC(C=O)OC=O)(CC(C)O)=O,4,3,0,3,37,0.000144
G5,C(CC1(COC(C(C1)O)=O)O)=O,4,3,0,3,51,0.000144
G5,C1(COC(C(C1C(C)O)O)=O)=O,8,3,0,3,27,0.000145
G5,C1(CC(C(OC1C(C)O)=O)O)=O,8,3,0,3,27,0.000145
G5,C(CC(C=C(C(CO)=O)CO)O)=O,4,1,0,1,2,4.9e-05
G5,C(CC(C(CO)=CC=O)(CO)O)=O,4,1,0,1,2,4.9e-05
G5,C(C(CO)=CC=O)(C(C(C)O)O)=O,8,5,0,5,4,0.00023999999999999998
G5,C(CC(C(C(C(CO)=O)=C)O)O)=O,4,1,0,1,47,4.9e-05
G5,C(C(C(C(CO)(CC=O)O)=C)O)=O,4,1,0,1,47,4.9e-05
G5,C(C(C(C(C(C(C)O)O)=O)=C)O)=O,8,5,0,5,4,0.00023999999999999998
G5,C(CC(C(C=C)O)O)=O,4,4,0,4,29,0.00019099999999999998
G5,C(CC1(C=COC1)O)=O,2,2,0,2,35,9.6e-05
G5,C1OC(C(C=1)=O)C(C)O,4,6,0,6,4,0.00028700000000000004
G5,C(CC1(C=CC(O)OC1)O)=O,4,2,0,2,27,9.6e-05
G5,C1C(OC(C(C=1)=O)C(C)O)O,8,6,0,6,4,0.00028700000000000004
G5,C(CC(C=COCC=O)(CO)O)=O,4,1,0,1,38,4.9e-05
G5,C(CC(COC=CC(CO)=O)O)=O,4,1,0,1,38,4.9e-05
G5,C(COC=CC(C(C(C)O)O)=O)=O,8,5,0,5,38,0.00023999999999999998
G5,C(C(C(C)O)OC=CC(CO)=O)=O,8,2,0,2,38,9.8e-05
G5,C(OCC=CC(CO)(CC=O)O)=O,4,1,0,1,19,4.9e-05
G5,C(OCC=CC(C(C(C)O)O)=O)=O,8,5,0,5,19,0.00023999999999999998
G5,C(CC(COC(CO)=CC=O)O)=O,4,1,0,1,40,4.9e-05
G5,C(COC(CO)=CC(CC=O)O)=O,4,1,0,1,40,4.9e-05
G5,C(C(C(C)O)OC(CO)=CC=O)=O,8,5,0,5,40,0.00023999999999999998
G5,C(C(C(OCC(CC=O)O)=C)O)=O,4,1,0,1,26,4.9e-05
G5,C(CC(C(C(OCC=O)=C)O)O)=O,4,1,0,1,26,4.9e-05
G5,C(C(C(OC(C=O)C(C)O)=C)O)=O,8,5,0,5,26,0.00023999999999999998
G5,C(CC(COC(C=CC=O)O)O)=O,8,1,0,1,37,4.9e-05
G5,C(COC(C=CC(CC=O)O)O)=O,8,1,0,1,37,4.9e-05
G5,C(C(C(C)O)OC(C=CC=O)O)=O,16,5,0,5,37,0.00023999999999999998
G5,C(C(C=COCC(CC=O)O)O)=O,8,1,0,1,37,4.9e-05
G5,C(CC(C(C=COCC=O)O)O)=O,8,1,0,1,37,4.9e-05
G5,C(C(C=COC(C=O)C(C)O)O)=O,16,5,0,5,37,0.00023999999999999998
G5,C(CC(C(CCCC=O)=O)O)=O,2,4,0,4,4,0.000193
G5,C(CCCC(C=O)(CC=O)O)=O,2,2,0,2,7,9.6e-05
G5,C(CCC(C(C=O)=O)C(C)O)=O,4,3,0,3,4,0.000145
G5,C(CCCC(CO)(CC=O)O)=O,2,2,0,2,49,9.6e-05
G5,C(CCCC(C(C(C)O)O)=O)=O,4,4,0,4,4,0.000194
G5,C(CCC(C(CO)=O)C(C)O)=O,4,3,0,3,4,0.000145
G5,C(CC(C(CC=O)O)CC=O)=O,2,4,0,4,4,0.000193
G5,C(CC1(CCC(C(C1O)=O)O)O)=O,8,2,0,2,29,9.6e-05
G5,C1(C(CC(C(C1O)=O)O)C(C)O)=O,16,2,0,2,12,9.6e-05
G5,C(CC(C1(C(C(CC1)O)=O)O)O)=O,8,2,0,2,12,9.6e-05
G5,C(C1(CCC(C1(CC=O)O)O)O)=O,8,1,0,1,12,4.9e-05
G5,C1(C(CC(C(C1C(C)O)=O)O)O)=O,6,3,0,3,32,0.000145
G5,C(CC(CO)(CC(C(C)O)=O)O)=O,4,3,0,3,4,0.000155
G5,C(C(C)O)(C(C(CO)=O)C(C)O)=O,8,4,0,4,24,0.000204
G5,C(C(C(C)O)O)(CC(C(C)O)=O)=O,8,3,0,3,24,0.000145
G5,C(CC(C)(C(CC(C=O)O)O)O)=O,8,2,0,2,29,9.6e-05
G5,C(CC(C(CC(C(C)=O)O)O)O)=O,8,1,0,1,29,4.9e-05
G5,C(C(CC(C=O)O)O)(CC(C)O)=O,8,2,0,2,4,9.6e-05
G5,C(CC(C(C)(CC(C=O)O)O)O)=O,8,2,0,2,4,9.6e-05
G5,C(C(C)(CC(C(CC=O)O)O)O)=O,8,1,0,1,16,4.9e-05
G5,C(CC(C)O)(C(C(C(C)O)=O)O)=O,8,2,0,2,4,9.6e-05
G5,C(CC(C(C(C(C)O)=O)(C)O)O)=O,8,3,0,3,49,0.000144
G5,C(C(C)(C(C(C)O)(CC=O)O)O)=O,8,2,0,2,49,9.7e-05
G5,C(CC(C(C)O)(CC=O)O)=O,2,1,0,1,45,4.9e-05
G5,C(CC(CC(C(C)O)=O)O)=O,4,2,0,2,45,9.6e-05
G5,C(C(C(C(C)O)=O)C(C)O)=O,8,4,0,4,45,0.000192
G5,C(CC(C(C(CC(C)O)O)=O)O)=O,8,3,0,3,49,0.000144
G5,C(CC(CO)(C(CC(C)O)O)O)=O,8,2,0,2,43,0.00010700000000000001
G5,C(C(CC(C)O)O)(C(C(C)O)O)=O,16,4,0,4,11,0.000192
G5,C(CC(C(C(CO)CO)O)O)=O,4,3,0,3,29,0.000155
G5,C(CC(C(CCO)O)(C(C)O)O)=O,8,2,0,2,3,0.00010700000000000001
G5,C(CC(C(C(CO)C(C)O)O)O)=O,16,2,0,2,29,0.00010700000000000001
G5,C(CC(C(CC(C)(CO)O)O)O)=O,8,1,0,1,49,4.9e-05
G5,C(CC(C(C)O)(C(C)(CO)O)O)=O,8,1,0,1,49,4.9e-05
G5,C(CC(C(CC(C)O)O)O)=O,8,1,0,1,11,4.9e-05
G5,C(CC(C(C)O)(C(C)O)O)=O,3,1,0,1,49,4.9e-05
G5,C(C(C(C(C(C)O)O)=O)(C)O)=O,8,3,0,3,0,0.000145
G5,C(CC(C(CC(CO)O)O)O)=O,8,2,0,2,4,0.00010700000000000001
G5,C(C(C=CC(CC=O)O)O)=O,8,4,0,4,29,0.00019099999999999998
G5,C(CC(C(C=CC=O)O)O)=O,8,3,0,3,4,0.000144
G5,C(CC(C(C=C)=O)(C(CO)O)O)=O,4,5,0,5,7,0.000262
G5,C(C(CO)O)(C(C=C)(CC=O)O)=O,4,3,0,3,29,0.000155
G5,C(C(CO)(CC=O)O)(C(C=C)O)=O,4,2,0,2,7,9.6e-05
G5,C(CC(C(CO)=O)(C(C=C)O)O)=O,4,3,0,3,27,0.000144
G5,C=CC(C(C(C(C(C)O)O)=O)=O)O,8,3,0,3,32,0.000145
G5,C(CC(C(C(C(C=C)O)O)=O)O)=O,8,5,0,5,2,0.00025
G5,C(C(C(C(C=C)O)O)(CC=O)O)=O,8,3,0,3,29,0.000155
G5,C(CC(CO)(CCC(C=O)O)O)=O,4,3,0,3,29,0.000155
G5,C(C(CC(C(CO)=O)C(C)O)O)=O,8,4,0,4,29,0.00020299999999999997
G5,C(C(C(C)O)O)(CCC(C=O)O)=O,8,4,0,4,7,0.000193
G5,C(C(C)(CC=O)O)(C(CCO)O)=O,4,3,0,3,6,0.000155
G5,C(C(C(CCO)O)=O)(CC(C)O)=O,4,3,0,3,9,0.000155
G5,C(C(CCO)(CC=O)O)(C(C)O)=O,4,3,0,3,4,0.000155
G5,C(C(C(C)O)=O)(C(CO)C(C)O)=O,8,4,0,4,9,0.000204
G5,C(CC(CO)(C(CC(C)=O)O)O)=O,4,3,0,3,6,0.000155
G5,C(CC(C)(CC(C(CO)=O)O)O)=O,4,3,0,3,6,0.000155
G5,C(C)(C(C(C)O)C(C(CO)=O)O)=O,8,4,0,4,5,0.000204
G5,C(CC(C(CO)=O)O)(CC(C)O)=O,4,3,0,3,4,0.000155
G5,C(CCC(C(CO)(CC=O)O)O)=O,4,3,0,3,27,0.000155
G5,C(CC(CCC(C(CO)=O)O)O)=O,4,3,0,3,7,0.000155
G5,C(CCC(C(C(C(C)O)O)=O)O)=O,8,3,0,3,27,0.000145
G5,C(C(CC(C(CO)=O)O)C(C)O)=O,8,3,0,3,46,0.000155
G5,C(C(CO)(CC=O)O)(CCCO)=O,2,2,0,2,4,0.00010700000000000001
G5,C(CO)(C(CCCO)(CC=O)O)=O,2,3,0,3,29,0.000155
G5,C(C(C(C(C)O)O)=O)(CCCO)=O,4,3,0,3,55,0.000156
G5,C(C(CO)=O)(C(C(C)O)CCO)=O,4,3,0,3,4,0.000155
G5,C(CC(C(C(CCCO)O)=O)O)=O,4,3,0,3,55,0.000155
G5,C(C(C(CCCO)O)(CC=O)O)=O,4,2,0,2,29,0.00010700000000000001
G5,C(CC(C(C=CC(CO)O)O)O)=O,16,2,0,2,32,0.00010700000000000001
G5,C(CC(CO)(C(C=CCO)O)O)=O,8,3,0,3,29,0.000166
G5,C(C(C(C)O)O)(C(C=CCO)O)=O,16,3,0,3,29,0.000156
G5,C(CC(C(CO)O)(C(C=C)O)O)=O,8,2,0,2,27,0.00010700000000000001
G5,C1(C(C(CC1CO)O)(CC=O)O)=O,8,1,0,1,47,4.9e-05
G5,C1(C(C(CC1O)CO)(CC=O)O)=O,8,2,0,2,47,9.6e-05
G5,C1(C(CC(CO)C1O)(CC=O)O)=O,8,2,0,2,47,9.6e-05
G5,C1(C(C(C(CO)C1)O)(CC=O)O)=O,8,2,0,2,4,9.6e-05
G5,C1(C(C(C(CO)C1C(C)O)O)=O)=O,16,2,0,2,4,9.6e-05
G5,C(CC1(C(COC1C(C)=O)O)O)=O,8,1,0,1,4,4.9e-05
G5,C(CC(C)O)(C1C(C(CO1)O)=O)=O,8,2,0,2,4,9.6e-05
G5,C(CC(C)(C1CC(C(O1)=O)O)O)=O,8,2,0,2,22,9.6e-05
G5,C1(C(CC(C(CC(C)O)=O)O1)O)=O,8,2,0,2,22,9.6e-05
G5,C(CC(CC1CC(C(O1)=O)O)O)=O,8,2,0,2,13,9.6e-05
G5,C(C(C(C)O)C1CC(C(O1)=O)O)=O,16,3,0,3,23,0.000145
G5,C1(CCC(C(CO1)(CC=O)O)O)=O,4,1,0,1,4,4.9e-05
G5,C1(CCC(C(C(C(C)O)O1)=O)O)=O,8,2,0,2,4,9.8e-05
G5,C1(CC(C(CCO1)O)(CC=O)O)=O,4,1,0,1,19,4.9e-05
G5,C1(C(C(C(CCO1)O)=O)C(C)O)=O,8,3,0,3,19,0.000145
G5,C1(C(C(COCC1)O)(CC=O)O)=O,4,1,0,1,36,4.9e-05
G5,C1(C(CCOCC1O)(CC=O)O)=O,4,2,0,2,36,9.6e-05
G5,C1(C(C(COCC1C(C)O)O)=O)=O,8,3,0,3,36,0.000145
G5,C1(C(COCCC1O)(CC=O)O)=O,4,2,0,2,36,9.6e-05
G5,C1(COCCC(C1(CC=O)O)O)=O,4,1,0,1,36,4.9e-05
G5,C1(C(C(C(C)O)OCCC1O)=O)=O,8,3,0,3,36,0.000145
G5,C(CC1(CC(C(OCC1)=O)O)O)=O,4,2,0,2,30,9.6e-05
G5,C1(C(C(C)O)C(C(OCC1)=O)O)=O,8,3,0,3,30,0.000145
G5,C1(CC(C(OCC1C(C)O)=O)O)=O,8,3,0,3,30,0.000145
G5,C(CC1(COC(C(CC1)O)=O)O)=O,4,2,0,2,29,9.6e-05
G5,C1(C(CC(C(CO1)=O)C(C)O)O)=O,8,2,0,2,12,9.6e-05
G5,C1(C(CCC(C(C(C)O)O1)=O)O)=O,8,3,0,3,12,0.000145
G5,C(CC(C1C(C(C(C)O1)O)=O)O)=O,16,2,0,2,29,9.6e-05
G5,C(CC1(C(C(C)OC1C=O)O)O)=O,16,1,0,1,17,4.9e-05
G5,C(CC1(C(C=C(CO)C1O)O)O)=O,8,1,0,1,46,4.9e-05
G5,C(CC1(C(C(C(C1O)=C)O)O)O)=O,16,1,0,1,2,4.9e-05
G5,C(CC(CO)(C(C(C=C)O)O)O)=O,8,1,0,1,27,4.9e-05
G5,C(C(C(C=C)O)O)(C(C(C)O)O)=O,16,4,0,4,27,0.000193
G5,C(CC1(C(CO)OC=CC1O)O)=O,8,1,0,1,2,4.9e-05
G5,C(CC1(C(COC=CC1O)O)O)=O,8,1,0,1,38,4.9e-05
G5,C(CC1(C(OCC=CC1O)O)O)=O,8,1,0,1,41,4.9e-05
G5,C(CC1(COC(C=CC1O)O)O)=O,8,1,0,1,38,4.9e-05
G5,C1(C(C(C)O)OC(C=CC1O)O)=O,16,2,0,2,38,9.8e-05
G5,C(CC(C1OCC(C=1)O)(CO)O)=O,4,1,0,1,36,4.9e-05
G5,C1C(COC=1C(C(C(C)O)O)=O)O,8,2,0,2,36,9.8e-05
G5,C(CC(CO)(C1(C=CCO1)O)O)=O,4,1,0,1,2,4.9e-05
G5,C(C(C(C)O)O)(C1(C=CCO1)O)=O,8,2,0,2,2,9.8e-05
G5,C(CC(CO)(C1C=CC(O1)O)O)=O,8,1,0,1,38,4.9e-05
G5,C(C(C(C)O)O)(C1C=CC(O1)O)=O,16,2,0,2,38,9.8e-05
G5,C(CC(CO)(C1C(C=CO1)O)O)=O,8,1,0,1,38,4.9e-05
G5,C(C1C(C=CO1)O)(C(C(C)O)O)=O,16,2,0,2,38,9.8e-05
G5,C(CC1(CC(C(CO)C1O)O)O)=O,16,2,0,2,4,0.00010700000000000001
G5,C(CC1(CC(CO)C(C1O)O)O)=O,16,2,0,2,44,0.00010700000000000001
G5,C1(C(C(C(CO)C1C(C)O)O)O)=O,32,2,0,2,4,0.00010700000000000001
G5,C(CC(C)(C(CCO)O)O)=O,4,2,0,2,45,0.00010800000000000001
G5,C(C(CCO)O)(CC(C)O)=O,4,2,0,2,4,0.00010800000000000001
G5,C(CC(C(C)(CCO)O)O)=O,4,2,0,2,45,0.00010700000000000001
G5,C(CC(C(C(C)(CCO)O)O)O)=O,8,2,0,2,4,0.00010700000000000001
G5,C(CC(CCO)(C(CCO)O)O)=O,4,3,0,3,29,0.000166
G5,C(C(CCO)O)(C(CO)C(C)O)=O,8,4,0,4,29,0.000215
G5,C(CC(C(CCO)(CCO)O)O)=O,2,2,0,2,29,0.00010700000000000001
G5,C(CC(C(CC(CCO)O)O)O)=O,8,2,0,2,29,0.00010700000000000001
G5,C(CC(C(C)(C(CO)O)O)O)=O,8,4,0,4,29,0.000213
G5,C(CC(C(CCC(CO)O)=O)O)=O,4,3,0,3,7,0.000155
G5,C(C(CCC(CO)O)(CC=O)O)=O,4,2,0,2,29,0.00010700000000000001
G5,C(C(C(CC(CO)O)C(C)O)=O)=O,8,4,0,4,46,0.00021400000000000002
G5,C(CC(CCCO)(C(CO)O)O)=O,4,3,0,3,29,0.000166
G5,C(C(CO)O)(C(C(C)O)CCO)=O,8,3,0,3,29,0.000166
G5,C(CC(CC(CO)O)(CCO)O)=O,4,3,0,3,29,0.000166
G5,C(CCO)(C(C(CO)O)C(C)O)=O,8,4,0,4,29,0.000215
G5,C(CC(CO)O)(C(CO)C(C)O)=O,8,4,0,4,29,0.000215
G5,C(CC1(CCC(C1(CO)O)O)O)=O,8,2,0,2,7,0.00010700000000000001
G5,C1(C(CO)(C(CC1C(C)O)O)O)=O,16,4,0,4,46,0.000202
G5,C(CC1(CC(C(CO)(C1)O)O)O)=O,8,2,0,2,4,0.00010700000000000001
G5,C1(CC(C(CO)(C1C(C)O)O)O)=O,16,3,0,3,17,0.000156
G5,C1(CC(CO)(C(C1C(C)O)O)O)=O,16,3,0,3,17,0.000156
G5,C(CC(C(CO)(CCO)O)O)=O,4,4,0,4,29,0.00021400000000000002
G5,C(CC(C(CCO)(C(C)O)O)O)=O,8,2,0,2,4,0.00010700000000000001
G5,C(CC1(COC(CCO)C1O)O)=O,8,2,0,2,4,0.00010700000000000001
G5,C1(C(C(C)O)OC(CCO)C1O)=O,16,3,0,3,29,0.000156
G5,C(CC1(C(O)OC(C1)CCO)O)=O,8,3,0,3,4,0.000155
G5,C1(C(O)OC(CCO)C1C(C)O)=O,16,4,0,4,4,0.000204
G5,C(CC1(C(CCO)OC(C1)O)O)=O,8,3,0,3,4,0.000155
G5,C1(C(CCO)OC(C1C(C)O)O)=O,16,4,0,4,4,0.000204
G5,C(CC(C=CC(C)=O)(CO)O)=O,4,4,0,4,29,0.000202
G5,C(CC(C=CC(CO)=O)(C)O)=O,4,3,0,3,29,0.000155
G5,C(C=CC(C)=O)(C(C(C)O)O)=O,8,4,0,4,45,0.000192
G5,C(C=CC(CO)=O)(CC(C)O)=O,4,3,0,3,29,0.000155
G5,C(CC=CC(CO)(CC=O)O)=O,4,4,0,4,29,0.000202
G5,C(CC(CC=CC(CO)=O)O)=O,4,3,0,3,29,0.000155
G5,C(CC=CC(C(C(C)O)O)=O)=O,8,4,0,4,29,0.000192
G5,C(C(C=CC(CO)=O)C(C)O)=O,8,4,0,4,29,0.000202
G5,C(CC(C(C=CCCO)=O)O)=O,4,3,0,3,4,0.000155
G5,C(C(C=CCCO)(CC=O)O)=O,4,3,0,3,4,0.000155
G5,C(CC(C(C)=O)(C=CCO)O)=O,4,5,0,5,29,0.00025
G5,C(CC(C(C=CCO)=O)(C)O)=O,4,3,0,3,29,0.000155
G5,C(CO)=CC(C(CC(C)O)=O)=O,4,3,0,3,29,0.000155
G5,C(CC(C=CC(CCO)=O)O)=O,4,5,0,5,29,0.00025
G5,C(CC(C=CC=O)(CCO)O)=O,4,5,0,5,29,0.00025
G5,C(C=CC(C(CO)C(C)O)=O)=O,8,6,0,6,27,0.000299
G5,C(CC(CO)(CC(C=C)=O)O)=O,2,3,0,3,29,0.000155
G5,C(CC(C=C)(CC(CO)=O)O)=O,2,4,0,4,29,0.000202
G5,C(C(C(C)O)O)(CC(C=C)=O)=O,4,4,0,4,27,0.000192
G5,C(CO)(C(C(C=C)=O)C(C)O)=O,4,5,0,5,27,0.000251
G5,C(CC(C(C=C)=O)(CCO)O)=O,2,3,0,3,29,0.000155
G5,C(CCO)(C(C=C)(CC=O)O)=O,2,5,0,5,29,0.00025
G5,C=CC(C(C(CO)C(C)O)=O)=O,4,5,0,5,45,0.000251
G5,C(CC(CO)(CC=CC=O)O)=O,4,3,0,3,29,0.000155
G5,C(CC(C=CCC(CO)=O)O)=O,4,5,0,5,29,0.00025
G5,C(C(C(C)O)O)(CC=CC=O)=O,8,3,0,3,27,0.000145
G5,C(CO)(C(C=CC=O)C(C)O)=O,8,3,0,3,29,0.000155
G5,C(CC(C(CC=CCO)=O)O)=O,4,4,0,4,29,0.000202
G5,C(CC(C=O)(CC=CCO)O)=O,4,3,0,3,4,0.000155
G5,C(C(C(C=O)=O)C(C)O)=CCO,8,3,0,3,29,0.000155
G5,C(CC1(C(CCO)OCC1O)O)=O,8,2,0,2,9,0.00010700000000000001
G5,C(CC1(CCOC1(CCO)O)O)=O,4,3,0,3,53,0.000155
G5,C1(C(CCO)(O)OCC1C(C)O)=O,8,4,0,4,2,0.000204
G5,C(CC1(COC(C1)(CCO)O)O)=O,4,3,0,3,26,0.000155
G5,C1(COC(CCO)(C1C(C)O)O)=O,8,4,0,4,30,0.000204
G5,C1(C(C(C)O)OC(CCO)(C1)O)=O,8,4,0,4,30,0.000204
G5,C(CC(CO)(C1CC(CO1)O)O)=O,8,2,0,2,4,0.00010700000000000001
G5,C(C1CC(CO1)O)(C(C(C)O)O)=O,16,2,0,2,4,9.8e-05
G5,C(CC(C1CC(C(CO)O1)O)O)=O,16,2,0,2,29,0.00010700000000000001
G5,C(CC(C1C(CC(CO)O1)O)O)=O,16,2,0,2,40,0.00010700000000000001
G5,C(CC1(C(CO)OC(C)(C1)O)O)=O,8,3,0,3,4,0.000155
G5,C1(C(CO)OC(C)(C1C(C)O)O)=O,16,4,0,4,26,0.000204
G5,C(CC1(CC(CO)OC1(C)O)O)=O,8,3,0,3,29,0.000155
G5,C1(C(C)(O)OC(CO)C1C(C)O)=O,16,4,0,4,14,0.000204
G5,C(CC1(C(C)OC(CO)C1O)O)=O,16,2,0,2,29,0.00010700000000000001
G5,C(CC1(CC(CO)(O)OCC1)O)=O,4,3,0,3,29,0.000155
G5,C1(CCOC(CO)(C1C(C)O)O)=O,8,4,0,4,30,0.000204
G5,C1(CC(CO)(O)OCC1C(C)O)=O,8,4,0,4,30,0.000204
G5,C(CC1(COC(CO)(CC1)O)O)=O,4,3,0,3,29,0.000155
G5,C1(COC(CO)(CC1C(C)O)O)=O,8,3,0,3,12,0.000155
G5,C1(C(C(C)O)OC(CO)(CC1)O)=O,8,4,0,4,29,0.000204
G5,C(CC1(CCC(O)OC1CO)O)=O,8,3,0,3,29,0.000155
G5,C1(C(CO)OC(CC1C(C)O)O)=O,16,3,0,3,4,0.000155
G5,C(CC1(CC(CO)OC(C1)O)O)=O,8,3,0,3,4,0.000155
G5,C1(CC(O)OC(CO)C1C(C)O)=O,16,4,0,4,44,0.000204
G5,C1(CC(CO)OC(C1C(C)O)O)=O,16,4,0,4,44,0.000204
G5,C(CC(C(C)(CC=O)O)O)(O)=O,4,2,0,2,45,0.00010700000000000001
G5,C(CC(C(CC(C)O)=O)O)(O)=O,4,2,0,2,4,0.00010700000000000001
G5,C(CC(C)(C(CC=O)O)O)(O)=O,4,2,0,2,29,0.00010700000000000001
G5,C(C(CO)C(C(CC=O)O)O)(O)=O,8,5,0,5,29,0.000263
G5,C(CC(C(C(CC=O)O)O)O)(O)=O,8,2,0,2,4,0.00010700000000000001
G5,C(C(C(C)O)C(C(O)=O)(CO)O)=O,8,7,0,7,33,0.00036
G5,C(CC(CO)(C(CC=O)O)O)(O)=O,4,3,0,3,29,0.000166
G5,C(C(C=CC(C)=O)(CC=O)O)(O)=O,4,2,0,2,29,0.00010700000000000001
G5,C(CC(C=CC(C(O)=O)=O)(C)O)=O,4,2,0,2,29,0.00010700000000000001
G5,C(C(C=CC(CC(C)O)=O)=O)(O)=O,4,2,0,2,4,0.00010700000000000001
G5,C(C(C=CCC=O)(CC=O)O)(O)=O,4,2,0,2,29,0.00010700000000000001
G5,C(CC(CC=CC(C(O)=O)=O)O)=O,4,2,0,2,29,0.00010700000000000001
G5,C(C(C=CC(C(O)=O)=O)C(C)O)=O,8,2,0,2,46,0.00010700000000000001
G5,C(CC=CC(C(CC=O)O)=O)(O)=O,4,2,0,2,29,0.00010700000000000001
G5,C(C(C=CCC(O)=O)(CC=O)O)=O,4,2,0,2,29,0.00010700000000000001
G5,C(CC(C(C)=O)(C=CC(O)=O)O)=O,4,2,0,2,21,0.00010700000000000001
G5,C(CC(C(C=CC(O)=O)=O)(C)O)=O,4,2,0,2,29,0.00010700000000000001
G5,C(C(C=CC(O)=O)=O)(CC(C)O)=O,4,2,0,2,4,0.00010700000000000001
G5,C(CC(C=CC(O)=O)(CC=O)O)=O,2,2,0,2,4,0.00010700000000000001
G5,C(CC(CC(C=CC(O)=O)=O)O)=O,4,2,0,2,29,0.00010700000000000001
G5,C(C(C(C=CC(O)=O)=O)C(C)O)=O,8,3,0,3,29,0.000156
G5,C(CC(C=CC(CC=O)O)=O)(O)=O,4,2,0,2,29,0.00010700000000000001
G5,C(CC(C=CC=O)(CC=O)O)(O)=O,4,2,0,2,4,0.00010700000000000001
G5,C(C(C(C=CC=O)=O)C(C)O)(O)=O,8,3,0,3,29,0.000156
G5,C(C(CC=O)(CC(C=C)=O)O)(O)=O,2,2,0,2,29,0.00010700000000000001
G5,C(CC(C=C)(CC(C(O)=O)=O)O)=O,2,2,0,2,29,0.00010700000000000001
G5,C=CC(C(C(C(O)=O)=O)C(C)O)=O,4,3,0,3,29,0.000156
G5,C(CC(C(C=C)=O)(CC=O)O)(O)=O,2,2,0,2,4,0.00010700000000000001
G5,C(CC(O)=O)(C(C=C)(CC=O)O)=O,2,2,0,2,29,0.00010700000000000001
G5,C(C(C(C(C=C)=O)=O)C(C)O)(O)=O,4,3,0,3,29,0.000156
G5,C(C(CC=O)(CC=CC=O)O)(O)=O,4,2,0,2,29,0.00010700000000000001
G5,C(CC(C=CCC(C(O)=O)=O)O)=O,4,2,0,2,29,0.00010700000000000001
G5,C(C(C(C(O)=O)=O)C(C)O)=CC=O,8,2,0,2,29,0.00010700000000000001
G5,C(CC(C(CC=CC(O)=O)=O)O)=O,4,2,0,2,29,0.00010700000000000001
G5,C(CC(C=O)(CC=CC(O)=O)O)=O,4,2,0,2,29,0.00010700000000000001
G5,C(C(C(C=O)=O)C(C)O)=CC(O)=O,8,2,0,2,29,0.00010700000000000001
G5,C(CC1(C2CC(C1(CO2)O)O)O)=O,16,1,0,1,9,4.9e-05
G5,C(C(C(O)=O)(C(CC=O)O)O)(O)=O,2,6,0,6,17,0.0003
G5,C(C1(COCC1(CC=O)O)O)(O)=O,4,1,0,1,17,4.9e-05
G5,C(C1(C(C(C(C)O)OC1)=O)O)(O)=O,8,4,0,4,4,0.000194
G5,C(CC1(COCC1(CO)O)O)=O,4,1,0,1,10,4.9e-05
G5,C1(C(C(C)O)OCC1(CO)O)=O,8,4,0,4,4,0.000196
G5,C(CC(C(C(C)O)(C(C)O)O)O)=O,6,1,0,1,4,4.9e-05
G5,C(CC1(COCC1(C(C)O)O)O)=O,8,1,0,1,4,4.9e-05
G5,C1(C(C(C)O)OCC1(C(C)O)O)=O,16,4,0,4,4,0.000195
G5,C(CC(C1(CC(CC1O)O)O)O)=O,16,1,0,1,43,4.9e-05
G5,C1(C(CC(C1(C)O)O)(CC=O)O)=O,8,2,0,2,4,9.6e-05
G5,C1(C(C(C(C1C(C)O)O)(C)O)=O)=O,16,3,0,3,4,0.000145
G5,C(CC1(CC2CC(C1(O)O2)O)O)=O,16,1,0,1,23,4.9e-05
G5,C1(C2(C(CC(C1C(C)O)O2)O)O)=O,32,3,0,3,23,0.000145
G5,C(CC(C(C)(C(CCO)O)O)O)=O,8,1,0,1,11,4.9e-05
G5,C(CC(C(C(C(O)=O)(C)O)=O)O)=O,4,4,0,4,28,0.00020299999999999997
G5,C(C(C(C(C(C)O)O)=O)(C)O)(O)=O,8,4,0,4,17,0.000193
G5,C(C(C)(C(CC(CC=O)O)O)O)=O,8,2,0,2,11,9.7e-05
G5,C(CC(C(C)(C(CC=O)O)O)O)=O,3,1,0,1,11,4.9e-05
G5,C(C(C(C(C=O)(C)O)O)C(C)O)=O,16,3,0,3,11,0.000145
G5,C(CC1(CCOC1(C(O)=O)O)O)=O,4,1,0,1,17,4.9e-05
G5,C(C1(C(C(CO1)C(C)O)=O)O)(O)=O,8,3,0,3,17,0.000146
G5,C(CC(C(C)(C(C(C)O)O)O)O)=O,16,1,0,1,11,4.9e-05
G5,C(CC(C(C)(CO)O)O)=O,4,3,0,3,29,0.000155
G5,C(CC1(CCOC1(CO)O)O)=O,4,1,0,1,34,4.9e-05
G5,C1(C(CO)(O)OCC1C(C)O)=O,8,3,0,3,34,0.000147
G5,C(CC(C(C)(C(C)(CO)O)O)O)=O,8,2,0,2,11,0.00010700000000000001
G5,C(CC(C(C(C)(C(C)O)O)=O)O)=O,8,2,0,2,4,9.8e-05
G5,C(C(C(C)(C(C)O)O)(CC=O)O)=O,8,1,0,1,4,4.9e-05
G5,C(CC(CO)(C(C)(C(C)O)O)O)=O,8,1,0,1,4,4.9e-05
G5,C(C(C(C)O)O)(C(C)(C(C)O)O)=O,16,3,0,3,4,0.000146
G5,C(CC(C(C)(C(C)O)O)O)=O,8,1,0,1,18,4.9e-05
G5,C(CC1(CCOC1(C(C)O)O)O)=O,8,1,0,1,4,4.9e-05
G5,C1(C(C(C)O)(O)OCC1C(C)O)=O,16,3,0,3,4,0.000146
G5,C1(C(C(C(C1O)O)C)(CC=O)O)=O,16,1,0,1,42,4.9e-05
G5,C1(C(C(C(C1C)O)O)(CC=O)O)=O,16,1,0,1,42,4.9e-05
G5,C(CC1(C(C(C(C1O)=O)C)O)O)=O,16,1,0,1,42,4.9e-05
G5,C(CC1(C(C)C(C(C1O)=O)O)O)=O,16,1,0,1,42,4.9e-05
G5,C(CC1(C(CCC(C1)=O)=O)O)=O,2,3,0,3,29,0.000144
G5,C1(CCC(C(C1)=O)(CC=O)O)=O,2,4,0,4,29,0.00019099999999999998
G5,C1(CCC(C(C1C(C)O)=O)=O)=O,4,5,0,5,45,0.00023999999999999998
G5,C1(CC(C(C(C1)=O)=O)C(C)O)=O,4,3,0,3,29,0.000144
G5,C1(C(C(C)O)CC(C(C1)=O)=O)=O,4,4,0,4,29,0.00019099999999999998
G5,C(CC(C1C(C(CC1)=O)=O)O)=O,4,3,0,3,7,0.000144
G5,C1(C(CCC1C=O)(CC=O)O)=O,4,2,0,2,29,9.6e-05
G5,C(C1C(C(C(C1)C(C)O)=O)=O)=O,8,3,0,3,12,0.000144
G5,C1(CC(CC(C1C(C)O)=O)=O)=O,2,5,0,5,29,0.00023999999999999998
G5,C(CC(C1C(CC(C1)=O)=O)O)=O,4,4,0,4,29,0.00019099999999999998
G5,C1(C(C=O)CC(C1C(C)O)=O)=O,8,6,0,6,29,0.00028700000000000004
G5,C1(C(C=O)C(C(C1)=O)C(C)O)=O,8,4,0,4,29,0.00019099999999999998
G5,C(C1CC(C(C1)=O)(CC=O)O)=O,4,3,0,3,29,0.000144
G5,C(CC(C1CC(C(C1)=O)=O)O)=O,2,3,0,3,21,0.000144
G5,C(C1CC(C(C1C(C)O)=O)=O)=O,8,4,0,4,14,0.00019099999999999998
G5,C(CC(C1C(CCC1=O)=O)O)=O,2,3,0,3,29,0.000144
G5,C1(C(C(C)O)CC(C1C=O)=O)=O,8,6,0,6,29,0.000286
G5,C(CC1(C=CCC(C1O)=O)O)=O,4,3,0,3,29,0.000144
G5,C1(C(C(C=CC1C(C)O)=O)O)=O,8,3,0,3,29,0.000144
G5,C(CC1(C(C=CC(C1)=O)O)O)=O,4,2,0,2,27,9.6e-05
G5,C(CC1(C=CC(C(C1)=O)O)O)=O,4,3,0,3,29,0.000144
G5,C1(C(C=CC(C1C(C)O)=O)O)=O,8,4,0,4,45,0.000192
G5,C(CC(C(CO)=O)(C(C=O)C)O)=O,4,1,0,1,42,4.9e-05
G5,C(C(CO)(CC=O)O)(C(C=O)C)=O,4,1,0,1,42,4.9e-05
G5,C(CC(C(C(C(CO)=O)=O)C)O)=O,4,2,0,2,42,9.7e-05
G5,C(C(C(C(C(C(C)O)O)=O)=O)C)=O,8,2,0,2,42,9.8e-05
G5,C(CC(C(CO)CC(C=O)=O)O)=O,4,3,0,3,55,0.000144
G5,C(CC(C(CC(C=O)CO)=O)O)=O,4,1,0,1,55,4.9e-05
G5,C(C(CO)CC(C=O)(CC=O)O)=O,4,1,0,1,55,4.9e-05
G5,C(C(CO)C(C(C=O)=O)C(C)O)=O,8,1,0,1,55,4.9e-05
G5,C(CO)(C(C(CO)C)(CC=O)O)=O,4,1,0,1,42,4.9e-05
G5,C(C(CO)(CC=O)O)(C(CO)C)=O,4,1,0,1,42,4.9e-05
G5,C(C(C(C(C)O)O)=O)(C(CO)C)=O,8,2,0,2,42,9.8e-05
G5,C(C(C)C(C(CO)(CC=O)O)O)=O,8,1,0,1,49,4.9e-05
G5,C(CC(C(C)C(C(CO)=O)O)O)=O,8,1,0,1,49,4.9e-05
G5,C(C(C)C(C(C(C(C)O)O)=O)O)=O,16,2,0,2,49,9.8e-05
G5,C(CC(C(CO)CC(CO)=O)O)=O,4,4,0,4,18,0.00020299999999999997
G5,C(C(CO)CC(CO)(CC=O)O)=O,4,1,0,1,55,4.9e-05
G5,C(C(CO)CC(C(C(C)O)O)=O)=O,8,3,0,3,55,0.000145
G5,C(C(C)(CC=O)O)(C(CO)CO)=O,2,1,0,1,2,4.9e-05
G5,C(C)(C(C(CO)CO)(CC=O)O)=O,2,2,0,2,4,0.00010800000000000001
G5,C(C(CC(C)O)=O)(C(CO)CO)=O,2,1,0,1,2,4.9e-05
G5,C(CO)(C(CC)(CC=O)O)=O,2,1,0,1,42,4.9e-05
G5,C(C(CO)(CC=O)O)(CC)=O,2,2,0,2,4,9.6e-05
G5,C(C(CO)=O)(C(C)C(C)O)=O,4,1,0,1,42,4.9e-05
G5,C(C(C(C(C)O)O)=O)(CC)=O,4,3,0,3,42,0.000145
G5,C(CC(C(CO)CC=O)O)=O,4,5,0,5,29,0.000251
G5,C(C(CO)CC(CC=O)O)=O,4,2,0,2,4,9.6e-05
G5,C(CC(C(CCC(C=O)=O)=O)O)=O,2,2,0,2,7,9.6e-05
G5,C(C=O)(C(C(C)O)CC(C=O)=O)=O,4,1,0,1,7,4.9e-05
G5,C(CC(C(CC(C=O)C)=O)O)=O,4,2,0,2,49,9.6e-05
G5,C(C(C)CC(C=O)(CC=O)O)=O,4,2,0,2,4,9.6e-05
G5,C(CC(C(C)CC(C=O)=O)O)=O,4,2,0,2,28,9.7e-05
G5,C(C(C)C(C(C=O)=O)C(C)O)=O,8,3,0,3,49,0.000144
G5,C(CC(C(C)=O)(CC(C)=O)O)=O,2,5,0,5,29,0.000239
G5,C(C)(CC(C(C)(CC=O)O)=O)=O,2,3,0,3,29,0.000144
G5,C(C)(C(C(C(C)=O)=O)C(C)O)=O,4,5,0,5,14,0.00023999999999999998
G5,C(C)(CC(C(CC(C)O)=O)=O)=O,2,3,0,3,29,0.000144
G5,C(CC(C)O)(CC(C(C)=O)=O)=O,2,5,0,5,29,0.000239
G5,C(CC(C(C(C(C)=O)=O)C)O)=O,4,3,0,3,45,0.000144
G5,C(C(C)(CC=O)O)(C(C=O)C)=O,4,2,0,2,11,9.6e-05
G5,C(CC(C(C)=O)(C(C=O)C)O)=O,4,2,0,2,45,9.6e-05
G5,C(C(C(C(CC(C)O)=O)=O)C)=O,4,2,0,2,45,9.6e-05
G5,C(CC(C(CC=O)(CC=O)O)=O)=O,1,1,0,1,2,4.9e-05
G5,C(C(C(C(CC=O)=O)=O)C(C)O)=O,4,2,0,2,2,9.8e-05
G5,C(CC(CC(C(CC)=O)=O)O)=O,2,3,0,3,4,0.000144
G5,C(CC(C(CC)=O)(CC=O)O)=O,1,2,0,2,4,9.6e-05
G5,C(C(CC)(CC=O)O)(CC=O)=O,2,1,0,1,27,4.9e-05
G5,C(C(C(C(CC)=O)=O)C(C)O)=O,4,3,0,3,27,0.000145
G5,C(CC(C(C(C)C(C)O)=O)=O)=O,4,1,0,1,27,4.9e-05
G5,C(C)(C(CCC=O)(CC=O)O)=O,2,4,0,4,29,0.00019099999999999998
G5,C(CCC=O)(C(C)(CC=O)O)=O,2,3,0,3,29,0.000144
G5,C(CC(CCC(C(C)=O)=O)O)=O,2,3,0,3,29,0.000144
G5,C(CCC(C(CC(C)O)=O)=O)=O,2,3,0,3,29,0.000144
G5,C(CC(C(C(C)CC=O)=O)O)=O,4,2,0,2,4,9.6e-05
G5,C(CC(C)C(C=O)(CC=O)O)=O,4,2,0,2,45,9.7e-05
G5,C(CC(CC(C(C=O)=O)C)O)=O,4,2,0,2,4,9.6e-05
G5,C(C(C(C)O)C(C(C=O)=O)C)=O,8,2,0,2,1,9.6e-05
G5,C(CC(CO)(C(C)CC=O)O)=O,4,2,0,2,0,9.6e-05
G5,C(CC(CC(C(CO)=O)C)O)=O,4,2,0,2,4,9.6e-05
G5,C(C(C)CC=O)(C(C(C)O)O)=O,8,2,0,2,0,9.8e-05
G5,C(C(C(C)O)C(C(CO)=O)C)=O,8,2,0,2,28,9.6e-05
G5,C(C(CC)(CC=O)O)(CCO)=O,2,1,0,1,27,4.9e-05
G5,C(C(CCO)(CC=O)O)(CC)=O,2,2,0,2,4,9.6e-05
G5,C(C(CCO)=O)(C(C)C(C)O)=O,4,1,0,1,27,4.9e-05
G5,C(C(CC)=O)(C(CO)C(C)O)=O,4,3,0,3,27,0.000145
G5,C(CC(C)(CC(CCO)=O)O)=O,2,3,0,3,6,0.000155
G5,C(CCO)(C(C(C)=O)C(C)O)=O,4,4,0,4,27,0.000192
G5,C(C(CO)C(C)O)(CC(C)=O)=O,4,3,0,3,27,0.000145
G5,C(CC(C)O)(CC(CCO)=O)=O,2,3,0,3,29,0.000144
G5,C(CC(C(CC=O)O)CCO)=O,4,3,0,3,46,0.000144
G5,C(C(CC(CC=O)O)CCO)=O,4,3,0,3,4,0.000155
G5,C(C(C(C)O)C(C=O)CCO)=O,8,5,0,5,46,0.00025
G5,C(C(C)CC(CO)(CC=O)O)=O,4,2,0,2,4,9.6e-05
G5,C(CC(C(C)CC(CO)=O)O)=O,4,2,0,2,28,9.7e-05
G5,C(C(C)C(C(CO)=O)C(C)O)=O,8,3,0,3,49,0.000144
G5,C(C(C)CC(C(C(C)O)O)=O)=O,8,3,0,3,28,0.000145
G5,C(C(C)(CC=O)O)(C(CO)C)=O,4,2,0,2,4,9.6e-05
G5,C(C)(C(C(CO)C)(CC=O)O)=O,4,1,0,1,27,4.9e-05
G5,C(C(CC(C)O)=O)(C(C)CO)=O,4,2,0,2,11,9.6e-05
G5,C(C(C)C(C(C)(CC=O)O)O)=O,8,2,0,2,4,9.6e-05
G5,C(CC(C(C)C(C(C)=O)O)O)=O,8,1,0,1,27,4.9e-05
G5,C(C(C)C(C(CC(C)O)=O)O)=O,8,2,0,2,11,9.6e-05
G5,C(C(C)(CC=O)O)(CC)=O,2,2,0,2,4,9.6e-05
G5,C(C)(C(CC)(CC=O)O)=O,2,1,0,1,28,4.9e-05
G5,C(C(CC)=O)(CC(C)O)=O,2,2,0,2,4,9.6e-05
G5,C(C(C)=O)(C(C)C(C)O)=O,4,1,0,1,28,4.9e-05
G5,C(CC(C)(CC(C)=O)O)=O,2,3,0,3,4,0.000144
G5,C(CC(C)O)(CC(C)=O)=O,2,3,0,3,29,0.000144
G5,C(C)(C(C(C)=O)C(C)O)=O,2,3,0,3,28,0.000145
G5,C(CC(C(C)CC=O)O)=O,4,2,0,2,28,9.7e-05
G5,C(C(C)CC(CC=O)O)=O,4,2,0,2,18,9.6e-05
G5,C(C(C(C)O)C(C=O)C)=O,8,3,0,3,49,0.000144
G5,C(C(CC(CC=O)O)C(CO)O)=O,8,2,0,2,46,0.00010700000000000001
G5,C(CC(C(C(CO)O)CC=O)O)=O,8,3,0,3,46,0.000144
G5,C(CC(CO)(C(CO)CC=O)O)=O,4,4,0,4,11,0.00020299999999999997
G5,C(C(CO)CC=O)(C(C(C)O)O)=O,8,3,0,3,2,0.000145
G5,C(C(CC)(CC=O)O)(C(CO)O)=O,4,1,0,1,42,4.9e-05
G5,C(C(C(CO)O)(CC=O)O)(CC)=O,4,1,0,1,42,4.9e-05
G5,C(C(C(CO)O)=O)(C(C)C(C)O)=O,8,1,0,1,42,4.9e-05
G5,C(CC(C(C(C=O)C)=O)O)=O,4,4,0,4,29,0.00019099999999999998
G5,C(CC(C(C(C=O)=O)C)O)=O,4,3,0,3,0,0.000144
G5,C(CC(C(C(CO)CC=O)=O)O)=O,4,1,0,1,55,4.9e-05
G5,C(CC(CO)C(C=O)(CC=O)O)=O,4,3,0,3,43,0.000155
G5,C(C(C(C)O)C(C(C=O)=O)CO)=O,8,2,0,2,55,9.6e-05
G5,C(CC(CC(C=O)C(C=O)O)O)=O,8,3,0,3,29,0.000155
G5,C(CC(C(C(C=O)O)CC=O)O)=O,8,6,0,6,29,0.00031
G5,C(CC(C(C(C)=O)C(CO)=O)O)=O,4,7,0,7,26,0.000346
G5,C(CC(C)O)(C(C=O)C(CO)=O)=O,4,1,0,1,2,4.9e-05
G5,C(C(C(C)O)O)(C(C=O)C(C)=O)=O,8,4,0,4,2,0.00020299999999999997
G5,C(CC(CC(C=O)C(CO)=O)O)=O,4,2,0,2,41,9.7e-05
G5,C(C(C(C)O)C(C=O)C(CO)=O)=O,8,2,0,2,55,9.6e-05
G5,C(C(C(C)O)O)(C(C=O)CC=O)=O,8,3,0,3,41,0.000145
G5,C(CC(C(C(C)C(C=O)O)=O)O)=O,8,1,0,1,28,4.9e-05
G5,C(C(C(C)C(C=O)(CC=O)O)O)=O,8,1,0,1,28,4.9e-05
G5,C(CC(C(C(C)C(CO)O)=O)O)=O,8,1,0,1,28,4.9e-05
G5,C(C(C(C)C(CO)O)(CC=O)O)=O,8,1,0,1,28,4.9e-05
G5,C(CC(C(C(C(CO)=O)C)O)O)=O,8,1,0,1,28,4.9e-05
G5,C(CC(CO)(C(C)C(C=O)O)O)=O,8,1,0,1,28,4.9e-05
G5,C(C(C)C(C=O)O)(C(C(C)O)O)=O,16,2,0,2,28,9.8e-05
G5,C(CC(C(C(C=O)CCO)=O)O)=O,4,3,0,3,29,0.000155
G5,C(CC(C=O)(C(C=O)CCO)O)=O,4,3,0,3,29,0.000155
G5,C(CC(C(C(C=O)=O)CCO)O)=O,4,4,0,4,29,0.00020299999999999997
G5,C(CC(C(C(CO)CCO)=O)O)=O,4,1,0,1,55,4.9e-05
G5,C(C(C(CO)CCO)(CC=O)O)=O,4,1,0,1,55,4.9e-05
G5,C(C(CCO)C(C(CC=O)O)O)=O,8,3,0,3,29,0.000166
G5,C(CC(C(CCO)C(C=O)O)O)=O,8,1,0,1,3,4.9e-05
G5,C(CC(C)O)(C(C(CO)=O)CO)=O,4,1,0,1,2,4.9e-05
G5,C(C(C(C)O)O)(C(C(C)=O)CO)=O,8,2,0,2,2,9.8e-05
G5,C(CC(C(C(CO)C)=O)O)=O,4,2,0,2,4,9.6e-05
G5,C(C(C(CO)C)(CC=O)O)=O,4,2,0,2,49,0.00010700000000000001
G5,C(C(C)C(C(CC=O)O)O)=O,8,2,0,2,4,9.6e-05
G5,C(CC(C(C)C(C=O)O)O)=O,8,1,0,1,49,4.9e-05
G5,C(CC(C(CC)=O)O)=O,2,2,0,2,28,9.6e-05
G5,C(C(CC)(CC=O)O)=O,2,1,0,1,28,4.9e-05
G5,C(C(C(C)C(C)O)=O)=O,4,1,0,1,28,4.9e-05
G5,C(CC(C(C(CCO)=O)=O)(C)O)=O,2,2,0,2,34,9.6e-05
G5,C(C)(C(C(CCO)=O)(CC=O)O)=O,2,1,0,1,2,4.9e-05
G5,C(CC(C(C(C)=O)=O)(CCO)O)=O,2,1,0,1,2,4.9e-05
G5,C(C(C(CCO)=O)=O)(CC(C)O)=O,2,1,0,1,2,4.9e-05
G5,C(C(C(C)=O)=O)(C(CO)C(C)O)=O,4,2,0,2,2,9.8e-05
G5,C(CC(C(C(CCCO)=O)=O)O)=O,2,1,0,1,55,4.9e-05
G5,C(CCCO)(C(C=O)(CC=O)O)=O,2,1,0,1,55,4.9e-05
G5,C(CC(C(C=O)=O)(CCCO)O)=O,2,1,0,1,55,4.9e-05
G5,C(C(C(C(CCO)C(C)O)=O)=O)=O,4,1,0,1,55,4.9e-05
G5,C(C)(C(C(C(C)(CC=O)O)=O)O)=O,4,2,0,2,25,9.6e-05
G5,C(C)(C(C(C(CC(C)O)=O)=O)O)=O,4,1,0,1,25,4.9e-05
G5,C(CC(C)O)(C(C(C(C)=O)=O)O)=O,4,1,0,1,25,4.9e-05
G5,C(CC(C(C(C(CC)=O)=O)O)O)=O,4,4,0,4,42,0.00020299999999999997
G5,C(C(CC)(CC=O)O)(C(C=O)O)=O,4,2,0,2,4,0.00010700000000000001
G5,C(C(C(C(C(C)C(C)O)=O)=O)O)=O,8,1,0,1,42,4.9e-05
G5,C(CCC(C(C(CC=O)O)O)O)=O,8,2,0,2,27,9.6e-05
G5,C(CC(CCC(C(C=O)O)O)O)=O,8,2,0,2,7,0.00010700000000000001
G5,C(CC(C=C)(C(C(C)=O)O)O)=O,4,3,0,3,29,0.000144
G5,C(CC(C)O)(C(C(C=C)=O)O)=O,4,3,0,3,29,0.000144
G5,C(CC(C)(C(C=CC=O)O)O)=O,8,2,0,2,4,9.6e-05
G5,C(CC(C=CC(C(C)=O)O)O)=O,8,3,0,3,29,0.000144
G5,C(CC(C)O)(C(C=CC=O)O)=O,8,2,0,2,4,9.6e-05
G5,C(CC(CC1(CC(CO1)O)O)O)=O,8,2,0,2,29,9.6e-05
G5,C(C(C(C)O)C1(CC(CO1)O)O)=O,16,3,0,3,44,0.000145
G5,C(CC(C)(C1(CC(CO1)O)O)O)=O,8,2,0,2,14,9.6e-05
G5,C(C1(CC(CO1)O)O)(CC(C)O)=O,8,2,0,2,4,9.6e-05
G5,C(CC(CC1C(CC(O)O1)O)O)=O,16,2,0,2,4,9.6e-05
G5,C(C(C1C(CC(O)O1)O)C(C)O)=O,32,3,0,3,43,0.000145
G5,C(CC(C)(C1C(CC(O)O1)O)O)=O,16,2,0,2,45,9.6e-05
G5,C(C1C(CC(O1)O)O)(CC(C)O)=O,16,2,0,2,4,9.6e-05
G5,C(CC(C1CC(C(CO1)O)O)O)=O,16,1,0,1,29,4.9e-05
G5,C(CC1(C=CC(C1CO)=O)O)=O,4,4,0,4,29,0.00019099999999999998
G5,C(C(C)C(CO)(C(CC=O)O)O)=O,8,1,0,1,49,4.9e-05
G5,C(C(CO)(C(C)C(CC=O)O)O)=O,8,1,0,1,49,4.9e-05
G5,C(C(C)(CC=O)O)(C(C=O)C=O)=O,2,1,0,1,14,4.9e-05
G5,C(C(C=O)C(C(CC(C)O)=O)=O)=O,2,1,0,1,14,4.9e-05
G5,C(C(C(C(CC=O)O)=O)C(C)=O)=O,4,2,0,2,23,9.6e-05
G5,C(C(C(CC(C)O)=O)C(C=O)=O)=O,4,1,0,1,23,4.9e-05
G5,C(C(C=O)C(CC(C)O)=O)=O,2,4,0,4,29,0.00019099999999999998
G5,C(CC(C(C(C)=O)C(C)=O)O)=O,2,4,0,4,28,0.000192
G5,C(CC(C)O)(C(C=O)C(C)=O)=O,4,4,0,4,29,0.00019099999999999998
G5,C(CC(C)(C(C(C)=O)CO)O)=O,4,5,0,5,28,0.000251
G5,C(CC(C)O)(C(C(C)=O)CO)=O,4,3,0,3,29,0.000144
G5,C(CC(C(C=O)(C(C=O)C)O)O)=O,8,2,0,2,49,9.7e-05
G5,C(C(C=O)(C(C)C(CC=O)O)O)=O,4,1,0,1,49,4.9e-05
G5,C(CC(C(C(C)=O)(C(C)=O)O)O)=O,2,5,0,5,49,0.000251
G5,C(CC(C)O)(C(C=O)(C(C)=O)O)=O,4,1,0,1,1,4.9e-05
G5,C(CC(CC(C=O)(C(C)=O)O)O)=O,4,1,0,1,25,4.9e-05
G5,C(C(C(C)O)C(C=O)(C(C)=O)O)=O,8,4,0,4,25,0.000193
G5,C(CC(C)O)(C(C=O)(CC=O)O)=O,4,1,0,1,25,4.9e-05
G5,C(CC(C)O)(C(C(C)=O)(CO)O)=O,4,1,0,1,49,4.9e-05
G5,C(C1(CC(CC1(CC=O)O)O)O)=O,8,2,0,2,6,9.6e-05
G5,C(C1(C(C(C(C)O)C(C1)O)=O)O)=O,16,2,0,2,43,9.8e-05
G5,C(C1CC(C(C1(CC=O)O)O)O)=O,16,1,0,1,41,4.9e-05
G5,C(CC1(CC(C(C1(C)O)=O)O)O)=O,8,2,0,2,9,9.6e-05
G5,C1(C(C(C)O)C(C(C1(C)O)=O)O)=O,16,2,0,2,45,9.8e-05
G5,C(CC1(C(C(C(C1C)=O)O)O)O)=O,16,1,0,1,42,4.9e-05
G5,C1(C(C(C)O)C(C(C1O)=O)(C)O)=O,16,2,0,2,25,9.8e-05
G5,C(CC(C(C(C(O)=O)=O)C)O)=O,4,3,0,3,25,0.000144
G5,C(CC(C(O)=O)(C(C=O)C)O)=O,4,4,0,4,29,0.000213
G5,C(C(C(C(CC=O)O)=O)CC=O)=O,4,2,0,2,43,9.6e-05
G5,C(CC(C(C(C=O)=O)CC=O)O)=O,4,3,0,3,33,0.000145
G5,C(C(C(C=O)=O)CC(CC=O)O)=O,4,1,0,1,33,4.9e-05
G5,C(C(C(C=O)=O)C(C=O)C(C)O)=O,8,1,0,1,33,4.9e-05
G5,C(C(C=O)CC(CC=O)O)=O,2,2,0,2,43,9.6e-05
G5,C(C(C=O)C(C=O)C(C)O)=O,4,3,0,3,29,0.000144
G5,C(CC(C(C)C(C(O)=O)O)O)=O,8,1,0,1,49,4.9e-05
G5,C(C(C(CO)C)(CC=O)O)(O)=O,4,2,0,2,42,0.00010700000000000001
G5,C(C)(C(C(CC=O)O)CC=O)=O,4,3,0,3,4,0.000144
G5,C(CC(CC(C=O)C(C)=O)O)=O,4,2,0,2,4,9.6e-05
G5,C(C(C(C)O)C(C=O)C(C)=O)=O,8,4,0,4,29,0.00019099999999999998
G5,C(CC(C)O)(C(C=O)CC=O)=O,4,2,0,2,43,9.6e-05
G5,C(C(CC)(CC=O)O)(O)=O,2,2,0,2,27,0.00010700000000000001
G5,C(C(C(C)C(C)O)=O)(O)=O,4,1,0,1,28,4.9e-05
G5,C(CC(C1C(CC(CO)O1)=O)O)=O,8,1,0,1,26,4.9e-05
G5,C(CC1(CC(CO)OC1C=O)O)=O,8,1,0,1,26,4.9e-05
G5,C(C1C(C(C(C)O)C(CO)O1)=O)=O,16,2,0,2,26,9.8e-05
G5,C(CC(C1CC(C(CO)O1)=O)O)=O,8,1,0,1,2,4.9e-05
G5,C(CC1(CC(C=O)OC1CO)O)=O,8,1,0,1,2,4.9e-05
G5,C1(C(C(C)O)C(C=O)OC1CO)=O,16,2,0,2,2,9.8e-05
G5,C(CC(C1C(CC(CO1)O)=O)O)=O,8,1,0,1,37,4.9e-05
G5,C(CC1(CC(COC1C=O)O)O)=O,8,1,0,1,37,4.9e-05
G5,C(C1C(C(C(C)O)C(CO1)O)=O)=O,16,2,0,2,37,9.8e-05
G5,C(CC(C1CC(C(CO1)O)=O)O)=O,8,1,0,1,37,4.9e-05
G5,C(CC1(CC(C=O)OCC1O)O)=O,8,1,0,1,37,4.9e-05
G5,C1(C(C(C)O)C(C=O)OCC1O)=O,16,2,0,2,37,9.8e-05
G5,C(CC(C1C(C(CCO1)=O)O)O)=O,8,1,0,1,37,4.9e-05
G5,C(CC1(C(C(C=O)OCC1)O)O)=O,8,1,0,1,37,4.9e-05
G5,C1(C(C(C=O)OCC1C(C)O)O)=O,16,2,0,2,37,9.8e-05
G5,C(CC(C1C(CC(CO1)=O)O)O)=O,8,1,0,1,37,4.9e-05
G5,C(CC1(COC(C=O)C(C1)O)O)=O,8,1,0,1,37,4.9e-05
G5,C(C1C(C(C(CO1)=O)C(C)O)O)=O,16,2,0,2,37,9.8e-05
G5,C1(C(C(C)O)OC(C=O)C(C1)O)=O,16,2,0,2,37,9.8e-05
G5,C1(C(C(CO)OCC1)(CC=O)O)=O,4,1,0,1,2,4.9e-05
G5,C1(C(CCOC1CO)(CC=O)O)=O,4,1,0,1,2,4.9e-05
G5,C1(C(C(CO)OCC1C(C)O)=O)=O,8,2,0,2,2,9.8e-05
G5,C(C)(C1CC(C(O1)=O)(CC=O)O)=O,4,1,0,1,27,4.9e-05
G5,C(CC(C)(C1CC(C(O1)=O)=O)O)=O,4,1,0,1,27,4.9e-05
G5,C(C1C(C(C(O1)=O)=O)C(C)O)(C)=O,8,2,0,2,27,9.8e-05
G5,C(C1CC(C(O1)=O)=O)(CC(C)O)=O,4,1,0,1,27,4.9e-05
G5,C1(C(CC(CC=O)O1)(CC=O)O)=O,4,1,0,1,27,4.9e-05
G5,C(CC(CC1CC(C(O1)=O)=O)O)=O,4,1,0,1,27,4.9e-05
G5,C(CC1C(C(C(O1)=O)=O)C(C)O)=O,8,2,0,2,27,9.8e-05
G5,C(C(C1CC(C(O1)=O)=O)C(C)O)=O,8,2,0,2,27,9.8e-05
G5,C1(CC(C(C(C)=O)O1)(CC=O)O)=O,4,1,0,1,27,4.9e-05
G5,C(CC(C)(C1C(CC(O1)=O)=O)O)=O,4,3,0,3,28,0.000144
G5,C1(C(C(C(C(C)=O)O1)=O)C(C)O)=O,8,2,0,2,27,9.8e-05
G5,C1(CC(C(C(CC(C)O)=O)O1)=O)=O,4,1,0,1,27,4.9e-05
G5,C1(CC(C(CC=O)O1)(CC=O)O)=O,4,1,0,1,27,4.9e-05
G5,C(CC(CC1C(CC(O1)=O)=O)O)=O,4,1,0,1,27,4.9e-05
G5,C(CC1C(C(C(O1)=O)C(C)O)=O)=O,8,2,0,2,27,9.8e-05
G5,C(C(C(C)O)C1C(CC(O1)=O)=O)=O,8,2,0,2,27,9.8e-05
G5,C1(CC(C(OCC1)=O)(CC=O)O)=O,2,1,0,1,27,4.9e-05
G5,C(CC1(CCOC(C(C1)=O)=O)O)=O,2,1,0,1,27,4.9e-05
G5,C1(CCOC(C(C1C(C)O)=O)=O)=O,4,2,0,2,27,9.8e-05
G5,C1(C(COC(C(C1)=O)=O)C(C)O)=O,4,2,0,2,27,9.8e-05
G5,C1(C(CCC(CO1)=O)(CC=O)O)=O,2,1,0,1,27,4.9e-05
G5,C(CC1(COC(C(CC1)=O)=O)O)=O,2,1,0,1,27,4.9e-05
G5,C1(CC(C(C(OC1)=O)=O)C(C)O)=O,4,1,0,1,27,4.9e-05
G5,C1(COC(C(CC1C(C)O)=O)=O)=O,4,1,0,1,27,4.9e-05
G5,C1(CCC(C(OC1C(C)O)=O)=O)=O,4,2,0,2,27,9.8e-05
G5,C1(CC(C(CCO1)=O)(CC=O)O)=O,2,1,0,1,27,4.9e-05
G5,C1(C(CCOC(C1)=O)(CC=O)O)=O,2,1,0,1,27,4.9e-05
G5,C1(C(C(C(CCO1)=O)=O)C(C)O)=O,4,2,0,2,27,9.8e-05
G5,C1(CC(C(C(CO1)C(C)O)=O)=O)=O,4,2,0,2,27,9.8e-05
G5,C1(CC(CC=O)(CC(CO1)=O)O)=O,2,1,0,1,27,4.9e-05
G5,C1(CC(CC(CO1)(CC=O)O)=O)=O,2,1,0,1,27,4.9e-05
G5,C1(C(C(CC(CO1)=O)=O)C(C)O)=O,4,2,0,2,27,9.8e-05
G5,C1(CC(OCC(C1C(C)O)=O)=O)=O,4,2,0,2,27,9.8e-05
G5,C1(CC(CC(C(C(C)O)O1)=O)=O)=O,4,2,0,2,27,9.8e-05
G5,C(CC1(C=C(C(C1)=O)CO)O)=O,2,3,0,3,29,0.000144
G5,C(CC1(C(CO)=CC(C1)=O)O)=O,2,4,0,4,29,0.00019099999999999998
G5,C1(C=C(C(C1C(C)O)=O)CO)=O,4,5,0,5,45,0.00023999999999999998
G5,C(CC1(C(C(CO)=CC1)=O)O)=O,2,2,0,2,4,9.6e-05
G5,C1(CC=C(CO)C1(CC=O)O)=O,2,4,0,4,29,0.00019099999999999998
G5,C1C(C(C(C=1CO)=O)=O)C(C)O,4,2,0,2,4,9.6e-05
G5,C(CC1(C(C(C(C1)O)=O)=C)O)=O,4,2,0,2,30,9.6e-05
G5,C(CC1(C(C(CC1O)=O)=C)O)=O,4,3,0,3,29,0.000144
G5,C=C1C(C(C(C)O)C(C1=O)O)=O,8,3,0,3,45,0.000145
G5,C(CC1(C(C(C(C1)=C)=O)O)O)=O,4,2,0,2,47,9.6e-05
G5,C(CC1(C(CC(C1O)=O)=C)O)=O,4,3,0,3,29,0.000144
G5,C1(C(C(C(C1C(C)O)=C)=O)O)=O,8,2,0,2,4,9.6e-05
G5,C(CC1(C(C(C(C1)=O)=C)O)O)=O,4,2,0,2,23,9.6e-05
G5,C(CC1(C(C(C(C1)=O)O)=C)O)=O,4,3,0,3,47,0.000144
G5,C1(C(C(C(C1C(C)O)=O)=C)O)=O,8,4,0,4,45,0.000192
G5,C(CC1(C(C(C(C1)O)=C)=O)O)=O,4,2,0,2,4,9.6e-05
G5,C(CC1(C(CC(C1=C)O)=O)O)=O,4,4,0,4,29,0.00019099999999999998
G5,C=C1C(C(C(C(C)O)C1O)=O)=O,8,3,0,3,45,0.000145
G5,C(CC1(C=C(C=O)C(C1)O)O)=O,4,3,0,3,29,0.000144
G5,C(CC(C1C(CC(C=1)=O)O)O)=O,4,4,0,4,29,0.00019099999999999998
G5,C1(C=C(C=O)C(C1C(C)O)O)=O,8,4,0,4,45,0.000192
G5,C(CC1(C(C(C=O)=CC1)O)O)=O,4,3,0,3,29,0.000144
G5,C1(C(C(C(CC=O)O)=CC1)O)=O,4,4,0,4,29,0.00019099999999999998
G5,C1(C(C(C=O)=CC1C(C)O)O)=O,8,3,0,3,29,0.000144
G5,C(CC1(C(C=C(C=O)C1)O)O)=O,4,3,0,3,29,0.000144
G5,C1(C(C=C(C(CC=O)O)C1)O)=O,4,4,0,4,29,0.00019099999999999998
G5,C1(C(C=C(C=O)C1C(C)O)O)=O,8,3,0,3,29,0.000144
G5,C(CC1(C(C=O)=CC(C1)O)O)=O,4,2,0,2,4,9.6e-05
G5,C(CC(C1C(CC(C=1)O)=O)O)=O,4,3,0,3,29,0.000144
G5,C1C(C(C(C=1C=O)=O)C(C)O)O,8,3,0,3,45,0.000145
G5,C(CC(C=CC(O)=O)(CCO)O)=O,4,1,0,1,46,4.9e-05
G5,C(C=CC(C(CO)C(C)O)=O)(O)=O,8,2,0,2,46,9.8e-05
G5,C(CC(CO)(CC=CC(O)=O)O)=O,4,1,0,1,12,4.9e-05
G5,C(CO)(C(C=CC(O)=O)C(C)O)=O,8,1,0,1,12,4.9e-05
G5,C(C(C(C)O)O)(CC=CC(O)=O)=O,8,2,0,2,12,9.8e-05
G5,C(CC(C)(C(C=CC(O)=O)O)O)=O,8,1,0,1,45,4.9e-05
G5,C(CC(C)O)(C(C=CC(O)=O)O)=O,8,1,0,1,45,4.9e-05
G5,C(CC(CC(C=CC(O)=O)O)O)=O,8,1,0,1,18,4.9e-05
G5,C(C(C(C)O)C(C=CC(O)=O)O)=O,16,5,0,5,18,0.000252
G5,C(CC(C(CC(C=C)O)=O)O)=O,4,5,0,5,4,0.000239
G5,C(C(CC(C=C)O)(CC=O)O)=O,4,2,0,2,4,9.6e-05
G5,C=CC(C(C(C=O)=O)C(C)O)O,8,6,0,6,4,0.000288
G5,C(CC(CC(C(C=C)O)=O)O)=O,4,5,0,5,29,0.000239
G5,C(CC(C(C=C)O)(CC=O)O)=O,2,3,0,3,29,0.000144
G5,C(C(C(C(C=C)O)=O)C(C)O)=O,8,6,0,6,27,0.00028700000000000004
G5,C(CC(C(C(CC=C)=O)O)O)=O,4,6,0,6,28,0.00028700000000000004
G5,C(CC(C(C=O)O)(CC=C)O)=O,4,3,0,3,29,0.000144
G5,C(C(C=O)O)(C(C=C)C(C)O)=O,8,3,0,3,4,0.000144
G5,C(CC(C(CC(C=C)=O)O)O)=O,4,3,0,3,4,0.000144
G5,C(C(CC(C=C)(CC=O)O)O)=O,4,2,0,2,29,9.6e-05
G5,C(C(C(C(C=C)=O)C(C)O)O)=O,8,3,0,3,27,0.000145
G5,C1(C(C=CC1C(CC=O)O)O)=O,8,3,0,3,29,0.000144
G5,C1(CC=CC1(C(CC=O)O)O)=O,4,3,0,3,29,0.000144
G5,C(C1(C=CCC1(CC=O)O)O)=O,4,2,0,2,44,9.6e-05
G5,C(C1(C(C(C=C1)C(C)O)=O)O)=O,8,2,0,2,4,9.6e-05
G5,C(CC(C)(C1C=CC(O1)=O)O)=O,4,2,0,2,48,9.6e-05
G5,C(CC(C)O)(C1C=CC(O1)=O)=O,4,2,0,2,4,9.6e-05
G5,C(CC(CC1C=CC(O1)=O)O)=O,4,2,0,2,48,9.6e-05
G5,C(C(C(C)O)C1C=CC(O1)=O)=O,8,3,0,3,48,0.000145
G5,C(CC1(C=COC1C(C)=O)O)=O,4,3,0,3,29,0.000144
G5,C(CC(C)(C1C(C=CO1)=O)O)=O,4,4,0,4,28,0.000192
G5,C(CC(C)O)(C1C(C=CO1)=O)=O,4,2,0,2,9,9.6e-05
G5,C(CC1C(C=CO1)(CC=O)O)=O,4,3,0,3,29,0.000144
G5,C(CC(CC1C(C=CO1)=O)O)=O,4,2,0,2,13,9.6e-05
G5,C(C(C(C)O)C1C(C=CO1)=O)=O,8,3,0,3,45,0.000145
G5,C(CC1(C=CC(OCC1)=O)O)=O,2,2,0,2,19,9.6e-05
G5,C1(C=CC(C(CO1)C(C)O)=O)=O,4,3,0,3,19,0.000145
G5,C(CC1(COC(C=CC1)=O)O)=O,2,2,0,2,48,9.6e-05
G5,C1(COC(C=CC1C(C)O)=O)=O,4,2,0,2,4,9.6e-05
G5,C1(C(C(C)O)OC(C=CC1)=O)=O,4,3,0,3,48,0.000145
G5,C1(CCOC=CC1(CC=O)O)=O,2,3,0,3,4,0.000144
G5,C(CC1(C(C=COCC1)=O)O)=O,2,2,0,2,53,9.6e-05
G5,C1OCC(C(C(C=1)=O)=O)C(C)O,4,3,0,3,45,0.000145
G5,C(CC1(C=COCC(C1)=O)O)=O,2,3,0,3,29,0.000144
G5,C(CC1(COC=CC(C1)=O)O)=O,2,2,0,2,26,9.6e-05
G5,C1(COC=CC(C1C(C)O)=O)=O,4,4,0,4,38,0.000192
G5,C1(C(C(C)O)OC=CC(C1)=O)=O,4,3,0,3,38,0.000145
G5,C1(CC(C=CCO1)(CC=O)O)=O,2,3,0,3,29,0.000144
G5,C1(C(C(C=CCO1)=O)C(C)O)=O,4,4,0,4,19,0.000192
G5,C(CC1(C(C=CCOC1)=O)O)=O,2,2,0,2,4,9.6e-05
G5,C(CC1(C(COCC=C1)=O)O)=O,2,3,0,3,19,0.000144
G5,C1COC(C(C(C=1)=O)=O)C(C)O,4,3,0,3,36,0.000145
G5,C1(CC=CC(CO1)(CC=O)O)=O,2,3,0,3,29,0.000144
G5,C1(CC=CC(C(C(C)O)O1)=O)=O,4,4,0,4,48,0.000192
G5,C(CC1(C=CC(COC1)=O)O)=O,2,4,0,4,29,0.00019099999999999998
G5,C1(C=CC(COC1C(C)O)=O)=O,4,5,0,5,45,0.00023999999999999998
G5,C(CC(C=C1C(CCO1)=O)O)=O,4,3,0,3,29,0.000144
G5,C(CC1(C(OCC1)=CC=O)O)=O,4,2,0,2,53,9.6e-05
G5,C(C=C1C(C(CO1)C(C)O)=O)=O,8,3,0,3,45,0.000145
G5,C(CC(C=C1CC(CO1)=O)O)=O,4,3,0,3,29,0.000144
G5,C(CC1(COC(C1)=CC=O)O)=O,4,2,0,2,26,9.6e-05
G5,C1(COC(C1C(C)O)=CC=O)=O,8,3,0,3,45,0.000145
G5,C1(C(C(C)O)OC(C1)=CC=O)=O,8,3,0,3,45,0.000145
G5,C(CC(C(C1C=CCO1)=O)O)=O,4,3,0,3,39,0.000144
G5,C(CC(C=O)(C1C=CCO1)O)=O,4,2,0,2,4,9.6e-05
G5,C(CC(C1C=CC(C=O)O1)O)=O,8,4,0,4,40,0.00019099999999999998
G5,C(CC(C1C(CC(O1)=C)=O)O)=O,4,3,0,3,29,0.000144
G5,C(CC1(C(C=O)OC(C1)=C)O)=O,4,2,0,2,4,9.6e-05
G5,C1(C(C=O)OC(C1C(C)O)=C)=O,8,3,0,3,26,0.000145
G5,C(CC(C1CC(C(O1)=C)=O)O)=O,4,3,0,3,26,0.000144
G5,C(C1CC(C(O1)=C)(CC=O)O)=O,4,2,0,2,21,9.6e-05
G5,C(C1C(C(C(O1)=C)=O)C(C)O)=O,8,3,0,3,14,0.000145
G5,C(CC(C1OCCC(C=1)=O)O)=O,2,3,0,3,30,0.000144
G5,C(CC1(C=C(C=O)OCC1)O)=O,2,2,0,2,30,9.6e-05
G5,C(C1OCC(C(C=1)=O)C(C)O)=O,4,3,0,3,30,0.000145
G5,C(CC(C1OCC(CC=1)=O)O)=O,2,3,0,3,30,0.000144
G5,C(CC1(COC(C=O)=CC1)O)=O,2,2,0,2,29,9.6e-05
G5,C1(COC(C=O)=CC1C(C)O)=O,4,2,0,2,12,9.6e-05
G5,C1(C(C(C)O)OC(C=O)=CC1)=O,4,3,0,3,12,0.000145
G5,C(CC(C1C(CC=CO1)=O)O)=O,4,3,0,3,37,0.000144
G5,C(CC1(C(C=O)OC=CC1)O)=O,4,2,0,2,29,9.6e-05
G5,C1(C(C=O)OC=CC1C(C)O)=O,8,2,0,2,4,9.6e-05
G5,C(CC(C1CC(C=CO1)=O)O)=O,4,3,0,3,29,0.000144
G5,C(C1CC(C=CO1)(CC=O)O)=O,4,2,0,2,4,9.6e-05
G5,C(C1C(C(C=CO1)=O)C(C)O)=O,8,3,0,3,37,0.000145
G5,C(CC1(CC2C(CC1(O)O2)O)O)=O,16,2,0,2,14,9.6e-05
G5,C1(C2(CC(C(C1C(C)O)O2)O)O)=O,32,3,0,3,14,0.000145
G5,C(CC1(C2CC(C(C1O)O2)O)O)=O,32,1,0,1,9,4.9e-05
G5,C(CC1(C2C(C(C(O)O2)C1)O)O)=O,32,3,0,3,44,0.000144
G5,C1(C2C(C(C(O2)O)C1C(C)O)O)=O,64,3,0,3,4,0.000144
G5,C(CC1(COC(C(CO)=O)C1)O)=O,4,1,0,1,32,4.9e-05
G5,C(CC(CO)(C1CC(CO1)=O)O)=O,4,1,0,1,32,4.9e-05
G5,C1(CC(C(CO)=O)OC1C(C)O)=O,8,2,0,2,32,9.8e-05
G5,C1(COC(C(CO)=O)C1C(C)O)=O,8,2,0,2,32,9.8e-05
G5,C1(CC(C(C(C(C)O)O)=O)OC1)=O,8,2,0,2,32,9.8e-05
G5,C(CC1(COC(C(C)=O)(C1)O)O)=O,4,2,0,2,14,9.6e-05
G5,C(CC(C)(C1(CC(CO1)=O)O)O)=O,4,2,0,2,21,9.6e-05
G5,C1(CC(C(C)=O)(OC1C(C)O)O)=O,8,3,0,3,24,0.000145
G5,C1(COC(C(C)=O)(C1C(C)O)O)=O,8,3,0,3,24,0.000145
G5,C1(CC(C(CC(C)O)=O)(OC1)O)=O,4,2,0,2,4,9.6e-05
G5,C1(CCC(C(CO)(CC=O)O)O1)=O,4,1,0,1,32,4.9e-05
G5,C1(CCC(C(C(C(C)O)O)=O)O1)=O,8,2,0,2,32,9.8e-05
G5,C1(C(COC1CCO)(CC=O)O)=O,4,1,0,1,4,4.9e-05
G5,C1(COC(CCO)C1(CC=O)O)=O,4,1,0,1,4,4.9e-05
G5,C1(C(C(C(C)O)OC1CCO)=O)=O,8,2,0,2,4,9.8e-05
G5,C1(CC(C(CCO)O1)(CC=O)O)=O,4,1,0,1,2,4.9e-05
G5,C1(C(C(C(CCO)O1)=O)C(C)O)=O,8,2,0,2,2,9.8e-05
G5,C(CC(C(C1C(CCO1)O)=O)O)=O,8,1,0,1,39,4.9e-05
G5,C(C(C1C(CCO1)O)(CC=O)O)=O,8,1,0,1,39,4.9e-05
G5,C(CC(C(C1C(CCO1)=O)O)O)=O,8,1,0,1,4,4.9e-05
G5,C(CC1(C(C(C=O)O)OCC1)O)=O,8,1,0,1,4,4.9e-05
G5,C(C(C1C(C(CO1)C(C)O)=O)O)=O,16,2,0,2,4,9.8e-05
G5,C(CC(C(C1CC(CO1)=O)O)O)=O,8,1,0,1,4,4.9e-05
G5,C(CC1(COC(C1)C(C=O)O)O)=O,8,1,0,1,4,4.9e-05
G5,C(C(C1C(C(CO1)=O)C(C)O)O)=O,16,2,0,2,4,9.8e-05
G5,C(C(C1CC(C(C(C)O)O1)=O)O)=O,16,2,0,2,4,9.8e-05
G5,C1(CCC(C(C(CC=O)O)O)O1)=O,8,1,0,1,32,4.9e-05
G5,C(CC1(C2C(CO)OC1CO2)O)=O,16,1,0,1,17,4.9e-05
G5,C(CC1(COC2C1OC(C2)O)O)=O,16,2,0,2,4,9.6e-05
G5,C1(C2C(CC(O2)O)OC1C(C)O)=O,32,3,0,3,9,0.000145
G5,C(CC1(C2CC(O)OC1CO2)O)=O,16,2,0,2,9,9.6e-05
G5,C(CC1(COC2COC1(C2)O)O)=O,8,2,0,2,54,9.6e-05
G5,C1(C2(CC(CO2)OC1C(C)O)O)=O,16,3,0,3,54,0.000145
G5,C(CC1(C(O)OC2COC1C2)O)=O,16,2,0,2,39,9.6e-05
G5,C(CC1(C2COCC(C1O)O2)O)=O,16,1,0,1,4,4.9e-05
G5,C(CC1(CC2COCC1(O)O2)O)=O,8,2,0,2,36,9.6e-05
G5,C1(C2(COCC(C1C(C)O)O2)O)=O,16,3,0,3,36,0.000145
G5,C(CC1(CC2(COCC1O2)O)O)=O,8,2,0,2,36,9.6e-05
G5,C1(C2COCC(C1C(C)O)(O2)O)=O,16,3,0,3,36,0.000145
G5,C(CC1(COC2C(CC1O2)O)O)=O,16,1,0,1,4,4.9e-05
G5,C1(C(C(C)O)OC2C(CC1O2)O)=O,32,2,0,2,4,9.8e-05
G5,C(CC1(C2OC(C1)(CCO2)O)O)=O,8,2,0,2,23,9.6e-05
G5,C1(C2OC(CCO2)(C1C(C)O)O)=O,16,3,0,3,30,0.000145
G5,C(CC1(CC2OC1(CCO2)O)O)=O,8,2,0,2,4,9.6e-05
G5,C1(C2(CCOC(C1C(C)O)O2)O)=O,16,3,0,3,17,0.000145
G5,C(CC1(C2CCOC(C1O)O2)O)=O,16,1,0,1,4,4.9e-05
G5,C(CC1(COC(C=O)CC1O)O)=O,8,1,0,1,4,4.9e-05
G5,C(CC(C1CC(C(CO1)=O)O)O)=O,8,1,0,1,4,4.9e-05
G5,C(C1CC(C(C(C(C)O)O1)=O)O)=O,16,2,0,2,4,9.8e-05
G5,C1(CCC(C(C(CC=O)O)O1)O)=O,8,1,0,1,37,4.9e-05
G5,C1(CC(CC(C(CC=O)O)O1)O)=O,8,1,0,1,48,4.9e-05
G5,C(CC1(C(OC(C=O)CC1)O)O)=O,8,2,0,2,12,9.6e-05
G5,C(CC(C1CCC(C(O)O1)=O)O)=O,8,2,0,2,12,9.6e-05
G5,C(C1CC(C(C(O1)O)=O)C(C)O)=O,16,2,0,2,12,9.6e-05
G5,C1(C(COC(C)(C1)O)(CC=O)O)=O,4,2,0,2,26,9.6e-05
G5,C1(COC(C)(CC1(CC=O)O)O)=O,4,2,0,2,26,9.6e-05
G5,C1(C(C(C(C)O)OC(C)(C1)O)=O)=O,8,3,0,3,26,0.000145
G5,C1(C(COC(C)(C1C(C)O)O)=O)=O,8,3,0,3,26,0.000145
G5,C(CC1(COC(C(C1)=O)(C)O)O)=O,4,2,0,2,14,9.6e-05
G5,C(CC1(C(C)(OCC(C1)=O)O)O)=O,4,2,0,2,24,9.6e-05
G5,C1(C(C(C)O)OC(C(C1)=O)(C)O)=O,8,3,0,3,24,0.000145
G5,C1(C(C)(OCC(C1C(C)O)=O)O)=O,8,3,0,3,24,0.000145
G5,C(CC1(COC(C(C1O)=O)C)O)=O,8,1,0,1,24,4.9e-05
G5,C(CC1(C(C)OCC(C1O)=O)O)=O,8,1,0,1,24,4.9e-05
G5,C1(C(C(C)O)OC(C(C1O)=O)C)=O,16,2,0,2,24,9.8e-05
G5,C1(CC(C(C(C)O1)(CC=O)O)O)=O,8,1,0,1,24,4.9e-05
G5,C(CC1(C(OC(C(C1)=O)C)O)O)=O,8,2,0,2,4,9.6e-05
G5,C(CC1(C(C)OC(C(C1)=O)O)O)=O,8,2,0,2,45,9.6e-05
G5,C1(C(C)OC(C(C1C(C)O)=O)O)=O,16,3,0,3,24,0.000145
G5,C1(C(CC(OC1C)O)(CC=O)O)=O,8,2,0,2,4,9.6e-05
G5,C1(C(C(C)OC(C1C(C)O)O)=O)=O,16,3,0,3,4,0.000145
G5,C(CC1(COC(C)(C(C1)O)O)O)=O,8,2,0,2,29,9.6e-05
G5,C1(C(C(C)O)OC(C(C1)O)(C)O)=O,16,3,0,3,45,0.000145
G5,C1(COC(C)(C(C1C(C)O)O)O)=O,16,3,0,3,45,0.000145
G5,C(CC1(CCOC(C)(C1O)O)O)=O,8,2,0,2,49,9.6e-05
G5,C1(C(C(C)(O)OCC1C(C)O)O)=O,16,3,0,3,9,0.000145
G5,C(CC1(CC(C)(O)OCC1O)O)=O,8,2,0,2,27,9.6e-05
G5,C1(C(COC(C)(C1C(C)O)O)O)=O,16,3,0,3,26,0.000145
G5,C(CC1(CC(COC1(C)O)O)O)=O,8,2,0,2,29,9.6e-05
G5,C1(C(C)(O)OCC(C1C(C)O)O)=O,16,3,0,3,14,0.000145
G5,C(CC1(C(C)OCC(C1O)O)O)=O,16,1,0,1,4,4.9e-05
G5,C(CC1(C2C(COC1CO2)O)O)=O,16,1,0,1,17,4.9e-05
G5,C(CC1(C2COC(CO2)C1O)O)=O,16,1,0,1,4,4.9e-05
G5,C(CC1(CC2COC1(CO2)O)O)=O,8,2,0,2,54,9.6e-05
G5,C1(C2(COC(CO2)C1C(C)O)O)=O,16,3,0,3,54,0.000145
G5,C(CC1(CC2(COC1CO2)O)O)=O,8,2,0,2,54,9.6e-05
G5,C1(C2COC(CO2)(C1C(C)O)O)=O,16,3,0,3,54,0.000145
G5,C1(C(COC(CC1)O)(CC=O)O)=O,4,2,0,2,17,9.6e-05
G5,C1(COC(CCC1(CC=O)O)O)=O,4,2,0,2,27,9.6e-05
G5,C1(C(C(C(C)O)OC(CC1)O)=O)=O,8,3,0,3,17,0.000145
G5,C1(C(COC(CC1C(C)O)O)=O)=O,8,2,0,2,4,9.6e-05
G5,C(CC1(COC(CC(C1)O)O)O)=O,8,2,0,2,4,9.6e-05
G5,C1(C(C(C)O)OC(CC(C1)O)O)=O,16,3,0,3,17,0.000145
G5,C1(COC(CC(C1C(C)O)O)O)=O,16,3,0,3,17,0.000145
G5,C(CC1(CCOC(CC1O)O)O)=O,8,2,0,2,4,9.6e-05
G5,C1(C(CC(O)OCC1C(C)O)O)=O,16,3,0,3,4,0.000145
G5,C(CC1(CCC(O)OCC1O)O)=O,8,2,0,2,29,9.6e-05
G5,C1(C(COC(CC1C(C)O)O)O)=O,16,2,0,2,46,9.6e-05
G5,C(CC1(CC(COC(C1)O)O)O)=O,8,2,0,2,44,9.6e-05
G5,C1(CC(O)OCC(C1C(C)O)O)=O,16,3,0,3,44,0.000145
G5,C1(CC(COC(C1C(C)O)O)O)=O,16,3,0,3,44,0.000145
G5,C(CC1(COCCC(C1O)O)O)=O,8,1,0,1,4,4.9e-05
G5,C1(C(C(C)O)OCCC(C1O)O)=O,16,2,0,2,4,9.7e-05
G5,C(CC1(C(O)OCCC(C1)O)O)=O,8,2,0,2,4,9.6e-05
G5,C1(C(O)OCCC(C1C(C)O)O)=O,16,3,0,3,4,0.000145
G5,C(CC1(CC(O)OCCC1O)O)=O,8,2,0,2,4,9.6e-05
G5,C1(C(CCOC(C1C(C)O)O)O)=O,16,3,0,3,4,0.000145
G5,C(CC1(CCCOC(C1O)O)O)=O,8,2,0,2,29,9.6e-05
G5,C1(C(C(O)OCCC1C(C)O)O)=O,16,2,0,2,4,9.6e-05
G5,C(CC1(CC(C(O)OCC1)O)O)=O,8,2,0,2,29,9.6e-05
G5,C1(CCOC(C(C1C(C)O)O)O)=O,16,3,0,3,29,0.000145
G5,C1(CC(C(O)OCC1C(C)O)O)=O,16,3,0,3,29,0.000145
G5,C(CC1(C2OC(C1)CC(O)O2)O)=O,16,2,0,2,23,9.6e-05
G5,C1(C2OC(CC(O2)O)C1C(C)O)=O,32,3,0,3,23,0.000145
G5,C(CC1(C2CC(O)OC(C1)O2)O)=O,16,2,0,2,17,9.6e-05
G5,C1(C2CC(O)OC(C1C(C)O)O2)=O,32,3,0,3,17,0.000145
G5,C(CC1(COC2CC(C1O2)O)O)=O,16,1,0,1,17,4.9e-05
G5,C1(C(C(C)O)OC2CC(C1O2)O)=O,32,2,0,2,17,9.8e-05
G5,C(CC(C1C(CCC(O1)=O)=O)O)=O,4,3,0,3,7,0.000145
G5,C1(CCC(C(C=O)O1)(CC=O)O)=O,4,1,0,1,27,4.9e-05
G5,C1(C(C(C)O)CC(OC1C=O)=O)=O,8,1,0,1,27,4.9e-05
G5,C1(CC(CC(C(CC=O)O)O1)=O)=O,4,1,0,1,27,4.9e-05
G5,C1(CC(CC(C=O)O1)(CC=O)O)=O,4,1,0,1,27,4.9e-05
G5,C1(C(C(C)O)C(C=O)OC(C1)=O)=O,8,2,0,2,27,9.8e-05
G5,C1(CC(C=O)OC(C1C(C)O)=O)=O,8,2,0,2,27,9.8e-05
G5,C(CC1(C=C(CO)C(C1O)O)O)=O,8,1,0,1,46,4.9e-05
G5,C(CC(C1CC(C(C=1)=O)O)O)=O,4,2,0,2,22,9.6e-05
G5,C(CC1(C=C(C=O)CC1O)O)=O,4,2,0,2,22,9.6e-05
G5,C1(C(C=CC1CO)(CC=O)O)=O,4,2,0,2,4,9.6e-05
G5,C(CC1(C(C=CC1CO)=O)O)=O,4,2,0,2,4,9.6e-05
G5,C(CC(C1C(C(CC=1)O)=O)O)=O,4,2,0,2,13,9.6e-05
G5,C(CC1(C(C=O)=CCC1O)O)=O,4,2,0,2,13,9.6e-05
G5,C(CC(CO)(C(C(C=O)=C)O)O)=O,4,1,0,1,2,4.9e-05
G5,C(CC(C(C(C(CO)=O)O)=C)O)=O,4,1,0,1,2,4.9e-05
G5,C(C(C(C)O)O)(C(C(C=O)=C)O)=O,8,2,0,2,2,9.8e-05
G5,C(CC(C(C=C(CO)CO)=O)O)=O,2,1,0,1,55,4.9e-05
G5,C(C(C=C(CO)CO)(CC=O)O)=O,2,1,0,1,55,4.9e-05
G5,C(CC(CO)(C(C(CO)=C)O)O)=O,4,1,0,1,49,4.9e-05
G5,C(C(C(C)O)O)(C(C(CO)=C)O)=O,8,2,0,2,49,9.8e-05
G5,C(CC(C=C(CO)CO)(CO)O)=O,2,1,0,1,49,4.9e-05
G5,C(CO)(CO)=CC(C(C(C)O)O)=O,4,2,0,2,49,9.8e-05
G5,C(CC(CO)(C(C=C)O)O)=O,4,2,0,2,4,9.6e-05
G5,C(C(C(C)O)O)(C(C=C)O)=O,8,4,0,4,31,0.000192
G5,C(CC(C=C(CO)CO)O)=O,2,2,0,2,4,9.6e-05
G5,C(CC(C=CC(CO)O)O)=O,8,2,0,2,29,9.6e-05
G5,C(CC(C(C=C(C=O)C)=O)O)=O,4,2,0,2,4,9.6e-05
G5,C(C(C=C(C=O)C)(CC=O)O)=O,4,2,0,2,4,9.6e-05
G5,C(CC(C(C)=CC(C=O)=O)O)=O,4,2,0,2,4,9.6e-05
G5,C(CC(C(CC(C=O)=C)=O)O)=O,2,2,0,2,4,9.6e-05
G5,C(CC(C=O)(CC(C=O)=C)O)=O,2,2,0,2,4,9.6e-05
G5,C(CC(C(CC(C=O)=O)=C)O)=O,2,2,0,2,4,9.6e-05
G5,C=C(C=O)C(C(C=O)=O)C(C)O,4,2,0,2,4,9.6e-05
G5,C(CC(C(C=CC=O)=O)O)=O,4,3,0,3,20,0.000144
G5,C(C(C=CC=O)(CC=O)O)=O,4,3,0,3,43,0.000144
G5,C(C(C=CC(C(CC=O)O)=O)O)=O,8,1,0,1,12,4.9e-05
G5,C(C(C=CC(C=O)O)(CC=O)O)=O,8,1,0,1,12,4.9e-05
G5,C(CC(C(C=CC(C=O)=O)O)O)=O,8,1,0,1,12,4.9e-05
G5,C(CC(C(C=C(C)CO)=O)O)=O,4,2,0,2,49,9.6e-05
G5,C(C(C=C(CO)C)(CC=O)O)=O,4,2,0,2,4,9.6e-05
G5,C(CC(C(CC(CO)=C)=O)O)=O,2,2,0,2,49,9.6e-05
G5,C(CC(C=O)(CC(CO)=C)O)=O,2,2,0,2,4,9.6e-05
G5,C=C(CO)C(C(C=O)=O)C(C)O,4,2,0,2,49,9.6e-05
G5,C(CC(C(CC(CO)=O)=C)O)=O,2,2,0,2,4,9.6e-05
G5,C(CC(CO)(CC(C=O)=C)O)=O,2,2,0,2,4,9.6e-05
G5,C(CO)(C(C(C=O)=C)C(C)O)=O,4,2,0,2,45,9.6e-05
G5,C(C(C(C)O)O)(CC(C=O)=C)=O,4,3,0,3,16,0.000145
G5,C(CC(C(C)=CC(CO)=O)O)=O,4,2,0,2,4,9.6e-05
G5,C(CC(C=C(C=O)C)(CO)O)=O,4,2,0,2,4,9.6e-05
G5,C(C=C(C=O)C)(C(C(C)O)O)=O,8,3,0,3,16,0.000145
G5,C(CC(C(C(C(C)=O)O)=C)O)=O,4,2,0,2,45,9.6e-05
G5,C(CC(C)(C(C(C=O)=C)O)O)=O,4,3,0,3,45,0.000144
G5,C(CC(C)O)(C(C(C=O)=C)O)=O,4,3,0,3,29,0.000144
G5,C(CC(C(C=CC)=O)O)=O,4,2,0,2,4,9.6e-05
G5,C(C(C=CC)(CC=O)O)=O,4,2,0,2,4,9.6e-05
G5,C(CC(C(CC=C)=O)O)=O,2,2,0,2,4,9.6e-05
G5,C(CC(C=O)(CC=C)O)=O,2,2,0,2,4,9.6e-05
G5,C=CC(C(C=O)=O)C(C)O,4,2,0,2,4,9.6e-05
G5,C(CC(C=CC=O)(C)O)=O,4,2,0,2,45,9.6e-05
G5,C(CC(C=CC(C)=O)O)=O,4,2,0,2,45,9.6e-05
G5,C(C=CC(CC(C)O)=O)=O,4,2,0,2,4,9.6e-05
G5,C(CC(C(CC=O)O)=C)=O,2,2,0,2,45,9.6e-05
G5,C(CC(CC(C=O)=C)O)=O,2,2,0,2,18,9.6e-05
G5,C(C(C(C=O)=C)C(C)O)=O,4,2,0,2,45,9.6e-05
G5,C(CC(C(C)=CC=O)O)=O,4,2,0,2,45,9.6e-05
G5,C(CC(C=C(C=O)C)O)=O,4,2,0,2,18,9.6e-05
G5,C(CC(C(C(CO)=O)=CC=O)O)=O,4,1,0,1,55,4.9e-05
G5,C(CC(C(C=O)=CC=O)(CO)O)=O,4,1,0,1,55,4.9e-05
G5,C(CC(C=C(C=O)C(CO)=O)O)=O,4,1,0,1,55,4.9e-05
G5,C(C(C(C(C(C)O)O)=O)=CC=O)=O,8,2,0,2,55,9.8e-05
G5,C(CC(C(C(CO)=O)=C)O)=O,2,5,0,5,29,0.00025
G5,C(CC(C(C=O)=C)(CO)O)=O,2,4,0,4,29,0.000202
G5,C=C(C=O)C(C(C(C)O)O)=O,4,3,0,3,9,0.000145
G5,C(CC(C(C(CO)=O)=CC)O)=O,4,3,0,3,29,0.000155
G5,C(CC(C(C=O)=CC)(CO)O)=O,4,2,0,2,4,9.6e-05
G5,C(C)=C(C(C(C(C)O)O)=O)C=O,8,3,0,3,45,0.000145
G5,C(CC(C(C(CO)=O)C=C)O)=O,4,4,0,4,29,0.00020299999999999997
G5,C(C(C(C(C(C)O)O)=O)C=C)=O,8,3,0,3,45,0.000145
G5,C(CC(CO)=CC(CC=O)O)=O,4,3,0,3,29,0.000155
G5,C(CC(CC(CO)=CC=O)O)=O,4,3,0,3,29,0.000155
G5,C(C(C(CO)=CC=O)C(C)O)=O,8,2,0,2,4,9.6e-05
G5,C(C(C(C=CC(CC=O)O)=O)O)=O,8,1,0,1,46,4.9e-05
G5,C(CC(C=C)(C(C=O)O)O)=O,4,3,0,3,45,0.000144
G5,C(CC(C(C(C=CC)=O)O)O)=O,8,4,0,4,28,0.000192
G5,C(CC(C=CC)(C(C=O)O)O)=O,8,2,0,2,4,9.6e-05
G5,C(CC(C(C(CC=O)=C)O)O)=O,4,2,0,2,4,9.6e-05
G5,C(C(C(CC(CC=O)O)=C)O)=O,4,2,0,2,4,9.6e-05
G5,C(C(C(C(C=O)O)=C)C(C)O)=O,8,2,0,2,1,9.6e-05
G5,C(CC(C(C(C)=CC=O)O)O)=O,8,2,0,2,4,9.6e-05
G5,C(C(C(C)=CC(CC=O)O)O)=O,8,2,0,2,4,9.6e-05
G5,C(CC(C=C(C(C=O)=O)CO)O)=O,4,1,0,1,55,4.9e-05
G5,C(CC(C(C(CO)=CC=O)=O)O)=O,4,1,0,1,55,4.9e-05
G5,C(C(C(CO)=CC=O)(CC=O)O)=O,4,1,0,1,55,4.9e-05
G5,C(CC(C(C(C(C=O)=O)=C)O)O)=O,4,1,0,1,0,4.9e-05
G5,C(C(C(C(C(CC=O)O)=O)=C)O)=O,4,1,0,1,0,4.9e-05
G5,C(C(C(C(C=O)O)=C)(CC=O)O)=O,4,1,0,1,0,4.9e-05
G5,C(C(C(C=O)=CC(CC=O)O)O)=O,8,1,0,1,43,4.9e-05
G5,C(CC(C(C(C=O)=CC=O)O)O)=O,8,1,0,1,43,4.9e-05
G5,C(C(C(C(CC=O)O)=CC=O)O)=O,8,1,0,1,43,4.9e-05
G5,C(CC(C=CC)(C(CO)O)O)=O,8,2,0,2,4,9.6e-05
G5,C(CC(C(CO)O)(CC=C)O)=O,4,2,0,2,4,9.6e-05
G5,C(C(CO)O)(C(C=C)C(C)O)=O,8,2,0,2,4,9.6e-05
G5,C(CC(CC(C(CO)O)=C)O)=O,4,2,0,2,4,9.6e-05
G5,C(C(C(C(CO)O)=C)C(C)O)=O,8,2,0,2,28,9.6e-05
G5,C(CC(C=C(C)C(CO)O)O)=O,8,2,0,2,46,9.6e-05
G5,C(CC(C(C(CO)=C)=O)O)=O,2,6,0,6,29,0.000297
G5,C(CC(C(CO)=C)(CO)O)=O,2,4,0,4,29,0.000202
G5,C=C(C(C(C(C)O)O)=O)CO,4,3,0,3,49,0.000145
G5,C(CC(C(C(C=O)=C)O)O)=O,4,4,0,4,29,0.00019099999999999998
G5,C(C(C(C(CC=O)O)=C)O)=O,4,3,0,3,43,0.000144
G5,C(CC(C=C(C=O)CO)O)=O,4,4,0,4,29,0.00019099999999999998
G5,C(CC(C(CO)=CC=O)O)=O,4,3,0,3,29,0.000144
G5,C(CC(C=C)O)=O,2,6,0,6,17,0.000286
G5,C(CC(C(C(C(C)O)=C)=O)O)=O,4,2,0,2,4,9.6e-05
G5,C(C(C(C(C)O)=C)(CC=O)O)=O,4,2,0,2,4,9.6e-05
G5,C(CC(C(C(CO)=CC)=O)O)=O,4,3,0,3,29,0.000155
G5,C(C(C(CO)=CC)(CC=O)O)=O,4,2,0,2,4,9.6e-05
G5,C(CC(C(C(C=C)CO)=O)O)=O,4,3,0,3,29,0.000155
G5,C(CC(C=O)(C(C=C)CO)O)=O,4,2,0,2,4,9.6e-05
G5,C(CC(C(CC=O)O)=CCO)=O,4,3,0,3,4,0.000155
G5,C(CC(CC(C=O)=CCO)O)=O,4,3,0,3,29,0.000155
G5,C(C(C(C=O)=CCO)C(C)O)=O,8,2,0,2,3,9.6e-05
G5,C(CC(C(CCO)=CC=O)O)=O,4,3,0,3,29,0.000155
G5,C(CC(C=C(C=O)CCO)O)=O,4,3,0,3,29,0.000155
G5,C(CC(CCO)(C(C=C)O)O)=O,4,2,0,2,4,9.6e-05
G5,C(C(CO)C(C)O)(C(C=C)O)=O,8,3,0,3,27,0.000145
G5,C(CC(C(C(C)O)=C)(CO)O)=O,4,2,0,2,4,9.6e-05
G5,C=C(C(C(C(C)O)O)=O)C(C)O,8,3,0,3,4,0.000145
G5,C(CC(C(CO)=CC)(CO)O)=O,4,2,0,2,4,9.6e-05
G5,C(C)=C(C(C(C(C)O)O)=O)CO,8,3,0,3,27,0.000145
G5,C(CC(CO)(C(C=C)CO)O)=O,4,2,0,2,4,9.6e-05
G5,C(C(C(C)O)O)(C(C=C)CO)=O,8,3,0,3,28,0.000145
G5,C(CC(CC(CO)=CCO)O)=O,4,2,0,2,4,9.6e-05
G5,C(C(C(CO)=CCO)C(C)O)=O,8,2,0,2,3,9.6e-05
G5,C(CC(C=C(CO)CCO)O)=O,4,2,0,2,46,9.6e-05
G5,C(CC(C=C(CO)C)(CO)O)=O,4,2,0,2,4,9.6e-05
G5,C(CO)(C)=CC(C(C(C)O)O)=O,8,3,0,3,49,0.000145
G5,C(CC(CO)(CC(CO)=C)O)=O,2,2,0,2,4,9.6e-05
G5,C(CO)(C(C(CO)=C)C(C)O)=O,4,2,0,2,49,9.6e-05
G5,C(C(C(C)O)O)(CC(CO)=C)=O,4,3,0,3,49,0.000145
G5,C(CC(C)(C(C(CO)=C)O)O)=O,4,2,0,2,4,9.6e-05
G5,C(CC(C)O)(C(C(CO)=C)O)=O,4,2,0,2,11,9.6e-05
G5,C(CC(C=CC)(CO)O)=O,4,2,0,2,11,9.6e-05
G5,C(C)=CC(C(C(C)O)O)=O,8,3,0,3,28,0.000145
G5,C(CC(CO)(CC=C)O)=O,2,2,0,2,11,9.6e-05
G5,C(CO)(C(C=C)C(C)O)=O,4,2,0,2,4,9.6e-05
G5,C(C(C(C)O)O)(CC=C)=O,4,3,0,3,28,0.000145
G5,C(CC(C)(C(C=C)O)O)=O,4,2,0,2,4,9.6e-05
G5,C(CC(C)O)(C(C=C)O)=O,4,2,0,2,4,9.6e-05
G5,C(CC(CC(CO)=C)O)=O,2,2,0,2,18,9.6e-05
G5,C(C(C(CO)=C)C(C)O)=O,4,2,0,2,49,9.6e-05
G5,C(CC(C=C(C)CO)O)=O,4,2,0,2,18,9.6e-05
G5,C(CC(C=C(C=O)C(C)O)O)=O,8,3,0,3,29,0.000144
G5,C(CC(C(C(C)O)=CC=O)O)=O,8,3,0,3,4,0.000144
G5,C(CC(C(C(C=O)=CC)O)O)=O,8,2,0,2,43,9.6e-05
G5,C(C(C(C(CC=O)O)=CC)O)=O,8,2,0,2,4,9.6e-05
G5,C(CC(C(C=C)C(C=O)O)O)=O,8,2,0,2,4,9.6e-05
G5,C(CC(C(C=CCC=O)O)O)=O,8,2,0,2,4,9.6e-05
G5,C(C(C=CCC(CC=O)O)O)=O,8,2,0,2,4,9.6e-05
G5,C(C(C=CC(C=O)O)C(C)O)=O,16,2,0,2,43,9.6e-05
G5,C(CC(C(CC=CC=O)O)O)=O,8,2,0,2,4,9.6e-05
G5,C(CC(C=CCC(C=O)O)O)=O,8,2,0,2,4,9.6e-05
G5,C(CC(C=CC)O)=O,4,2,0,2,28,9.6e-05
G5,C(CC(CC=C)O)=O,2,2,0,2,28,9.6e-05
G5,C(C(C=C)C(C)O)=O,4,2,0,2,4,9.6e-05
G5,C(CC(C=C(CO)C(CO)O)O)=O,8,1,0,1,46,4.9e-05
G5,C(CC(C(C(CO)=CC=O)O)O)=O,8,2,0,2,29,0.00010700000000000001
G5,C(C(C(CO)=CC(CC=O)O)O)=O,8,1,0,1,29,4.9e-05
G5,C(CC(C(C(CO)=O)=CCO)O)=O,4,1,0,1,55,4.9e-05
G5,C(CC(C(C=O)=CCO)(CO)O)=O,4,1,0,1,55,4.9e-05
G5,C(CO)=C(C(C(C(C)O)O)=O)C=O,8,2,0,2,55,9.8e-05
G5,C(CC(C(C(C(C=O)O)=C)O)O)=O,8,1,0,1,29,4.9e-05
G5,C(CC(C(C(C(CO)O)=C)O)O)=O,8,1,0,1,29,4.9e-05
G5,C(CC(C(C(C=O)=CCO)O)O)=O,8,1,0,1,43,4.9e-05
G5,C(C(C(C(CC=O)O)=CCO)O)=O,8,1,0,1,43,4.9e-05
G5,C(CC(C(C(CO)=CCO)=O)O)=O,4,1,0,1,29,4.9e-05
G5,C(C(C(CO)=CCO)(CC=O)O)=O,4,1,0,1,29,4.9e-05
G5,C(CC(C(C(C(CO)O)=C)=O)O)=O,4,1,0,1,0,4.9e-05
G5,C(C(C(C(CO)O)=C)(CC=O)O)=O,4,1,0,1,0,4.9e-05
G5,C(CC(C(C(CO)=CCO)O)O)=O,8,1,0,1,29,4.9e-05
G5,C(CC(C(CO)=CCO)(CO)O)=O,4,1,0,1,2,4.9e-05
G5,C(CO)=C(C(C(C(C)O)O)=O)CO,8,2,0,2,2,9.8e-05
G5,C(CC(C(C(CO)O)=C)(CO)O)=O,4,1,0,1,0,4.9e-05
G5,C=C(C(C(C(C)O)O)=O)C(CO)O,8,2,0,2,0,9.8e-05
G5,C(CC(C(C(CO)=C)O)O)=O,4,2,0,2,4,9.6e-05
G5,C(CC(C=C(C=O)C(CO)O)O)=O,8,2,0,2,29,0.00010700000000000001
G5,C(CC(C(C(CO)O)=CC=O)O)=O,8,3,0,3,29,0.000166
G5,C(CC(C=C(C(O)=O)CCO)O)=O,4,1,0,1,46,4.9e-05
G5,C(CC(CC(C(O)=O)=CCO)O)=O,4,1,0,1,7,4.9e-05
G5,C(C(C(C(O)=O)=CCO)C(C)O)=O,8,1,0,1,7,4.9e-05
G5,C(CC(C(C=C(C(O)=O)C)O)O)=O,8,1,0,1,14,4.9e-05
G5,C(CC(C(CC(C(O)=O)=C)O)O)=O,4,1,0,1,14,4.9e-05
G5,C(CC1(C(C=CC1(CO)O)O)O)=O,8,1,0,1,2,4.9e-05
G5,C(CC(C(C(C=O)=C)(CO)O)O)=O,4,1,0,1,16,4.9e-05
G5,C(CC(C(C(C=O)(CO)O)=C)O)=O,4,1,0,1,16,4.9e-05
G5,C(CC(C(C(CO)=C)(CO)O)O)=O,4,1,0,1,49,4.9e-05
G5,C(CC(C(C=C)(CO)O)O)=O,4,2,0,2,4,9.6e-05
G5,C(C(C=O)(C(C(CC=O)O)=C)O)=O,2,1,0,1,1,4.9e-05
G5,C(C(C(C=O)=C)(C(CC=O)O)O)=O,4,2,0,2,1,9.7e-05
G5,C(CC(C(C(C)=O)(C=C)O)O)=O,4,3,0,3,4,0.000144
G5,C(C(C=C)(C(C)(CC=O)O)O)=O,4,4,0,4,29,0.000192
G5,C(C(C(CC(C)O)=O)(C=C)O)=O,4,2,0,2,4,9.6e-05
G5,C(CC(C)(C(C=C)(CO)O)O)=O,4,2,0,2,4,9.6e-05
G5,C(CC(C)O)(C(C=C)(CO)O)=O,4,2,0,2,4,9.6e-05
G5,C(CC(C(C=O)(C(CO)=C)O)O)=O,4,2,0,2,29,9.7e-05
G5,C(C(C=C)(C(CC=O)O)O)=O,4,4,0,4,29,0.000192
G5,C(CC(CO)(C(C=C)(CO)O)O)=O,4,2,0,2,7,0.00010700000000000001
G5,C(C(C(C)O)O)(C(C=C)(CO)O)=O,8,3,0,3,2,0.000145
G5,C(CC(C(C=C)(C(CO)O)O)O)=O,8,1,0,1,7,4.9e-05
G5,C(C(C(C(CC=O)O)=C)O)(O)=O,4,5,0,5,29,0.000261
G5,C(CC(C(CO)=CC(CO)=O)O)=O,4,1,0,1,46,4.9e-05
G5,C(CC(C=C(C=O)CO)(CO)O)=O,4,1,0,1,46,4.9e-05
G5,C(C=C(C=O)CO)(C(C(C)O)O)=O,8,2,0,2,46,9.8e-05
G5,C(CC1(C=C(CO)OC1CO)O)=O,4,1,0,1,2,4.9e-05
G5,C(CC(CC1OCC(C=1)=O)O)=O,2,2,0,2,26,9.6e-05
G5,C(CC1OCC(C=1)(CC=O)O)=O,2,2,0,2,26,9.6e-05
G5,C(C(C1OCC(C=1)=O)C(C)O)=O,4,3,0,3,48,0.000145
G5,C(CC1OC(C(C=1)=O)C(C)O)=O,4,3,0,3,48,0.000145
G5,C(CC(C1C(C=C(C)O1)=O)O)=O,4,2,0,2,26,9.6e-05
G5,C(CC1(C=C(C)OC1C=O)O)=O,4,2,0,2,4,9.6e-05
G5,C(CC1(C=CCOC1(CO)O)O)=O,4,1,0,1,46,4.9e-05
G5,C(CC1(C=C(CO)OCC1O)O)=O,4,1,0,1,32,4.9e-05
G5,C(CC1(C=CC(CO)(O)OC1)O)=O,4,1,0,1,32,4.9e-05
G5,C1C(CO)(OC(C(C=1)=O)C(C)O)O,8,2,0,2,32,9.8e-05
G5,C1(C(C=CC(CO)O1)(CC=O)O)=O,4,1,0,1,50,4.9e-05
G5,C(CC1(C=CC(OC1CO)=O)O)=O,4,1,0,1,2,4.9e-05
G5,C1(C(C=CC(CO1)O)(CC=O)O)=O,4,1,0,1,27,4.9e-05
G5,C1(C(C(C=CCO1)(CC=O)O)O)=O,4,1,0,1,2,4.9e-05
G5,C(CC1(C=CC(OCC1O)=O)O)=O,4,1,0,1,46,4.9e-05
G5,C1(C(C=CC(CO1)(CC=O)O)O)=O,4,1,0,1,27,4.9e-05
G5,C1(C(C=CC(C(C(C)O)O1)=O)O)=O,8,2,0,2,27,9.8e-05
G5,C(CC1(C=C(C(CO)O)OC1)O)=O,4,1,0,1,2,4.9e-05
G5,C1(C(CO)O)OC(C(C=1)=O)C(C)O,8,2,0,2,2,9.8e-05
G5,C(CC1(COC(C1O)=CCO)O)=O,8,1,0,1,2,4.9e-05
G5,C1(C(C(C)O)OC(C1O)=CCO)=O,16,2,0,2,2,9.7e-05
G5,C(CC1(COC(C=C)(C1O)O)O)=O,8,2,0,2,7,9.6e-05
G5,C1(C(C(C=C)(OC1C(C)O)O)O)=O,16,3,0,3,32,0.000145
G5,C(CC1(C(C(OC1C=C)O)O)O)=O,16,2,0,2,27,9.6e-05
G5,C(CC(C1(C(C=CCO1)O)O)O)=O,8,1,0,1,30,4.9e-05
G5,C(CC1(COC(CO)=CC1O)O)=O,4,1,0,1,32,4.9e-05
G5,C1(C(C(C)O)OC(CO)=CC1O)=O,8,2,0,2,32,9.8e-05
G5,C(CC(C1C=CC(C(O1)O)O)O)=O,16,1,0,1,29,4.9e-05
G5,C(CC1(COC(C(C1O)O)=C)O)=O,8,1,0,1,24,4.9e-05
G5,C1(C(C(C(OC1C(C)O)=C)O)O)=O,16,2,0,2,24,9.7e-05
G5,C(CC1(COC=CC(C1O)O)O)=O,8,1,0,1,38,4.9e-05
G5,C1(C(C(C=COC1C(C)O)O)O)=O,16,2,0,2,38,9.8e-05
G5,C(CC(C(C1C=CC(O1)=O)O)O)=O,8,1,0,1,8,4.9e-05
G5,C(CC(C1C(C=CC(O1)=O)O)O)=O,8,1,0,1,8,4.9e-05
G5,C(CC(C(C(C=C)O)O)O)=O,8,1,0,1,27,4.9e-05
G5,C(C1(C)CC(C(O1)O)(CC=O)O)=O,8,2,0,2,4,9.6e-05
G5,C(CC(C1(C)CC(C(O)O1)=O)O)=O,8,2,0,2,4,9.6e-05
G5,C(C1(C)C(C(C(O1)O)=O)C(C)O)=O,16,3,0,3,4,0.000145
G5,C(CC1(CC(C=O)OC1O)O)=O,8,2,0,2,20,9.6e-05
G5,C1(C(OC(C=O)C1C(C)O)O)=O,16,3,0,3,0,0.000145
G5,C(CC1(C(O)OC(C)(CO)C1)O)=O,8,2,0,2,49,9.6e-05
G5,C1(C(O)OC(CO)(C)C1C(C)O)=O,16,3,0,3,49,0.000145
G5,C(CC(C1(CC(CO1)(C)O)O)O)=O,8,2,0,2,49,9.6e-05
G5,C(CC1(C(O)OC(C)C1)O)=O,8,2,0,2,4,9.6e-05
G5,C1(C(O)OC(C)C1C(C)O)=O,16,3,0,3,45,0.000145
G5,C(CC(C1C(C)(CC(O)O1)O)O)=O,16,2,0,2,6,9.6e-05
G5,C(CC(C1COC(C1O)O)O)=O,16,2,0,2,27,9.6e-05
G5,C(CC1(C(O)OC(C)C1CO)O)=O,16,2,0,2,4,9.6e-05
G5,C(CC(C1C(CC(O)O1)O)O)=O,16,2,0,2,4,9.6e-05
G5,C(CC(C1C(C)OC(C1O)O)O)=O,32,2,0,2,4,9.6e-05
G5,C(CC(CC1CC(C(O)O1)O)O)=O,16,2,0,2,43,9.6e-05
G5,C(C(C1CC(C(O)O1)O)C(C)O)=O,32,3,0,3,43,0.000145
G5,C(CC(C1(CC(CO1)O)O)O)=O,8,2,0,2,0,9.6e-05
G5,C(CC(C1C(C(C(O)O1)O)O)O)=O,32,4,0,4,29,0.000213
G5,C1(C(C(C)O)OC(C)(C1O)O)=O,16,3,0,3,0,0.000145
G5,C(CC(C1CC(C(O)O1)O)O)=O,16,2,0,2,4,9.6e-05
G5,C(CC1(C(C)OC(C1O)O)O)=O,16,2,0,2,45,9.6e-05
G5,C(CC(C1(CCC(C=O)O1)O)O)=O,8,2,0,2,12,9.6e-05
G5,C(CC(C1CCC(C=O)(O)O1)O)=O,8,2,0,2,12,9.6e-05
G5,C(CC(C1(CC(C(C)O1)=O)O)O)=O,8,2,0,2,45,9.6e-05
G5,C(CC1(CC(C=O)(O)OC1C)O)=O,8,2,0,2,24,9.6e-05
G5,C1(C(C(C)O)C(C=O)(OC1C)O)=O,16,3,0,3,24,0.000145
G5,C(CC(C(C1CCC(O1)O)=O)O)=O,8,2,0,2,27,9.6e-05
G5,C(C(C1CCC(O)O1)(CC=O)O)=O,8,2,0,2,27,9.6e-05
G5,C(CC(CC1(C(CCO1)O)O)O)=O,8,2,0,2,4,9.6e-05
G5,C(C(C1(C(CCO1)O)O)C(C)O)=O,16,3,0,3,4,0.000145
G5,C(CC(C(C1(CCCO1)O)O)O)=O,8,2,0,2,55,9.6e-05
G5,C(CC(C1(COC(C1O)O)O)O)=O,16,4,0,4,29,0.000213
G5,C(CC(C1(C(O)OCC1O)O)O)=O,16,3,0,3,1,0.000155
G5,C(CC(C1(COC(C1)O)O)O)=O,8,2,0,2,27,9.6e-05
G5,C(CC(C1(CC(O)OC1C)O)O)=O,16,2,0,2,4,9.6e-05
G5,C(CC1(C(C2(CC1CO2)O)O)O)=O,16,3,0,3,47,0.000144
G5,C(CC1(CC2(CC1(CO2)O)O)O)=O,8,3,0,3,4,0.000144
G5,C1(C2(COC(C2)(C1C(C)O)O)O)=O,16,4,0,4,4,0.000192
G5,C(CC(C1(C2CC(CO2)O1)O)O)=O,16,2,0,2,39,9.6e-05
G5,C(CC(C1C2CC(C(O)O2)O1)O)=O,32,2,0,2,40,9.6e-05
G5,C(CC1(COC(C(C1O)O)O)O)=O,16,5,0,5,29,0.000272
G5,C1(C(C(C)O)OC(C(C1O)O)O)=O,32,3,0,3,5,0.000145
G5,C(CC1(C(O)OCC(C)(C1)O)O)=O,8,2,0,2,49,9.6e-05
G5,C1(C(O)OCC(C)(C1C(C)O)O)=O,16,3,0,3,49,0.000145
G5,C(CC1(COC(C(C)(C1)O)O)O)=O,8,2,0,2,4,9.6e-05
G5,C1(COC(C(C)(C1C(C)O)O)O)=O,16,3,0,3,16,0.000145
G5,C1(C(C(C)O)OC(C(C)(C1)O)O)=O,16,3,0,3,16,0.000145
G5,C(CC1(CC(O)OCC1O)O)=O,8,2,0,2,4,9.6e-05
G5,C1(C(COC(C1C(C)O)O)O)=O,16,3,0,3,27,0.000145
G5,C(CC1(CC(O)OC(C)C1O)O)=O,16,2,0,2,4,9.6e-05
G5,C1(C(C(C)OC(C1C(C)O)O)O)=O,32,3,0,3,4,0.000145
G5,C(CC1(CCOC(C1O)O)O)=O,8,2,0,2,0,9.6e-05
G5,C1(C(C(O)OCC1C(C)O)O)=O,16,3,0,3,27,0.000145
G5,C(CC1(CC(C)OC(C1O)O)O)=O,16,2,0,2,4,9.6e-05
G5,C1(C(C(O)OC(C)C1C(C)O)O)=O,32,3,0,3,4,0.000145
G5,C(CC(C1(CC(O)OCC1)O)O)=O,8,2,0,2,3,9.6e-05
G5,C(CC(C1CC(CC(O)O1)O)O)=O,16,2,0,2,43,9.6e-05
G5,C(CC(C1(CC(CCO1)O)O)O)=O,8,2,0,2,4,9.6e-05
G5,C1(C(CCO1)(CC(CC=O)O)O)=O,4,1,0,1,28,4.9e-05
G5,C(C(C(C)O)C1(C(OCC1)=O)O)=O,8,4,0,4,28,0.000193
G5,C1(C(C)(CC(C(CC=O)O)O1)O)=O,8,1,0,1,14,4.9e-05
G5,C(CC(C1C(C(C(O1)=O)O)O)O)=O,16,1,0,1,17,4.9e-05
G5,C(CC1(CCC(C(C1O)O)O)O)=O,16,1,0,1,7,4.9e-05
G5,C1(C(C(C(CC1C(C)O)O)O)O)=O,32,1,0,1,7,4.9e-05
G5,C(CC(C(CCCO)=O)O)=O,2,3,0,3,55,0.000144
G5,C(C(CCCO)(CC=O)O)=O,2,1,0,1,55,4.9e-05
G5,C(C(C(CCO)C(C)O)=O)=O,4,2,0,2,4,9.7e-05
G5,C(CC(C(CCCCO)=O)O)=O,2,3,0,3,46,0.000144
G5,C(C(CCCCO)(CC=O)O)=O,2,1,0,1,46,4.9e-05
G5,C(C(C(CCCO)C(C)O)=O)=O,4,2,0,2,46,9.6e-05
G5,C(CC(C(CCC(C)O)=O)O)=O,4,3,0,3,27,0.000144
G5,C(C(CCC(C)O)(CC=O)O)=O,4,1,0,1,27,4.9e-05
G5,C(C(C(CC(C)O)C(C)O)=O)=O,8,2,0,2,27,9.6e-05
G5,C(CCCC(C(CC=O)O)=O)(O)=O,2,3,0,3,18,0.000144
G5,C(CCCC(C=O)(CC=O)O)(O)=O,2,2,0,2,18,9.6e-05
G5,C(CCC(C(C=O)=O)C(C)O)(O)=O,4,3,0,3,18,0.000144
G5,C(CC(CO)(CCCO)O)=O,2,1,0,1,55,4.9e-05
G5,C(C(C(C)O)O)(CCCO)=O,4,3,0,3,55,0.000145
G5,C(CO)(C(C(C)O)CCO)=O,4,3,0,3,46,0.000155
G5,C(CC(CO)(CCCCO)O)=O,2,1,0,1,27,4.9e-05
G5,C(C(C(C)O)O)(CCCCO)=O,4,3,0,3,27,0.000145
G5,C(CO)(C(C(C)O)CCCO)=O,4,2,0,2,4,9.6e-05
G5,C(CC(CO)(CCC(C)O)O)=O,4,1,0,1,27,4.9e-05
G5,C(C(C(C)O)O)(CCC(C)O)=O,8,3,0,3,27,0.000145
G5,C(CO)(C(C(C)O)CC(C)O)=O,8,2,0,2,4,9.6e-05
G5,C(CCCC(CO)(CC=O)O)(O)=O,2,2,0,2,18,9.6e-05
G5,C(CCCC(C(C(C)O)O)=O)(O)=O,4,4,0,4,18,0.000193
G5,C(CCC(C(CO)=O)C(C)O)(O)=O,4,3,0,3,18,0.000144
G5,C(CC(C(C(C)O)CC=O)O)=O,8,3,0,3,46,0.000144
G5,C(C(CC(CC=O)O)C(C)O)=O,8,1,0,1,27,4.9e-05
G5,C(C(C(C)O)C(C=O)C(C)O)=O,10,3,0,3,25,0.000144
G5,C(CC(C(CC=O)O)CC=O)(O)=O,4,3,0,3,4,0.000145
G5,C(CC(CC(C=O)CC(O)=O)O)=O,4,3,0,3,43,0.000155
G5,C(CC(C=O)C(C=O)C(C)O)(O)=O,8,4,0,4,28,0.00020299999999999997
G5,C(CC(CO)(CCC(CO)O)O)=O,4,1,0,1,46,4.9e-05
G5,C(C(C(C)O)O)(CCC(CO)O)=O,8,3,0,3,46,0.000145
G5,C(CO)(C(C(C)O)CC(CO)O)=O,8,2,0,2,46,9.6e-05
G5,C(CC(C(C(C=C)=O)(CO)O)O)=O,4,7,0,7,45,0.000338
G5,C(CC(C=C)(C(C=O)(CO)O)O)=O,4,1,0,1,2,4.9e-05
G5,C(CC1(C=CC(C1O)=O)O)=O,4,3,0,3,20,0.000144
G5,C(CC(C(OCC(C=C)=O)O)O)=O,4,3,0,3,7,0.000144
G5,C(CC(C=C)(COC(C=O)O)O)=O,4,1,0,1,4,4.9e-05
G5,C(C(OC(C(C=C)=O)C(C)O)O)=O,8,3,0,3,4,0.000145
G5,C(CC(C(C(C=C)=O)OCO)O)=O,4,2,0,2,37,9.6e-05
G5,C(CC(C=C)(C(C=O)OCO)O)=O,4,1,0,1,37,4.9e-05
G5,C(CC=CC(CC=O)O)=O,4,1,0,1,28,4.9e-05
G5,C(CC(CC=CC=O)O)=O,4,1,0,1,28,4.9e-05
G5,C(C(C=CC=O)C(C)O)=O,8,2,0,2,4,9.6e-05
G5,C(C(C(C)(C)O)O)(C(CO)O)=O,4,2,0,2,2,9.6e-05
G5,C(C)(CC(CO)(C(CO)O)O)=O,4,1,0,1,2,4.8e-05
G5,C(C(C(C=CC)O)O)(C(CO)O)=O,16,2,0,2,2,9.499999999999999e-05
G5,C(C(C(CC=C)O)O)(C(CO)O)=O,8,2,0,2,2,9.499999999999999e-05
G5,C(C(C=C)C(CO)(C(CO)O)O)=O,8,1,0,1,2,4.8e-05
G5,C1(C(C(C(C1C(C)(C)O)O)O)O)=O,16,2,0,2,4,9.499999999999999e-05
G5,C(C)(CC1(CC(C(C1O)O)O)O)=O,16,1,0,1,4,4.8e-05
G5,C1(C(C(C(C1O)O)O)C(C=C)O)=O,32,2,0,2,4,9.499999999999999e-05
G5,C(C(C(C)O)O)(C(C(C)(C)O)O)=O,8,2,0,2,2,9.499999999999999e-05
G5,C(C)(CC(CO)(C(C(C)O)O)O)=O,8,1,0,1,2,4.8e-05
G5,C(C(C(C)(C)O)C(CO)(CO)O)=O,2,2,0,2,5,9.499999999999999e-05
G5,C(C)(CC(CC(CO)(CO)O)O)=O,2,1,0,1,5,4.8e-05
G5,C(C(C(CO)(CO)O)C(C=C)O)=O,4,2,0,2,5,9.499999999999999e-05
G5,C(C(C(C(CO)O)O)C(C)(C)O)=O,8,2,0,2,41,9.499999999999999e-05
G5,C(C)(CC(CC(C(CO)O)O)O)=O,8,1,0,1,41,4.8e-05
G5,C(C(C(C(CO)O)O)C(C=C)O)=O,16,2,0,2,41,9.499999999999999e-05
G5,C(C(C(C(C=O)=O)C(C)(C)O)O)=O,4,2,0,2,0,9.499999999999999e-05
G5,C(C(CC(C(CC(C)=O)O)=O)O)=O,4,1,0,1,0,4.8e-05
G5,C(C(CC(C=O)(CC(C)=O)O)O)=O,4,2,0,2,27,9.499999999999999e-05
G5,C(C(C(C(C)O)C(C)(C)O)=O)=O,4,2,0,2,4,9.499999999999999e-05
G5,C(CC(C(CC(C)O)=O)O)(C)=O,4,2,0,2,11,9.499999999999999e-05
G5,C(C(CC(C)O)(CC(C)=O)O)=O,4,1,0,1,4,4.8e-05
G5,C(C)=CC(C(C(C=O)=O)C(C)O)O,16,2,0,2,4,9.499999999999999e-05
G5,C=CCC(C(C(C=O)=O)C(C)O)O,8,2,0,2,4,9.499999999999999e-05
G5,C(C(C=C)C(C(CC(C)O)=O)O)=O,8,1,0,1,4,4.8e-05
G5,C(C(C=C)C(C=O)(CC(C)O)O)=O,8,1,0,1,4,4.8e-05
G5,C(CC(C(CC(C)(C)O)=O)O)=O,2,1,0,1,45,4.8e-05
G5,C(C(C(C)(C)O)C(C(C)=O)O)=O,4,2,0,2,45,9.6e-05
G5,C(CC(C(C)(CC(C)=O)O)O)=O,4,1,0,1,45,4.8e-05
G5,C(C)(CC(CC(C(C)=O)O)O)=O,4,1,0,1,45,4.8e-05
G5,C(C(C(C=C)O)C(C(C)=O)O)=O,8,4,0,4,45,0.00018999999999999998
G5,C(CC(C(CC(C=CC)O)=O)O)=O,8,1,0,1,45,4.8e-05
G5,C(C(C(C(C)=O)O)C(C=CC)O)=O,16,2,0,2,45,9.499999999999999e-05
G5,C(CC(C(CC(CC=C)O)=O)O)=O,4,1,0,1,45,4.8e-05
G5,C(C(C(CC=C)O)C(C(C)=O)O)=O,8,2,0,2,45,9.499999999999999e-05
G5,C(C(C=C)C(C)(C(CC=O)O)O)=O,8,1,0,1,45,4.8e-05
G5,C(C(C=C)C(CC(C(C)=O)O)O)=O,8,1,0,1,45,4.8e-05
G5,C(C(C(C)(C)O)C(C=O)(C)O)=O,4,2,0,2,45,9.499999999999999e-05
G5,C(CC(C)(C(CC(C)=O)O)O)=O,4,1,0,1,45,4.8e-05
G5,C(C(C)(CC(CC(C)=O)O)O)=O,4,1,0,1,45,4.8e-05
G5,C(C(C)(C(C=O)C(C=C)O)O)=O,8,4,0,4,45,0.00018999999999999998
G5,C(C(C)(C(C=O)C(C=CC)O)O)=O,16,2,0,2,45,9.499999999999999e-05
G5,C(C(C(CC=C)O)C(C=O)(C)O)=O,8,2,0,2,45,9.499999999999999e-05
G5,C(C(C=C)C(C(C)(CC=O)O)O)=O,8,1,0,1,45,4.8e-05
G5,C(C(C=C)C(CC(C=O)(C)O)O)=O,8,1,0,1,45,4.8e-05
G5,C(C(C(C(C(C)(C)O)O)=O)CO)=O,4,2,0,2,2,9.499999999999999e-05
G5,C(C(CO)C(CO)(CC(C)=O)O)=O,4,4,0,4,26,0.000202
G5,C(C(C(C(C(C=C)O)O)=O)CO)=O,8,2,0,2,2,9.499999999999999e-05
G5,C(C(C(C(CO)O)=O)C(C)(C)O)=O,4,2,0,2,2,9.499999999999999e-05
G5,C(C(CO)O)(C(C=O)C(C=C)O)=O,8,2,0,2,2,9.499999999999999e-05
G5,C(C(C(C(CO)C(C)(C)O)=O)O)=O,4,2,0,2,27,9.499999999999999e-05
G5,C(C(CO)C(C=C)O)(C(C=O)O)=O,8,2,0,2,27,9.499999999999999e-05
G5,C(C(CO)O)(C(CO)C(C)(C)O)=O,4,2,0,2,2,9.499999999999999e-05
G5,C(C)(CC(CCO)(C(CO)O)O)=O,4,3,0,3,29,0.000165
G5,C(C(CO)C(C=C)O)(C(CO)O)=O,8,2,0,2,2,9.499999999999999e-05
G5,C(CC(C(C(CO)CO)=O)O)(C)=O,2,1,0,1,2,4.8e-05
G5,C(C(C(CO)CO)(CC(C)=O)O)=O,2,2,0,2,23,0.000106
G5,C(C(C(C)(C)O)O)(C(CO)CO)=O,2,2,0,2,2,9.499999999999999e-05
G5,C(C)(CC(CO)(C(CO)CO)O)=O,2,1,0,1,2,4.8e-05
G5,C(C(C(C=C)O)O)(C(CO)CO)=O,4,2,0,2,2,9.499999999999999e-05
G5,C(C(CO)C(C(CC(C)=O)O)O)=O,8,3,0,3,27,0.000144
G5,C(C(C(C(CC(C)=O)O)CO)O)=O,8,3,0,3,3,0.000154
G5,C(C(CO)C1(CC(CC1O)O)O)=O,16,2,0,2,45,9.6e-05
G5,C(C(CO)C1(CC(C(C1)=O)O)O)=O,8,2,0,2,26,9.6e-05
G5,C(C(CO)C1(C=CC(C1O)O)O)=O,16,2,0,2,28,9.6e-05
G5,C(C(CO)C(C(C=O)CO)O)(O)=O,8,3,0,3,18,0.000143
G5,C(CC(C=O)(C(C=O)CO)O)(O)=O,4,3,0,3,17,0.000155
G5,C(C(CO)C(C(CO)CO)O)=O,4,2,0,2,18,9.6e-05
G5,C(C(CO)C(C(CO)C(C)O)O)=O,16,2,0,2,18,9.6e-05
G5,C(C(CO)C(C(C)=O)(CCO)O)=O,4,3,0,3,14,0.000155
G5,C(C(CO)C(CCO)(CC=O)O)=O,4,2,0,2,2,9.6e-05
G5,C(C(CO)C(C=C)(C(CO)O)O)=O,8,2,0,2,7,9.6e-05
G5,C(C(CO)C(CC(CCO)O)O)=O,8,2,0,2,18,9.6e-05
G5,C(C(C(CCO)O)C(CCO)O)=O,3,2,0,2,18,9.6e-05
G5,C(C(CO)C(CC(O)=O)O)=O,4,3,0,3,28,0.000155
G5,C(C(C=O)C(CCO)O)(O)=O,4,6,0,6,18,0.000298
G5,C(C(CO)C(CC(C(C)O)O)O)=O,16,2,0,2,11,9.6e-05
G5,C(C(C(C(C)O)O)C(CCO)O)=O,16,4,0,4,11,0.000192
G5,C(C(CO)C(C(C=O)=O)(C)O)=O,4,4,0,4,25,0.00019099999999999998
G5,C(C(C(CC(CCO)O)=O)=O)=O,2,3,0,3,29,0.000143
G5,C(C(CO)C(C(C=O)=O)O)=O,4,5,0,5,1,0.00023799999999999998
G5,C(C)(C(C(CO)=O)C(CCO)O)=O,4,3,0,3,26,0.000155
G5,C(C(CO)C(C)(CCO)O)=O,4,3,0,3,28,0.000155
G5,C(CC(CCO)O)(CCO)=O,2,2,0,2,18,0.00010700000000000001
G5,C(C)(C(CO)C(CCO)O)=O,4,3,0,3,28,0.000155
G5,C(C(CO)C(CC=O)(CC=O)O)=O,2,2,0,2,9,9.6e-05
G5,C(C(C(CC=O)=O)C(CCO)O)=O,4,2,0,2,9,9.6e-05
G5,C(C(CO)C(C)(C)O)=O,2,2,0,2,18,9.6e-05
G5,C(C)(CC(CCO)O)=O,2,3,0,3,27,0.000154
G5,C(C(CO)C(CCC=O)(CO)O)=O,4,3,0,3,7,0.000144
G5,C(CO)(C(C(CCO)O)CC=O)=O,4,3,0,3,18,0.000154
G5,C(C(C(CCO)O)CC(CO)=O)=O,4,3,0,3,18,0.000154
G5,C(C(CO)C(C)(CC(C=O)O)O)=O,8,2,0,2,27,9.6e-05
G5,C(C)(C(C(CCO)O)C(C=O)O)=O,8,2,0,2,27,9.6e-05
G5,C(C(CO)C(C=CCO)(CO)O)=O,8,3,0,3,11,0.000155
G5,C(OCC(C)(C(C=O)CO)O)=O,4,2,0,2,35,9.6e-05
G5,C(OCC(CC(CCO)O)=O)=O,2,3,0,3,35,0.000143
G5,C(OC(C(C)=O)C(CCO)O)=O,4,3,0,3,35,0.000143
G5,C(OCC(C(C=O)CO)O)=O,4,2,0,2,28,9.6e-05
G5,C(OC(C=O)C(CCO)O)=O,4,2,0,2,28,9.6e-05
G5,C(C(CO)C(COC(CO)=O)O)=O,4,2,0,2,40,9.6e-05
G5,C(C(C(CCO)O)OC(CO)=O)=O,4,2,0,2,40,9.6e-05
G5,C(C(CO)C(COC(C)=O)O)=O,4,2,0,2,28,9.6e-05
G5,C(C(C(CCO)O)OC(C)=O)=O,4,2,0,2,28,9.6e-05
G5,C(CCC(C(C(C=O)CO)O)=O)=O,4,2,0,2,20,9.6e-05
G5,C(CCC(C=O)(C(C=O)CO)O)=O,4,3,0,3,20,0.000143
G5,C(CC(C(C=O)=O)C(CCO)O)=O,4,3,0,3,29,0.000154
G5,C(C(C(CCO)O)CC(C=O)=O)=O,4,2,0,2,18,9.6e-05
G5,C(C(CO)C(CCC=O)O)=O,4,4,0,4,27,0.00019099999999999998
G5,C(C(C(CCO)O)CC=O)=O,4,4,0,4,18,0.000202
G5,C(C(CO)C(C(C=CCO)=O)O)=O,8,2,0,2,55,9.6e-05
G5,C(C(CO)C(C=O)(C=CCO)O)=O,8,2,0,2,55,9.6e-05
G5,C(C(CO)C(C=CCO)O)=O,8,5,0,5,28,0.00024900000000000004
G5,C(CC(C(O)=O)(C(C=O)CO)O)=O,4,3,0,3,45,0.000155
G5,C(C(C(C(O)=O)=O)C(CCO)O)=O,4,3,0,3,45,0.000155
G5,C(C(CO)C(C)(CC(O)=O)O)=O,4,3,0,3,6,0.000155
G5,C(CC(CC(CCO)O)=O)(O)=O,2,2,0,2,18,0.00010700000000000001
G5,C(C(C(C)=O)C(CCO)O)(O)=O,4,4,0,4,6,0.000202
G5,C(C(CO)=O)(C(C(CCO)O)O)=O,4,5,0,5,5,0.00024900000000000004
G5,C(C(CO)C(C(C=C)=O)(CO)O)=O,4,3,0,3,7,0.000145
G5,C(C(CO)C(C(CO)=O)(C=C)O)=O,4,2,0,2,7,9.6e-05
G5,C=CC(C(C(C(CCO)O)O)=O)=O,4,2,0,2,7,9.6e-05
G5,C(C(CO)C(C(C(C)O)=O)(C)O)=O,8,2,0,2,49,9.6e-05
G5,C(C(C(C)O)=O)(CC(CCO)O)=O,4,3,0,3,49,0.000154
G5,C(C(CO)C1(CCC(C1O)=O)O)=O,8,2,0,2,47,9.6e-05
G5,C1(C(C(CCO)O)CC(C1O)=O)=O,8,2,0,2,18,9.6e-05
G5,C(C(CO)C1(COC(CC1)=O)O)=O,4,2,0,2,7,9.6e-05
G5,C1(COC(CC1C(CCO)O)=O)=O,4,1,0,1,7,4.8e-05
G5,C1(CCC(OC1C(CCO)O)=O)=O,4,2,0,2,7,9.6e-05
G5,C(C(CO)C1(COCC(C1)=O)O)=O,4,2,0,2,54,9.6e-05
G5,C1(C(C(CCO)O)OCC(C1)=O)=O,4,2,0,2,54,9.6e-05
G5,C1(COCC(C1C(CCO)O)=O)=O,2,2,0,2,54,9.6e-05
G5,C1(C(C(CO1)C(CCO)O)=O)=O,4,3,0,3,28,0.000143
G5,C(C(CO)C1(COC(C1)=O)O)=O,4,3,0,3,28,0.000143
G5,C1(C(C(CO1)=O)C(CCO)O)=O,4,4,0,4,28,0.00019099999999999998
G5,C1(CC(C(C(CCO)O)O1)=O)=O,4,3,0,3,28,0.000143
G5,C(C(CO)C(C(C=C)O)O)=O,8,4,0,4,28,0.00019099999999999998
G5,C(C(CO)C1(C=COC1)O)=O,4,3,0,3,28,0.000143
G5,C1OC(C(C=1)=O)C(CCO)O,4,3,0,3,28,0.000143
G5,C(C(CO)C1(C=CC(O)OC1)O)=O,8,2,0,2,27,9.6e-05
G5,C1C(OC(C(C=1)=O)C(CCO)O)O,8,2,0,2,27,9.6e-05
G5,C(C(CO)C(C(C)O)(CC=O)O)=O,8,2,0,2,45,9.6e-05
G5,C(C(C(CC(C(C)O)=O)O)CO)=O,8,3,0,3,45,0.000143
G5,C(C(C(C(C)O)=O)C(CCO)O)=O,8,3,0,3,45,0.000143
G5,C(C(CO)C(C(CC(C)O)O)O)=O,16,2,0,2,11,9.6e-05
G5,C(C(CO)C(C(C)O)(C(C)O)O)=O,6,2,0,2,49,9.6e-05
G5,C(C(CO)C(C=CC(C=O)O)O)=O,16,3,0,3,20,0.000143
G5,C(C(CO)C(C(C=CC=O)O)O)=O,16,2,0,2,20,9.6e-05
G5,C(C(CO)C(C)(C(CCO)O)O)=O,8,3,0,3,45,0.000155
G5,C(C(CCO)O)(CC(CCO)O)=O,4,3,0,3,29,0.000165
G5,C(C(CO)C(C(C)(CCO)O)O)=O,8,3,0,3,29,0.000154
G5,C(C(CO)C(C(C)(CO)O)O)=O,8,2,0,2,11,9.6e-05
G5,C(C(CO)C(C(C)(C(C)O)O)O)=O,16,2,0,2,18,9.6e-05
G5,C(C(CO)C(C(CO)=O)(CC)O)=O,4,2,0,2,42,9.6e-05
G5,C(C(CO)C(C(CC)=O)(CO)O)=O,4,2,0,2,42,9.6e-05
G5,C(C(CO)=O)(C(C)C(CCO)O)=O,4,1,0,1,42,4.8e-05
G5,C(C(C(C(CCO)O)O)=O)(CC)=O,4,2,0,2,42,9.6e-05
G5,C(C(CO)C(C(CO)CC=O)O)=O,8,4,0,4,55,0.00019099999999999998
G5,C(C(CO)C(CC(C=O)CO)O)=O,8,2,0,2,55,9.6e-05
G5,C(C(C(CCO)O)C(C=O)CO)=O,8,2,0,2,18,9.6e-05
G5,C(C(CO)C(C(CC)=O)(C)O)=O,4,3,0,3,28,0.000143
G5,C(C(CO)C(C(C)=O)(CC)O)=O,4,2,0,2,28,9.6e-05
G5,C(C(CC)=O)(CC(CCO)O)=O,2,2,0,2,18,9.499999999999999e-05
G5,C(C(C)=O)(C(C)C(CCO)O)=O,4,1,0,1,28,4.8e-05
G5,C(CC(CCO)O)(CC(C)=O)=O,2,2,0,2,18,9.499999999999999e-05
G5,C(C)(C(C(C)=O)C(CCO)O)=O,2,3,0,3,28,0.000143
G5,C(C(CO)C(C(C)CC=O)O)=O,8,3,0,3,28,0.000143
G5,C(C(CO)C(CC(C=O)C)O)=O,8,3,0,3,28,0.000143
G5,C(C(C(CCO)O)C(C=O)C)=O,8,3,0,3,49,0.000143
G5,C(C(CO)C(C(C(C=O)C)=O)O)=O,8,2,0,2,49,9.6e-05
G5,C(C(CO)C(C(C(CO)C)=O)O)=O,8,2,0,2,28,9.6e-05
G5,C(C(CO)C(C=O)(C(CO)C)O)=O,8,2,0,2,28,9.6e-05
G5,C(C(C)C(C(C(C=O)CO)O)O)=O,16,2,0,2,49,9.6e-05
G5,C(C(CO)C(C(C)C(C=O)O)O)=O,16,2,0,2,49,9.6e-05
G5,C(C(CO)C(C(CC)=O)O)=O,4,3,0,3,28,0.000143
G5,C(C(CO)C(C=O)(CC)O)=O,4,2,0,2,28,9.6e-05
G5,C(C(C(C)C(CCO)O)=O)=O,4,1,0,1,28,4.8e-05
G5,C(C(C=O)C(CC(CCO)O)=O)=O,2,1,0,1,6,4.8e-05
G5,C(C(C=O)CC(C(C=O)CO)O)=O,4,2,0,2,43,9.6e-05
G5,C(C(C=O)C(C=O)C(CCO)O)=O,4,1,0,1,43,4.8e-05
G5,C(C(CO)C(C(O)=O)(CC)O)=O,4,2,0,2,28,9.6e-05
G5,C(C(C(C)C(CCO)O)=O)(O)=O,4,1,0,1,28,4.8e-05
G5,C(C(CO)C(CO)(C(C=C)O)O)=O,8,2,0,2,31,9.6e-05
G5,C(C(C(CCO)O)O)(C(C=C)O)=O,8,4,0,4,31,0.000202
G5,C(C(CO)C(C=C(CO)CO)O)=O,4,2,0,2,18,9.6e-05
G5,C(C(CO)C(C=CC(CO)O)O)=O,16,2,0,2,46,9.6e-05
G5,C(C(CO)C(C(C=CC=O)=O)O)=O,8,2,0,2,20,9.6e-05
G5,C(C(C=CC=O)(C(C=O)CO)O)=O,8,2,0,2,20,9.6e-05
G5,C(C(CO)C(C(C=CC)=O)O)=O,8,3,0,3,28,0.000143
G5,C(C(CO)C(C=O)(C=CC)O)=O,8,3,0,3,28,0.000143
G5,C(C(CO)C(C(CC=C)=O)O)=O,4,3,0,3,28,0.000143
G5,C(C(CO)C(C=O)(CC=C)O)=O,4,3,0,3,28,0.000143
G5,C=CC(C(C=O)=O)C(CCO)O,4,3,0,3,29,0.000154
G5,C(C(CO)C(C=CC=O)(C)O)=O,8,3,0,3,28,0.000143
G5,C(C(CO)C(C=CC(C)=O)O)=O,8,3,0,3,28,0.000143
G5,C(C=CC(CC(CCO)O)=O)=O,4,5,0,5,29,0.00024900000000000004
G5,C(C(CO)C(C(CC=O)=C)O)=O,4,3,0,3,28,0.000143
G5,C(C(CO)C(CC(C=O)=C)O)=O,4,3,0,3,28,0.000143
G5,C(C(C(C=O)=C)C(CCO)O)=O,4,2,0,2,45,9.499999999999999e-05
G5,C(C(CO)C(C(C)=CC=O)O)=O,8,3,0,3,28,0.000143
G5,C(C(CO)C(C=C(C=O)C)O)=O,8,3,0,3,28,0.000143
G5,C(C(CO)C(C(C(CO)=O)=C)O)=O,4,2,0,2,9,9.6e-05
G5,C(C(CO)C(C(C=O)=C)(CO)O)=O,4,2,0,2,9,9.6e-05
G5,C=C(C=O)C(C(C(CCO)O)O)=O,4,2,0,2,9,9.6e-05
G5,C(C(C(C=C)(C(C=O)CO)O)O)=O,8,2,0,2,0,9.6e-05
G5,C(C(CO)C(C(C(CO)=C)=O)O)=O,4,2,0,2,49,9.6e-05
G5,C(C(CO)C(C(CO)=C)(CO)O)=O,4,2,0,2,49,9.6e-05
G5,C=C(C(C(C(CCO)O)O)=O)CO,4,2,0,2,49,9.6e-05
G5,C(C(CO)C(C(C(C=O)=C)O)O)=O,8,2,0,2,16,9.6e-05
G5,C(C(CO)C(C(C(C=O)O)=C)O)=O,8,2,0,2,16,9.6e-05
G5,C(C(CO)C(C=C(C=O)CO)O)=O,8,2,0,2,18,9.6e-05
G5,C(C(CO)C(C(CO)=CC=O)O)=O,8,2,0,2,18,9.6e-05
G5,C(C(CO)C(C=C)O)=O,4,4,0,4,18,0.00019099999999999998
G5,C(C(CO)C(C=CC)(CO)O)=O,8,3,0,3,28,0.000143
G5,C(C)=CC(C(C(CCO)O)O)=O,8,3,0,3,28,0.000143
G5,C(C(CO)C(CO)(CC=C)O)=O,4,3,0,3,28,0.000143
G5,C(CO)(C(C=C)C(CCO)O)=O,4,2,0,2,11,9.499999999999999e-05
G5,C(C(C(CCO)O)O)(CC=C)=O,4,3,0,3,28,0.000143
G5,C(C(CO)C(C)(C(C=C)O)O)=O,8,3,0,3,28,0.000143
G5,C(CC(CCO)O)(C(C=C)O)=O,4,2,0,2,18,9.499999999999999e-05
G5,C(C(CO)C(CC(CO)=C)O)=O,4,3,0,3,28,0.000143
G5,C(C(C(CO)=C)C(CCO)O)=O,4,2,0,2,49,9.499999999999999e-05
G5,C(C(CO)C(C=C(CO)C)O)=O,8,3,0,3,28,0.000143
G5,C(C(CO)C(C=CC)O)=O,8,3,0,3,18,0.000143
G5,C(C(CO)C(CC=C)O)=O,4,3,0,3,45,0.000143
G5,C(C(C=C)C(CCO)O)=O,4,2,0,2,18,9.499999999999999e-05
G5,C(C(CO)C(C(C(CO)=C)O)O)=O,8,2,0,2,49,9.6e-05
G5,C(C(CO)C(C(C=C)(CO)O)O)=O,8,2,0,2,29,9.6e-05
G5,C(C(C=C)(C(C(C=O)CO)O)O)=O,8,3,0,3,28,0.000143
G5,C(C(CO)C(C(C(C=C)O)O)O)=O,16,2,0,2,27,9.6e-05
G5,C(C(CO)C1(C(O)OC(C)C1)O)=O,16,3,0,3,45,0.000143
G5,C1(C(O)OC(C)C1C(CCO)O)=O,16,4,0,4,45,0.000202
G5,C1(C(C(CCO)O)OC(C1O)O)=O,16,3,0,3,5,0.000143
G5,C(C(CO)C(C(CCCO)=O)O)=O,4,3,0,3,55,0.000144
G5,C(C(CO)C(C=O)(CCCO)O)=O,4,2,0,2,55,9.6e-05
G5,C(C(C(CCO)C(CCO)O)=O)=O,4,1,0,1,55,4.8e-05
G5,C(C(CO)C(CO)(CCCO)O)=O,4,2,0,2,55,9.6e-05
G5,C(C(C(CCO)O)O)(CCCO)=O,4,5,0,5,55,0.000261
G5,C(CO)(C(CCO)C(CCO)O)=O,4,1,0,1,55,4.8e-05
G5,C(C(CO)C1(C=CC(C1O)=O)O)=O,8,2,0,2,47,9.6e-05
G5,C(C(CO)C(C=CCC=O)O)=O,8,2,0,2,28,9.6e-05
G5,C(C(CO)C(CC=CC=O)O)=O,8,2,0,2,28,9.6e-05
G5,C(C(C=CC=O)C(CCO)O)=O,8,1,0,1,28,4.8e-05
G5,C(C(C(C(C=O)O)O)C(C)(C)O)=O,8,2,0,2,0,9.499999999999999e-05
G5,C(C(C(C(C=O)C(C=C)O)O)O)=O,16,2,0,2,0,9.499999999999999e-05
G5,C(CO)(C(C(C)O)C(C)(C)O)=O,4,2,0,2,11,9.6e-05
G5,C(C(C(C)(C)O)O)(CC(C)O)=O,4,2,0,2,11,9.6e-05
G5,C(C)(CC(CO)(CC(C)O)O)=O,4,1,0,1,11,4.8e-05
G5,C(CO)(C(C(C)O)C(C=C)O)=O,8,4,0,4,11,0.00018999999999999998
G5,C(C(C(C=C)O)O)(CC(C)O)=O,8,4,0,4,11,0.00018999999999999998
G5,C(CO)(C(C(C)O)C(C=CC)O)=O,16,2,0,2,11,9.499999999999999e-05
G5,C(C(C(C=CC)O)O)(CC(C)O)=O,16,2,0,2,11,9.499999999999999e-05
G5,C(CO)(C(C(CC=C)O)C(C)O)=O,8,2,0,2,11,9.499999999999999e-05
G5,C(C(C(CC=C)O)O)(CC(C)O)=O,8,2,0,2,11,9.499999999999999e-05
G5,C(C(C=C)C(CO)(CC(C)O)O)=O,8,1,0,1,11,4.8e-05
G5,C(C(C(C)O)O)(CC(C)(C)O)=O,4,1,0,1,4,4.8e-05
G5,C(C)(CC(C)(C(C(C)O)O)O)=O,8,1,0,1,4,4.8e-05
G5,C(CC(C=C)O)(C(C(C)O)O)=O,8,3,0,3,29,0.000143
G5,C(CC(C=CC)O)(C(C(C)O)O)=O,16,1,0,1,4,4.8e-05
G5,C(C(C(C)O)O)(CC(CC=C)O)=O,8,1,0,1,4,4.8e-05
G5,C(C(C=C)C(C)(C(C(C)O)O)O)=O,16,1,0,1,4,4.8e-05
G5,C(C(C(C)(C)O)C(C)(CO)O)=O,4,2,0,2,49,9.499999999999999e-05
G5,C(C)(CC(CC(C)(CO)O)O)=O,4,1,0,1,49,4.8e-05
G5,C(C(C(CO)(C)O)C(C=C)O)=O,8,4,0,4,49,0.00018999999999999998
G5,C(C(C(CO)(C)O)C(C=CC)O)=O,16,2,0,2,49,9.499999999999999e-05
G5,C(C(C(CC=C)O)C(C)(CO)O)=O,8,2,0,2,49,9.499999999999999e-05
G5,C(C(C=C)C(CC(C)(CO)O)O)=O,8,1,0,1,49,4.8e-05
G5,C(C(C(C)O)C(C(CO)CO)O)=O,8,2,0,2,18,9.6e-05
G5,C(C(C(CC(O)=O)O)C(C)O)=O,8,3,0,3,28,0.000154
G5,C(C(C=O)C(CC(C)O)O)(O)=O,8,6,0,6,28,0.000298
G5,C(C(C(C)O)C(C(C=O)=O)(C)O)=O,8,2,0,2,25,9.6e-05
G5,C(C(C(CC(CC(C)O)O)=O)=O)=O,4,1,0,1,25,4.8e-05
G5,C(C(C(C)O)C(C(C=O)=O)O)=O,8,4,0,4,1,0.00019099999999999998
G5,C(C(C(C)O)C(C)(CCO)O)=O,8,3,0,3,28,0.000154
G5,C(CC(CC(C)O)O)(CCO)=O,4,2,0,2,28,0.00010700000000000001
G5,C(C)(C(CO)C(CC(C)O)O)=O,8,3,0,3,28,0.000154
G5,C(C(C(C)O)C(C)(C)O)=O,4,2,0,2,28,9.6e-05
G5,C(C)(CC(CC(C)O)O)=O,4,1,0,1,28,4.8e-05
G5,C(OCC(C)(C(C=O)C(C)O)O)=O,8,2,0,2,35,9.6e-05
G5,C(OCC(CC(CC(C)O)O)=O)=O,4,3,0,3,35,0.000143
G5,C(OC(C(C)=O)C(CC(C)O)O)=O,8,3,0,3,35,0.000143
G5,C(OCC(C(C=O)C(C)O)O)=O,8,2,0,2,28,9.6e-05
G5,C(OC(C=O)C(CC(C)O)O)=O,8,2,0,2,28,9.6e-05
G5,C(C(C(C)O)C(COC(C)=O)O)=O,8,2,0,2,28,9.6e-05
G5,C(C(C(CC(C)O)O)OC(C)=O)=O,8,2,0,2,28,9.6e-05
G5,C(C(C(C)O)C(CCC=O)O)=O,8,4,0,4,27,0.00019099999999999998
G5,C(C(C(CC(C)O)O)CC=O)=O,8,3,0,3,6,0.000143
G5,C(C(C(C)O)C(C=CCO)O)=O,16,5,0,5,28,0.00024900000000000004
G5,C(C(C(C(CC(C)O)O)O)=O)(O)=O,8,3,0,3,33,0.000154
G5,C(C(C(C)O)C(C)(CC(O)=O)O)=O,8,3,0,3,6,0.000154
G5,C(CC(CC(CC(C)O)O)=O)(O)=O,4,2,0,2,28,0.00010700000000000001
G5,C(C(C(C)=O)C(CC(C)O)O)(O)=O,8,3,0,3,6,0.000154
G5,C1(C(C(CO1)C(CC(C)O)O)=O)=O,8,2,0,2,28,9.6e-05
G5,C(C(C(C)O)C1(COC(C1)=O)O)=O,8,2,0,2,28,9.6e-05
G5,C1(C(C(CO1)=O)C(CC(C)O)O)=O,8,2,0,2,28,9.6e-05
G5,C1(CC(C(C(CC(C)O)O)O1)=O)=O,8,2,0,2,28,9.6e-05
G5,C(C(C(C(C=C)O)O)C(C)O)=O,16,4,0,4,28,0.00019099999999999998
G5,C(C(C(C)O)C1(C=COC1)O)=O,8,3,0,3,28,0.000143
G5,C1OC(C(C=1)=O)C(CC(C)O)O,8,3,0,3,28,0.000143
G5,C(C(C(C)O)C(C(C)(CO)O)O)=O,16,2,0,2,11,9.6e-05
G5,C(C(C(C)O)C(C(CC)=O)(C)O)=O,8,2,0,2,28,9.6e-05
G5,C(C(C(C)O)C(C(C)=O)(CC)O)=O,8,2,0,2,28,9.6e-05
G5,C(C(CC)=O)(CC(CC(C)O)O)=O,4,1,0,1,28,4.8e-05
G5,C(C(C)=O)(C(C)C(CC(C)O)O)=O,8,1,0,1,28,4.8e-05
G5,C(CC(CC(C)O)O)(CC(C)=O)=O,4,1,0,1,28,4.8e-05
G5,C(C)(C(C(C)=O)C(CC(C)O)O)=O,4,2,0,2,28,9.6e-05
G5,C(C(C(C)O)C(C(C)CC=O)O)=O,16,3,0,3,28,0.000143
G5,C(C(C(C)O)C(CC(C=O)C)O)=O,16,2,0,2,28,9.6e-05
G5,C(C(C(CC(C)O)O)C(C=O)C)=O,16,2,0,2,28,9.499999999999999e-05
G5,C(C(C(C)O)C(C(CC)=O)O)=O,8,3,0,3,28,0.000143
G5,C(C(C(C)O)C(C=O)(CC)O)=O,8,2,0,2,28,9.6e-05
G5,C(C(C(C)C(CC(C)O)O)=O)=O,8,1,0,1,28,4.8e-05
G5,C(C(C(C)O)C(C(O)=O)(CC)O)=O,8,2,0,2,28,9.6e-05
G5,C(C(C(C)C(CC(C)O)O)=O)(O)=O,8,1,0,1,28,4.8e-05
G5,C(C(C(C)O)C(C(C=CC)=O)O)=O,16,2,0,2,28,9.6e-05
G5,C(C(C(C)O)C(C=O)(C=CC)O)=O,16,2,0,2,28,9.6e-05
G5,C(C(C(C)O)C(C(CC=C)=O)O)=O,8,2,0,2,28,9.6e-05
G5,C(C(C(C)O)C(C=O)(CC=C)O)=O,8,2,0,2,28,9.6e-05
G5,C=CC(C(C=O)=O)C(CC(C)O)O,8,1,0,1,28,4.8e-05
G5,C(C(C(C)O)C(C=CC=O)(C)O)=O,16,2,0,2,28,9.6e-05
G5,C(C(C(C)O)C(C=CC(C)=O)O)=O,16,2,0,2,28,9.6e-05
G5,C(C=CC(CC(CC(C)O)O)=O)=O,8,1,0,1,28,4.8e-05
G5,C(C(C(C)O)C(C(CC=O)=C)O)=O,8,2,0,2,28,9.6e-05
G5,C(C(C(CC(C=O)=C)O)C(C)O)=O,8,2,0,2,28,9.6e-05
G5,C(C(C(C=O)=C)C(CC(C)O)O)=O,8,1,0,1,28,4.8e-05
G5,C(C(C(C)O)C(C(C)=CC=O)O)=O,16,2,0,2,28,9.6e-05
G5,C(C(C(C)O)C(C=C(C=O)C)O)=O,16,2,0,2,28,9.6e-05
G5,C(C(C(C)O)C(C=C)O)=O,8,4,0,4,28,0.00019099999999999998
G5,C(C(C(C)O)C(C=CC)(CO)O)=O,16,2,0,2,28,9.6e-05
G5,C(C)=CC(C(C(CC(C)O)O)O)=O,16,2,0,2,28,9.6e-05
G5,C(C(C(C)O)C(CO)(CC=C)O)=O,8,2,0,2,28,9.6e-05
G5,C(CO)(C(C=C)C(CC(C)O)O)=O,8,1,0,1,28,4.8e-05
G5,C(C(C(CC(C)O)O)O)(CC=C)=O,8,2,0,2,28,9.6e-05
G5,C(C(C(C)O)C(C)(C(C=C)O)O)=O,16,2,0,2,28,9.6e-05
G5,C(CC(CC(C)O)O)(C(C=C)O)=O,8,1,0,1,28,4.8e-05
G5,C(C(C(CC(CO)=C)O)C(C)O)=O,8,2,0,2,28,9.6e-05
G5,C(C(C(CO)=C)C(CC(C)O)O)=O,8,1,0,1,28,4.8e-05
G5,C(C(C(C)O)C(C=C(CO)C)O)=O,16,2,0,2,28,9.6e-05
G5,C(C(C(C)O)C(C=CC)O)=O,16,3,0,3,28,0.000143
G5,C(C(C(CC=C)O)C(C)O)=O,8,3,0,3,28,0.000143
G5,C(C(C=C)C(CC(C)O)O)=O,8,2,0,2,28,9.499999999999999e-05
G5,C(C(C(C)O)C(C=CCC=O)O)=O,16,2,0,2,28,9.6e-05
G5,C(C(C(CC=CC=O)O)C(C)O)=O,16,2,0,2,28,9.6e-05
G5,C(C(C=CC=O)C(CC(C)O)O)=O,16,1,0,1,28,4.8e-05
G5,C(C(C)(C(C(CC(C)=O)O)O)O)=O,8,2,0,2,45,9.6e-05
G5,C(C(C(C(CC(C)=O)O)(C)O)O)=O,8,2,0,2,25,9.499999999999999e-05
G5,C(C(C(C(CO)O)C(C)(C)O)=O)=O,4,2,0,2,0,9.499999999999999e-05
G5,C(CC(C(CC(CO)O)=O)O)(C)=O,4,1,0,1,0,4.8e-05
G5,C(C(CC(CO)O)(CC(C)=O)O)=O,4,1,0,1,0,4.8e-05
G5,C(C)(CC(C(C(C)(CO)O)O)O)=O,8,1,0,1,49,4.8e-05
G5,C(CO)(C(C(CO)O)C(C)(C)O)=O,4,2,0,2,0,9.499999999999999e-05
G5,C(C(C(C)(C)O)O)(CC(CO)O)=O,4,2,0,2,0,9.499999999999999e-05
G5,C(C)(CC(CO)(CC(CO)O)O)=O,4,1,0,1,0,4.8e-05
G5,C(CO)(C(C(CO)O)C(C=C)O)=O,8,2,0,2,0,9.499999999999999e-05
G5,C(C(C(C=C)O)O)(CC(CO)O)=O,8,2,0,2,0,9.499999999999999e-05
G5,C(C(C(CO)O)O)(CC(C)(C)O)=O,4,1,0,1,0,4.8e-05
G5,C(C)(CC(C)(C(C(CO)O)O)O)=O,8,1,0,1,0,4.8e-05
G5,C(CC(C=C)O)(C(C(CO)O)O)=O,8,1,0,1,0,4.8e-05
G5,C(C(C=O)C(C(C(C)O)O)O)(O)=O,16,5,0,5,28,0.000251
G5,C(CC(C(C(C)O)O)O)(CCO)=O,8,2,0,2,6,0.00010700000000000001
G5,C(C)(C(CO)C(C(C(C)O)O)O)=O,16,3,0,3,28,0.000154
G5,C(C)(CC(C(C(C)O)O)O)=O,8,1,0,1,28,4.8e-05
G5,C(OC(C=O)C(C(C(C)O)O)O)=O,16,2,0,2,28,9.6e-05
G5,C(C(C(C(C(C)O)O)O)CC=O)=O,16,2,0,2,28,9.6e-05
G5,C1OC(C(C=1)=O)C(C(C(C)O)O)O,16,2,0,2,28,9.499999999999999e-05
G5,C(C(C(C)C(C(C(C)O)O)O)=O)=O,16,1,0,1,28,4.8e-05
G5,C(C(C=C)C(C(C(C)O)O)O)=O,16,2,0,2,28,9.499999999999999e-05
G5,C(C(C(CC(O)=O)O)C(CO)O)=O,8,3,0,3,6,0.000154
G5,C(C(C=O)C(CC(CO)O)O)(O)=O,8,6,0,6,6,0.000309
G5,C(C(C(CO)O)C(C(C=O)=O)O)=O,8,3,0,3,6,0.000154
G5,C(C(C(CO)O)C(C)(CCO)O)=O,8,3,0,3,6,0.000154
G5,C(CC(CC(CO)O)O)(CCO)=O,4,2,0,2,6,0.000106
G5,C(C)(C(CO)C(CC(CO)O)O)=O,8,3,0,3,6,0.000154
G5,C(C(C(CO)O)C(C)(C)O)=O,4,2,0,2,6,9.6e-05
G5,C(C)(CC(CC(CO)O)O)=O,4,1,0,1,6,4.8e-05
G5,C(OCC(C(C=O)C(CO)O)O)=O,8,2,0,2,6,9.499999999999999e-05
G5,C(OC(C=O)C(CC(CO)O)O)=O,8,2,0,2,6,9.499999999999999e-05
G5,C(C(C(CO)O)C(CCC=O)O)=O,8,3,0,3,6,0.000143
G5,C(C(C(CC(CO)O)O)CC=O)=O,8,3,0,3,43,0.000154
G5,C(C(C(CO)O)C(C=CCO)O)=O,16,3,0,3,6,0.000154
G5,C(C(C(C(C=C)O)O)C(CO)O)=O,16,2,0,2,6,9.6e-05
G5,C(C(C(CO)O)C1(C=COC1)O)=O,8,2,0,2,6,9.499999999999999e-05
G5,C1OC(C(C=1)=O)C(CC(CO)O)O,8,2,0,2,6,9.499999999999999e-05
G5,C(C(C(CO)O)C(C(CC)=O)O)=O,8,2,0,2,6,9.499999999999999e-05
G5,C(C(C(CO)O)C(C=O)(CC)O)=O,8,2,0,2,6,9.499999999999999e-05
G5,C(C(C(C)C(CC(CO)O)O)=O)=O,8,1,0,1,6,4.8e-05
G5,C(C(C(CO)O)C(C=C)O)=O,8,4,0,4,6,0.00018999999999999998
G5,C(C(C(CO)O)C(C=CC)O)=O,16,3,0,3,6,0.000143
G5,C(C(C(CC=C)O)C(CO)O)=O,8,3,0,3,6,0.000143
G5,C(C(C=C)C(CC(CO)O)O)=O,8,2,0,2,6,9.499999999999999e-05
G5,C(C(C(CO)O)(CC(C)=O)O)=O,4,5,0,5,29,0.000261
G5,C(C(C=C)C(C=O)(C(CO)O)O)=O,8,2,0,2,45,9.6e-05
G5,C(C(C=C)C(C(C(CO)O)=O)O)=O,8,2,0,2,29,0.000106
G5,C(C(C(C)=O)(C(C(C=O)=O)O)O)=O,4,4,0,4,1,0.00019099999999999998
G5,C(C(C(C(C(C(C)=O)=O)O)O)=O)=O,4,4,0,4,25,0.00019099999999999998
G5,C(C=O)(C(C)(C(C(C=O)=O)O)O)=O,4,3,0,3,25,0.000144
G5,C(C(CO)(CC(C(C=O)=O)=O)O)=O,2,1,0,1,25,4.8e-05
G5,C(CO)(C(CC(C(C=O)=O)=O)O)=O,2,1,0,1,25,4.8e-05
G5,C(C(C=O)(C(C(C=O)=O)O)O)=O,2,5,0,5,1,0.000239
G5,C(C(C(C(C(C=O)=O)O)O)=O)=O,3,3,0,3,1,0.000143
G5,C(C(C(C(C)(CCO)O)O)=O)=O,4,3,0,3,28,0.000154
G5,C(C(CO)(C(C(C)=O)CO)O)=O,4,4,0,4,28,0.000202
G5,C(C(C(C(C)(C)O)O)=O)=O,2,2,0,2,5,9.6e-05
G5,C(C(CO)(CC(C)=O)O)=O,2,8,0,8,17,0.000393
G5,C(OCC(C)(C(C(C=O)=O)O)O)=O,4,2,0,2,35,9.6e-05
G5,C(C(CO)(CC(COC=O)=O)O)=O,2,3,0,3,5,0.000143
G5,C(OCC(CC(C(CO)=O)O)=O)=O,2,3,0,3,5,0.000143
G5,C(C(CO)(C(C(C)=O)OC=O)O)=O,4,3,0,3,35,0.000143
G5,C(OC(C(C)=O)C(C(CO)=O)O)=O,4,3,0,3,35,0.000143
G5,C(OCC(C(C(C=O)=O)O)O)=O,4,2,0,2,28,9.6e-05
G5,C(C(CO)(C(C=O)OC=O)O)=O,4,2,0,2,28,9.6e-05
G5,C(OC(C=O)C(C(CO)=O)O)=O,4,2,0,2,5,9.6e-05
G5,C(C)(OCC(C(C(C=O)=O)O)O)=O,4,2,0,2,28,9.6e-05
G5,C(C)(OC(C=O)C(C=O)(CO)O)=O,4,2,0,2,28,9.6e-05
G5,C(C)(OC(C=O)C(C(CO)=O)O)=O,4,2,0,2,28,9.6e-05
G5,C(CCC(C(C(C=O)=O)O)O)=O,4,5,0,5,27,0.00024900000000000004
G5,C(C(C(C(C=O)=O)O)O)=CCO,8,5,0,5,28,0.00024900000000000004
G5,C(C(CO)(C(C(C=O)=O)O)O)(O)=O,4,7,0,7,33,0.000349
G5,C(C(CO)(C(C(C(O)=O)=O)O)O)=O,4,3,0,3,33,0.000154
G5,C(CO)(C(C(C(C(O)=O)=O)O)O)=O,4,3,0,3,5,0.000154
G5,C(CC(C)(C(C(C=O)=O)O)O)(O)=O,4,3,0,3,6,0.000154
G5,C(CC(CC(C(CO)=O)O)=O)(O)=O,2,5,0,5,29,0.000261
G5,C(C(CO)(C(C(O)=O)C(C)=O)O)=O,4,3,0,3,6,0.000154
G5,C(C(C(C)=O)C(C(CO)=O)O)(O)=O,4,7,0,7,5,0.000357
G5,C(C(C(C(C=O)=O)O)O)=CC(O)=O,8,3,0,3,18,0.000154
G5,C1(C(CCO1)(C(C(C=O)=O)O)O)=O,4,3,0,3,28,0.000143
G5,C(C(CO)(C1C(C(OC1)=O)=O)O)=O,4,2,0,2,28,9.6e-05
G5,C(C(C1C(C(OC1)=O)=O)O)(CO)=O,4,2,0,2,28,9.6e-05
G5,C1(CC(CO1)(C(C(C=O)=O)O)O)=O,4,2,0,2,28,9.6e-05
G5,C(C(CO)(C1C(OCC1=O)=O)O)=O,4,2,0,2,28,9.6e-05
G5,C1(C(C(CO1)=O)C(C(CO)=O)O)=O,4,2,0,2,28,9.6e-05
G5,C(C(CO)(C1C(CC(O1)=O)=O)O)=O,4,2,0,2,28,9.6e-05
G5,C1(CC(C(C(C(CO)=O)O)O1)=O)=O,4,2,0,2,28,9.6e-05
G5,C=CC(C(C(C(C=O)=O)O)O)O,8,4,0,4,28,0.00019099999999999998
G5,C1C(COC=1)(C(C(C=O)=O)O)O,4,3,0,3,28,0.000143
G5,C(C(CO)(C1C(C=CO1)=O)O)=O,4,3,0,3,28,0.000143
G5,C(CO)(C(C1C(C=CO1)=O)O)=O,4,3,0,3,28,0.000143
G5,C(C(C=C)(C(C(C=O)=O)O)O)(O)=O,4,5,0,5,7,0.00025
G5,C(C(C(C(C(CO)(C)O)O)O)=O)=O,8,4,0,4,11,0.000202
G5,C(C(C)(C(C(C=O)=O)O)O)(CC)=O,4,2,0,2,28,9.6e-05
G5,C(C)(C(CC)(C(C(C=O)=O)O)O)=O,4,2,0,2,28,9.6e-05
G5,C(C(CO)(CC(C(CC)=O)=O)O)=O,2,2,0,2,0,9.7e-05
G5,C(C(CC(C(CC)=O)=O)O)(CO)=O,2,1,0,1,28,4.8e-05
G5,C(C(CO)(C(C(C(C)=O)=O)C)O)=O,4,2,0,2,0,9.7e-05
G5,C(C(C(C(C(C)=O)=O)C)O)(CO)=O,4,1,0,1,28,4.8e-05
G5,C(C(CO)(CC(CC(C)=O)=O)O)=O,2,2,0,2,49,9.7e-05
G5,C(C)(CC(CC(C(CO)=O)O)=O)=O,2,1,0,1,28,4.8e-05
G5,C(C(CO)(C(C(C)=O)C(C)=O)O)=O,2,3,0,3,28,0.000145
G5,C(C)(C(C(C)=O)C(C(CO)=O)O)=O,2,2,0,2,28,9.6e-05
G5,C(CC(C)C(C(C(C=O)=O)O)O)=O,8,4,0,4,28,0.000202
G5,C(C(C)CC(C(C(C=O)=O)O)O)=O,8,2,0,2,28,9.6e-05
G5,C(C(C)C(C=O)C(C=O)(CO)O)=O,8,3,0,3,28,0.000145
G5,C(C(C(C=O)C(C=O)C)O)(CO)=O,8,2,0,2,5,9.6e-05
G5,C(C(C(C(C=O)=O)O)O)(CC)=O,4,3,0,3,28,0.000143
G5,C(C(CC)(C(C(C=O)=O)O)O)=O,4,2,0,2,28,9.6e-05
G5,C(C(C=O)C(C(C(C=O)=O)O)O)=O,4,4,0,4,5,0.000192
G5,C(C(CC)(C(C(C=O)=O)O)O)(O)=O,4,2,0,2,28,9.6e-05
G5,C(C(CO)(C(C(C(O)=O)=O)C)O)=O,4,3,0,3,28,0.000156
G5,C(C(C(C(C(O)=O)=O)C)O)(CO)=O,4,2,0,2,5,0.00010700000000000001
G5,C(C(C=CC)(C(C(C=O)=O)O)O)=O,8,2,0,2,28,9.6e-05
G5,C(C(CC=C)(C(C(C=O)=O)O)O)=O,4,2,0,2,28,9.6e-05
G5,C(C(CO)(C(C=C)C(C=O)=O)O)=O,4,1,0,1,28,4.8e-05
G5,C(CO)(C(C(C=C)C(C=O)=O)O)=O,4,1,0,1,28,4.8e-05
G5,C(C(C)(C(C(C=O)=O)O)O)=CC=O,8,2,0,2,28,9.6e-05
G5,C(C(C(C(C=O)=O)O)O)=CC(C)=O,8,2,0,2,28,9.6e-05
G5,C(C(CO)(CC(C=CC=O)=O)O)=O,4,1,0,1,28,4.8e-05
G5,C(CO)(C(CC(C=CC=O)=O)O)=O,4,2,0,2,45,9.499999999999999e-05
G5,C(CC(C(C(C(C=O)=O)O)O)=C)=O,4,2,0,2,28,9.6e-05
G5,C=C(C=O)CC(C(C(C=O)=O)O)O,4,2,0,2,28,9.6e-05
G5,C(C(C(C=O)=C)C(C=O)(CO)O)=O,4,2,0,2,45,9.7e-05
G5,C(C(C(C=O)=C)C(C(CO)=O)O)=O,4,1,0,1,28,4.8e-05
G5,C(C)(C(C(C(C=O)=O)O)O)=CC=O,8,2,0,2,28,9.6e-05
G5,C(C(C(C(C=O)=O)O)O)=C(C=O)C,8,2,0,2,28,9.6e-05
G5,C(C)=CC(CO)(C(C(C=O)=O)O)O,8,2,0,2,28,9.6e-05
G5,C(C(CO)(C(C(C=CC)=O)O)O)=O,8,6,0,6,28,0.00029
G5,C(CC(CO)(C(C(C=O)=O)O)O)=C,4,2,0,2,28,9.6e-05
G5,C(C(CO)(C(C(CO)=O)C=C)O)=O,4,2,0,2,11,9.7e-05
G5,C(CO)(C(C=C)C(C(CO)=O)O)=O,4,1,0,1,28,4.8e-05
G5,C(C(CO)(C(C(CC=C)=O)O)O)=O,4,6,0,6,28,0.00029
G5,C=CC(C(C)(C(C(C=O)=O)O)O)O,8,2,0,2,28,9.6e-05
G5,C(C(CO)(CC(C(C=C)O)=O)O)=O,4,2,0,2,0,9.7e-05
G5,C(CC(C(CO)=O)O)(C(C=C)O)=O,4,1,0,1,28,4.8e-05
G5,C=C(CO)CC(C(C(C=O)=O)O)O,4,2,0,2,28,9.6e-05
G5,C(C(CO)(C(C=O)C(CO)=C)O)=O,4,2,0,2,49,9.7e-05
G5,C(C(C(CO)=C)C(C(CO)=O)O)=O,4,1,0,1,28,4.8e-05
G5,C(C(C(C(C=O)=O)O)O)=C(C)CO,8,2,0,2,28,9.6e-05
G5,C(C(C(C(C=O)=O)O)O)=CC,8,3,0,3,5,0.000143
G5,C(CC(C(C(C=O)=O)O)O)=C,4,3,0,3,5,0.000143
G5,C(C(C=C)C(C=O)(CO)O)=O,4,5,0,5,29,0.00023999999999999998
G5,C(C(C=C)C(C(CO)=O)O)=O,4,4,0,4,29,0.00018999999999999998
G5,C(CC=CC(C(C(C=O)=O)O)O)=O,8,2,0,2,28,9.6e-05
G5,C(CC(C(C(C=O)=O)O)O)=CC=O,8,2,0,2,28,9.6e-05
G5,C(C(C=CC=O)C(C=O)(CO)O)=O,8,1,0,1,28,4.8e-05
G5,C(C(C=CC=O)C(C(CO)=O)O)=O,8,1,0,1,28,4.8e-05
G5,C(C(C(C)(C)O)C(C(CO)=O)O)=O,4,2,0,2,2,9.499999999999999e-05
G5,C(CC(C(C(C(C)(C)O)O)=O)O)=O,4,2,0,2,2,9.499999999999999e-05
G5,C(C)(CC(CC(C(CO)=O)O)O)=O,4,2,0,2,6,9.499999999999999e-05
G5,C(CC(C(CO)(CC(C)=O)O)O)=O,4,1,0,1,2,4.8e-05
G5,C(C(C(C=C)O)C(C(CO)=O)O)=O,8,2,0,2,2,9.499999999999999e-05
G5,C(CC(C(C(C(C)=O)=O)O)O)(O)=O,4,3,0,3,25,0.000154
G5,C(CC(CC(C(CO)=O)=O)O)(O)=O,2,2,0,2,25,0.00010700000000000001
G5,C(C(C=O)C(C(C)=O)(CO)O)(O)=O,4,6,0,6,25,0.0003
G5,C(C(C=O)C(C(CO)=O)(C)O)(O)=O,4,6,0,6,25,0.000298
G5,C(C(C=O)(C(C(C(C)=O)=O)O)O)=O,2,4,0,4,25,0.00019099999999999998
G5,C(C(C=O)(CC(C(CO)=O)=O)O)=O,1,1,0,1,25,4.8e-05
G5,C(C(C(CC(C(CO)=O)=O)O)=O)=O,2,1,0,1,25,4.8e-05
G5,C(C(C)=O)(C(C(C)(CCO)O)O)=O,4,3,0,3,25,0.000154
G5,C(C(CO)=O)(CC(C)(CCO)O)=O,2,3,0,3,29,0.000154
G5,C(C)(C(CO)(CC(CCO)=O)O)=O,2,2,0,2,25,0.00010700000000000001
G5,C(CO)(C(C)(CC(CCO)=O)O)=O,2,2,0,2,25,0.00010700000000000001
G5,C(C)(C(CO)C(C(C)=O)(CO)O)=O,4,3,0,3,25,0.000154
G5,C(C)(C(CO)C(C(CO)=O)(C)O)=O,4,3,0,3,25,0.000154
G5,C(C(C)=O)(C(C(C)(C)O)O)=O,2,2,0,2,25,9.6e-05
G5,C(C(CO)=O)(CC(C)(C)O)=O,1,1,0,1,25,4.8e-05
G5,C(C)(C(CO)(CC(C)=O)O)=O,2,2,0,2,11,9.499999999999999e-05
G5,C(CO)(C(C)(CC(C)=O)O)=O,2,2,0,2,11,9.499999999999999e-05
G5,C(OCC(C(C(C(C)=O)=O)O)O)=O,4,2,0,2,25,9.6e-05
G5,C(OCC(CC(C(CO)=O)=O)O)=O,2,1,0,1,25,4.8e-05
G5,C(C)(C(CO)(C(C=O)OC=O)O)=O,4,2,0,2,25,9.6e-05
G5,C(CO)(C(C)(C(C=O)OC=O)O)=O,4,2,0,2,25,9.6e-05
G5,C(CCC(C(C(C(C)=O)=O)O)O)=O,4,4,0,4,25,0.000202
G5,C(CCC(CC(C(CO)=O)=O)O)=O,2,2,0,2,2,9.6e-05
G5,C(CO)=CC(C(C(C(C)=O)=O)O)O,8,3,0,3,25,0.000154
G5,C(CO)=CC(CC(C(CO)=O)=O)O,4,2,0,2,25,0.00010700000000000001
G5,C(C(C(C(C(C(C)=O)=O)O)O)O)=C,8,2,0,2,28,9.6e-05
G5,C(C(C(CC(C(CO)=O)=O)O)O)=C,4,1,0,1,28,4.8e-05
G5,C1C(COC=1)(C(C(C(C)=O)=O)O)O,4,2,0,2,25,9.6e-05
G5,C1C(COC=1)(CC(C(CO)=O)=O)O,2,1,0,1,25,4.8e-05
G5,C(C)(C(CO)(C1C(C=CO1)=O)O)=O,4,2,0,2,25,9.6e-05
G5,C(CO)(C(C)(C1C(C=CO1)=O)O)=O,4,2,0,2,25,9.6e-05
G5,C(C(C(C(C(C)=O)=O)O)O)(CC)=O,4,2,0,2,25,9.6e-05
G5,C(C(CC(C(CO)=O)=O)O)(CC)=O,2,1,0,1,25,4.8e-05
G5,C(C(CC)(C(C(C(C)=O)=O)O)O)=O,4,2,0,2,25,9.6e-05
G5,C(C(CC)(CC(C(CO)=O)=O)O)=O,2,1,0,1,25,4.8e-05
G5,C(C)(C(CO)(C(C(C=O)=O)C)O)=O,4,2,0,2,28,9.7e-05
G5,C(CO)(C(C)(C(C(C=O)=O)C)O)=O,4,1,0,1,25,4.8e-05
G5,C=CC(C(C(C(C)=O)=O)O)O,4,4,0,4,25,0.00018999999999999998
G5,C=CC(CC(C(CO)=O)=O)O,2,3,0,3,29,0.000143
G5,C(C)=CC(C(C(C(C)=O)=O)O)O,8,3,0,3,25,0.000143
G5,C(C)=CC(CC(C(CO)=O)=O)O,4,2,0,2,25,9.499999999999999e-05
G5,C(CC(C(C(C(C)=O)=O)O)O)=C,4,3,0,3,25,0.000143
G5,C(CC(CC(C(CO)=O)=O)O)=C,2,2,0,2,25,9.499999999999999e-05
G5,C(C(C=C)C(C(C)=O)(CO)O)=O,4,3,0,3,29,0.000143
G5,C(C(C=C)C(C(CO)=O)(C)O)=O,4,3,0,3,29,0.000143
G5,C(C(C(C)(C)O)O)(CC(CO)=O)=O,2,2,0,2,27,9.499999999999999e-05
G5,C(CO)(C(C(CO)=O)C(C)(C)O)=O,1,2,0,2,27,9.499999999999999e-05
G5,C(C(C(C=C)O)O)(CC(CO)=O)=O,4,2,0,2,27,9.499999999999999e-05
G5,C(CO)(C(C(CO)=O)C(C=C)O)=O,2,2,0,2,27,9.499999999999999e-05
G5,C(C(C(C)(C)O)O)(C(C(C)=O)O)=O,4,2,0,2,0,9.499999999999999e-05
G5,C(CC(C)(C)O)(C(C(CO)=O)O)=O,2,1,0,1,0,4.8e-05
G5,C(C(C(C=C)O)O)(C(C(C)=O)O)=O,8,2,0,2,0,9.499999999999999e-05
G5,C(CC(C=C)O)(C(C(CO)=O)O)=O,4,1,0,1,0,4.8e-05
G5,C(C(C=O)C(C(C(C)O)=O)O)(O)=O,8,7,0,7,25,0.000346
G5,C(CC(C(C(C)O)=O)O)(CCO)=O,4,3,0,3,30,0.000154
G5,C(C)(C(CO)C(C(C(C)O)=O)O)=O,8,3,0,3,25,0.000154
G5,C(C(C(C)O)(C(C(C)=O)CO)O)=O,8,3,0,3,25,0.000154
G5,C(CC(C(C(C)O)=O)O)(C)=O,4,3,0,3,25,0.000143
G5,C(C(C(C)O)(CC(C)=O)O)=O,4,4,0,4,25,0.00019099999999999998
G5,C(C(C(C=O)OC=O)O)(C(C)O)=O,8,2,0,2,25,9.6e-05
G5,C(C(C(C)O)(C(C=O)OC=O)O)=O,8,2,0,2,25,9.6e-05
G5,C(C(C1C(C=CO1)=O)O)(C(C)O)=O,8,2,0,2,25,9.6e-05
G5,C(C(C(C)O)(C1C(C=CO1)=O)O)=O,8,2,0,2,25,9.6e-05
G5,C(C(C(C(C=O)=O)C)O)(C(C)O)=O,8,1,0,1,25,4.8e-05
G5,C(C(C(C)O)(C(C(C=O)=O)C)O)=O,8,2,0,2,28,9.7e-05
G5,C(C(C=C)C(C(C(C)O)=O)O)=O,8,3,0,3,29,0.000143
G5,C(C(C=C)C(C=O)(C(C)O)O)=O,8,4,0,4,29,0.00019099999999999998
G5,C(CC(C(C(C(C)O)=O)O)O)(O)=O,8,4,0,4,25,0.000202
G5,C(C(C=O)C(CO)(C(C)O)O)(O)=O,8,6,0,6,25,0.000309
G5,C(C(C(C)(CCO)O)O)(C(C)O)=O,8,3,0,3,25,0.000154
G5,C(CC(CO)(C(C)O)O)(CCO)=O,4,3,0,3,29,0.000165
G5,C(C)(C(CO)C(CO)(C(C)O)O)=O,8,3,0,3,25,0.000154
G5,C(C(C(C)(C)O)O)(C(C)O)=O,4,2,0,2,25,9.6e-05
G5,C(C)(CC(CO)(C(C)O)O)=O,4,1,0,1,25,4.8e-05
G5,C(OCC(C(C(C(C)O)=O)O)O)=O,8,2,0,2,25,9.6e-05
G5,C(OC(C=O)C(CO)(C(C)O)O)=O,8,2,0,2,25,9.6e-05
G5,C(CCC(C(C(C(C)O)=O)O)O)=O,8,3,0,3,25,0.000143
G5,C(C(C(CO)(C(C)O)O)CC=O)=O,8,4,0,4,43,0.000213
G5,C(C(C(C=CCO)O)O)(C(C)O)=O,16,3,0,3,25,0.000154
G5,C(C(C)O)(C(C(C(C=C)O)O)O)=O,16,2,0,2,25,9.6e-05
G5,C(C(C1(C=COC1)O)O)(C(C)O)=O,8,2,0,2,25,9.6e-05
G5,C1OC(C(C=1)=O)C(CO)(C(C)O)O,8,2,0,2,25,9.6e-05
G5,C(C(C(C(C(C)O)=O)O)O)(CC)=O,8,2,0,2,25,9.6e-05
G5,C(C(CC)(C(C(C(C)O)=O)O)O)=O,8,2,0,2,25,9.6e-05
G5,C(C(C(C)C(CO)(C(C)O)O)=O)=O,8,1,0,1,25,4.8e-05
G5,C(C(C(C=C)O)O)(C(C)O)=O,8,4,0,4,25,0.00018999999999999998
G5,C(C(C(C=CC)O)O)(C(C)O)=O,16,3,0,3,25,0.000143
G5,C(C(C(CC=C)O)O)(C(C)O)=O,8,3,0,3,25,0.000143
G5,C(C(C=C)C(CO)(C(C)O)O)=O,8,2,0,2,25,9.499999999999999e-05
G5,C(C(C=O)C1(CC(CC1O)O)O)=O,8,2,0,2,45,9.6e-05
G5,C(C(C=O)C1(CC(C(C1)=O)O)O)=O,4,2,0,2,26,9.6e-05
G5,C(C(C=O)C1(C=CC(C1O)O)O)=O,8,2,0,2,28,9.6e-05
G5,C(C(C=O)C1(C=CC(C(C1)O)=O)O)=O,4,2,0,2,45,9.6e-05
G5,C(C1(C=CC(C1)(C(C=O)C=O)O)O)=O,4,2,0,2,45,9.6e-05
G5,C(C(C=O)C(C1C=CC(C1O)=O)O)=O,8,2,0,2,45,9.6e-05
G5,C(C(C=O)C1(C(C=CC(C1)O)=O)O)=O,4,2,0,2,27,9.6e-05
G5,C(C(C=O)C(C(C(O)=O)CO)O)=O,4,3,0,3,18,0.000144
G5,C(C(C=O)C(C(CC(O)=O)=O)O)=O,2,6,0,6,17,0.000298
G5,C(C(C=O)C(C=O)(CC(O)=O)O)=O,2,3,0,3,17,0.000155
G5,C(C(C=O)C(C(CO)CO)O)=O,2,2,0,2,18,9.6e-05
G5,C(C(C=O)C(C(CO)C(C)O)O)=O,8,2,0,2,18,9.6e-05
G5,C(C(C=O)C(C(C)=O)(CCO)O)=O,2,4,0,4,14,0.000202
G5,C(C(C=O)C(CCO)(CC=O)O)=O,2,2,0,2,2,9.6e-05
G5,C(C(C=O)C(C=C)(C(CO)O)O)=O,4,2,0,2,7,9.6e-05
G5,C(C(C=O)C(CC(CCO)O)O)=O,4,2,0,2,18,9.6e-05
G5,C(C(C=O)C(CC(O)=O)O)=O,2,3,0,3,28,0.000155
G5,C(C(C=O)C(CC(C(C)O)O)O)=O,8,2,0,2,11,9.6e-05
G5,C(C(C=O)C(C=O)(C(C)=O)O)=O,2,4,0,4,25,0.00019099999999999998
G5,C(C(C=O)C(C(C(C)=O)=O)O)=O,2,5,0,5,25,0.00023799999999999998
G5,C(C(C=O)C(C(C=O)=O)(C)O)=O,2,4,0,4,25,0.00019099999999999998
G5,C(CC(CC(C(C=O)=O)=O)O)=O,2,4,0,4,29,0.00018999999999999998
G5,C(C(C=O)C(C=O)(C=O)O)=O,1,3,0,3,1,0.000143
G5,C(C(C=O)C(C(C=O)=O)O)=O,2,5,0,5,1,0.00023799999999999998
G5,C(C(C=O)C(C(C(C=O)O)=O)O)=O,4,2,0,2,5,9.6e-05
G5,C(C(C=O)C(C)(CCO)O)=O,2,3,0,3,28,0.000155
G5,C(C(C=O)C(CC(CC=O)=O)O)=O,2,3,0,3,9,0.000144
G5,C(C(C=O)C(CC=O)(CC=O)O)=O,1,2,0,2,9,9.6e-05
G5,C(C(C(CC=O)=O)C(CC=O)O)=O,4,2,0,2,9,9.6e-05
G5,C(C(C=O)C(C)(C)O)=O,1,2,0,2,45,9.6e-05
G5,C(C(C=O)C(CCC=O)(CO)O)=O,2,3,0,3,7,0.000144
G5,C(C(C=O)C(CCC(CO)=O)O)=O,2,5,0,5,44,0.000239
G5,C(C(C=O)C(C)(CC(C=O)O)O)=O,4,2,0,2,27,9.6e-05
G5,C(C(C=O)C(C=CCO)(CO)O)=O,4,3,0,3,11,0.000155
G5,C(OCC(C)(C(C=O)C=O)O)=O,2,2,0,2,35,9.6e-05
G5,C(CC(CC(COC=O)=O)O)=O,2,3,0,3,35,0.000143
G5,C(CC(C(C(C)=O)OC=O)O)=O,4,3,0,3,35,0.000143
G5,C(OCC(C(C=O)C=O)O)=O,2,2,0,2,28,9.6e-05
G5,C(CC(C(C=O)OC=O)O)=O,4,2,0,2,28,9.6e-05
G5,C(C(C=O)C(COC(CO)=O)O)=O,2,2,0,2,40,9.6e-05
G5,C(CC(C(C=O)OC(CO)=O)O)=O,4,4,0,4,40,0.00019099999999999998
G5,C(C(C=O)C(COC(C)=O)O)=O,2,2,0,2,28,9.6e-05
G5,C(CC(C(C=O)OC(C)=O)O)=O,4,2,0,2,28,9.6e-05
G5,C(C(C=O)C(C(CCC=O)=O)O)=O,2,2,0,2,20,9.6e-05
G5,C(CCC(C=O)(C(C=O)C=O)O)=O,2,3,0,3,20,0.000144
G5,C(C(C=O)C(CCC(C=O)=O)O)=O,2,3,0,3,20,0.000144
G5,C(CC(C(C=O)CC(C=O)=O)O)=O,4,2,0,2,20,9.6e-05
G5,C(C(C=O)C(CCC=O)O)=O,2,4,0,4,27,0.00019099999999999998
G5,C(C(C=O)C(C(C=CCO)=O)O)=O,4,2,0,2,55,9.6e-05
G5,C(C(C=O)C(C=O)(C=CCO)O)=O,4,2,0,2,55,9.6e-05
G5,C(C(C=O)C(C=CCO)O)=O,4,6,0,6,29,0.000297
G5,C(C(C=O)C(C(O)=O)(CO)O)=O,2,5,0,5,33,0.000252
G5,C(C(C=O)C(C(O)=O)(CC=O)O)=O,2,3,0,3,45,0.000155
G5,C(C(C=O)C(CC(C(O)=O)=O)O)=O,2,4,0,4,45,0.000202
G5,C(C(C(C(O)=O)=O)C(CC=O)O)=O,4,3,0,3,45,0.000155
G5,C(C(C=O)C(C)(CC(O)=O)O)=O,2,3,0,3,6,0.000155
G5,C(C(C=O)C(C=CC(O)=O)O)=O,4,6,0,6,29,0.000297
G5,C(C(C=O)C(C(CO)=O)(CO)O)=O,2,4,0,4,5,0.000193
G5,C(CC(C(C(C(CO)=O)=O)O)O)=O,4,3,0,3,5,0.000143
G5,C(C(C=O)C(C(C=O)(C=O)O)O)=O,2,4,0,4,1,0.00019099999999999998
G5,C(C(C=O)C(C(C=C)=O)(CO)O)=O,2,3,0,3,7,0.000145
G5,C(C(C=O)C(C(CO)=O)(C=C)O)=O,2,2,0,2,7,9.6e-05
G5,C(CC(C(C(C(C=C)=O)=O)O)O)=O,4,2,0,2,7,9.6e-05
G5,C(C(C=O)C(C(C)=O)(C(C)O)O)=O,4,4,0,4,49,0.000192
G5,C(C(C=O)C(C(C(C)O)=O)(C)O)=O,4,2,0,2,49,9.6e-05
G5,C(C(C=O)C1(CCC(C1O)=O)O)=O,4,2,0,2,47,9.6e-05
G5,C(CC(C1C(C(C(C1)=O)O)=O)O)=O,8,2,0,2,47,9.6e-05
G5,C(C(C=O)C1(COC(CC1)=O)O)=O,2,2,0,2,7,9.6e-05
G5,C(CC(C1C(COC(C1)=O)=O)O)=O,4,1,0,1,7,4.8e-05
G5,C(C(C=O)C1(COCC(C1)=O)O)=O,2,2,0,2,54,9.6e-05
G5,C(CC(C1C(CC(CO1)=O)=O)O)=O,4,2,0,2,54,9.6e-05
G5,C(CC(C1C(COCC1=O)=O)O)=O,2,2,0,2,54,9.6e-05
G5,C(C(C=O)C1(C(OCC1)=O)O)=O,2,3,0,3,28,0.000143
G5,C(CC(C1C(C(OC1)=O)=O)O)=O,4,3,0,3,28,0.000143
G5,C(C(C=O)C1(COC(C1)=O)O)=O,2,3,0,3,28,0.000143
G5,C(CC(C1C(OCC1=O)=O)O)=O,4,4,0,4,28,0.00019099999999999998
G5,C(CC(C1C(CC(O1)=O)=O)O)=O,4,3,0,3,28,0.000143
G5,C(C(C=O)C(C(C=C)O)O)=O,4,5,0,5,28,0.00023799999999999998
G5,C(C(C=O)C1(C=COC1)O)=O,2,3,0,3,28,0.000143
G5,C(CC(C1C(C=CO1)=O)O)=O,4,3,0,3,28,0.000143
G5,C(C(C=O)C1(C=CC(O)OC1)O)=O,4,2,0,2,27,9.6e-05
G5,C(CC(C1C(C=CC(O1)O)=O)O)=O,8,2,0,2,27,9.6e-05
G5,C(C(C=O)C(C(C)O)(CC=O)O)=O,4,2,0,2,45,9.6e-05
G5,C(C(C=O)C(CC(C(C)O)=O)O)=O,4,3,0,3,45,0.000143
G5,C(CC(C(C=O)C(C(C)O)=O)O)=O,8,3,0,3,45,0.000143
G5,C(C(C=O)C(C(CC(C)O)O)O)=O,8,2,0,2,11,9.6e-05
G5,C(C(C=O)C(C(C)O)(C(C)O)O)=O,3,2,0,2,49,9.6e-05
G5,C(C(C=O)C(C(O)=O)(C(C)O)O)=O,4,4,0,4,4,0.00020299999999999997
G5,C(C(C=O)C(C=CC(C=O)O)O)=O,8,3,0,3,20,0.000143
G5,C(C(C=O)C(C(C=CC=O)O)O)=O,8,2,0,2,20,9.6e-05
G5,C(C(C=O)C(C)(C(CCO)O)O)=O,4,3,0,3,45,0.000155
G5,C(C(C=O)C(C(C)(CCO)O)O)=O,4,3,0,3,29,0.000155
G5,C(C(C=C)(C(C=O)C=O)O)(O)=O,2,4,0,4,7,0.000202
G5,C(C(C=O)C(C(C(O)=O)(C)O)O)=O,4,3,0,3,25,0.000144
G5,C(C(C=O)C(C(C)(CO)O)O)=O,4,2,0,2,11,9.6e-05
G5,C(C(C=O)C(C(C)(C(C)O)O)O)=O,8,2,0,2,18,9.6e-05
G5,C(C(C=O)C1(C(CCC(C1)=O)=O)O)=O,2,2,0,2,45,9.6e-05
G5,C1(CCC(C(C1)=O)(C(C=O)C=O)O)=O,2,3,0,3,45,0.000143
G5,C(C(C=O)C1(CCC(C(C1)=O)=O)O)=O,2,3,0,3,45,0.000143
G5,C(CC(C1C(CCC(C1=O)=O)=O)O)=O,4,2,0,2,45,9.6e-05
G5,C(CC(C1C(C(CC(C1)=O)=O)=O)O)=O,4,1,0,1,45,4.8e-05
G5,C(CC(C1C(CC(C(C1)=O)=O)=O)O)=O,4,1,0,1,45,4.8e-05
G5,C(C(C=O)C(C1C(C(CC1)=O)=O)O)=O,4,3,0,3,45,0.000143
G5,C(C1C(C(CC1)(C(C=O)C=O)O)=O)=O,4,2,0,2,45,9.6e-05
G5,C(C1CCC(C1(C(C=O)C=O)O)=O)=O,4,3,0,3,45,0.000143
G5,C(C1C(C(C(C1)C(CC=O)O)=O)=O)=O,8,1,0,1,45,4.8e-05
G5,C(C(C=O)C1(CC(CC(C1)=O)=O)O)=O,1,2,0,2,45,9.6e-05
G5,C1(CC(CC(C1C(CC=O)O)=O)=O)=O,2,2,0,2,45,9.6e-05
G5,C(C1C(CC(C1)=O)(C(C=O)C=O)O)=O,4,3,0,3,45,0.000143
G5,C(C1C(CC(C1)(C(C=O)C=O)O)=O)=O,4,2,0,2,45,9.6e-05
G5,C(C(C=O)C(C1C(CC(C1)=O)=O)O)=O,4,2,0,2,45,9.6e-05
G5,C(CC(C1C(C(C=O)CC1=O)=O)O)=O,8,2,0,2,45,9.6e-05
G5,C(CC(C1C(CC(C1C=O)=O)=O)O)=O,8,1,0,1,45,4.8e-05
G5,C(C1CC(C(C1)=O)(C(C=O)C=O)O)=O,4,3,0,3,45,0.000143
G5,C(C(C=O)C(C1CC(C(C1)=O)=O)O)=O,2,3,0,3,45,0.000143
G5,C(CC(C1C(C(CC1C=O)=O)=O)O)=O,8,2,0,2,45,9.499999999999999e-05
G5,C(C(C=O)C1(CCC(C1C=O)=O)O)=O,4,2,0,2,45,9.6e-05
G5,C(C(C=O)C(C1C(CCC1=O)=O)O)=O,2,2,0,2,45,9.6e-05
G5,C(CC(C1C(C(C=O)C(C1)=O)=O)O)=O,8,1,0,1,45,4.8e-05
G5,C(C(C=O)C1(C(C(C=CC1)=O)O)O)=O,4,2,0,2,32,9.6e-05
G5,C(C(C=O)C1(C=CCC(C1O)=O)O)=O,4,2,0,2,32,9.6e-05
G5,C1(C(C(C=CC1C(CC=O)O)=O)O)=O,8,1,0,1,32,4.8e-05
G5,C(C(C=O)C1(C(C=CC(C1)=O)O)O)=O,4,2,0,2,45,9.6e-05
G5,C(C(C=O)C1(C=CC(C(C1)=O)O)O)=O,4,2,0,2,45,9.6e-05
G5,C1(C(C=CC(C1C(CC=O)O)=O)O)=O,8,2,0,2,45,9.6e-05
G5,C(C(C=O)C(C(CO)=O)(CC)O)=O,2,2,0,2,42,9.6e-05
G5,C(C(C=O)C(C(CC)=O)(CO)O)=O,2,2,0,2,42,9.6e-05
G5,C(C(C=O)C(C(CO)CC=O)O)=O,4,4,0,4,55,0.00019099999999999998
G5,C(C(C=O)C(CC(C=O)CO)O)=O,4,2,0,2,55,9.6e-05
G5,C(C(C=O)C(C(CC)=O)(C)O)=O,2,3,0,3,28,0.000143
G5,C(C(C=O)C(C(C)=O)(CC)O)=O,2,2,0,2,28,9.6e-05
G5,C(C(C=O)C(C(C)CC=O)O)=O,4,3,0,3,28,0.000143
G5,C(C(C=O)C(CC(C=O)C)O)=O,4,3,0,3,28,0.000143
G5,C(CC(C(C=O)C(C=O)C)O)=O,8,3,0,3,49,0.000143
G5,C(C(C(C(C(C=O)C=O)O)=O)C)=O,4,2,0,2,49,9.6e-05
G5,C(C(C)C(C=O)(C(C=O)C=O)O)=O,4,2,0,2,49,9.6e-05
G5,C(C(C=O)C(C(C(CO)C)=O)O)=O,4,2,0,2,28,9.6e-05
G5,C(C(C=O)C(C=O)(C(CO)C)O)=O,4,2,0,2,28,9.6e-05
G5,C(C(C=O)C(C(C(C=O)C)O)O)=O,8,2,0,2,49,9.6e-05
G5,C(C(C=O)C(C(C)C(C=O)O)O)=O,8,2,0,2,49,9.6e-05
G5,C(C(C=O)C(C(CC)=O)O)=O,2,3,0,3,28,0.000143
G5,C(C(C=O)C(C=O)(CC)O)=O,2,2,0,2,28,9.6e-05
G5,C(C(C=O)C1(C=CC(C1CO)=O)O)=O,4,2,0,2,45,9.6e-05
G5,C(C(C=O)C(C(C=O)C(C)=O)O)=O,4,4,0,4,6,0.000192
G5,C(C(C=O)C(C)(C(C=O)C=O)O)=O,1,2,0,2,6,9.6e-05
G5,C(C(C=O)C(CC(CC=O)O)=O)=O,2,1,0,1,6,4.8e-05
G5,C(C(C=O)C(C(C=O)C=O)O)=O,1,3,0,3,1,0.000143
G5,C(C(C=O)CC(C(C=O)C=O)O)=O,2,2,0,2,43,9.6e-05
G5,C(CC(C(C=O)C(C=O)C=O)O)=O,4,1,0,1,43,4.8e-05
G5,C(C(C=O)C(C(O)=O)(CC)O)=O,2,2,0,2,28,9.6e-05
G5,C(C(C=O)C1(C=C(C(C1)=O)CO)O)=O,2,2,0,2,45,9.6e-05
G5,C(C(C=O)C1(C(CO)=CC(C1)=O)O)=O,2,2,0,2,45,9.6e-05
G5,C(CC(C1C(C=C(C1=O)CO)=O)O)=O,4,2,0,2,45,9.6e-05
G5,C(C(C=O)C1(C(C(CO)=CC1)=O)O)=O,2,2,0,2,45,9.6e-05
G5,C(C(C=O)C1(C(CC=C1CO)=O)O)=O,2,2,0,2,45,9.6e-05
G5,C(CC(C1C=C(C(C1=O)=O)CO)O)=O,4,1,0,1,45,4.8e-05
G5,C(C(C=O)C1(C(C(C(C1)O)=O)=C)O)=O,4,2,0,2,45,9.6e-05
G5,C(C(C=O)C1(C(C(CC1O)=O)=C)O)=O,4,2,0,2,45,9.6e-05
G5,C(CC(C1C(C(C(C1O)=O)=C)=O)O)=O,8,2,0,2,45,9.6e-05
G5,C(C(C=O)C1(C(C(C(C1)=C)=O)O)O)=O,4,2,0,2,47,9.6e-05
G5,C(C(C=O)C1(C(CC(C1O)=O)=C)O)=O,4,2,0,2,47,9.6e-05
G5,C1(C(C(C(C1C(CC=O)O)=C)=O)O)=O,8,1,0,1,47,4.8e-05
G5,C(C(C=O)C1(C(C(C(C1)=O)=C)O)O)=O,4,2,0,2,45,9.6e-05
G5,C(C(C=O)C1(C(C(C(C1)=O)O)=C)O)=O,4,2,0,2,45,9.6e-05
G5,C1(C(C(C(C1C(CC=O)O)=O)=C)O)=O,8,2,0,2,45,9.6e-05
G5,C(C(C=O)C1(C(C(C(C1)O)=C)=O)O)=O,4,2,0,2,45,9.6e-05
G5,C(C(C=O)C1(C(CC(C1=C)O)=O)O)=O,4,2,0,2,45,9.6e-05
G5,C(CC(C1C(C(C(C1O)=C)=O)=O)O)=O,8,2,0,2,45,9.6e-05
G5,C(C(C=O)C1(C=C(C=O)C(C1)O)O)=O,4,2,0,2,45,9.6e-05
G5,C(C(C=O)C(C1C(CC(C=1)=O)O)O)=O,4,2,0,2,45,9.6e-05
G5,C(CC(C1C(C=C(C=O)C1O)=O)O)=O,8,2,0,2,45,9.6e-05
G5,C(C(C=O)C1(C(C(C=O)=CC1)O)O)=O,4,2,0,2,27,9.6e-05
G5,C(C(C=O)C(C1C(C(CC=1)=O)O)O)=O,4,2,0,2,27,9.6e-05
G5,C1(C(C(C=O)=CC1C(CC=O)O)O)=O,8,1,0,1,27,4.8e-05
G5,C(C(C=O)C1(C(C=C(C=O)C1)O)O)=O,4,2,0,2,45,9.6e-05
G5,C(C(C=O)C(C1CC(C(C=1)O)=O)O)=O,4,2,0,2,45,9.6e-05
G5,C1(C(C=C(C=O)C1C(CC=O)O)O)=O,8,1,0,1,45,4.8e-05
G5,C(C(C=O)C1(C(C=O)=CC(C1)O)O)=O,4,2,0,2,45,9.6e-05
G5,C(C(C=O)C(C1C(CC(C=1)O)=O)O)=O,4,2,0,2,45,9.6e-05
G5,C(CC(C1C(C(C=O)=CC1O)=O)O)=O,8,2,0,2,45,9.6e-05
G5,C(C(C=O)C(C1C(C(C=C1)O)=O)O)=O,8,2,0,2,45,9.6e-05
G5,C(C1C=CC(C1(C(C=O)C=O)O)O)=O,8,2,0,2,45,9.6e-05
G5,C(C(C=O)C(C1(C(CC=C1)=O)O)O)=O,4,2,0,2,45,9.6e-05
G5,C(C(C=O)C1(CC=CC1(C=O)O)O)=O,4,2,0,2,45,9.6e-05
G5,C(C1(C(C(C=C1)C(CC=O)O)=O)O)=O,8,1,0,1,45,4.8e-05
G5,C(C(C=O)C(C)(C1C=CC(O1)=O)O)=O,4,2,0,2,48,9.6e-05
G5,C(CC(CC(C1C=CC(O1)=O)=O)O)=O,4,1,0,1,48,4.8e-05
G5,C(C(C=O)C(CC1C=CC(O1)=O)O)=O,4,2,0,2,48,9.6e-05
G5,C(CC(C(C=O)C1C=CC(O1)=O)O)=O,8,2,0,2,48,9.6e-05
G5,C(C(C=O)C1(C=COC1C(C)=O)O)=O,4,2,0,2,9,9.6e-05
G5,C(CC(CC(C1C(C=CO1)=O)=O)O)=O,4,1,0,1,9,4.8e-05
G5,C(CC1C(C=CO1)(C(C=O)C=O)O)=O,4,2,0,2,45,9.6e-05
G5,C(C(C=O)C(CC1C(C=CO1)=O)O)=O,4,2,0,2,45,9.6e-05
G5,C(CC(C(C=O)C1C(C=CO1)=O)O)=O,8,2,0,2,45,9.6e-05
G5,C(C(C=O)C1(C=CC(OCC1)=O)O)=O,2,2,0,2,19,9.6e-05
G5,C(CC(C1C(C=CC(OC1)=O)=O)O)=O,4,2,0,2,19,9.6e-05
G5,C(C(C=O)C1(COC(C=CC1)=O)O)=O,2,2,0,2,48,9.6e-05
G5,C(CC(C1C(COC(C=C1)=O)=O)O)=O,4,1,0,1,48,4.8e-05
G5,C(CC(C1C(CC=CC(O1)=O)=O)O)=O,4,2,0,2,48,9.6e-05
G5,C(C(C=O)C1(C(CCOC=C1)=O)O)=O,2,2,0,2,45,9.6e-05
G5,C(C(C=O)C1(C(C=COCC1)=O)O)=O,2,2,0,2,45,9.6e-05
G5,C(CC(C1C(C(C=COC1)=O)=O)O)=O,4,2,0,2,45,9.6e-05
G5,C(C(C=O)C1(C=COCC(C1)=O)O)=O,2,2,0,2,38,9.6e-05
G5,C(C(C=O)C1(COC=CC(C1)=O)O)=O,2,2,0,2,38,9.6e-05
G5,C(CC(C1C(COC=CC1=O)=O)O)=O,4,2,0,2,38,9.6e-05
G5,C(CC(C1C(CC(C=CO1)=O)=O)O)=O,4,2,0,2,38,9.6e-05
G5,C(C(C=O)C1(C=CCOC(C1)=O)O)=O,2,2,0,2,19,9.6e-05
G5,C(CC(C1C(OCC=CC1=O)=O)O)=O,4,2,0,2,19,9.6e-05
G5,C(C(C=O)C1(C(C=CCOC1)=O)O)=O,2,2,0,2,36,9.6e-05
G5,C(C(C=O)C1(C(COCC=C1)=O)O)=O,2,2,0,2,36,9.6e-05
G5,C(CC(C1C(C(C=CCO1)=O)=O)O)=O,4,2,0,2,36,9.6e-05
G5,C1(CC=CC(CO1)(C(C=O)C=O)O)=O,2,2,0,2,48,9.6e-05
G5,C(CC(C1C(C=CCC(O1)=O)=O)O)=O,4,2,0,2,48,9.6e-05
G5,C(C(C=O)C1(C=CC(COC1)=O)O)=O,2,2,0,2,45,9.6e-05
G5,C(CC(C1C(C=CC(CO1)=O)=O)O)=O,4,2,0,2,45,9.6e-05
G5,C(C(C=O)C(C=C1C(CCO1)=O)O)=O,4,2,0,2,45,9.6e-05
G5,C(C(C=O)C1(C(OCC1)=CC=O)O)=O,4,2,0,2,45,9.6e-05
G5,C(CC(C1C(C(OC1)=CC=O)=O)O)=O,8,2,0,2,45,9.6e-05
G5,C(C(C=O)C(C=C1CC(CO1)=O)O)=O,4,2,0,2,45,9.6e-05
G5,C(C(C=O)C1(COC(C1)=CC=O)O)=O,4,2,0,2,45,9.6e-05
G5,C(CC(C1C(COC1=CC=O)=O)O)=O,8,2,0,2,45,9.6e-05
G5,C(CC(C1C(CC(O1)=CC=O)=O)O)=O,8,2,0,2,45,9.6e-05
G5,C(C(C=O)C(C(C1C=CCO1)=O)O)=O,4,2,0,2,39,9.6e-05
G5,C(C(C=O)C(C=O)(C1C=CCO1)O)=O,4,2,0,2,39,9.6e-05
G5,C(C(C=O)C(C1C=CC(C=O)O1)O)=O,8,2,0,2,40,9.6e-05
G5,C(C(C=O)C(C1C(CC(O1)=C)=O)O)=O,4,2,0,2,26,9.6e-05
G5,C(C(C=O)C1(C(C=O)OC(C1)=C)O)=O,4,2,0,2,26,9.6e-05
G5,C1(C(C=O)OC(C1C(CC=O)O)=C)=O,8,2,0,2,26,9.6e-05
G5,C(C(C=O)C(C1CC(C(O1)=C)=O)O)=O,4,2,0,2,14,9.6e-05
G5,C(C1CC(C(O1)=C)(C(C=O)C=O)O)=O,4,2,0,2,14,9.6e-05
G5,C(CC(C1C(C(OC1C=O)=C)=O)O)=O,8,2,0,2,14,9.6e-05
G5,C(C(C=O)C(C1OCCC(C=1)=O)O)=O,2,2,0,2,30,9.6e-05
G5,C(C(C=O)C1(C=C(C=O)OCC1)O)=O,2,2,0,2,30,9.6e-05
G5,C(CC(C1C(C=C(C=O)OC1)=O)O)=O,4,2,0,2,30,9.6e-05
G5,C(C(C=O)C(C1OCC(CC=1)=O)O)=O,2,2,0,2,12,9.6e-05
G5,C(C(C=O)C1(COC(C=O)=CC1)O)=O,2,2,0,2,12,9.6e-05
G5,C(CC(C1C(COC(C=O)=C1)=O)O)=O,4,1,0,1,12,4.8e-05
G5,C(CC(C1C(CC=C(C=O)O1)=O)O)=O,4,2,0,2,12,9.6e-05
G5,C(C(C=O)C(C1C(CC=CO1)=O)O)=O,4,2,0,2,37,9.6e-05
G5,C(C(C=O)C1(C(C=O)OC=CC1)O)=O,4,2,0,2,37,9.6e-05
G5,C1(C(C=O)OC=CC1C(CC=O)O)=O,8,1,0,1,37,4.8e-05
G5,C(C(C=O)C(C1CC(C=CO1)=O)O)=O,4,2,0,2,37,9.6e-05
G5,C(C1CC(C=CO1)(C(C=O)C=O)O)=O,4,2,0,2,37,9.6e-05
G5,C(CC(C1C(C=COC1C=O)=O)O)=O,8,2,0,2,37,9.6e-05
G5,C(C(C=O)C(C1CC(C(C=1)=O)O)O)=O,4,2,0,2,45,9.6e-05
G5,C(C(C=O)C1(C=C(C=O)CC1O)O)=O,4,2,0,2,45,9.6e-05
G5,C(C(C=O)C1(C(C(C=C1)CO)=O)O)=O,4,2,0,2,45,9.6e-05
G5,C(C(C=O)C1(C(C=CC1CO)=O)O)=O,4,2,0,2,45,9.6e-05
G5,C(C(C=O)C(C1C(C(CC=1)O)=O)O)=O,4,2,0,2,27,9.6e-05
G5,C(C(C=O)C1(C(C=O)=CCC1O)O)=O,4,2,0,2,27,9.6e-05
G5,C(C(C=O)C(CO)(C(C=C)O)O)=O,4,2,0,2,31,9.6e-05
G5,C(C(C=O)C(C=C(CO)CO)O)=O,2,2,0,2,18,9.6e-05
G5,C(C(C=O)C(C=CC(CO)O)O)=O,8,2,0,2,46,9.6e-05
G5,C(C(C=O)C(C(C=C(C=O)C)=O)O)=O,4,2,0,2,45,9.6e-05
G5,C(C(C=O)C(C=O)(C=C(C=O)C)O)=O,4,2,0,2,45,9.6e-05
G5,C(C(C=O)C(C(C)=CC(C=O)=O)O)=O,4,2,0,2,45,9.6e-05
G5,C(C(C=O)C(C(CC(C=O)=C)=O)O)=O,2,2,0,2,45,9.6e-05
G5,C(C(C=O)C(C=O)(CC(C=O)=C)O)=O,2,2,0,2,45,9.6e-05
G5,C(C(C=O)C(C(CC(C=O)=O)=C)O)=O,2,2,0,2,45,9.6e-05
G5,C(CC(C(C(C=O)=O)C(C=O)=C)O)=O,4,1,0,1,45,4.8e-05
G5,C(C(C=O)C(C(C=CC=O)=O)O)=O,4,2,0,2,20,9.6e-05
G5,C(C(C=O)C(C=O)(C=CC=O)O)=O,4,2,0,2,20,9.6e-05
G5,C(C(C=O)C(C=CC(C=O)=O)O)=O,4,2,0,2,20,9.6e-05
G5,C(C(C=O)C(C(C=CC)=O)O)=O,4,3,0,3,28,0.000143
G5,C(C(C=O)C(C=O)(C=CC)O)=O,4,3,0,3,28,0.000143
G5,C(C(C=O)C(C(CC=C)=O)O)=O,2,3,0,3,28,0.000143
G5,C(C(C=O)C(C=O)(CC=C)O)=O,2,3,0,3,28,0.000143
G5,C(C(C=O)C(C=CC=O)(C)O)=O,4,3,0,3,28,0.000143
G5,C(C(C=O)C(C=CC(C)=O)O)=O,4,3,0,3,28,0.000143
G5,C(C(C=O)C(C(CC=O)=C)O)=O,2,3,0,3,28,0.000143
G5,C(C(C=O)C(CC(C=O)=C)O)=O,2,3,0,3,28,0.000143
G5,C(C(C(C=O)=C)C(CC=O)O)=O,4,2,0,2,45,9.499999999999999e-05
G5,C(C(C=O)C(C(C)=CC=O)O)=O,4,3,0,3,28,0.000143
G5,C(C(C=O)C(C=C(C=O)C)O)=O,4,3,0,3,28,0.000143
G5,C(C(C=O)C(C(C(CO)=O)=C)O)=O,2,2,0,2,9,9.6e-05
G5,C(C(C=O)C(C(C=O)=C)(CO)O)=O,2,2,0,2,9,9.6e-05
G5,C(CC(C(C(C(C=O)=C)=O)O)O)=O,4,2,0,2,9,9.6e-05
G5,C(C(C=O)C(C(C(C=C)=O)O)O)=O,4,4,0,4,1,0.000192
G5,C(C(C=O)C(C=C)(C(C=O)O)O)=O,4,2,0,2,0,9.6e-05
G5,C(C(C=O)C(C(C(CO)=C)=O)O)=O,2,2,0,2,49,9.6e-05
G5,C(C(C=O)C(C=O)(C(CO)=C)O)=O,2,2,0,2,49,9.6e-05
G5,C(C(C=O)C(C(CO)=C)(CO)O)=O,2,2,0,2,49,9.6e-05
G5,C(CC(C(C(C(CO)=C)=O)O)O)=O,4,3,0,3,49,0.000143
G5,C(C(C=O)C(C(C(C=O)=C)O)O)=O,4,2,0,2,16,9.6e-05
G5,C(C(C=O)C(C(C(C=O)O)=C)O)=O,4,2,0,2,16,9.6e-05
G5,C(C(C=O)C(C=C(C=O)CO)O)=O,4,2,0,2,18,9.6e-05
G5,C(C(C=O)C(C(CO)=CC=O)O)=O,4,2,0,2,18,9.6e-05
G5,C(C(C=O)C(C=C)O)=O,2,4,0,4,45,0.00019099999999999998
G5,C(C(C=O)C(C=CC)(CO)O)=O,4,3,0,3,28,0.000143
G5,C(C(C=O)C(CO)(CC=C)O)=O,2,3,0,3,28,0.000143
G5,C(C(C=O)C(C)(C(C=C)O)O)=O,4,3,0,3,28,0.000143
G5,C(C(C=O)C(CC(CO)=C)O)=O,2,3,0,3,28,0.000143
G5,C(CC(C(C=O)C(CO)=C)O)=O,4,2,0,2,49,9.499999999999999e-05
G5,C(C(C=O)C(C=C(C)CO)O)=O,4,3,0,3,28,0.000143
G5,C(C(C=O)C(C=CC)O)=O,4,3,0,3,45,0.000143
G5,C(C(C=O)C(CC=C)O)=O,2,3,0,3,45,0.000143
G5,C(C(C=C)C(CC=O)O)=O,4,2,0,2,4,9.499999999999999e-05
G5,C(C(C=O)C(C(C(CO)=C)O)O)=O,4,2,0,2,49,9.6e-05
G5,C(C(C=O)C(C(C=C)(CO)O)O)=O,4,2,0,2,29,9.6e-05
G5,C(C(C=O)C(C(C=O)(C=C)O)O)=O,4,3,0,3,28,0.000144
G5,C(C(C=O)C(CC1OCC(C=1)=O)O)=O,2,2,0,2,48,9.6e-05
G5,C(CC1OCC(C=1)(C(C=O)C=O)O)=O,2,2,0,2,48,9.6e-05
G5,C(CC(C(C=O)C1OCC(C=1)=O)O)=O,4,2,0,2,48,9.6e-05
G5,C(CC(C1C(C=C(CC=O)O1)=O)O)=O,4,2,0,2,48,9.6e-05
G5,C(C(C=O)C(C1C(C=C(C)O1)=O)O)=O,4,2,0,2,26,9.6e-05
G5,C(C(C=O)C1(C=C(C)OC1C=O)O)=O,4,2,0,2,26,9.6e-05
G5,C(C(C=O)C(C(C(C=C)O)O)O)=O,8,2,0,2,27,9.6e-05
G5,C(C(C=O)C1(C(O)OC(C)C1)O)=O,8,3,0,3,45,0.000143
G5,C(C(C=O)C1(C(O)OCC1O)O)=O,8,3,0,3,0,0.000143
G5,C(C(C=O)C1(COC(C1O)O)O)=O,8,3,0,3,5,0.000143
G5,C(CC(C1C(C(C(O1)O)O)=O)O)=O,16,3,0,3,5,0.000143
G5,C(C(C=O)C(C(CCCO)=O)O)=O,2,3,0,3,55,0.000144
G5,C(C(C=O)C(C=O)(CCCO)O)=O,2,2,0,2,55,9.6e-05
G5,C(C(C=O)C(CO)(CCCO)O)=O,2,2,0,2,55,9.6e-05
G5,C(CC(C(C(CO)=O)CCO)O)=O,4,2,0,2,18,0.00010700000000000001
G5,C(C(C=O)C1(C=CC(C1O)=O)O)=O,4,2,0,2,47,9.6e-05
G5,C(C(C=O)C(C=CCC=O)O)=O,4,2,0,2,28,9.6e-05
G5,C(C(C=O)C(CC=CC=O)O)=O,4,2,0,2,28,9.6e-05
G5,C(C(C=CC=O)C(CC=O)O)=O,8,1,0,1,28,4.8e-05
G5,C(C(C(C(C(C)(C)O)O)=O)O)=O,4,2,0,2,5,9.6e-05
G5,C(C(C(C(C(C=C)O)O)=O)O)=O,8,5,0,5,5,0.00024900000000000004
G5,C(C(C(C(C(C=CC)O)O)=O)O)=O,16,3,0,3,5,0.000154
G5,C(C(C(C(C(CC=C)O)O)=O)O)=O,8,3,0,3,5,0.000154
G5,C(C(C=C)C(C(C(CO)=O)O)O)=O,8,2,0,2,4,0.000106
G5,C(C(C=O)C(C(CCO)O)O)(O)=O,8,6,0,6,29,0.000309
G5,C(CC(C(CCO)O)O)(CCO)=O,4,3,0,3,29,0.000165
G5,C(C)(C(CO)C(C(CCO)O)O)=O,8,3,0,3,29,0.000154
G5,C(C)(CC(C(CCO)O)O)=O,4,1,0,1,29,4.8e-05
G5,C(OC(C=O)C(C(CCO)O)O)=O,8,2,0,2,29,9.499999999999999e-05
G5,C(C(C(C(CCO)O)O)CC=O)=O,8,3,0,3,43,0.000154
G5,C1OC(C(C=1)=O)C(C(CCO)O)O,8,2,0,2,29,9.499999999999999e-05
G5,C(C(C(C)C(C(CCO)O)O)=O)=O,8,1,0,1,29,4.8e-05
G5,C(C(C=C)C(C(CCO)O)O)=O,8,2,0,2,29,9.499999999999999e-05
G5,C(C(CC(C(CO)CO)O)=O)(O)=O,2,3,0,3,29,0.000165
G5,C(C(C=O)C(C(O)=O)(C)O)(O)=O,4,8,0,8,28,0.00041500000000000006
G5,C(C(C(C)=O)(CC(C(O)=O)=O)O)=O,2,2,0,2,25,0.00010700000000000001
G5,C(C(CC(C(C(C)=O)=O)O)=O)(O)=O,2,1,0,1,28,4.8e-05
G5,C(C=O)(C(C)(CC(C(O)=O)=O)O)=O,2,1,0,1,28,4.8e-05
G5,C(C(C)(CC(C(C=O)=O)=O)O)(O)=O,2,1,0,1,28,4.8e-05
G5,C(C(C=O)(CC(C(O)=O)=O)O)=O,1,3,0,3,1,0.000154
G5,C(C(CC(C(C=O)=O)O)=O)(O)=O,2,3,0,3,29,0.000143
G5,C(C(CC(C)(CCO)O)=O)(O)=O,2,2,0,2,28,0.00010700000000000001
G5,C(C(C)(CC(CCO)=O)O)(O)=O,2,4,0,4,29,0.000212
G5,C(C(C)(C(C(C)=O)CO)O)(O)=O,4,5,0,5,28,0.00026000000000000003
G5,C(C(CC(C)(C)O)=O)(O)=O,1,1,0,1,28,4.8e-05
G5,C(C(C)(CC(C)=O)O)(O)=O,2,4,0,4,29,0.00020099999999999998
G5,C(OCC(C)(CC(C(O)=O)=O)O)=O,2,1,0,1,28,4.8e-05
G5,C(C(C)(CC(COC=O)=O)O)(O)=O,2,3,0,3,28,0.000143
G5,C(C(C)(C(C(C)=O)OC=O)O)(O)=O,4,3,0,3,28,0.000143
G5,C(OCC(CC(C(O)=O)=O)O)=O,2,1,0,1,28,4.8e-05
G5,C(C(C)(C(C=O)OC=O)O)(O)=O,4,2,0,2,28,9.6e-05
G5,C(C)(OCC(CC(C(O)=O)=O)O)=O,2,1,0,1,28,4.8e-05
G5,C(C(C)(C(C=O)OC(C)=O)O)(O)=O,4,2,0,2,28,9.6e-05
G5,C(CCC(CC(C(O)=O)=O)O)=O,2,3,0,3,29,0.000143
G5,C(C(CC(C(O)=O)=O)O)=CCO,4,4,0,4,29,0.00020099999999999998
G5,C(C(CO)(CC(C(O)=O)=O)O)(O)=O,2,3,0,3,17,0.000156
G5,C(C(C)(C(C(C(O)=O)=O)O)O)(O)=O,4,3,0,3,33,0.000154
G5,C(CC(C)(CC(C(O)=O)=O)O)(O)=O,2,2,0,2,28,0.00010700000000000001
G5,C(C(C)(CC(CC(O)=O)=O)O)(O)=O,2,2,0,2,29,0.00010700000000000001
G5,C(C(C)(C(C(O)=O)C(C)=O)O)(O)=O,4,3,0,3,28,0.000154
G5,C(C(CC(C(O)=O)=O)O)=CC(O)=O,4,2,0,2,29,0.00010700000000000001
G5,C1(C(CCO1)(CC(C(O)=O)=O)O)=O,2,1,0,1,28,4.8e-05
G5,C(C(C)(C1C(C(OC1)=O)=O)O)(O)=O,4,2,0,2,28,9.6e-05
G5,C1(CC(CO1)(CC(C(O)=O)=O)O)=O,2,1,0,1,28,4.8e-05
G5,C(C(C)(C1C(OCC1=O)=O)O)(O)=O,4,2,0,2,28,9.6e-05
G5,C(C(C)(C1C(CC(O1)=O)=O)O)(O)=O,4,2,0,2,28,9.6e-05
G5,C=CC(C(CC(C(O)=O)=O)O)O,4,3,0,3,29,0.000143
G5,C1OCC(C=1)(CC(C(O)=O)=O)O,2,2,0,2,28,9.499999999999999e-05
G5,C(C(C)(C1C(C=CO1)=O)O)(O)=O,4,3,0,3,28,0.000143
G5,C(C(C=C)(CC(C(O)=O)=O)O)(O)=O,2,2,0,2,29,0.00010700000000000001
G5,C(C(CC(C(C)(CO)O)O)=O)(O)=O,4,1,0,1,11,4.8e-05
G5,C(C(C)(CC(C(O)=O)=O)O)(CC)=O,2,1,0,1,28,4.8e-05
G5,C(C)(C(CC)(CC(C(O)=O)=O)O)=O,2,1,0,1,28,4.8e-05
G5,C(C(C)(CC(C(CC)=O)=O)O)(O)=O,2,1,0,1,28,4.8e-05
G5,C(C(C)(C(C(C(C)=O)=O)C)O)(O)=O,4,1,0,1,28,4.8e-05
G5,C(C(C)(CC(CC(C)=O)=O)O)(O)=O,2,1,0,1,28,4.8e-05
G5,C(C(C)(C(C(C)=O)C(C)=O)O)(O)=O,2,2,0,2,28,9.6e-05
G5,C(CC(C)C(CC(C(O)=O)=O)O)=O,4,2,0,2,7,9.499999999999999e-05
G5,C(C(C)CC(CC(C(O)=O)=O)O)=O,4,1,0,1,28,4.8e-05
G5,C(C(C)(C(C=O)C(C=O)C)O)(O)=O,8,2,0,2,25,9.499999999999999e-05
G5,C(C(CC(C(O)=O)=O)O)(CC)=O,2,2,0,2,28,9.499999999999999e-05
G5,C(C(CC)(CC(C(O)=O)=O)O)=O,2,1,0,1,28,4.8e-05
G5,C(C(C)(C(C(C=O)=O)C)O)(O)=O,4,2,0,2,25,9.499999999999999e-05
G5,C(C(CC)(CC(C(O)=O)=O)O)(O)=O,2,1,0,1,28,4.8e-05
G5,C(C(C)(C(C(C(O)=O)=O)C)O)(O)=O,4,1,0,1,28,4.8e-05
G5,C(C)=CC(C(CC(C(O)=O)=O)O)=O,4,2,0,2,22,0.00010700000000000001
G5,C(C(C=CC)(CC(C(O)=O)=O)O)=O,4,1,0,1,28,4.8e-05
G5,C(C(CC(C(O)=O)=O)O)(CC=C)=O,2,2,0,2,22,0.00010700000000000001
G5,C(C(CC(C(O)=O)=O)(CC=C)O)=O,2,1,0,1,28,4.8e-05
G5,C(C(C)(C(C=C)C(C=O)=O)O)(O)=O,4,1,0,1,28,4.8e-05
G5,C(C(C)(CC(C(O)=O)=O)O)=CC=O,4,1,0,1,28,4.8e-05
G5,C(C(CC(C(O)=O)=O)O)=CC(C)=O,4,1,0,1,28,4.8e-05
G5,C(C(C)(CC(C=CC=O)=O)O)(O)=O,4,1,0,1,28,4.8e-05
G5,C(CC(C(CC(C(O)=O)=O)O)=C)=O,2,2,0,2,22,0.00010700000000000001
G5,C=C(C=O)CC(CC(C(O)=O)=O)O,2,1,0,1,28,4.8e-05
G5,C(C(C(C=O)=C)C(C(O)=O)(C)O)=O,4,1,0,1,28,4.8e-05
G5,C(C)(C(CC(C(O)=O)=O)O)=CC=O,4,2,0,2,22,0.00010700000000000001
G5,C(C(CC(C(O)=O)=O)O)=C(C=O)C,4,1,0,1,28,4.8e-05
G5,C=CC(CC(C(O)=O)=O)O,2,5,0,5,29,0.00024900000000000004
G5,C(C)=CC(CO)(CC(C(O)=O)=O)O,4,1,0,1,28,4.8e-05
G5,C(C(C)(C(C(C=CC)=O)O)O)(O)=O,8,3,0,3,28,0.000143
G5,C=CCC(CO)(CC(C(O)=O)=O)O,2,1,0,1,28,4.8e-05
G5,C(C(C)(C(C(CO)=O)C=C)O)(O)=O,4,1,0,1,28,4.8e-05
G5,C(C(C)(C(C(CC=C)=O)O)O)(O)=O,4,3,0,3,28,0.000143
G5,C=CC(C(C)(CC(C(O)=O)=O)O)O,4,1,0,1,28,4.8e-05
G5,C(C(C)(CC(C(C=C)O)=O)O)(O)=O,4,1,0,1,28,4.8e-05
G5,C=C(CO)CC(CC(C(O)=O)=O)O,2,1,0,1,28,4.8e-05
G5,C(C(C)(C(C=O)C(CO)=C)O)(O)=O,4,1,0,1,28,4.8e-05
G5,C(C(CC(C(O)=O)=O)O)=C(C)CO,4,1,0,1,28,4.8e-05
G5,C(C(CC(C(O)=O)=O)O)=CC,4,2,0,2,28,9.499999999999999e-05
G5,C=CCC(CC(C(O)=O)=O)O,2,2,0,2,28,9.499999999999999e-05
G5,C(C(C=C)C(C(O)=O)(C)O)=O,4,3,0,3,29,0.000143
G5,C(CC=CC(CC(C(O)=O)=O)O)=O,4,2,0,2,13,0.00010700000000000001
G5,C(CC(CC(C(O)=O)=O)O)=CC=O,4,2,0,2,13,0.00010700000000000001
G5,C(C(C=CC=O)C(C(O)=O)(C)O)=O,8,1,0,1,28,4.8e-05
G5,C(CC(C(C(C(O)=O)O)=O)=O)(O)=O,2,3,0,3,17,0.000145
G5,C(C(C(O)=O)C(C(CO)=O)=O)(O)=O,1,2,0,2,17,9.6e-05
G5,C(C(C(O)=O)C(C(O)=O)=O)(O)=O,1,2,0,2,17,9.6e-05
G5,C(C(C(O)=O)C(C(C)=O)=O)(O)=O,1,4,0,4,17,0.00020299999999999997
G5,C(CC(C(CC(O)=O)=O)=O)(O)=O,1,3,0,3,29,0.000154
G5,C(C(C(O)=O)C(CC=O)=O)(O)=O,1,2,0,2,17,9.6e-05
G5,C(C(C(O)=O)C(CC(O)=O)=O)=O,2,3,0,3,17,0.000145
G5,C(C1C(C(C(O)=O)OC1O)=O)(O)=O,8,4,0,4,17,0.000193
G5,C(C(C(C(C(O)=O)O)=O)O)(O)=O,3,3,0,3,17,0.000155
G5,C(C(C(O)=O)C(C=O)=O)(O)=O,1,4,0,4,17,0.00020299999999999997
G5,C(C(C(C=O)=O)C(C(O)=O)O)(O)=O,4,6,0,6,33,0.00031
G5,C(C(C(C=O)=O)C(C(C)O)O)(O)=O,8,5,0,5,11,0.000251
G5,C(C(C=O)C(C(C(O)=O)O)=O)(O)=O,4,4,0,4,17,0.000193
G5,C(C(C(O)=O)C(C(C=O)O)=O)(O)=O,2,2,0,2,17,9.6e-05
G5,C(C(C(O)=O)C(O)=O)=O,1,4,0,4,28,0.00020299999999999997
G5,C(C(C=O)C(C(C(O)=O)O)O)(O)=O,8,7,0,7,17,0.000357
G5,C(C(C=O)C(C(C)=O)(C)O)(O)=O,4,7,0,7,14,0.000346
G5,C(C(C=O)C1(COC(C1)O)O)(O)=O,8,6,0,6,35,0.000298
G5,C(C(C=O)C(C(C=C)=O)O)(O)=O,4,7,0,7,7,0.000346
G5,C(C(C=O)C(C=O)(C=C)O)(O)=O,4,8,0,8,7,0.000393
G5,C(C(C=O)C(C=C)(CO)O)(O)=O,4,7,0,7,7,0.000346
G5,C(C(C=O)C(C=CC=O)O)(O)=O,8,8,0,8,43,0.000393
G5,C(C(C=O)C(C(C)O)O)(O)=O,8,6,0,6,11,0.000298
G5,C(C(C=O)C1(COCC1O)O)(O)=O,8,5,0,5,10,0.000251
G5,C(C(C=O)C1(C(O)OCC1)O)(O)=O,8,6,0,6,34,0.000298
G5,C(C(C(C)=O)C(C(O)=O)O)(O)=O,4,8,0,8,17,0.00041500000000000006
G5,C(CC(C=CC(C(O)=O)O)=O)(O)=O,4,3,0,3,17,0.000165
G5,C(C(C=O)C=CC(C(O)=O)O)(O)=O,8,3,0,3,17,0.000165
G5,C(C(C(C=C)=O)C(C(O)=O)O)(O)=O,4,4,0,4,17,0.000213
G5,C(CC(C(C=O)=O)=O)(O)=O,1,5,0,5,29,0.00023799999999999998
G5,C(C(C(CO)=O)C(C=O)=O)(O)=O,2,5,0,5,51,0.000239
G5,C(C(C(CC(C=O)=O)=O)O)(O)=O,2,5,0,5,51,0.000239
G5,C(CC(C(C(C=O)=O)O)=O)(O)=O,2,3,0,3,29,0.000143
G5,C(C(C(C)=O)C(C(C=O)=O)=O)(O)=O,2,2,0,2,27,9.6e-05
G5,C(CC(CC(C(C=O)=O)=O)=O)(O)=O,1,1,0,1,27,4.8e-05
G5,C(C(C(C(C=O)=O)=O)CC=O)(O)=O,2,1,0,1,27,4.8e-05
G5,C(C(C(O)=O)CC(C(C=O)=O)=O)=O,2,1,0,1,27,4.8e-05
G5,C(C(C(C=O)=O)C(C(C)=O)=O)(O)=O,2,2,0,2,27,9.6e-05
G5,C(CC(C(CC(C=O)=O)=O)=O)(O)=O,1,1,0,1,27,4.8e-05
G5,C(C(C(CC=O)=O)C(C=O)=O)(O)=O,2,2,0,2,27,9.6e-05
G5,C(C(C(O)=O)C(CC(C=O)=O)=O)=O,2,2,0,2,27,9.6e-05
G5,C(C(C(C=CC(C=O)=O)=O)O)(O)=O,4,2,0,2,12,9.6e-05
G5,C(C(C(C(C(CO)O)=O)=O)O)(O)=O,4,3,0,3,0,0.000155
G5,C(C(C=O)CC(C(C(O)=O)O)=O)=O,2,5,0,5,17,0.000239
G5,C(C(C(CO)=O)C(C=O)C=O)(O)=O,2,3,0,3,17,0.000143
G5,C(C(C(C(C(CO)=O)O)=O)O)(O)=O,4,3,0,3,5,0.000144
G5,C(C(C=O)C(C(C(O)=O)O)=O)=O,2,4,0,4,1,0.00020299999999999997
G5,C(C(C=O)C(C(C=O)O)=O)(O)=O,4,4,0,4,1,0.00020299999999999997
G5,C(C(C(C)=O)C(CO)=O)(O)=O,2,10,0,10,29,0.000499
G5,C(C(C(O)=O)C(CC=O)=O)=O,2,6,0,6,29,0.000286
G5,C(C(C(CC(C)=O)=O)C(O)=O)=O,2,8,0,8,29,0.000392
G5,C(CC(C(C(O)=O)C(C)=O)=O)=O,2,7,0,7,29,0.00034500000000000004
G5,C(CC(CC(CC(O)=O)=O)=O)=O,1,5,0,5,29,0.00024900000000000004
G5,C(C(C(CO)=O)CC=O)(O)=O,2,6,0,6,17,0.000297
G5,C(C(C=O)CC(CO)=O)(O)=O,2,8,0,8,29,0.000392
G5,C(C(C(O)=O)C(CCC=O)=O)=O,2,6,0,6,29,0.000298
G5,C(CC=O)(C(C(O)=O)CC=O)=O,2,5,0,5,29,0.00024900000000000004
G5,C(C(C(O)=O)CC(CC=O)=O)=O,2,5,0,5,29,0.00024900000000000004
G5,C(C(C=O)C(C=CCO)=O)(O)=O,4,8,0,8,29,0.000404
G5,C(OCC(CC(O)=O)=O)=O,1,3,0,3,17,0.000143
G5,C(C(C(C)=O)OC=O)(O)=O,2,3,0,3,35,0.000144
G5,C(C(C(CO)=O)OCC=O)(O)=O,2,2,0,2,27,9.6e-05
G5,C(C(C(COCC=O)=O)O)(O)=O,2,2,0,2,27,9.6e-05
G5,C(C(C=O)OCC(CO)=O)(O)=O,2,2,0,2,27,9.6e-05
G5,C(CC(C(O)OCC=O)=O)(O)=O,2,1,0,1,27,4.8e-05
G5,C(C(C=O)OC(C(C)=O)O)(O)=O,4,2,0,2,27,9.6e-05
G5,C(CC(COC(C=O)O)=O)(O)=O,2,3,0,3,17,0.000143
G5,C(C(C(C)=O)OC(C=O)O)(O)=O,4,3,0,3,27,0.000144
G5,C(OC(C=O)C(O)=O)=O,2,2,0,2,28,9.6e-05
G5,C(C(C=O)OC(CO)=O)(O)=O,2,2,0,2,40,9.6e-05
G5,C(C(C=O)OC(C)=O)(O)=O,2,2,0,2,28,9.6e-05
G5,C(C(C(C(CC(O)=O)O)=O)O)(O)=O,4,4,0,4,2,0.00020299999999999997
G5,C(C(C(C=O)=O)CC=O)(O)=O,2,5,0,5,29,0.00024900000000000004
G5,C(C(C(O)=O)CC(C=O)=O)=O,2,3,0,3,17,0.000143
G5,C(C(C(O)=O)CC=O)=O,2,5,0,5,29,0.00024900000000000004
G5,C(C1C(C(CC(O1)O)O)=O)(O)=O,8,3,0,3,27,0.000144
G5,C(C(C(C(O)=O)=O)O)(O)=O,2,4,0,4,33,0.00020299999999999997
G5,C(C(C(C)=O)C(C(O)=O)=O)(O)=O,2,4,0,4,0,0.00020299999999999997
G5,C(CC(CC(C(O)=O)=O)=O)(O)=O,1,4,0,4,29,0.000202
G5,C(C(C(O)=O)C(C(O)=O)=O)=O,2,4,0,4,45,0.00020299999999999997
G5,C(CC(CC(O)=O)=O)(O)=O,1,2,0,2,17,0.00010700000000000001
G5,C(C(C(O)=O)C(C)=O)(O)=O,1,4,0,4,6,0.00020299999999999997
G5,C(C(C(C=CC(O)=O)=O)O)(O)=O,4,4,0,4,18,0.00020299999999999997
G5,C(C(C(C(C(O)=O)O)=O)(CO)O)=O,4,4,0,4,17,0.000195
G5,C(C(C(C(CO)=O)=O)O)(O)=O,2,4,0,4,5,0.00019099999999999998
G5,C(C(C=O)(C(C(C(O)=O)O)=O)O)=O,2,2,0,2,4,9.6e-05
G5,C(C(C=O)(C(CC(O)=O)=O)O)=O,1,3,0,3,29,0.000154
G5,C(CC(C(C(C=O)O)=O)=O)(O)=O,2,2,0,2,5,9.6e-05
G5,C(C(C(C(C(C)O)=O)=O)O)(O)=O,4,4,0,4,0,0.00019099999999999998
G5,C(C(C(C(C=C)=O)=O)O)(O)=O,2,2,0,2,7,9.6e-05
G5,C(C(C(C(CO)(C)O)=O)O)(O)=O,4,4,0,4,49,0.000205
G5,C(C(C=O)C(C(CO)=O)=O)(O)=O,2,3,0,3,0,0.000144
G5,C(C(C(C(CC=O)=O)=O)O)(O)=O,2,4,0,4,0,0.00019099999999999998
G5,C(C1C(C(C(C1)=O)O)=O)(O)=O,4,8,0,8,17,0.00037999999999999997
G5,C(C(C=O)C(O)=O)(OCC(C)=O)=O,2,6,0,6,48,0.000286
G5,C(CC(OC(C(O)=O)C(C)=O)=O)=O,2,7,0,7,48,0.000334
G5,C(CC=O)(OCC(CC(O)=O)=O)=O,1,7,0,7,17,0.000333
G5,C(C(C(C=O)=O)OCC(C)=O)(O)=O,2,5,0,5,17,0.000239
G5,C(C(C(C)=O)OCC(C=O)=O)(O)=O,2,6,0,6,17,0.000286
G5,C(CC(COCC(C=O)=O)=O)(O)=O,1,5,0,5,17,0.00023799999999999998
G5,C(CC(C(C(C)=O)OC=O)=O)(O)=O,2,4,0,4,17,0.00019099999999999998
G5,C(OC(C(CC(O)=O)=O)CC=O)=O,2,3,0,3,17,0.000143
G5,C(OC(C(C)=O)C(C=O)C(O)=O)=O,4,3,0,3,17,0.000144
G5,C(C1C(COC(C1)=O)=O)(O)=O,2,4,0,4,17,0.00019099999999999998
G5,C(C1C(CCC(O1)=O)=O)(O)=O,2,9,0,9,17,0.00044
G5,C1(C(C(O)=O)OCC(C1)=O)=O,2,8,0,8,54,0.000381
G5,C(C1C(COCC1=O)=O)(O)=O,1,5,0,5,17,0.000239
G5,C(C(C(O)=O)C(C)=O)(OCC=O)=O,2,3,0,3,19,0.000144
G5,C(CC(CC(O)=O)=O)(OCC=O)=O,1,3,0,3,17,0.000143
G5,C(C(C=O)OC(CC(C)=O)=O)(O)=O,2,2,0,2,19,9.6e-05
G5,C(C(C(C(C)=O)=O)OCC=O)(O)=O,2,3,0,3,36,0.000144
G5,C(CC(C(COCC=O)=O)=O)(O)=O,1,3,0,3,17,0.000143
G5,C(C(C=O)OCC(C(C)=O)=O)(O)=O,2,2,0,2,36,9.6e-05
G5,C(OCCC(C(CC(O)=O)=O)=O)=O,1,3,0,3,17,0.000143
G5,C(OCC(C(O)=O)C(C(C)=O)=O)=O,2,3,0,3,17,0.000144
G5,C(OCC(CC(CC(O)=O)=O)=O)=O,1,3,0,3,17,0.000143
G5,C(OCC(C(C(O)=O)C(C)=O)=O)=O,2,3,0,3,38,0.000144
G5,C(C(C(CC(C)=O)=O)OC=O)(O)=O,2,3,0,3,38,0.000144
G5,C(C1C(C(C(CO)O1)O)=O)(O)=O,8,4,0,4,27,0.00020299999999999997
G5,C(C1C(C(O)OC1CO)=O)(O)=O,8,4,0,4,27,0.00019099999999999998
G5,C(C1C(COC1(CO)O)=O)(O)=O,4,3,0,3,27,0.000144
G5,C(C1C(CC(CO)(O1)O)=O)(O)=O,4,3,0,3,27,0.000144
G5,C(C1C(C(OC1)=O)=O)(O)=O,2,4,0,4,28,0.00019099999999999998
G5,C1(C(C(O)=O)C(CO1)=O)=O,2,5,0,5,28,0.000239
G5,C1(CC(C(C(O)=O)O1)=O)=O,2,4,0,4,28,0.00019099999999999998
G5,C(C(C=O)OC(C=O)CC=O)(O)=O,4,5,0,5,40,0.000239
G5,C(C(C=O)C(C=O)OCC=O)(O)=O,4,2,0,2,40,9.6e-05
G5,C(CC(C(C=O)OC(C)=O)=O)(O)=O,2,3,0,3,17,0.000143
G5,C(C(C=O)OC(C(C=O)=O)C)(O)=O,4,5,0,5,17,0.000239
G5,C(C1C(C(C(CO1)O)O)=O)(O)=O,8,4,0,4,27,0.00020299999999999997
G5,C(C1C(C(O)OCC1O)=O)(O)=O,8,4,0,4,27,0.00019099999999999998
G5,C(CCOC(C=O)=O)(CC(O)=O)=O,1,3,0,3,30,0.000143
G5,C(C)(C(C(O)=O)COC(C=O)=O)=O,2,3,0,3,30,0.000144
G5,C(OC(C=O)C(C(O)=O)C(C)=O)=O,4,3,0,3,37,0.000144
G5,C(OC(C=O)CC(CC(O)=O)=O)=O,2,3,0,3,17,0.000143
G5,C(C1C(COC(C1O)=O)=O)(O)=O,4,3,0,3,27,0.000144
G5,C(C1C(CC(C(O1)=O)O)=O)(O)=O,4,3,0,3,27,0.000144
G5,C(C(C(C(CO)=CC=O)=O)O)(O)=O,4,5,0,5,17,0.000239
G5,C(C(C(C(C(C=O)O)=C)=O)O)(O)=O,4,5,0,5,17,0.000239
G5,C(C1C(C=CO1)=O)(O)=O,2,6,0,6,17,0.000286
G5,C(C1C(C=CC(O1)O)=O)(O)=O,4,6,0,6,17,0.000286
G5,C(C(C(C=COCC=O)=O)O)(O)=O,4,5,0,5,38,0.000239
G5,C(C(C=O)OC=CC(CO)=O)(O)=O,4,2,0,2,38,9.6e-05
G5,C(OCC=CC(C(C(O)=O)O)=O)=O,4,5,0,5,19,0.000239
G5,C(C(C=O)OC(CO)=CC=O)(O)=O,4,5,0,5,40,0.000239
G5,C(C(C=O)OC(C(C=O)O)=C)(O)=O,4,5,0,5,26,0.000239
G5,C(C(C=O)OC(C=CC=O)O)(O)=O,8,5,0,5,37,0.000239
G5,C(C(C=O)OC=CC(C=O)O)(O)=O,8,5,0,5,37,0.000239
G5,C(C(C(O)=O)CCC(C=O)=O)=O,2,4,0,4,7,0.000202
G5,C(CCC(C(O)=O)C(C=O)=O)=O,2,2,0,2,7,9.6e-05
G5,C(C(C=O)CCC(CO)=O)(O)=O,2,4,0,4,7,0.000202
G5,C(C(C(CCCC=O)=O)O)(O)=O,2,4,0,4,27,0.000193
G5,C(CCC(C(O)=O)C(CO)=O)=O,2,2,0,2,27,9.6e-05
G5,C(C(C(O)=O)C(C=O)CC=O)=O,4,5,0,5,29,0.00025
G5,C(C1C(C(C(C(C1)O)=O)O)=O)(O)=O,8,2,0,2,12,9.6e-05
G5,C(C1C(C(CC(C1=O)O)O)=O)(O)=O,3,3,0,3,32,0.000144
G5,C(C(C)O)(C(C(O)=O)C(CO)=O)=O,4,5,0,5,24,0.000261
G5,C(C(C(O)=O)O)(CC(C(C)O)=O)=O,4,4,0,4,24,0.00020299999999999997
G5,C(CC(C(CC(C=O)O)O)=O)(O)=O,4,3,0,3,32,0.000154
G5,C(CC(C(C(C(C)O)=O)O)=O)(O)=O,4,3,0,3,9,0.000154
G5,C(C(C=O)C(C(C)O)=O)(O)=O,4,4,0,4,45,0.00019099999999999998
G5,C(C(C(C(CC(C)O)O)=O)O)(O)=O,8,4,0,4,11,0.00020299999999999997
G5,C(C(C(C(C(O)=O)O)=O)(C)O)=O,4,2,0,2,0,9.6e-05
G5,C(C(C(C(C(C=C)O)=O)=O)O)(O)=O,4,3,0,3,32,0.000144
G5,C(C(CC(C(O)=O)C(CO)=O)O)=O,4,4,0,4,29,0.000213
G5,C(CCC(C=O)O)(C(C(O)=O)O)=O,4,4,0,4,7,0.000192
G5,C(CC(C(C(CCO)O)=O)=O)(O)=O,2,4,0,4,29,0.000213
G5,C(CCC(C(C(C(O)=O)O)=O)O)=O,4,3,0,3,27,0.000144
G5,C(C(C=O)CC(C(CO)=O)O)(O)=O,4,4,0,4,29,0.000213
G5,C(C(C(C(CCCO)=O)=O)O)(O)=O,2,3,0,3,55,0.000155
G5,C(C(C(C(CO)=O)=O)CCO)(O)=O,2,4,0,4,29,0.000213
G5,C(C(C(O)=O)O)(C(C=CCO)O)=O,8,3,0,3,29,0.000155
G5,C(C1C(C(C(C1CO)O)=O)=O)(O)=O,8,2,0,2,17,9.6e-05
G5,C(CC(C1C(C(CO1)O)=O)=O)(O)=O,4,2,0,2,17,9.6e-05
G5,C1(C(CC(C(CC(O)=O)=O)O1)O)=O,4,2,0,2,17,9.6e-05
G5,C(C(C=O)C1CC(C(O1)=O)O)(O)=O,8,3,0,3,23,0.000144
G5,C1(CCC(C(C(C(O)=O)O1)=O)O)=O,4,2,0,2,4,9.6e-05
G5,C1(C(C(O)=O)C(C(CCO1)O)=O)=O,4,3,0,3,19,0.000144
G5,C(C1C(C(C(COC1)O)=O)=O)(O)=O,4,3,0,3,36,0.000144
G5,C(C1C(C(C(CCO1)O)=O)=O)(O)=O,4,3,0,3,36,0.000144
G5,C1(CCOC(C(C1C(O)=O)O)=O)=O,4,3,0,3,30,0.000144
G5,C1(CC(C(OCC1C(O)=O)=O)O)=O,4,3,0,3,30,0.000144
G5,C1(C(CC(C(O)=O)C(CO1)=O)O)=O,4,2,0,2,17,9.6e-05
G5,C(C1C(CCC(C(O1)=O)O)=O)(O)=O,4,3,0,3,12,0.000144
G5,C1(C(C(O)=O)OC(C=CC1O)O)=O,8,2,0,2,38,9.6e-05
G5,C(C(C(C1OCC(C=1)O)=O)O)(O)=O,4,2,0,2,36,9.6e-05
G5,C(C(C(C1(C=CCO1)O)=O)O)(O)=O,4,2,0,2,2,9.6e-05
G5,C(C(C(C1C=CC(O1)O)=O)O)(O)=O,8,2,0,2,38,9.6e-05
G5,C(C(C(C1C(C=CO1)O)=O)O)(O)=O,8,2,0,2,38,9.6e-05
G5,C(C1C(C(C(C1CO)O)O)=O)(O)=O,16,2,0,2,17,0.00010700000000000001
G5,C(C(C(C=O)=O)CC(CO)O)(O)=O,4,3,0,3,29,0.000166
G5,C(C(C(C(CO)O)=O)CCO)(O)=O,4,3,0,3,29,0.000166
G5,C(C1C(C(CO)(C(C1)O)O)=O)(O)=O,8,4,0,4,17,0.000202
G5,C(C1C(CC(C1(CO)O)O)=O)(O)=O,8,3,0,3,17,0.000155
G5,C(C1C(C(C(CCO)O1)O)=O)(O)=O,8,3,0,3,29,0.000155
G5,C(C1C(C(O)OC1CCO)=O)(O)=O,8,4,0,4,4,0.00020299999999999997
G5,C(C1C(C(CCO)OC1O)=O)(O)=O,8,4,0,4,4,0.00020299999999999997
G5,C(C(C(C=CC(C)=O)=O)O)(O)=O,4,5,0,5,45,0.00025
G5,C(CC(C=CC(CO)=O)=O)(O)=O,2,4,0,4,29,0.000202
G5,C(C(C(C=CCC=O)=O)O)(O)=O,4,5,0,5,29,0.00025
G5,C(C(C=O)C=CC(CO)=O)(O)=O,4,5,0,5,29,0.000261
G5,C(CC(C(C=CCO)=O)=O)(O)=O,2,3,0,3,29,0.000154
G5,C(C(C(CC(C=C)=O)=O)O)(O)=O,2,5,0,5,27,0.00025
G5,C(C(C(CO)=O)C(C=C)=O)(O)=O,2,5,0,5,27,0.00025
G5,C(C(C(CC=CC=O)=O)O)(O)=O,4,4,0,4,27,0.00020299999999999997
G5,C(C(C(CO)=O)C=CC=O)(O)=O,4,3,0,3,17,0.000154
G5,C(C(C=CCO)C(C=O)=O)(O)=O,4,3,0,3,29,0.000154
G5,C(C1C(C(CCO)(O)OC1)=O)(O)=O,4,5,0,5,2,0.000261
G5,C(C1C(COC1(CCO)O)=O)(O)=O,4,4,0,4,30,0.00020299999999999997
G5,C(C1C(CC(CCO)(O1)O)=O)(O)=O,4,5,0,5,30,0.000261
G5,C(C(C(C1CC(CO1)O)=O)O)(O)=O,8,2,0,2,4,9.6e-05
G5,C(C1C(C(CO)OC1(C)O)=O)(O)=O,8,4,0,4,26,0.00020299999999999997
G5,C(C1C(C(C)(O)OC1CO)=O)(O)=O,8,4,0,4,14,0.00020299999999999997
G5,C(C1C(CCOC1(CO)O)=O)(O)=O,4,4,0,4,30,0.00020299999999999997
G5,C(C1C(CC(CO)(O)OC1)=O)(O)=O,4,5,0,5,30,0.000261
G5,C(C1C(COC(CO)(C1)O)=O)(O)=O,4,3,0,3,17,0.000154
G5,C(C1C(CCC(CO)(O1)O)=O)(O)=O,4,4,0,4,29,0.00020299999999999997
G5,C(C1C(C(CO)OC(C1)O)=O)(O)=O,8,3,0,3,17,0.000154
G5,C(C1C(CC(O)OC1CO)=O)(O)=O,8,5,0,5,44,0.000261
G5,C(C1C(CC(CO)OC1O)=O)(O)=O,8,5,0,5,44,0.000261
G5,C(C(C(CC(O)=O)=O)(CO)O)(O)=O,2,7,0,7,17,0.000361
G5,C(CC(C=CC(C(O)=O)=O)=O)(O)=O,2,2,0,2,17,0.00010700000000000001
G5,C(C(C(O)=O)C=CC(C(O)=O)=O)=O,4,2,0,2,17,0.00010700000000000001
G5,C(CC(C(C=CC(O)=O)=O)=O)(O)=O,2,2,0,2,17,0.00010700000000000001
G5,C(C(C(O)=O)C(C=CC(O)=O)=O)=O,4,3,0,3,29,0.000155
G5,C(C(C(O)=O)C(C=CC=O)=O)(O)=O,2,3,0,3,29,0.000155
G5,C(C(C(C(O)=O)=O)C(C=C)=O)(O)=O,2,3,0,3,29,0.000155
G5,C(C(C(O)=O)C(C(C=C)=O)=O)(O)=O,1,3,0,3,29,0.000155
G5,C(C(C=CC=O)C(C(O)=O)=O)(O)=O,4,2,0,2,17,0.00010700000000000001
G5,C(C(C=CC(O)=O)C(C=O)=O)(O)=O,4,2,0,2,29,0.00010700000000000001
G5,C(C1(C(C(C(O)=O)OC1)=O)O)(O)=O,4,4,0,4,17,0.000193
G5,C(C(C=O)(C(CC(O)=O)=O)O)(O)=O,2,3,0,3,17,0.000145
G5,C(C1C(C(CO)(CO1)O)=O)(O)=O,4,4,0,4,17,0.000195
G5,C(C1C(C(CO1)(C(C)O)O)=O)(O)=O,8,4,0,4,4,0.000194
G5,C(C1C(C(C(C)(C1O)O)=O)=O)(O)=O,8,3,0,3,4,0.000144
G5,C(C1C(C2(C(CC1O2)O)O)=O)(O)=O,16,3,0,3,23,0.000144
G5,C(C(C(C(C(O)=O)O)=O)(C)O)(O)=O,4,4,0,4,17,0.00020299999999999997
G5,C(C(C=O)C(C(C=O)(C)O)O)(O)=O,8,3,0,3,11,0.000144
G5,C(C1C(C(C(O)=O)(O)OC1)=O)(O)=O,4,3,0,3,17,0.000145
G5,C(C1C(C(CO)(O)OC1)=O)(O)=O,4,3,0,3,34,0.000146
G5,C(C(C=O)C(C(O)=O)(C=O)O)(O)=O,4,3,0,3,17,0.000145
G5,C(C(C(C(C)(C(C)O)O)=O)O)(O)=O,8,4,0,4,4,0.000204
G5,C(C1C(C(C(C)O)(O)OC1)=O)(O)=O,8,3,0,3,4,0.000145
G5,C(C1C(CCC(C1=O)=O)=O)(O)=O,2,5,0,5,45,0.000239
G5,C(C1C(C(CC(C1)=O)=O)=O)(O)=O,2,3,0,3,29,0.000143
G5,C1(CC(C(CC1C(O)=O)=O)=O)=O,2,3,0,3,29,0.000143
G5,C(C1C(C(C(C(O)=O)C1)=O)=O)=O,4,2,0,2,12,9.6e-05
G5,C(C1C(CC(CC1=O)=O)=O)(O)=O,1,5,0,5,45,0.000239
G5,C(C1C(C(C(O)=O)C(C1)=O)=O)=O,4,6,0,6,45,0.000286
G5,C(C1C(CC(C1C(O)=O)=O)=O)=O,4,4,0,4,29,0.00019099999999999998
G5,C(C1C(C(CC1C=O)=O)=O)(O)=O,4,3,0,3,17,0.000143
G5,C(C1C(C(C(O)=O)CC1=O)=O)=O,4,4,0,4,29,0.00019099999999999998
G5,C(C1C(C(C(C=C1)=O)O)=O)(O)=O,4,2,0,2,17,9.6e-05
G5,C(C1C(C(C=CC1=O)O)=O)(O)=O,4,4,0,4,45,0.00019099999999999998
G5,C(C(C(C(C(C(O)=O)O)=O)=O)C)=O,4,2,0,2,42,9.6e-05
G5,C(C(C(C=O)=O)C(C=O)CO)(O)=O,4,1,0,1,55,4.8e-05
G5,C(C(C(C(C(CO)C)=O)=O)O)(O)=O,4,2,0,2,42,9.6e-05
G5,C(C(C)C(C(C(C(O)=O)O)=O)O)=O,8,2,0,2,49,9.6e-05
G5,C(C(CO)C(C(O)=O)C(CO)=O)=O,4,2,0,2,55,0.00010700000000000001
G5,C(C(C(C(CO)=O)=O)C)(O)=O,2,3,0,3,5,0.000154
G5,C(C(C(C(CC)=O)=O)O)(O)=O,2,4,0,4,42,0.00020299999999999997
G5,C(C(C=O)C(C=O)CO)(O)=O,4,2,0,2,5,9.6e-05
G5,C(C(C(C=O)=O)CC(C=O)=O)(O)=O,2,1,0,1,7,4.8e-05
G5,C(C(C)C(C(O)=O)C(C=O)=O)=O,4,2,0,2,49,9.6e-05
G5,C(C(C(C)=O)C(C(C)=O)=O)(O)=O,2,6,0,6,29,0.000298
G5,C(CC(C(CC(C)=O)=O)=O)(O)=O,1,5,0,5,29,0.00024900000000000004
G5,C(CC(O)=O)(CC(C(C)=O)=O)=O,1,5,0,5,29,0.00024900000000000004
G5,C(C(C(C(CC(O)=O)=O)=O)C)=O,2,3,0,3,42,0.000154
G5,C(C(C(O)=O)C(C(CC=O)=O)=O)=O,2,2,0,2,2,9.6e-05
G5,C(C(C(O)=O)C(C(CC)=O)=O)=O,2,3,0,3,27,0.000144
G5,C(CC(C(C(C(O)=O)C)=O)=O)=O,2,3,0,3,29,0.000154
G5,C(C(C(C(C)=O)=O)CC=O)(O)=O,2,5,0,5,29,0.00024900000000000004
G5,C(CC(C(CCC=O)=O)=O)(O)=O,1,3,0,3,29,0.000143
G5,C(C(C(O)=O)CC(C(C)=O)=O)=O,2,5,0,5,29,0.00024900000000000004
G5,C(C(C(O)=O)C(C(C=O)=O)C)=O,4,2,0,2,17,9.6e-05
G5,C(C(C)CC=O)(C(C(O)=O)O)=O,4,4,0,4,0,0.00020299999999999997
G5,C(C(C=O)C(C(CO)=O)C)(O)=O,4,2,0,2,17,9.6e-05
G5,C(C(C(C(CCO)=O)=O)C)(O)=O,2,3,0,3,29,0.000154
G5,C(C(C(C(CC)=O)=O)CO)(O)=O,2,3,0,3,27,0.000144
G5,C(CCO)(C(C(O)=O)C(C)=O)=O,2,4,0,4,27,0.00019099999999999998
G5,C(C(C(CC(C)=O)=O)CO)(O)=O,2,4,0,4,27,0.00019099999999999998
G5,C(CC(CC(CCO)=O)=O)(O)=O,1,2,0,2,17,9.6e-05
G5,C(C(C=O)C(C=O)CCO)(O)=O,4,2,0,2,3,9.6e-05
G5,C(C(C)C(C(O)=O)C(CO)=O)=O,4,3,0,3,49,0.000154
G5,C(C(C)CC(C(C(O)=O)O)=O)=O,4,4,0,4,28,0.00020299999999999997
G5,C(CC(C(C(C)CO)=O)=O)(O)=O,2,3,0,3,49,0.000154
G5,C(C(C)C(C(CC(O)=O)=O)O)=O,4,3,0,3,29,0.000154
G5,C(CC(C(CC)=O)=O)(O)=O,1,3,0,3,29,0.000154
G5,C(C(C(C(C)=O)=O)C)(O)=O,2,3,0,3,28,0.000154
G5,C(CC(O)=O)(CC(C)=O)=O,1,6,0,6,29,0.000297
G5,C(C(C(C)=O)C(C)=O)(O)=O,1,5,0,5,28,0.00025
G5,C(C(C(O)=O)C(C=O)C)=O,4,2,0,2,49,9.6e-05
G5,C(C(C=O)C(C=O)C(CO)O)(O)=O,8,1,0,1,46,4.8e-05
G5,C(C(C=O)C(C(CO)=O)CO)(O)=O,4,1,0,1,2,4.8e-05
G5,C(C(C(C(C(CO)O)=O)=O)C)(O)=O,4,2,0,2,42,0.00010700000000000001
G5,C(C(C=O)C(C(C=O)=O)CO)(O)=O,4,1,0,1,55,4.8e-05
G5,C(C(C=O)C(C=O)C(C=O)O)(O)=O,8,1,0,1,43,4.8e-05
G5,C(C(C(CC(O)=O)=O)C(CO)=O)=O,2,2,0,2,1,0.00010700000000000001
G5,C(C(C(C(C(O)=O)O)=O)C(C)=O)=O,4,3,0,3,2,0.000155
G5,C(C(C=O)C(C=O)C(CO)=O)(O)=O,4,1,0,1,41,4.8e-05
G5,C(C(C(C(C(O)=O)O)=O)CC=O)=O,4,3,0,3,41,0.000155
G5,C(C(C)C(C=O)O)(C(C(O)=O)O)=O,8,3,0,3,28,0.000155
G5,C(C(C(C=O)=O)C)(O)=O,2,3,0,3,29,0.000154
G5,C(CC(C(C(CCO)=O)=O)=O)(O)=O,1,1,0,1,2,4.8e-05
G5,C(C(C(C(C(C)=O)=O)=O)CO)(O)=O,2,2,0,2,2,9.6e-05
G5,C(C(C(C(C=O)=O)=O)CCO)(O)=O,2,1,0,1,55,4.8e-05
G5,C(CC(C(C(C(C)=O)O)=O)=O)(O)=O,2,1,0,1,25,4.8e-05
G5,C(CC(C(C(C(C)=O)=O)O)=O)(O)=O,2,1,0,1,25,4.8e-05
G5,C(C(C(C(C(C=O)O)=O)=O)C)(O)=O,4,1,0,1,42,4.8e-05
G5,C(C(C=O)CC(C(C=O)O)O)(O)=O,8,2,0,2,43,0.00010700000000000001
G5,C(CC(C(C(C=C)=O)O)=O)(O)=O,2,4,0,4,29,0.000202
G5,C(CC(C(C=CC=O)O)=O)(O)=O,4,2,0,2,17,9.6e-05
G5,C(C(C=O)C1(CC(CO1)O)O)(O)=O,8,4,0,4,44,0.00020299999999999997
G5,C(CC(C1(CC(CO1)O)O)=O)(O)=O,4,2,0,2,14,9.6e-05
G5,C(C(C=O)C1C(CC(O)O1)O)(O)=O,16,4,0,4,43,0.00020299999999999997
G5,C(CC(C1C(CC(O1)O)O)=O)(O)=O,8,2,0,2,17,9.6e-05
G5,C(C(C=O)C(C(CC(O)=O)=O)=O)=O,1,1,0,1,14,4.8e-05
G5,C(C(C(CC(O)=O)=O)C(C=O)=O)=O,2,1,0,1,23,4.8e-05
G5,C(C(C=O)C(CC(O)=O)=O)=O,1,3,0,3,29,0.000143
G5,C(C(C(CC(O)=O)=O)C(C)=O)=O,2,5,0,5,29,0.00024900000000000004
G5,C(CC(O)=O)(C(C(C)=O)CO)=O,2,2,0,2,4,9.6e-05
G5,C(C(C(CC(O)=O)=O)(C(C)=O)O)=O,2,2,0,2,1,0.00010700000000000001
G5,C(C(C(CC(O)=O)=O)(CC=O)O)=O,2,2,0,2,29,0.00010700000000000001
G5,C(C1C(C(C=O)(CC1O)O)=O)(O)=O,8,2,0,2,43,9.6e-05
G5,C1(C(C(O)=O)C(C(C1(C)O)=O)O)=O,8,2,0,2,45,9.6e-05
G5,C1(C(C(O)=O)C(C(C1O)=O)(C)O)=O,8,2,0,2,25,9.6e-05
G5,C(C(C(O)=O)C(C=O)C(C=O)=O)=O,4,1,0,1,33,4.8e-05
G5,C(C(C=O)C(C=O)C(O)=O)=O,2,2,0,2,5,9.6e-05
G5,C(C(C(O)=O)C(C=O)C(C)=O)=O,4,2,0,2,4,9.6e-05
G5,C(C(C(CC(O)=O)=O)CC=O)=O,2,4,0,4,29,0.000202
G5,C(C(C(C(O)=O)=O)C)(O)=O,2,3,0,3,28,0.000154
G5,C(C1C(C(C=O)OC1CO)=O)(O)=O,8,2,0,2,26,9.6e-05
G5,C1(C(CO)OC(C=O)C1C(O)=O)=O,8,2,0,2,2,9.6e-05
G5,C(C1C(C(C=O)OCC1O)=O)(O)=O,8,2,0,2,37,9.6e-05
G5,C1(C(COC(C=O)C1C(O)=O)O)=O,8,2,0,2,37,9.6e-05
G5,C1(C(C(C=O)OCC1C(O)=O)O)=O,8,2,0,2,37,9.6e-05
G5,C(C1C(C(C(O)=O)C(CO1)=O)O)=O,8,2,0,2,37,9.6e-05
G5,C1(CC(C(C=O)OC1C(O)=O)O)=O,8,2,0,2,37,9.6e-05
G5,C(C1C(C(C(CO)OC1)=O)=O)(O)=O,4,2,0,2,2,9.6e-05
G5,C(C1C(C(OC1C(C)=O)=O)=O)(O)=O,4,2,0,2,27,9.6e-05
G5,C(CC(C1CC(C(O1)=O)=O)=O)(O)=O,2,1,0,1,27,4.8e-05
G5,C(CC1C(C(O)=O)C(C(O1)=O)=O)=O,4,2,0,2,27,9.6e-05
G5,C(C(C(O)=O)C1CC(C(O1)=O)=O)=O,4,2,0,2,27,9.6e-05
G5,C(C1C(C(C(C)=O)OC1=O)=O)(O)=O,4,2,0,2,27,9.6e-05
G5,C1(CC(C(C(CC(O)=O)=O)O1)=O)=O,2,1,0,1,27,4.8e-05
G5,C1(C(C(O)=O)C(C(CC=O)O1)=O)=O,4,2,0,2,27,9.6e-05
G5,C(C(C(O)=O)C1C(CC(O1)=O)=O)=O,4,2,0,2,27,9.6e-05
G5,C1(CCOC(C(C1C(O)=O)=O)=O)=O,2,2,0,2,27,9.6e-05
G5,C1(CC(C(OCC1C(O)=O)=O)=O)=O,2,2,0,2,27,9.6e-05
G5,C(C1C(C(OCC(C1)=O)=O)=O)(O)=O,2,1,0,1,27,4.8e-05
G5,C(C1C(COC(C(C1)=O)=O)=O)(O)=O,2,1,0,1,27,4.8e-05
G5,C(C1C(CCC(C(O1)=O)=O)=O)(O)=O,2,2,0,2,27,9.6e-05
G5,C1(C(C(O)=O)C(C(CCO1)=O)=O)=O,2,2,0,2,27,9.6e-05
G5,C1(CC(C(C(C(O)=O)CO1)=O)=O)=O,2,2,0,2,27,9.6e-05
G5,C1(C(C(CC(CO1)=O)=O)C(O)=O)=O,2,2,0,2,27,9.6e-05
G5,C1(CC(C(C(O)=O)C(CO1)=O)=O)=O,2,2,0,2,27,9.6e-05
G5,C1(CC(CC(C(C(O)=O)O1)=O)=O)=O,2,2,0,2,27,9.6e-05
G5,C(C1C(C(CO)=CC1=O)=O)(O)=O,2,5,0,5,45,0.000239
G5,C(C1C=C(C(C1=O)=O)CO)(O)=O,2,2,0,2,17,9.6e-05
G5,C(C1C(C(C(C1O)=O)=C)=O)(O)=O,4,3,0,3,45,0.000144
G5,C(C1C(C(C(C1=C)=O)O)=O)(O)=O,4,2,0,2,17,9.6e-05
G5,C(C1C(C(C(C1=O)=C)O)=O)(O)=O,4,4,0,4,45,0.00019099999999999998
G5,C(C1C(C(C(C1O)=C)=O)=O)(O)=O,4,3,0,3,45,0.000144
G5,C(C1C(C=C(C=O)C1O)=O)(O)=O,4,4,0,4,45,0.00019099999999999998
G5,C(C1C(C(C(C=O)=C1)O)=O)(O)=O,4,3,0,3,29,0.000143
G5,C(C1C(C(C=C1C=O)O)=O)(O)=O,4,3,0,3,29,0.000143
G5,C(C1C(C(C=O)=CC1O)=O)(O)=O,4,3,0,3,45,0.000144
G5,C(C(C(C=CC(O)=O)=O)CO)(O)=O,4,2,0,2,46,9.6e-05
G5,C(C(C(CO)=O)C=CC(O)=O)(O)=O,4,1,0,1,12,4.8e-05
G5,C(C(C(CC=CC(O)=O)=O)O)(O)=O,4,2,0,2,12,9.6e-05
G5,C(CC(C(C=CC(O)=O)O)=O)(O)=O,4,1,0,1,45,4.8e-05
G5,C(C(C=O)C(C(C=C)O)=O)(O)=O,4,5,0,5,27,0.000239
G5,C(C(C(C(C=O)O)=O)C=C)(O)=O,4,3,0,3,29,0.000143
G5,C(C(C(C=C)=O)C(C=O)O)(O)=O,4,4,0,4,27,0.00020299999999999997
G5,C(C1C(C(C=O)(C=C1)O)=O)(O)=O,4,2,0,2,17,9.6e-05
G5,C(CC(C1C=CC(O1)=O)=O)(O)=O,2,2,0,2,17,9.6e-05
G5,C(C(C(O)=O)C1C=CC(O1)=O)=O,4,3,0,3,48,0.000144
G5,C(CC(C1C(C=CO1)=O)=O)(O)=O,2,2,0,2,17,9.6e-05
G5,C(C(C(O)=O)C1C(C=CO1)=O)=O,4,3,0,3,45,0.000144
G5,C(C1C(C=CC(OC1)=O)=O)(O)=O,2,3,0,3,19,0.000144
G5,C(C1C(COC(C=C1)=O)=O)(O)=O,2,2,0,2,17,9.6e-05
G5,C(C1C(CC=CC(O1)=O)=O)(O)=O,2,3,0,3,48,0.000144
G5,C(C1C(C(C=COC1)=O)=O)(O)=O,2,3,0,3,45,0.000144
G5,C(C1C(COC=CC1=O)=O)(O)=O,2,4,0,4,38,0.00019099999999999998
G5,C(C1C(CC(C=CO1)=O)=O)(O)=O,2,3,0,3,38,0.000144
G5,C1(C(C(O)=O)C(C=CCO1)=O)=O,2,4,0,4,19,0.00019099999999999998
G5,C(C1C(C(C=CCO1)=O)=O)(O)=O,2,3,0,3,36,0.000144
G5,C1(CC=CC(C(C(O)=O)O1)=O)=O,2,4,0,4,48,0.00019099999999999998
G5,C(C1C(C=CC(CO1)=O)=O)(O)=O,2,5,0,5,45,0.000239
G5,C(C1C(C(OC1)=CC=O)=O)(O)=O,4,3,0,3,45,0.000144
G5,C(C1C(COC1=CC=O)=O)(O)=O,4,3,0,3,45,0.000144
G5,C(C1C(CC(O1)=CC=O)=O)(O)=O,4,3,0,3,45,0.000144
G5,C(C1C(C(C=O)OC1=C)=O)(O)=O,4,3,0,3,26,0.000144
G5,C(C1C(C(OC1C=O)=C)=O)(O)=O,4,3,0,3,14,0.000144
G5,C(C1C(C=C(C=O)OC1)=O)(O)=O,2,3,0,3,30,0.000144
G5,C(C1C(COC(C=O)=C1)=O)(O)=O,2,2,0,2,17,9.6e-05
G5,C(C1C(CC=C(C=O)O1)=O)(O)=O,2,3,0,3,12,0.000144
G5,C(C1C(C(C=O)OC=C1)=O)(O)=O,4,2,0,2,17,9.6e-05
G5,C(C1C(C=COC1C=O)=O)(O)=O,4,3,0,3,37,0.000144
G5,C(C1C(C2(CC(C1O2)O)O)=O)(O)=O,16,3,0,3,14,0.000144
G5,C(C1C(C2C(C1C(O2)O)O)=O)(O)=O,32,3,0,3,17,0.000143
G5,C(C1C(CC(C(CO)=O)O1)=O)(O)=O,4,2,0,2,32,9.6e-05
G5,C(C1C(COC1C(CO)=O)=O)(O)=O,4,2,0,2,32,9.6e-05
G5,C(C(C(C1CC(CO1)=O)=O)O)(O)=O,4,2,0,2,32,9.6e-05
G5,C(C1C(CC(C(C)=O)(O1)O)=O)(O)=O,4,3,0,3,24,0.000144
G5,C(C1C(COC1(C(C)=O)O)=O)(O)=O,4,3,0,3,24,0.000144
G5,C(CC(C1(CC(CO1)=O)O)=O)(O)=O,2,2,0,2,17,9.6e-05
G5,C1(CCC(C(C(C(O)=O)O)=O)O1)=O,4,2,0,2,32,9.6e-05
G5,C(C1C(C(C(CCO)O1)=O)=O)(O)=O,4,2,0,2,4,9.6e-05
G5,C(C1C(OC(C1=O)CCO)=O)(O)=O,4,2,0,2,2,9.6e-05
G5,C(C(C1C(C(C(O)=O)CO1)=O)O)=O,8,2,0,2,4,9.6e-05
G5,C(C(C1C(C(O)=O)C(CO1)=O)O)=O,8,2,0,2,4,9.6e-05
G5,C1(CC(C(C=O)O)OC1C(O)=O)=O,8,2,0,2,4,9.6e-05
G5,C(C1C(C2C(CC(O2)O)O1)=O)(O)=O,16,3,0,3,9,0.000144
G5,C(C1C(C2(CC(CO2)O1)O)=O)(O)=O,8,3,0,3,54,0.000144
G5,C(C1C(C2(COCC1O2)O)=O)(O)=O,8,3,0,3,36,0.000144
G5,C(C1C(C2COCC1(O2)O)=O)(O)=O,8,3,0,3,36,0.000144
G5,C(C1C(C2CC(C(O1)O2)O)=O)(O)=O,16,2,0,2,4,9.6e-05
G5,C(C1C(C2OCCC1(O2)O)=O)(O)=O,8,3,0,3,30,0.000144
G5,C(C1C(C2(CCOC1O2)O)=O)(O)=O,8,3,0,3,17,0.000144
G5,C(C1CC(C(C(C(O)=O)O1)=O)O)=O,8,2,0,2,4,9.6e-05
G5,C(C1CC(C(O)=O)C(C(O1)O)=O)=O,8,2,0,2,12,9.6e-05
G5,C(C1C(C(CC(C)(O1)O)=O)=O)(O)=O,4,3,0,3,26,0.000144
G5,C(C1C(C(COC1(C)O)=O)=O)(O)=O,4,3,0,3,26,0.000144
G5,C1(C(C(O)=O)OC(C(C1)=O)(C)O)=O,4,3,0,3,24,0.000144
G5,C1(C(C)(OCC(C1C(O)=O)=O)O)=O,4,3,0,3,24,0.000144
G5,C(C1C(C(C(C(C)O1)=O)O)=O)(O)=O,8,2,0,2,24,9.6e-05
G5,C1(C(C)OC(C(C1C(O)=O)=O)O)=O,8,3,0,3,24,0.000144
G5,C(C1C(C(C(C)OC1O)=O)=O)(O)=O,8,3,0,3,4,0.000144
G5,C(C1C(CC(C(C)(O1)O)O)=O)(O)=O,8,4,0,4,45,0.00020299999999999997
G5,C(C1C(COC(C)(C1O)O)=O)(O)=O,8,4,0,4,45,0.00020299999999999997
G5,C(C1C(C(C(C)(O)OC1)O)=O)(O)=O,8,4,0,4,9,0.00020299999999999997
G5,C(C1C(C(COC1(C)O)O)=O)(O)=O,8,3,0,3,26,0.000144
G5,C(C1C(C(C)(O)OCC1O)=O)(O)=O,8,3,0,3,14,0.000144
G5,C(C1C(C2(COC1CO2)O)=O)(O)=O,8,3,0,3,54,0.000144
G5,C(C1C(C2COC1(CO2)O)=O)(O)=O,8,3,0,3,54,0.000144
G5,C(C1C(C(CCC(O1)O)=O)=O)(O)=O,4,3,0,3,17,0.000144
G5,C(C1C(C(COC(C1)O)=O)=O)(O)=O,4,2,0,2,17,9.6e-05
G5,C(C1C(CC(CC(O1)O)O)=O)(O)=O,8,3,0,3,17,0.000144
G5,C(C1C(COC(CC1O)O)=O)(O)=O,8,3,0,3,17,0.000144
G5,C(C1C(C(CC(O)OC1)O)=O)(O)=O,8,4,0,4,4,0.00020299999999999997
G5,C(C1C(C(COC(C1)O)O)=O)(O)=O,8,2,0,2,7,9.6e-05
G5,C(C1C(CC(O)OCC1O)=O)(O)=O,8,4,0,4,44,0.00020299999999999997
G5,C(C1C(CC(COC1O)O)=O)(O)=O,8,4,0,4,44,0.00020299999999999997
G5,C(C1C(C(C(CCO1)O)O)=O)(O)=O,8,2,0,2,4,9.6e-05
G5,C(C1C(C(O)OCCC1O)=O)(O)=O,8,3,0,3,4,0.000144
G5,C(C1C(C(CCOC1O)O)=O)(O)=O,8,3,0,3,4,0.000144
G5,C(C1C(C(C(O)OCC1)O)=O)(O)=O,8,2,0,2,17,9.6e-05
G5,C(C1C(CCOC(C1O)O)=O)(O)=O,8,4,0,4,29,0.00020299999999999997
G5,C(C1C(CC(C(O)OC1)O)=O)(O)=O,8,4,0,4,29,0.00020299999999999997
G5,C(C1C(C2OC(CC1O2)O)=O)(O)=O,16,3,0,3,23,0.000144
G5,C(C1C(C2CC(O)OC1O2)=O)(O)=O,16,3,0,3,17,0.000144
G5,C(C1C(C2C(CC(O1)O2)O)=O)(O)=O,16,2,0,2,17,9.6e-05
G5,C(C1C(C(C=O)OC(C1)=O)=O)(O)=O,4,1,0,1,27,4.8e-05
G5,C1(CC(C(C(O)=O)C(C=O)O1)=O)=O,4,2,0,2,27,9.6e-05
G5,C1(C(C(O)=O)C(CC(C=O)O1)=O)=O,4,2,0,2,27,9.6e-05
G5,C(C(C(C(C(C=O)=C)O)=O)O)(O)=O,4,2,0,2,2,9.6e-05
G5,C(C(C(C(C(CO)=C)O)=O)O)(O)=O,4,2,0,2,49,9.6e-05
G5,C(C(C(C=C(CO)CO)=O)O)(O)=O,2,3,0,3,49,0.000155
G5,C(C(C(C=O)=O)C(C=O)=C)(O)=O,2,2,0,2,17,9.6e-05
G5,C(C(C(CO)=C)C(C=O)=O)(O)=O,2,2,0,2,49,9.6e-05
G5,C(C(C(CO)=O)C(C=O)=C)(O)=O,2,3,0,3,16,0.000154
G5,C(C(C(CC(C=O)=C)=O)O)(O)=O,2,5,0,5,16,0.00025
G5,C(C(C(C=C(C=O)C)=O)O)(O)=O,4,4,0,4,16,0.00020299999999999997
G5,C(CC(C(C(C=O)=C)O)=O)(O)=O,2,4,0,4,29,0.000202
G5,C(C(C=C)C(C=O)=O)(O)=O,2,2,0,2,4,9.6e-05
G5,C(C(C(O)=O)C(C=O)=C)=O,2,2,0,2,17,9.6e-05
G5,C(C(C(C(C=O)=CC=O)=O)O)(O)=O,4,2,0,2,55,9.6e-05
G5,C(C(C(C(C=O)=C)=O)O)(O)=O,2,3,0,3,9,0.000144
G5,C(C(C(C(C=O)=CC)=O)O)(O)=O,4,3,0,3,45,0.000144
G5,C(C(C(C(C(O)=O)O)=O)C=C)=O,4,3,0,3,45,0.000144
G5,C(C(C=O)C(CO)=CC=O)(O)=O,4,2,0,2,49,9.6e-05
G5,C(C(C=O)C(C(C=O)O)=C)(O)=O,4,2,0,2,17,9.6e-05
G5,C(C(C(C(CO)O)=O)C=C)(O)=O,4,2,0,2,4,9.6e-05
G5,C(C(C=O)C(C(CO)O)=C)(O)=O,4,2,0,2,17,9.6e-05
G5,C(C(C(C(CO)=C)=O)O)(O)=O,2,3,0,3,49,0.000144
G5,C(C(C=O)C(C=O)=CCO)(O)=O,4,2,0,2,3,9.6e-05
G5,C(C(C(C(C=C)O)=O)CO)(O)=O,4,3,0,3,27,0.000144
G5,C(C(C(C(C(C)O)=C)=O)O)(O)=O,4,3,0,3,4,0.000144
G5,C(C(C(C(CO)=CC)=O)O)(O)=O,4,3,0,3,27,0.000144
G5,C(C(C(O)=O)O)(C(C=C)CO)=O,4,3,0,3,28,0.000144
G5,C(C(C=O)C(CO)=CCO)(O)=O,4,2,0,2,3,9.6e-05
G5,C(C(C(C=C(CO)C)=O)O)(O)=O,4,4,0,4,49,0.00020299999999999997
G5,C(C(C(CO)=O)C(CO)=C)(O)=O,2,3,0,3,49,0.000154
G5,C(C(C(O)=O)O)(CC(CO)=C)=O,2,5,0,5,49,0.00025
G5,C(CC(C(C(CO)=C)O)=O)(O)=O,2,3,0,3,29,0.000154
G5,C(C(C(C=CC)=O)O)(O)=O,4,4,0,4,28,0.00020299999999999997
G5,C(C(C(CO)=O)C=C)(O)=O,2,4,0,4,29,0.000202
G5,C(C(C(CC=C)=O)O)(O)=O,2,6,0,6,29,0.000298
G5,C(CC(C(C=C)O)=O)(O)=O,2,5,0,5,29,0.00024900000000000004
G5,C(C(C=O)C(CO)=C)(O)=O,2,2,0,2,49,9.6e-05
G5,C(C(C=O)C=CC(C=O)O)(O)=O,8,2,0,2,43,9.6e-05
G5,C(C(C(O)=O)C=C)=O,2,2,0,2,4,9.6e-05
G5,C(C(C(C(C=O)=CCO)=O)O)(O)=O,4,2,0,2,55,9.6e-05
G5,C(C(C(C(CO)=CCO)=O)O)(O)=O,4,3,0,3,2,0.000155
G5,C(C(C(C(C(CO)O)=C)=O)O)(O)=O,4,3,0,3,0,0.000155
G5,C(C(C=O)C(C(O)=O)=CCO)(O)=O,4,1,0,1,7,4.8e-05
G5,C(C(C(CC(O)=O)=O)(C=C)O)=O,2,2,0,2,4,9.6e-05
G5,C(CC(O)=O)(C(C=C)(CO)O)=O,2,2,0,2,4,9.6e-05
G5,C(C(C(O)=O)O)(C(C=C)(CO)O)=O,4,4,0,4,2,0.000205
G5,C(C(C(C=C(C=O)CO)=O)O)(O)=O,4,2,0,2,46,9.6e-05
G5,C(C(C(O)=O)C1OCC(C=1)=O)=O,2,3,0,3,48,0.000144
G5,C(CC1OC(C(O)=O)C(C=1)=O)=O,2,3,0,3,48,0.000144
G5,C(C1C(C=CC(CO)(O1)O)=O)(O)=O,4,2,0,2,32,9.6e-05
G5,C1(C(C=CC(C(C(O)=O)O1)=O)O)=O,4,2,0,2,27,9.6e-05
G5,C(C1C(C=C(C(CO)O)O1)=O)(O)=O,4,2,0,2,2,9.6e-05
G5,C1(C(C(O)=O)OC(C1O)=CCO)=O,8,2,0,2,2,9.6e-05
G5,C(C1C(C(C(C=C)(O1)O)O)=O)(O)=O,8,3,0,3,32,0.000144
G5,C1(C(C(O)=O)OC(CO)=CC1O)=O,4,2,0,2,32,9.6e-05
G5,C(C1C(C(C(C(O1)=C)O)O)=O)(O)=O,8,2,0,2,24,9.6e-05
G5,C(C1C(C(C(C=CO1)O)O)=O)(O)=O,8,2,0,2,38,9.6e-05
G5,C(C1(C)C(C(O)=O)C(C(O1)O)=O)=O,8,3,0,3,4,0.000144
G5,C(C1C(C(O)OC1C=O)=O)(O)=O,8,3,0,3,0,0.000144
G5,C(C1C(C(O)OC1(CO)C)=O)(O)=O,8,3,0,3,49,0.000144
G5,C(C1C(C(O)OC1C)=O)(O)=O,8,3,0,3,45,0.000144
G5,C(C(C=O)C1CC(C(O)O1)O)(O)=O,16,3,0,3,43,0.000144
G5,C(C1C(C(C(C)(O1)O)O)=O)(O)=O,8,3,0,3,0,0.000144
G5,C(C1C(C(C(O1)O)O)=O)(O)=O,8,3,0,3,5,0.000144
G5,C1(C(C)OC(C=O)(C1C(O)=O)O)=O,8,3,0,3,24,0.000144
G5,C(C(C=O)C1(C(CCO1)O)O)(O)=O,8,3,0,3,4,0.000144
G5,C(C1C(C2(COC1(C2)O)O)=O)(O)=O,8,4,0,4,17,0.00019099999999999998
G5,C(C1C(C(C(C(O1)O)O)O)=O)(O)=O,16,3,0,3,5,0.000144
G5,C(C1C(C(O)OCC1(C)O)=O)(O)=O,8,3,0,3,49,0.000144
G5,C(C1C(COC(C1(C)O)O)=O)(O)=O,8,4,0,4,16,0.00020299999999999997
G5,C(C1C(CC(C)(C(O1)O)O)=O)(O)=O,8,4,0,4,16,0.00020299999999999997
G5,C(C1C(C(COC1O)O)=O)(O)=O,8,3,0,3,27,0.000144
G5,C(C1C(C(C(C)OC1O)O)=O)(O)=O,16,3,0,3,4,0.000144
G5,C(C1C(C(C(O)OC1)O)=O)(O)=O,8,3,0,3,27,0.000144
G5,C(C1C(C(C(O)OC1C)O)=O)(O)=O,16,3,0,3,4,0.000144
G5,C(C1C(C(C(C(C1)O)O)O)=O)(O)=O,16,1,0,1,7,4.8e-05
G5,C(C(C(C=O)=O)CCO)(O)=O,2,3,0,3,7,0.000154
G5,C(C(C(C=O)=O)CCCO)(O)=O,2,1,0,1,46,4.8e-05
G5,C(C(C(C=O)=O)CC(C)O)(O)=O,4,1,0,1,27,4.8e-05
G5,C(C(C(C=O)=O)CCC(O)=O)(O)=O,2,2,0,2,18,9.6e-05
G5,C(C(C(CO)=O)CCO)(O)=O,2,2,0,2,29,9.6e-05
G5,C(C(C(CCCCO)=O)O)(O)=O,2,3,0,3,27,0.000144
G5,C(C(C(CO)=O)CCCO)(O)=O,2,1,0,1,27,4.8e-05
G5,C(C(C(CCC(C)O)=O)O)(O)=O,4,3,0,3,27,0.000144
G5,C(C(C(CO)=O)CC(C)O)(O)=O,4,1,0,1,27,4.8e-05
G5,C(C(C(CCCC(O)=O)=O)O)(O)=O,2,4,0,4,18,0.000192
G5,C(CCC(C(O)=O)C(CO)=O)(O)=O,2,2,0,2,18,9.6e-05
G5,C(C(C=O)C(C=O)C(C)O)(O)=O,8,1,0,1,27,4.8e-05
G5,C(C(C(O)=O)C(C=O)CC(O)=O)=O,4,2,0,2,18,9.6e-05
G5,C(C(C(CCC(CO)O)=O)O)(O)=O,4,3,0,3,46,0.000144
G5,C(C(C(CO)=O)CC(CO)O)(O)=O,4,1,0,1,46,4.8e-05
G5,C(C(C(C=C)=O)OC(C=O)O)(O)=O,4,3,0,3,4,0.000144
G5,C(C(C(O)=O)C=CC=O)=O,4,1,0,1,28,4.8e-05
G5,C(C(C(CO)=O)C(C)(C)O)(O)=O,2,2,0,2,0,9.6e-05
G5,C(CC(C(C(C)(C)O)O)=O)(O)=O,2,2,0,2,0,9.6e-05
G5,C(CC(CO)(CC(C)=O)O)(O)=O,2,1,0,1,0,4.8e-05
G5,C(C(C(CO)=O)C(C=C)O)(O)=O,4,4,0,4,0,0.00018999999999999998
G5,C(CC(C(C(C=C)O)O)=O)(O)=O,4,4,0,4,0,0.00018999999999999998
G5,C(C(C(CO)=O)C(C=CC)O)(O)=O,8,2,0,2,0,9.499999999999999e-05
G5,C(CC(C(C(C=CC)O)O)=O)(O)=O,8,2,0,2,0,9.499999999999999e-05
G5,C(C(C(CO)=O)C(CC=C)O)(O)=O,4,2,0,2,0,9.499999999999999e-05
G5,C(CC(C(C(CC=C)O)O)=O)(O)=O,4,2,0,2,0,9.499999999999999e-05
G5,C(C(C=C)C(CO)(CC(O)=O)O)=O,4,1,0,1,0,4.8e-05
G5,C(C(C(CC(C)(C)O)=O)O)(O)=O,2,1,0,1,0,4.8e-05
G5,C(C(C(C)(CC(C)=O)O)O)(O)=O,4,3,0,3,33,0.000143
G5,C(C(C(CC(C=C)O)=O)O)(O)=O,4,3,0,3,29,0.000143
G5,C(C(C(CC(C=CC)O)=O)O)(O)=O,8,1,0,1,0,4.8e-05
G5,C(C(C(CC(CC=C)O)=O)O)(O)=O,4,1,0,1,0,4.8e-05
G5,C(C(C=C)C(C)(C(C(O)=O)O)O)=O,8,1,0,1,0,4.8e-05
G5,C(C(CC(C(C=O)=O)=O)O)(O)=O,2,3,0,3,29,0.000143
G5,C(C(CC(CC(CO)=O)=O)O)(O)=O,2,3,0,3,29,0.000165
G5,C(C(C(C(CO)=O)C(C)=O)O)(O)=O,4,4,0,4,26,0.000213
G5,C(C(CC(C(C(C)=O)O)=O)O)(O)=O,4,2,0,2,49,0.00010700000000000001
G5,C(C(C(CC=O)=O)C(C(O)=O)O)=O,4,3,0,3,9,0.000154
G5,C(C(C(C(CCC=O)=O)O)O)(O)=O,4,4,0,4,7,0.000202
G5,C(C(C(C(C=CCO)=O)O)O)(O)=O,8,5,0,5,11,0.000261
G5,C(OCC(CC(C(O)=O)O)=O)=O,2,3,0,3,33,0.000143
G5,C(OC(C(C)=O)C(C(O)=O)O)=O,4,3,0,3,33,0.000143
G5,C(OC(C=O)C(C(O)=O)O)=O,4,2,0,2,33,9.6e-05
G5,C(CO)(OC(C=O)C(C(O)=O)O)=O,4,2,0,2,40,9.6e-05
G5,C(C)(OC(C=O)C(C(O)=O)O)=O,4,2,0,2,28,9.6e-05
G5,C(C(C(C(C=O)=O)CC=O)O)(O)=O,4,2,0,2,20,9.6e-05
G5,C(C(C(C=O)CC(C=O)=O)O)(O)=O,4,3,0,3,29,0.000154
G5,C(C(C(C(C(O)=O)=O)O)O)(O)=O,4,3,0,3,33,0.000154
G5,C(C(C(C(O)=O)=O)C(C(O)=O)O)=O,4,3,0,3,45,0.000154
G5,C(C(C(C(C(CO)=O)=O)O)O)(O)=O,4,3,0,3,5,0.000143
G5,C(C(C(C(C(C=C)=O)=O)O)O)(O)=O,4,3,0,3,7,0.000143
G5,C(C(CC(C(C(C)O)=O)=O)O)(O)=O,4,1,0,1,49,4.8e-05
G5,C(C(C1C(C(C(C1)=O)O)=O)O)(O)=O,8,2,0,2,47,9.6e-05
G5,C1(CC(C(CO1)=O)C(C(O)=O)O)=O,4,1,0,1,7,4.8e-05
G5,C1(CCC(C(C(C(O)=O)O)O1)=O)=O,4,2,0,2,7,9.6e-05
G5,C(C(C1C(CC(CO1)=O)=O)O)(O)=O,4,2,0,2,54,9.6e-05
G5,C(C(C1C(COCC1=O)=O)O)(O)=O,2,2,0,2,54,9.6e-05
G5,C(C(C1C(C(OC1)=O)=O)O)(O)=O,4,3,0,3,33,0.000143
G5,C1(C(C(CO1)=O)C(C(O)=O)O)=O,4,4,0,4,33,0.00018999999999999998
G5,C1(CC(C(C(C(O)=O)O)O1)=O)=O,4,3,0,3,33,0.000143
G5,C(C(C1C(C=CO1)=O)O)(O)=O,4,3,0,3,33,0.000143
G5,C(C(C1C(C=CC(O)O1)=O)O)(O)=O,8,2,0,2,27,9.6e-05
G5,C(C(C)O)(C(C=O)C(C(O)=O)O)=O,8,4,0,4,45,0.000202
G5,C(CC(C(O)=O)O)(C(CCO)O)=O,4,5,0,5,29,0.000271
G5,C(C(C(C(C(CO)=O)=O)C)O)(O)=O,4,2,0,2,42,0.00010700000000000001
G5,C(C(C(C(C(CC)=O)=O)O)O)(O)=O,4,2,0,2,42,9.6e-05
G5,C(C(CC(C(CC)=O)=O)O)(O)=O,2,3,0,3,4,0.000154
G5,C(C(C(C(C(C)=O)=O)C)O)(O)=O,4,3,0,3,49,0.000154
G5,C(C(CC(CC(C)=O)=O)O)(O)=O,2,6,0,6,29,0.00031800000000000003
G5,C(C(C(C(C)=O)C(C)=O)O)(O)=O,2,4,0,4,33,0.000202
G5,C(C(C(C=O)C(C=O)C)O)(O)=O,8,4,0,4,28,0.000202
G5,C(C(C=O)C(CC(C(O)=O)O)=O)=O,2,2,0,2,29,0.00010700000000000001
G5,C(C(C=O)C(C=O)C(C(O)=O)O)=O,4,1,0,1,43,4.8e-05
G5,C(C(C(C(C(O)=O)=O)C)O)(O)=O,4,4,0,4,29,0.000213
G5,C(C(C(C(C(C=C)O)=O)O)O)(O)=O,8,3,0,3,31,0.000143
G5,C(C(C(C=C)C(C=O)=O)O)(O)=O,4,2,0,2,4,9.499999999999999e-05
G5,C(C(CC(C=CC=O)=O)O)(O)=O,4,2,0,2,33,9.499999999999999e-05
G5,C(C(C(C=O)=C)C(C(O)=O)O)=O,4,3,0,3,45,0.000154
G5,C(C(C(C(C(C=O)=C)=O)O)O)(O)=O,4,2,0,2,9,9.6e-05
G5,C(C(C(C(C(CO)=C)=O)O)O)(O)=O,4,4,0,4,49,0.000202
G5,C(C(C(C(C=CC)=O)O)O)(O)=O,8,5,0,5,33,0.00025
G5,C(C(C(C(CO)=O)C=C)O)(O)=O,4,3,0,3,11,0.000154
G5,C(C(C(C(CC=C)=O)O)O)(O)=O,4,6,0,6,33,0.000297
G5,C(C(CC(C(C=C)O)=O)O)(O)=O,4,3,0,3,4,0.000154
G5,C(C(C(CO)=C)C(C(O)=O)O)=O,4,3,0,3,49,0.000154
G5,C(C(C=C)C(C(O)=O)O)=O,4,5,0,5,29,0.00024900000000000004
G5,C1(C(O)OC(C)C1C(C(O)=O)O)=O,16,3,0,3,45,0.000143
G5,C(C(C1C(C(C(O1)O)O)=O)O)(O)=O,16,3,0,3,5,0.000143
G5,C(C(C(C(C=O)=O)CCO)O)(O)=O,4,1,0,1,55,4.8e-05
G5,C(CO)(C(CCO)C(C(O)=O)O)=O,4,2,0,2,33,0.00010700000000000001
G5,C(C(C=CC=O)C(C(O)=O)O)=O,8,3,0,3,29,0.000143
G5,C(C(C(C(C=O)OC=O)O)O)(O)=O,8,2,0,2,17,9.6e-05
G5,C(C(C(C1C(C=CO1)=O)O)O)(O)=O,8,2,0,2,17,9.499999999999999e-05
G5,C(C(C(C(C(C=O)=O)C)O)O)(O)=O,8,3,0,3,49,0.000154
G5,C(C(C=C)C(C(C(O)=O)O)O)=O,8,2,0,2,17,9.499999999999999e-05
G5,C(C(C(C(CC(C)=O)O)O)O)(O)=O,8,5,0,5,5,0.000271
G5,C(CC(C(CC(C)=O)O)O)(O)=O,4,1,0,1,29,4.8e-05
G5,C(C(C=C)C(C(CC(O)=O)O)O)=O,8,1,0,1,29,4.8e-05
G5,C(C)(C(C(C=O)=O)C(C)(C)O)=O,2,2,0,2,26,9.6e-05
G5,C(CC(C)(C)O)(CC(C=O)=O)=O,1,1,0,1,26,4.8e-05
G5,C(C)(CC(C(CC(C)=O)O)=O)=O,2,1,0,1,26,4.8e-05
G5,C(C(CC(C)=O)(CC(C)=O)O)=O,1,1,0,1,26,4.8e-05
G5,C(C)(C(C(C=O)=O)C1(C=COC1)O)=O,4,2,0,2,26,9.499999999999999e-05
G5,C(CC1(C=COC1)O)(CC(C=O)=O)=O,2,1,0,1,26,4.8e-05
G5,C(C(C1C(C=CO1)=O)O)(CC(C)=O)=O,4,2,0,2,26,9.499999999999999e-05
G5,C(C(CC(C)=O)(C1C(C=CO1)=O)O)=O,4,2,0,2,26,9.499999999999999e-05
G5,C(C)(C(C(C=O)=O)C(C=C)O)=O,4,4,0,4,26,0.00018999999999999998
G5,C(CC(C=C)O)(CC(C=O)=O)=O,2,3,0,3,29,0.000143
G5,C(C)(C(C(C=O)=O)C(C=CC)O)=O,8,2,0,2,26,9.499999999999999e-05
G5,C(CC(C=CC)O)(CC(C=O)=O)=O,4,1,0,1,26,4.8e-05
G5,C(C)(C(C(C=O)=O)C(CC=C)O)=O,4,2,0,2,26,9.499999999999999e-05
G5,C(CC(CC=C)O)(CC(C=O)=O)=O,2,1,0,1,26,4.8e-05
G5,C(C(C=C)C(C(CC(C)=O)=O)O)=O,4,1,0,1,26,4.8e-05
G5,C(C(C=C)C(C=O)(CC(C)=O)O)=O,4,1,0,1,26,4.8e-05
G5,C(C(C=C)C(C)(CC(C=O)=O)O)=O,4,1,0,1,26,4.8e-05
G5,C(C(C(C=O)=O)C(CC(O)=O)O)=O,4,3,0,3,23,0.000154
G5,C(C(C(C=O)=O)C(C=O)(C=O)O)=O,2,2,0,2,23,9.6e-05
G5,C(C(C(C=O)=O)C(C(C=O)=O)O)=O,4,2,0,2,23,9.6e-05
G5,C(C(C(C=O)=O)C(C)(CCO)O)=O,4,3,0,3,23,0.000154
G5,C(C)(C(CO)C(C(CC=O)=O)O)=O,4,4,0,4,23,0.000202
G5,C(C(C(C=O)=O)C(C)(C)O)=O,2,2,0,2,23,9.6e-05
G5,C(CC(C(CC(C)=O)O)=O)=O,2,4,0,4,30,0.00018999999999999998
G5,C(OCC(C(C=O)C(C=O)=O)O)=O,4,2,0,2,23,9.6e-05
G5,C(OC(C=O)C(C(CC=O)=O)O)=O,4,2,0,2,23,9.6e-05
G5,C(OC(C=O)C(C=O)(CC=O)O)=O,4,2,0,2,23,9.6e-05
G5,C(OC(C=O)C(CC(C=O)=O)O)=O,4,2,0,2,23,9.6e-05
G5,C(C(C(C=O)=O)C(CCC=O)O)=O,4,3,0,3,23,0.000143
G5,C(C(C(C=O)=O)C(C=CCO)O)=O,8,3,0,3,23,0.000154
G5,C(C(C(C=O)=O)C(C(C=C)O)O)=O,8,2,0,2,28,9.6e-05
G5,C(C(C(C=O)=O)C1(C=COC1)O)=O,4,2,0,2,23,9.6e-05
G5,C(CC(C(C1C(C=CO1)=O)O)=O)=O,4,2,0,2,23,9.6e-05
G5,C(CC(C=O)(C1C(C=CO1)=O)O)=O,4,2,0,2,23,9.6e-05
G5,C1OC(C(C=1)=O)C(CC(C=O)=O)O,4,2,0,2,23,9.6e-05
G5,C(C(C(C=O)=O)C(C(CC)=O)O)=O,4,2,0,2,23,9.6e-05
G5,C(C(C(C=O)=O)C(C=O)(CC)O)=O,4,2,0,2,23,9.6e-05
G5,C(CC(C(C(C(C=O)=O)C)O)=O)=O,4,1,0,1,23,4.8e-05
G5,C(CC(C=O)(C(C(C=O)=O)C)O)=O,4,1,0,1,23,4.8e-05
G5,C(C(C(C=O)=O)C(C(C=CC)=O)O)=O,8,2,0,2,28,9.6e-05
G5,C(C(C(C=O)=O)C(C=O)(C=CC)O)=O,8,2,0,2,28,9.6e-05
G5,C(C(C(C=O)=O)C(C(CC=C)=O)O)=O,4,2,0,2,23,9.6e-05
G5,C(C(C(C=O)=O)C(C=O)(CC=C)O)=O,4,2,0,2,28,9.6e-05
G5,C(CC(C(C(C=C)C(C=O)=O)O)=O)=O,4,1,0,1,23,4.8e-05
G5,C(CC(C=O)(C(C=C)C(C=O)=O)O)=O,4,1,0,1,23,4.8e-05
G5,C=CC(C(C=O)=O)C(CC(C=O)=O)O,4,1,0,1,28,4.8e-05
G5,C(C(C(C=O)=O)C(C=CC=O)(C)O)=O,8,2,0,2,23,9.6e-05
G5,C(C(C(C=O)=O)C(C=CC(C)=O)O)=O,8,2,0,2,23,9.6e-05
G5,C(CC(C(CC(C=CC=O)=O)O)=O)=O,4,1,0,1,28,4.8e-05
G5,C(CC(C=O)(CC(C=CC=O)=O)O)=O,4,1,0,1,23,4.8e-05
G5,C(C(C(C=O)=O)C(C(CC=O)=C)O)=O,4,2,0,2,28,9.6e-05
G5,C(C(C(C=O)=O)C(CC(C=O)=C)O)=O,4,2,0,2,28,9.6e-05
G5,C(C(C(C=O)=C)C(C(CC=O)=O)O)=O,4,1,0,1,23,4.8e-05
G5,C(C(C(C=O)=C)C(C=O)(CC=O)O)=O,4,1,0,1,28,4.8e-05
G5,C(C(C(C=O)=C)C(CC(C=O)=O)O)=O,4,1,0,1,23,4.8e-05
G5,C(C(C(C=O)=O)C(C(C)=CC=O)O)=O,8,2,0,2,28,9.6e-05
G5,C(C(C(C=O)=O)C(C=C(C=O)C)O)=O,8,2,0,2,28,9.6e-05
G5,C(C(C(C=O)=O)C(C=C)O)=O,4,4,0,4,23,0.00019099999999999998
G5,C(C(C(C=O)=O)C(C=CC)O)=O,8,3,0,3,23,0.000143
G5,C(C(C(C=O)=O)C(CC=C)O)=O,4,3,0,3,23,0.000143
G5,C(C(C=C)C(C=O)(CC=O)O)=O,4,3,0,3,29,0.000143
G5,C(C(C(C=O)=O)C(C=CCC=O)O)=O,8,2,0,2,23,9.6e-05
G5,C(C(C(C=O)=O)C(CC=CC=O)O)=O,8,2,0,2,23,9.6e-05
G5,C(C(C=CC=O)C(C(CC=O)=O)O)=O,8,1,0,1,23,4.8e-05
G5,C(C(C=CC=O)C(C=O)(CC=O)O)=O,8,1,0,1,23,4.8e-05
G5,C(C(C=CC=O)C(CC(C=O)=O)O)=O,8,1,0,1,23,4.8e-05
G5,C(C(C(C(C)=O)=O)C(C)(C)O)=O,2,2,0,2,14,9.6e-05
G5,C(CC(C(CC(C)(C)O)=O)=O)=O,1,1,0,1,14,4.8e-05
G5,C(C(C)(CC(C)=O)O)(CC=O)=O,2,1,0,1,14,4.8e-05
G5,C(C(C(C(C)=O)=O)C1(C=COC1)O)=O,4,2,0,2,14,9.499999999999999e-05
G5,C(CC(C(CC1(C=COC1)O)=O)=O)=O,2,1,0,1,14,4.8e-05
G5,C1OC(C(C=1)=O)C(CC(C(C)=O)=O)O,4,2,0,2,14,9.499999999999999e-05
G5,C(CC(C(C)=O)(C1C(C=CO1)=O)O)=O,4,2,0,2,14,9.499999999999999e-05
G5,C(C(C)(C1C(C=CO1)=O)O)(CC=O)=O,4,2,0,2,14,9.499999999999999e-05
G5,C(C(C(C(C)=O)=O)C(C=C)O)=O,4,4,0,4,14,0.00018999999999999998
G5,C(CC(C(CC(C=C)O)=O)=O)=O,2,3,0,3,29,0.000143
G5,C(C(C(C(C)=O)=O)C(C=CC)O)=O,8,2,0,2,14,9.499999999999999e-05
G5,C(CC(C(CC(C=CC)O)=O)=O)=O,4,1,0,1,14,4.8e-05
G5,C(C(C(C(C)=O)=O)C(CC=C)O)=O,4,2,0,2,14,9.499999999999999e-05
G5,C(CC(C(CC(CC=C)O)=O)=O)=O,2,1,0,1,14,4.8e-05
G5,C(C(C=C)C(CC(C(C)=O)=O)O)=O,4,1,0,1,14,4.8e-05
G5,C(C(C=C)C(C(C)=O)(CC=O)O)=O,4,1,0,1,14,4.8e-05
G5,C(CC(C(C)(C(C=O)C=C)O)=O)=O,4,1,0,1,14,4.8e-05
G5,C(C(C)=O)(CC(C(CO)CO)O)=O,2,2,0,2,14,0.00010700000000000001
G5,C(CC(CC(C(C)=O)=O)O)(O)=O,2,3,0,3,29,0.000154
G5,C(C(C(C)=O)(CC(C(C)=O)=O)O)=O,2,1,0,1,14,4.8e-05
G5,C(C(C(CC(C(C)=O)=O)O)=O)(C)=O,2,1,0,1,14,4.8e-05
G5,C(C(CC(C(C=O)=O)(C)O)=O)(C)=O,2,1,0,1,14,4.8e-05
G5,C(C)(C(C)(CC(C(C=O)=O)=O)O)=O,2,1,0,1,14,4.8e-05
G5,C(C(C(CC(C(C)=O)=O)O)=O)=O,2,4,0,4,29,0.00018999999999999998
G5,C(C(C)=O)(CC(C)(CCO)O)=O,2,2,0,2,14,0.00010700000000000001
G5,C(C)(C(C)(CC(CCO)=O)O)=O,2,2,0,2,14,0.00010700000000000001
G5,C(C)(C(CO)C(C(C)=O)(C)O)=O,4,3,0,3,14,0.000154
G5,C(C(C)=O)(CC(C)(C)O)=O,1,1,0,1,14,4.8e-05
G5,C(C)(C(C)(CC(C)=O)O)=O,2,1,0,1,14,4.8e-05
G5,C(OCC(C)(CC(C(C)=O)=O)O)=O,2,1,0,1,14,4.8e-05
G5,C(C)(C(C)(CC(COC=O)=O)O)=O,2,3,0,3,14,0.000143
G5,C(C)(C(C)(C(C(C)=O)OC=O)O)=O,4,3,0,3,35,0.000143
G5,C(OCC(CC(C(C)=O)=O)O)=O,2,2,0,2,19,9.499999999999999e-05
G5,C(C)(C(C)(C(C=O)OC=O)O)=O,4,2,0,2,14,9.6e-05
G5,C(C)(OCC(CC(C(C)=O)=O)O)=O,2,1,0,1,14,4.8e-05
G5,C(C)(C(C)(C(C=O)OC(C)=O)O)=O,4,2,0,2,14,9.6e-05
G5,C(CCC(CC(C(C)=O)=O)O)=O,2,3,0,3,14,0.000143
G5,C(C)(C(C)(C(C=O)CC=O)O)=O,4,2,0,2,14,9.499999999999999e-05
G5,C(C(CC(C(C)=O)=O)O)=CCO,4,4,0,4,29,0.00020099999999999998
G5,C(C)(C(C)(C(C(C(O)=O)=O)O)O)=O,4,3,0,3,14,0.000154
G5,C(CC(C)(CC(C(C)=O)=O)O)(O)=O,2,2,0,2,14,0.00010700000000000001
G5,C(C)(C(C)(CC(CC(O)=O)=O)O)=O,2,2,0,2,14,0.00010700000000000001
G5,C(C(C(C)=O)C(C(C)=O)(C)O)(O)=O,4,3,0,3,14,0.000154
G5,C(C(CC(C(C)=O)=O)O)=CC(O)=O,4,2,0,2,21,0.00010700000000000001
G5,C1(C(CCO1)(CC(C(C)=O)=O)O)=O,2,1,0,1,14,4.8e-05
G5,C(C)(C(C)(C1C(C(OC1)=O)=O)O)=O,4,2,0,2,14,9.6e-05
G5,C1(CC(CO1)(CC(C(C)=O)=O)O)=O,2,1,0,1,14,4.8e-05
G5,C(C)(C(C)(C1C(OCC1=O)=O)O)=O,4,2,0,2,14,9.6e-05
G5,C(C)(C(C)(C1C(CC(O1)=O)=O)O)=O,4,2,0,2,14,9.6e-05
G5,C(C(C(CC(C(C)=O)=O)O)O)=C,4,3,0,3,29,0.000143
G5,C1C(COC=1)(CC(C(C)=O)=O)O,2,2,0,2,14,9.499999999999999e-05
G5,C(C)(C(C)(C1C(C=CO1)=O)O)=O,4,3,0,3,14,0.000143
G5,C(C(C=C)(CC(C(C)=O)=O)O)(O)=O,2,2,0,2,14,0.00010700000000000001
G5,C(C(C)=O)(CC(C(C)(CO)O)O)=O,4,2,0,2,14,0.00010700000000000001
G5,C(C(C)(CC(C(C)=O)=O)O)(CC)=O,2,1,0,1,14,4.8e-05
G5,C(C)(C(CC)(CC(C(C)=O)=O)O)=O,2,1,0,1,14,4.8e-05
G5,C(C)(C(C)(CC(C(CC)=O)=O)O)=O,2,1,0,1,14,4.8e-05
G5,C(C)(C(C)(C(C(C(C)=O)=O)C)O)=O,4,1,0,1,14,4.8e-05
G5,C(C)(C(C)(CC(CC(C)=O)=O)O)=O,2,1,0,1,14,4.8e-05
G5,C(C)(C(C)(C(C(C)=O)C(C)=O)O)=O,2,2,0,2,14,9.6e-05
G5,C(CC(C)C(CC(C(C)=O)=O)O)=O,4,2,0,2,14,9.499999999999999e-05
G5,C(C(C)CC(CC(C(C)=O)=O)O)=O,4,1,0,1,28,4.8e-05
G5,C(C)(C(C)(C(C=O)C(C=O)C)O)=O,8,1,0,1,28,4.8e-05
G5,C(C(CC(C(C)=O)=O)O)(CC)=O,2,2,0,2,14,9.499999999999999e-05
G5,C(C(CC)(CC(C(C)=O)=O)O)=O,2,1,0,1,14,4.8e-05
G5,C(C)(C(C)(C(C(C=O)=O)C)O)=O,4,1,0,1,14,4.8e-05
G5,C(C(CC)(CC(C(C)=O)=O)O)(O)=O,2,1,0,1,28,4.8e-05
G5,C(C)(C(C)(C(C(C(O)=O)=O)C)O)=O,4,1,0,1,28,4.8e-05
G5,C(C=CC(C(CC(C(C)=O)=O)O)=O)=O,4,1,0,1,20,4.8e-05
G5,C(C(C=CC=O)(CC(C(C)=O)=O)O)=O,4,1,0,1,20,4.8e-05
G5,C(C(CC(C(C)=O)=O)O)=CC(C=O)=O,4,1,0,1,20,4.8e-05
G5,C(C)=CC(C(CC(C(C)=O)=O)O)=O,4,1,0,1,14,4.8e-05
G5,C(C(C=CC)(CC(C(C)=O)=O)O)=O,4,1,0,1,14,4.8e-05
G5,C(C(CC(C(C)=O)=O)O)(CC=C)=O,2,1,0,1,14,4.8e-05
G5,C(C(CC=C)(CC(C(C)=O)=O)O)=O,2,1,0,1,14,4.8e-05
G5,C(C)(C(C)(C(C=C)C(C=O)=O)O)=O,4,1,0,1,14,4.8e-05
G5,C(C(C)(CC(C(C)=O)=O)O)=CC=O,4,1,0,1,14,4.8e-05
G5,C(C(CC(C(C)=O)=O)O)=CC(C)=O,4,1,0,1,14,4.8e-05
G5,C(C)(C(C)(CC(C=CC=O)=O)O)=O,4,1,0,1,14,4.8e-05
G5,C(CC(C(CC(C(C)=O)=O)O)=C)=O,2,1,0,1,14,4.8e-05
G5,C=C(C=O)CC(CC(C(C)=O)=O)O,2,1,0,1,14,4.8e-05
G5,C(C(C(C=O)=C)C(C(C)=O)(C)O)=O,4,1,0,1,14,4.8e-05
G5,C(C)(C(CC(C(C)=O)=O)O)=CC=O,4,1,0,1,14,4.8e-05
G5,C(C(CC(C(C)=O)=O)O)=C(C=O)C,4,1,0,1,14,4.8e-05
G5,C=CC(CC(C(C)=O)=O)O,2,3,0,3,29,0.000143
G5,C(C)=CC(CO)(CC(C(C)=O)=O)O,4,1,0,1,14,4.8e-05
G5,C(C)(C(C)(C(C(C=CC)=O)O)O)=O,8,2,0,2,14,9.6e-05
G5,C(CC(CO)(CC(C(C)=O)=O)O)=C,2,1,0,1,14,4.8e-05
G5,C(C)(C(C)(C(C(CO)=O)C=C)O)=O,4,1,0,1,14,4.8e-05
G5,C(C)(C(C)(C(C(CC=C)=O)O)O)=O,4,2,0,2,14,9.6e-05
G5,C(C(C(C)(CC(C(C)=O)=O)O)O)=C,4,1,0,1,28,4.8e-05
G5,C(C)(C(C)(CC(C(C=C)O)=O)O)=O,4,1,0,1,28,4.8e-05
G5,C=C(CO)CC(CC(C(C)=O)=O)O,2,1,0,1,28,4.8e-05
G5,C(C)(C(C)(C(C=O)C(CO)=C)O)=O,4,1,0,1,28,4.8e-05
G5,C(C(CC(C(C)=O)=O)O)=C(C)CO,4,1,0,1,28,4.8e-05
G5,C(C)=CC(CC(C(C)=O)=O)O,4,2,0,2,14,9.499999999999999e-05
G5,C(CC(CC(C(C)=O)=O)O)=C,2,2,0,2,14,9.499999999999999e-05
G5,C(C(C=C)C(C(C)=O)(C)O)=O,4,2,0,2,14,9.499999999999999e-05
G5,C1C(CC(C(C)=O)=O)(C(C(C=1)=O)O)O,4,1,0,1,47,4.8e-05
G5,C(CC=CC(CC(C(C)=O)=O)O)=O,4,1,0,1,14,4.8e-05
G5,C(CC(CC(C(C)=O)=O)O)=CC=O,4,1,0,1,14,4.8e-05
G5,C(C(C=CC=O)C(C(C)=O)(C)O)=O,8,1,0,1,14,4.8e-05
G5,C(CC(CC(C(CO)CO)O)=O)=O,2,1,0,1,18,4.8e-05
G5,C(C(C(C)=O)C(C(CO)CO)O)=O,4,2,0,2,18,9.6e-05
G5,C(CC(CC(CC(O)=O)O)=O)=O,2,2,0,2,45,0.00010700000000000001
G5,C(CC(C(C=O)C(C)=O)O)(O)=O,4,3,0,3,28,0.000155
G5,C(C(C(C)=O)(CC(CC=O)=O)O)=O,2,1,0,1,25,4.8e-05
G5,C(C(C(C)=O)C(C=O)(C(C)=O)O)=O,4,2,0,2,25,9.6e-05
G5,C(CC(CC(C(C(C)=O)=O)O)=O)=O,2,1,0,1,25,4.8e-05
G5,C(C(C(C)=O)C(C(C(C)=O)=O)O)=O,4,2,0,2,25,9.6e-05
G5,C(CC(CC(C(C=O)=O)(C)O)=O)=O,2,1,0,1,25,4.8e-05
G5,C(C(C(C)=O)C(C(C=O)=O)(C)O)=O,4,2,0,2,25,9.6e-05
G5,C(C)(CC(CC(C(C=O)=O)=O)O)=O,2,1,0,1,25,4.8e-05
G5,C(C(C(C)=O)C(C=O)(C=O)O)=O,2,4,0,4,1,0.00019099999999999998
G5,C(CC(CC(C(C=O)=O)O)=O)=O,2,6,0,6,29,0.000285
G5,C(C(C(C)=O)C(C(C=O)=O)O)=O,4,6,0,6,1,0.000286
G5,C(CC(CC(C)(CCO)O)=O)=O,2,2,0,2,6,0.00010700000000000001
G5,C(C(C(C)=O)C(C)(CCO)O)=O,4,3,0,3,28,0.000154
G5,C(CC(CC(C)(C)O)=O)=O,1,1,0,1,6,4.8e-05
G5,C(C(C(C)=O)C(C)(C)O)=O,2,2,0,2,6,9.6e-05
G5,C(C)(CC(CC(C)=O)O)=O,1,1,0,1,6,4.8e-05
G5,C(OCC(C)(CC(CC=O)=O)O)=O,2,1,0,1,35,4.8e-05
G5,C(OCC(C)(C(C=O)C(C)=O)O)=O,4,2,0,2,35,9.6e-05
G5,C(C)(CC(CC(COC=O)=O)O)=O,2,3,0,3,6,0.000143
G5,C(OC(C(C)=O)C(CC(C)=O)O)=O,4,3,0,3,35,0.000143
G5,C(OCC(CC(CC=O)=O)O)=O,2,4,0,4,44,0.00018999999999999998
G5,C(OCC(C(C=O)C(C)=O)O)=O,4,4,0,4,28,0.00019099999999999998
G5,C(CC(C)(C(C=O)OC=O)O)=O,4,2,0,2,28,9.6e-05
G5,C(C(C(CC(C)=O)O)OC=O)=O,4,2,0,2,28,9.6e-05
G5,C(CC(COC(C)=O)O)(CC=O)=O,2,1,0,1,28,4.8e-05
G5,C(C(C(C)=O)C(COC(C)=O)O)=O,4,2,0,2,28,9.6e-05
G5,C(C(C(CC(C)=O)O)OC(C)=O)=O,4,2,0,2,28,9.6e-05
G5,C(CC(CC(CCC=O)O)=O)=O,2,3,0,3,6,0.000143
G5,C(CCC(C(C=O)C(C)=O)O)=O,4,4,0,4,27,0.00019099999999999998
G5,C(CC(CC(C=CCO)O)=O)=O,4,5,0,5,29,0.00024900000000000004
G5,C(C(C(C)=O)C(C=CCO)O)=O,8,6,0,6,29,0.000297
G5,C(C(CO)(C(C=O)C(C)=O)O)(O)=O,4,4,0,4,33,0.000204
G5,C(CC(C)(C(C(C(O)=O)=O)O)O)=O,4,3,0,3,33,0.000155
G5,C(C)(CC(C(C(C(O)=O)=O)O)O)=O,4,3,0,3,33,0.000155
G5,C(CC(CC(C)(CC(O)=O)O)=O)=O,2,2,0,2,6,0.00010700000000000001
G5,C(CC(C)(C(C=O)C(C)=O)O)(O)=O,4,3,0,3,6,0.000154
G5,C(CC(CC(C)(CC=O)O)=O)(O)=O,2,2,0,2,6,0.00010700000000000001
G5,C(CC(C)(C(C(O)=O)C(C)=O)O)=O,4,3,0,3,6,0.000154
G5,C(CC(CC(C=CC(O)=O)O)=O)=O,4,2,0,2,29,0.00010700000000000001
G5,C(C(C(C)=O)C(C=CC(O)=O)O)=O,8,3,0,3,18,0.000154
G5,C1(C(CCO1)(CC(CC=O)=O)O)=O,2,1,0,1,28,4.8e-05
G5,C1(C(CCO1)(C(C=O)C(C)=O)O)=O,4,2,0,2,28,9.6e-05
G5,C(CC(C)(C1C(C(OC1)=O)=O)O)=O,4,2,0,2,28,9.6e-05
G5,C(C)(CC(C1C(C(OC1)=O)=O)O)=O,4,2,0,2,28,9.6e-05
G5,C(CC(CC1(COC(C1)=O)O)=O)=O,2,1,0,1,28,4.8e-05
G5,C1(CC(CO1)(C(C=O)C(C)=O)O)=O,4,2,0,2,28,9.6e-05
G5,C(CC(C)(C1C(OCC1=O)=O)O)=O,4,2,0,2,28,9.6e-05
G5,C(C)(CC(C1C(OCC1=O)=O)O)=O,4,2,0,2,28,9.6e-05
G5,C1(C(C(CC(C)=O)O)OC(C1)=O)=O,4,2,0,2,28,9.6e-05
G5,C(CC(C(C=C)O)O)(CC=O)=O,4,4,0,4,29,0.00018999999999999998
G5,C(C(C(C)=O)C(C(C=C)O)O)=O,8,5,0,5,28,0.00023799999999999998
G5,C(CC(CC1(C=COC1)O)=O)=O,2,2,0,2,35,9.499999999999999e-05
G5,C(C(C(C)=O)C1(C=COC1)O)=O,4,3,0,3,28,0.000143
G5,C(C)(CC(C1C(C=CO1)=O)O)=O,4,3,0,3,28,0.000143
G5,C(C(C=C)(CC(CC=O)=O)O)(O)=O,2,2,0,2,29,0.00010700000000000001
G5,C(C(C(C)=O)C(C(O)=O)(C=C)O)=O,4,3,0,3,7,0.000154
G5,C(CC(CC(C(C)(CO)O)O)=O)=O,4,1,0,1,11,4.8e-05
G5,C(C(C(C)=O)C(C(C)(CO)O)O)=O,8,2,0,2,11,9.6e-05
G5,C(C(C)(CC(CC=O)=O)O)(CC)=O,2,1,0,1,28,4.8e-05
G5,C(C(C)(C(C=O)C(C)=O)O)(CC)=O,4,2,0,2,28,9.6e-05
G5,C(C)(C(CC)(CC(CC=O)=O)O)=O,2,1,0,1,28,4.8e-05
G5,C(C(C(C)=O)C(C(C)=O)(CC)O)=O,4,2,0,2,28,9.6e-05
G5,C(CC(C)(CC(C(CC)=O)=O)O)=O,2,1,0,1,28,4.8e-05
G5,C(CC(C)(C(C(C(C)=O)=O)C)O)=O,4,1,0,1,28,4.8e-05
G5,C(CC(C)(CC(CC(C)=O)=O)O)=O,2,1,0,1,28,4.8e-05
G5,C(CC(C)(C(C(C)=O)C(C)=O)O)=O,2,2,0,2,28,9.6e-05
G5,C(CC(CC(C(C)CC=O)O)=O)=O,4,2,0,2,2,9.6e-05
G5,C(CC(C)C(C(C=O)C(C)=O)O)=O,8,3,0,3,28,0.000143
G5,C(C(C)CC(CC(CC=O)=O)O)=O,4,1,0,1,28,4.8e-05
G5,C(C(C)CC(C(C=O)C(C)=O)O)=O,8,2,0,2,28,9.6e-05
G5,C(CC(C)(C(C=O)C(C=O)C)O)=O,8,2,0,2,28,9.6e-05
G5,C(C(C)C(C=O)C(CC(C)=O)O)=O,8,2,0,2,28,9.6e-05
G5,C(CC(C(CC)=O)O)(CC=O)=O,2,2,0,2,6,9.499999999999999e-05
G5,C(C)(C(C=O)C(C(CC)=O)O)=O,4,3,0,3,28,0.000143
G5,C(C(CC)(CC(CC=O)=O)O)=O,2,1,0,1,28,4.8e-05
G5,C(C(CC)(C(C=O)C(C)=O)O)=O,4,2,0,2,28,9.6e-05
G5,C(CC(C)(C(C(C=O)=O)C)O)=O,4,1,0,1,28,4.8e-05
G5,C(C(CC)(CC(CC=O)=O)O)(O)=O,2,2,0,2,4,0.000106
G5,C(C(CC)(C(C=O)C(C)=O)O)(O)=O,4,2,0,2,28,9.6e-05
G5,C(CC(C)(C(C(C(O)=O)=O)C)O)=O,4,1,0,1,28,4.8e-05
G5,C(CC(CC(C(C=CC=O)=O)O)=O)=O,4,1,0,1,20,4.8e-05
G5,C(C(C(C)=O)C(C(C=CC=O)=O)O)=O,8,2,0,2,20,9.6e-05
G5,C(C(C=CC=O)(CC(CC=O)=O)O)=O,4,1,0,1,20,4.8e-05
G5,C(C(C(C)=O)C(C=O)(C=CC=O)O)=O,8,2,0,2,20,9.6e-05
G5,C(CC(CC(C=CC(C=O)=O)O)=O)=O,4,1,0,1,20,4.8e-05
G5,C(C(C(C)=O)C(C=CC(C=O)=O)O)=O,8,2,0,2,20,9.6e-05
G5,C(CC(CC(C(C=CC)=O)O)=O)=O,4,1,0,1,28,4.8e-05
G5,C(C(C(C)=O)C(C(C=CC)=O)O)=O,8,2,0,2,28,9.6e-05
G5,C(C(C=CC)(CC(CC=O)=O)O)=O,4,1,0,1,28,4.8e-05
G5,C(C(C(C)=O)C(C=O)(C=CC)O)=O,8,2,0,2,28,9.6e-05
G5,C(CC(CC(C(CC=C)=O)O)=O)=O,2,1,0,1,28,4.8e-05
G5,C(C(C(C)=O)C(C(CC=C)=O)O)=O,4,2,0,2,28,9.6e-05
G5,C(CC(CC(C=O)(CC=C)O)=O)=O,2,1,0,1,28,4.8e-05
G5,C(C(C(C)=O)C(C=O)(CC=C)O)=O,4,2,0,2,28,9.6e-05
G5,C(CC(C)(C(C=C)C(C=O)=O)O)=O,4,1,0,1,28,4.8e-05
G5,C(C)(CC(C(C=C)C(C=O)=O)O)=O,4,1,0,1,28,4.8e-05
G5,C(CC(CC(C=CC=O)(C)O)=O)=O,4,1,0,1,28,4.8e-05
G5,C(C(C(C)=O)C(C=CC=O)(C)O)=O,8,2,0,2,28,9.6e-05
G5,C(CC(CC(C=CC(C)=O)O)=O)=O,4,1,0,1,28,4.8e-05
G5,C(C(C(C)=O)C(C=CC(C)=O)O)=O,8,2,0,2,28,9.6e-05
G5,C(CC(C)(CC(C=CC=O)=O)O)=O,4,1,0,1,28,4.8e-05
G5,C(C)(CC(CC(C=CC=O)=O)O)=O,4,2,0,2,45,9.6e-05
G5,C(CC(C(CC(CC=O)=O)O)=C)=O,2,1,0,1,28,4.8e-05
G5,C(C(C(C)=O)C(C(CC=O)=C)O)=O,4,2,0,2,28,9.6e-05
G5,C(CC(CC(CC(C=O)=C)O)=O)=O,2,1,0,1,28,4.8e-05
G5,C(C(C(C)=O)C(CC(C=O)=C)O)=O,4,2,0,2,28,9.6e-05
G5,C(C(C(C=O)=C)C(C)(CC=O)O)=O,4,1,0,1,28,4.8e-05
G5,C(C(C(C=O)=C)C(CC(C)=O)O)=O,4,1,0,1,28,4.8e-05
G5,C(CC(CC(C(C)=CC=O)O)=O)=O,4,1,0,1,28,4.8e-05
G5,C(C(C(C)=O)C(C(C)=CC=O)O)=O,8,2,0,2,28,9.6e-05
G5,C(CC(CC(C=C(C=O)C)O)=O)=O,4,1,0,1,28,4.8e-05
G5,C(C(C(C)=O)C(C=C(C=O)C)O)=O,8,2,0,2,28,9.6e-05
G5,C(CC(CC(C=C)O)=O)=O,2,3,0,3,29,0.000143
G5,C(C(C(C)=O)C(C=C)O)=O,4,4,0,4,6,0.00019099999999999998
G5,C(CC(CC(C=CC)(CO)O)=O)=O,4,1,0,1,28,4.8e-05
G5,C(C(C(C)=O)C(C=CC)(CO)O)=O,8,2,0,2,28,9.6e-05
G5,C(CC(C)(C(C(C=CC)=O)O)O)=O,8,2,0,2,28,9.6e-05
G5,C(CC(CC(CO)(CC=C)O)=O)=O,2,1,0,1,28,4.8e-05
G5,C(C(C(C)=O)C(CO)(CC=C)O)=O,4,2,0,2,28,9.6e-05
G5,C(CC(C)(C(C(CO)=O)C=C)O)=O,4,1,0,1,28,4.8e-05
G5,C(CC(C)(C(C(CC=C)=O)O)O)=O,4,2,0,2,28,9.6e-05
G5,C(CC(C)(C(C=C)O)O)(CC=O)=O,4,1,0,1,28,4.8e-05
G5,C(C(C(C)=O)C(C)(C(C=C)O)O)=O,8,2,0,2,28,9.6e-05
G5,C(CC(C)(CC(C(C=C)O)=O)O)=O,4,1,0,1,28,4.8e-05
G5,C(CC(CC(CO)=C)O)(CC=O)=O,2,1,0,1,28,4.8e-05
G5,C(C)(C(C=O)C(CC(CO)=C)O)=O,4,2,0,2,28,9.6e-05
G5,C(CC(C)(C(C=O)C(CO)=C)O)=O,4,1,0,1,28,4.8e-05
G5,C(C)(CC(C(C=O)C(CO)=C)O)=O,4,1,0,1,28,4.8e-05
G5,C(CC(CC(C=C(C)CO)O)=O)=O,4,1,0,1,28,4.8e-05
G5,C(C(C(C)=O)C(C=C(C)CO)O)=O,8,2,0,2,28,9.6e-05
G5,C(CC(CC(C=CC)O)=O)=O,4,2,0,2,28,9.499999999999999e-05
G5,C(C(C(C)=O)C(C=CC)O)=O,8,3,0,3,6,0.000143
G5,C(CC(CC(CC=C)O)=O)=O,2,2,0,2,28,9.499999999999999e-05
G5,C(C(C(C)=O)C(CC=C)O)=O,4,3,0,3,6,0.000143
G5,C(C(C=C)C(C)(CC=O)O)=O,4,2,0,2,6,9.499999999999999e-05
G5,C(C(C=C)C(CC(C)=O)O)=O,4,2,0,2,6,9.499999999999999e-05
G5,C(CC(CC1(C=CC(C1O)=O)O)=O)=O,4,1,0,1,47,4.8e-05
G5,C(C(C(C)=O)C1(C=CC(C1O)=O)O)=O,8,2,0,2,47,9.6e-05
G5,C(CC=CC(CC(CC=O)=O)O)=O,4,1,0,1,28,4.8e-05
G5,C(C(C(C)=O)C(C=CCC=O)O)=O,8,2,0,2,28,9.6e-05
G5,C(CC(CC(CC=CC=O)O)=O)=O,4,1,0,1,28,4.8e-05
G5,C(C(C(C)=O)C(CC=CC=O)O)=O,8,2,0,2,28,9.6e-05
G5,C(C(C=CC=O)C(C)(CC=O)O)=O,8,1,0,1,28,4.8e-05
G5,C(C(C=CC=O)C(CC(C)=O)O)=O,8,1,0,1,28,4.8e-05
G5,C(CC(C1C(COC1O)=O)O)(O)=O,8,3,0,3,35,0.000154
G5,C(CC(C1C(CC(O1)O)=O)O)(O)=O,8,3,0,3,35,0.000154
G5,C(C(C=O)(C1C(COC1O)=O)O)=O,4,2,0,2,35,9.6e-05
G5,C(C(C=O)(C1C(CC(O1)O)=O)O)=O,4,3,0,3,35,0.000143
G5,C1(COC(C1C(C(C=O)=O)O)O)=O,8,2,0,2,35,9.6e-05
G5,C1(C(C(C(C=O)=O)O)OC(C1)O)=O,8,3,0,3,35,0.000143
G5,C1(COC(C1C(C)(CCO)O)O)=O,8,3,0,3,35,0.000154
G5,C1(C(C(C)(CCO)O)OC(C1)O)=O,8,4,0,4,35,0.000202
G5,C(CC1(COC(C1)O)O)(CCO)=O,4,3,0,3,35,0.000154
G5,C(C)(C(CO)C1(COC(C1)O)O)=O,8,3,0,3,35,0.000154
G5,C1(COC(C1C(C)(C)O)O)=O,4,2,0,2,35,9.6e-05
G5,C1(C(C(C)(C)O)OC(C1)O)=O,4,2,0,2,35,9.6e-05
G5,C(C)(CC1(COC(C1)O)O)=O,4,1,0,1,35,4.8e-05
G5,C(OCC(C1C(COC1O)=O)O)=O,8,2,0,2,35,9.6e-05
G5,C(OCC(C1C(CC(O1)O)=O)O)=O,8,2,0,2,35,9.6e-05
G5,C(OC(C=O)C1(COC(C1)O)O)=O,8,2,0,2,35,9.6e-05
G5,C(CCC(C1C(COC1O)=O)O)=O,8,3,0,3,27,0.000143
G5,C(CCC(C1C(CC(O1)O)=O)O)=O,8,3,0,3,35,0.000143
G5,C(C(C1(COC(C1)O)O)CC=O)=O,8,3,0,3,43,0.000143
G5,C1(COC(C1C(C=CCO)O)O)=O,16,3,0,3,35,0.000154
G5,C1(C(C(C=CCO)O)OC(C1)O)=O,16,3,0,3,35,0.000154
G5,C1(COC(C1C(C(C=C)O)O)O)=O,16,2,0,2,35,9.6e-05
G5,C1(C(C(C(C=C)O)O)OC(C1)O)=O,16,2,0,2,35,9.6e-05
G5,C1(COC(C1C2(C=COC2)O)O)=O,8,2,0,2,35,9.6e-05
G5,C1(C(C2(C=COC2)O)OC(C1)O)=O,8,2,0,2,35,9.6e-05
G5,C1OC(C(C=1)=O)C2(COC(C2)O)O,8,2,0,2,35,9.6e-05
G5,C1(COC(C1C(C(CC)=O)O)O)=O,8,2,0,2,35,9.6e-05
G5,C(C(C1C(CC(O1)O)=O)O)(CC)=O,8,2,0,2,35,9.6e-05
G5,C(C(CC)(C1C(COC1O)=O)O)=O,8,2,0,2,35,9.6e-05
G5,C(C(CC)(C1C(CC(O1)O)=O)O)=O,8,2,0,2,35,9.6e-05
G5,C(C(C(C)C1(COC(C1)O)O)=O)=O,8,1,0,1,35,4.8e-05
G5,C1(COC(C1C(C=C)O)O)=O,8,4,0,4,35,0.00018999999999999998
G5,C1(C(C(C=C)O)OC(C1)O)=O,8,4,0,4,35,0.00018999999999999998
G5,C1(COC(C1C(C=CC)O)O)=O,16,3,0,3,35,0.000143
G5,C1(C(C(C=CC)O)OC(C1)O)=O,16,3,0,3,35,0.000143
G5,C1(COC(C1C(CC=C)O)O)=O,8,3,0,3,35,0.000143
G5,C1(C(C(CC=C)O)OC(C1)O)=O,8,3,0,3,35,0.000143
G5,C(C(C=C)C1(COC(C1)O)O)=O,8,2,0,2,35,9.499999999999999e-05
G5,C1(COC(C(C1C(C)(C)O)O)O)=O,8,2,0,2,27,9.499999999999999e-05
G5,C1(C(C(C)(C)O)OC(C(C1)O)O)=O,8,2,0,2,27,9.499999999999999e-05
G5,C(C)(CC1(COC(C(C1)O)O)O)=O,8,1,0,1,27,4.8e-05
G5,C1(COC(C(C1C(C=C)O)O)O)=O,16,2,0,2,27,9.499999999999999e-05
G5,C1(C(C(C=C)O)OC(C(C1)O)O)=O,16,2,0,2,27,9.499999999999999e-05
G5,C(C=CC(C(C(C)(C)O)O)=O)=O,4,2,0,2,11,9.6e-05
G5,C(C)(CC(C=CC(CO)=O)O)=O,4,1,0,1,11,4.8e-05
G5,C(CC(C=CC=O)(CO)O)(C)=O,4,1,0,1,11,4.8e-05
G5,C1C(COC=1)(C(C(C=CC=O)=O)O)O,8,2,0,2,11,9.499999999999999e-05
G5,C1OC(C(C=1)=O)C(C=CC(CO)=O)O,8,2,0,2,11,9.499999999999999e-05
G5,C(C(CO)(C1C(C=CO1)=O)O)=CC=O,8,2,0,2,11,9.499999999999999e-05
G5,C=CC(C(C(C=CC=O)=O)O)O,8,4,0,4,11,0.00018999999999999998
G5,C(C(C(C(C=CC=O)=O)O)O)=CC,16,2,0,2,11,9.499999999999999e-05
G5,C(CC(C(C(C=CC=O)=O)O)O)=C,8,2,0,2,11,9.499999999999999e-05
G5,C(C(C=C)C(C=CC(CO)=O)O)=O,8,1,0,1,11,4.8e-05
G5,C(C(C=C)C(C=CC=O)(CO)O)=O,8,1,0,1,11,4.8e-05
G5,C=CC(C(CC(C(C=O)=O)=O)O)=O,2,1,0,1,25,4.8e-05
G5,C(C(C=C)(CC(C(C=O)=O)=O)O)=O,2,1,0,1,25,4.8e-05
G5,C(CC(C(C=C)=O)O)(CCO)=O,2,3,0,3,29,0.000154
G5,C(C(C=C)(CC(CCO)=O)O)=O,2,4,0,4,29,0.000202
G5,C(C)(C(CO)C(C(C=C)=O)O)=O,4,4,0,4,28,0.000202
G5,C(C(C=C)(C(C(C)=O)CO)O)=O,4,3,0,3,28,0.000154
G5,C(C(C(CC=O)=O)C(C(C=C)=O)O)=O,4,2,0,2,9,9.6e-05
G5,C(C(C(CC=O)=O)C(C=O)(C=C)O)=O,4,2,0,2,9,9.6e-05
G5,C(C)(CC(C(C=C)=O)O)=O,2,2,0,2,11,9.499999999999999e-05
G5,C(C(C=C)(CC(C)=O)O)=O,2,1,0,1,7,4.8e-05
G5,C(OCC(CC(C(C=C)=O)O)=O)=O,2,3,0,3,7,0.000143
G5,C(OCC(CC(C=O)(C=C)O)=O)=O,2,3,0,3,7,0.000143
G5,C(OC(C(C)=O)C(C(C=C)=O)O)=O,4,3,0,3,35,0.000143
G5,C(OC(C(C)=O)C(C=O)(C=C)O)=O,4,3,0,3,35,0.000143
G5,C(OC(C=O)C(C(C=C)=O)O)=O,4,2,0,2,7,9.6e-05
G5,C(OC(C=O)C(C=O)(C=C)O)=O,4,2,0,2,7,9.6e-05
G5,C(C)(OC(C=O)C(C(C=C)=O)O)=O,4,2,0,2,28,9.6e-05
G5,C(C(C=C)(C(C=O)OC(C)=O)O)=O,4,2,0,2,28,9.6e-05
G5,C(CC(C(C=O)=O)C(C(C=C)=O)O)=O,4,2,0,2,20,9.6e-05
G5,C(C(C=C)(C(C(C=O)=O)CC=O)O)=O,4,2,0,2,20,9.6e-05
G5,C(C(CC(C=O)=O)C(C(C=C)=O)O)=O,4,2,0,2,20,9.6e-05
G5,C(C(C=C)(C(C=O)CC(C=O)=O)O)=O,4,2,0,2,20,9.6e-05
G5,C(C(C=C)(C(C=O)CC=O)O)=O,4,5,0,5,29,0.00023799999999999998
G5,C=CC(C(C(C(C(O)=O)=O)O)O)=O,4,4,0,4,33,0.000202
G5,C(C(C=C)(C(C(C(O)=O)=O)O)O)=O,4,3,0,3,33,0.000154
G5,C(CC(CC(C(C=C)=O)O)=O)(O)=O,2,2,0,2,7,0.00010700000000000001
G5,C(C(C=C)(CC(CC(O)=O)=O)O)=O,2,2,0,2,29,0.00010700000000000001
G5,C(C(C(C)=O)C(C(C=C)=O)O)(O)=O,4,3,0,3,6,0.000154
G5,C(C(C(C)=O)C(C=O)(C=C)O)(O)=O,4,3,0,3,6,0.000154
G5,C=CC(C(C(C(C(C=C)=O)=O)O)O)=O,4,2,0,2,7,9.6e-05
G5,C(C(C=C)(C(C(C(C=C)=O)=O)O)O)=O,4,2,0,2,7,9.6e-05
G5,C1(CC(C(C1O)=O)C(C(C=C)=O)O)=O,8,2,0,2,47,9.6e-05
G5,C(C(C=C)(C1C(C(C(C1)=O)O)=O)O)=O,8,2,0,2,47,9.6e-05
G5,C1(CC(C(CO1)=O)C(C(C=C)=O)O)=O,4,1,0,1,7,4.8e-05
G5,C(C(C=C)(C1C(COC(C1)=O)=O)O)=O,4,1,0,1,7,4.8e-05
G5,C1(CCC(C(C(C(C=C)=O)O)O1)=O)=O,4,2,0,2,7,9.6e-05
G5,C(C(C=C)(C1C(CCC(O1)=O)=O)O)=O,4,2,0,2,7,9.6e-05
G5,C1(C(C(C(C=C)=O)O)OCC(C1)=O)=O,4,2,0,2,54,9.6e-05
G5,C(C(C=C)(C1C(CC(CO1)=O)=O)O)=O,4,2,0,2,54,9.6e-05
G5,C1(COCC(C1C(C(C=C)=O)O)=O)=O,2,2,0,2,54,9.6e-05
G5,C(C(C=C)(C1C(COCC1=O)=O)O)=O,2,2,0,2,54,9.6e-05
G5,C=CC(C(C1C(C(OC1)=O)=O)O)=O,4,2,0,2,28,9.6e-05
G5,C(C(C=C)(C1C(C(OC1)=O)=O)O)=O,4,2,0,2,28,9.6e-05
G5,C1(C(C(CO1)=O)C(C(C=C)=O)O)=O,4,2,0,2,7,9.6e-05
G5,C1(C(C(CO1)=O)C(C=O)(C=C)O)=O,4,2,0,2,7,9.6e-05
G5,C1(CC(C(C(C(C=C)=O)O)O1)=O)=O,4,2,0,2,28,9.6e-05
G5,C(C(C=C)(C1C(CC(O1)=O)=O)O)=O,4,2,0,2,7,9.6e-05
G5,C1OC(C(C=1)=O)C(C(C=C)=O)O,4,3,0,3,28,0.000143
G5,C(C(C=C)(C1C(C=CO1)=O)O)=O,4,3,0,3,28,0.000143
G5,C=CC(C(C1C(C=CC(O)O1)=O)O)=O,8,2,0,2,27,9.6e-05
G5,C(C(C=C)(C1C(C=CC(O)O1)=O)O)=O,8,2,0,2,27,9.6e-05
G5,C=CC(C(CC(C(CC)=O)=O)O)=O,2,1,0,1,28,4.8e-05
G5,C(C(C=C)(CC(C(CC)=O)=O)O)=O,2,1,0,1,28,4.8e-05
G5,C=CC(C(C(C(C(C)=O)=O)C)O)=O,4,1,0,1,28,4.8e-05
G5,C(C(C=C)(C(C(C(C)=O)=O)C)O)=O,4,1,0,1,28,4.8e-05
G5,C(CC(C(C=C)=O)O)(CC(C)=O)=O,2,1,0,1,28,4.8e-05
G5,C(C(C=C)(CC(CC(C)=O)=O)O)=O,2,1,0,1,28,4.8e-05
G5,C(C)(C(C(C)=O)C(C(C=C)=O)O)=O,2,2,0,2,28,9.6e-05
G5,C(C(C=C)(C(C(C)=O)C(C)=O)O)=O,2,2,0,2,28,9.6e-05
G5,C(C(C)C(C=O)C(C(C=C)=O)O)=O,8,2,0,2,28,9.6e-05
G5,C(C(C)C(C=O)C(C=O)(C=C)O)=O,8,2,0,2,28,9.6e-05
G5,C=CC(C(C(C(C=O)=O)C)O)=O,4,2,0,2,1,9.499999999999999e-05
G5,C(C(C=C)(C(C(C=O)=O)C)O)=O,4,1,0,1,28,4.8e-05
G5,C(C(C=O)C(CC(C(C=C)=O)O)=O)=O,2,1,0,1,6,4.8e-05
G5,C(C(C=O)C(CC(C=O)(C=C)O)=O)=O,2,1,0,1,6,4.8e-05
G5,C(C(C=O)C(C=O)C(C(C=C)=O)O)=O,4,1,0,1,43,4.8e-05
G5,C(C(C=O)C(C=O)C(C=O)(C=C)O)=O,4,1,0,1,43,4.8e-05
G5,C=CC(C(C(C(C(O)=O)=O)C)O)=O,4,1,0,1,28,4.8e-05
G5,C(C(C=C)(C(C(C(O)=O)=O)C)O)=O,4,1,0,1,28,4.8e-05
G5,C=CC(C(C=O)=O)C(C(C=C)=O)O,4,1,0,1,28,4.8e-05
G5,C(C(C=C)(C(C=C)C(C=O)=O)O)=O,4,1,0,1,28,4.8e-05
G5,C=CC(C(CC(C=CC=O)=O)O)=O,4,1,0,1,28,4.8e-05
G5,C(C(C=C)(CC(C=CC=O)=O)O)=O,4,1,0,1,28,4.8e-05
G5,C(C(C(C=O)=C)C(C(C=C)=O)O)=O,4,1,0,1,28,4.8e-05
G5,C(C(C(C=O)=C)C(C=O)(C=C)O)=O,4,1,0,1,28,4.8e-05
G5,C=C(C=O)C(C(C(C(C=C)=O)O)O)=O,4,2,0,2,9,9.6e-05
G5,C(C(C=C)(C(C(C(C=O)=C)=O)O)O)=O,4,2,0,2,9,9.6e-05
G5,C=CC(C(C(C(C=CC)=O)O)O)=O,8,4,0,4,28,0.00019099999999999998
G5,C(C(C=C)(C(C(C=CC)=O)O)O)=O,8,3,0,3,28,0.000143
G5,C(CO)(C(C=C)C(C(C=C)=O)O)=O,4,1,0,1,28,4.8e-05
G5,C(C(C=C)(C(C(CO)=O)C=C)O)=O,4,1,0,1,28,4.8e-05
G5,C(C(C(C(C=C)=O)O)O)(CC=C)=O,4,4,0,4,28,0.00019099999999999998
G5,C(C(C=C)(C(C(CC=C)=O)O)O)=O,4,3,0,3,28,0.000143
G5,C(CC(C(C=C)=O)O)(C(C=C)O)=O,4,1,0,1,28,4.8e-05
G5,C(C(C=C)(CC(C(C=C)O)=O)O)=O,4,1,0,1,28,4.8e-05
G5,C(C(C(CO)=C)C(C(C=C)=O)O)=O,4,1,0,1,28,4.8e-05
G5,C(C(C(CO)=C)C(C=O)(C=C)O)=O,4,1,0,1,28,4.8e-05
G5,C(C(C=C)C(C(C=C)=O)O)=O,4,3,0,3,29,0.000143
G5,C(C(C=C)C(C=O)(C=C)O)=O,4,2,0,2,7,9.499999999999999e-05
G5,C(C(C=CC=O)C(C(C=C)=O)O)=O,8,1,0,1,28,4.8e-05
G5,C(C(C=CC=O)C(C=O)(C=C)O)=O,8,1,0,1,28,4.8e-05
G5,C=CC(C(C(C(CO)CO)O)O)=O,4,2,0,2,18,9.6e-05
G5,C(CC(C(C(C=C)=O)O)O)(O)=O,4,3,0,3,28,0.000154
G5,C(C(CO)(CC(C(C=O)=O)=O)O)=C,2,1,0,1,25,4.8e-05
G5,C=CC(C(C(C)(CCO)O)O)=O,4,3,0,3,7,0.000154
G5,C(CC(C=C)(CO)O)(CCO)=O,2,2,0,2,29,0.00010700000000000001
G5,C(C)(C(CO)C(C=C)(CO)O)=O,4,3,0,3,7,0.000154
G5,C=CC(C(C(C)(C)O)O)=O,2,2,0,2,7,9.6e-05
G5,C(CC(C=C)(CO)O)(C)=O,2,1,0,1,7,4.8e-05
G5,C(OCC(C)(C(C(C=C)=O)O)O)=O,4,2,0,2,35,9.6e-05
G5,C(OCC(CC(C=C)(CO)O)=O)=O,2,3,0,3,7,0.000143
G5,C(OC(C(C)=O)C(C=C)(CO)O)=O,4,3,0,3,35,0.000143
G5,C(OCC(C(C(C=C)=O)O)O)=O,4,4,0,4,7,0.00019099999999999998
G5,C(OC(C=O)C(C=C)(CO)O)=O,4,2,0,2,7,9.6e-05
G5,C(C)(OCC(C(C(C=C)=O)O)O)=O,4,2,0,2,28,9.6e-05
G5,C(C)(OC(C=O)C(C=C)(CO)O)=O,4,2,0,2,28,9.6e-05
G5,C(CCC(C(C(C=C)=O)O)O)=O,4,4,0,4,27,0.00019099999999999998
G5,C(CC(C=O)C(C=C)(CO)O)=O,4,2,0,2,7,9.499999999999999e-05
G5,C=CC(C(C(C=CCO)O)O)=O,8,5,0,5,28,0.00024900000000000004
G5,C(C(CO)(C(C(C(O)=O)=O)O)O)=C,4,3,0,3,33,0.000154
G5,C(CC(C)(C(C(C=C)=O)O)O)(O)=O,4,3,0,3,6,0.000154
G5,C(CC(CC(C=C)(CO)O)=O)(O)=O,2,2,0,2,29,0.00010700000000000001
G5,C(C(C(C)=O)C(C=C)(CO)O)(O)=O,4,3,0,3,6,0.000154
G5,C=CC(C(C(C=CC(O)=O)O)O)=O,8,3,0,3,18,0.000154
G5,C1(C(CCO1)(C(C(C=C)=O)O)O)=O,4,3,0,3,28,0.000144
G5,C=CC(CO)(C1C(C(OC1)=O)=O)O,4,2,0,2,28,9.6e-05
G5,C1(CC(CO1)(C(C(C=C)=O)O)O)=O,4,2,0,2,28,9.6e-05
G5,C1(C(C(CO1)=O)C(C=C)(CO)O)=O,4,2,0,2,7,9.6e-05
G5,C1(CC(C(C(C=C)(CO)O)O1)=O)=O,4,2,0,2,28,9.6e-05
G5,C=CC(C(C(C(C=C)=O)O)O)O,8,4,0,4,28,0.00019099999999999998
G5,C1C(COC=1)(C(C(C=C)=O)O)O,4,3,0,3,28,0.000143
G5,C(C(CO)(C1C(C=CO1)=O)O)=C,4,3,0,3,28,0.000143
G5,C(C(C=C)(C(C(C=C)=O)O)O)(O)=O,4,4,0,4,7,0.000202
G5,C=CC(C(C(C(CO)(C)O)O)O)=O,8,2,0,2,11,9.6e-05
G5,C(C(C)(C(C(C=C)=O)O)O)(CC)=O,4,2,0,2,28,9.6e-05
G5,C(C)(C(CC)(C(C(C=C)=O)O)O)=O,4,2,0,2,28,9.6e-05
G5,C(C(CO)(CC(C(CC)=O)=O)O)=C,2,1,0,1,28,4.8e-05
G5,C(C(CO)(C(C(C(C)=O)=O)C)O)=C,4,1,0,1,28,4.8e-05
G5,C(C)(CC(CC(C=C)(CO)O)=O)=O,2,1,0,1,28,4.8e-05
G5,C(C)(C(C(C)=O)C(C=C)(CO)O)=O,2,2,0,2,28,9.6e-05
G5,C(CC(C)C(C(C(C=C)=O)O)O)=O,8,3,0,3,28,0.000143
G5,C(C(C)CC(C(C(C=C)=O)O)O)=O,8,2,0,2,28,9.6e-05
G5,C(C(C)C(C=O)C(C=C)(CO)O)=O,8,1,0,1,28,4.8e-05
G5,C(C(C(C(C=C)=O)O)O)(CC)=O,4,3,0,3,28,0.000143
G5,C(C(CC)(C(C(C=C)=O)O)O)=O,4,2,0,2,28,9.6e-05
G5,C=CC(CO)(C(C(C=O)=O)C)O,4,1,0,1,28,4.8e-05
G5,C(C(CC)(C(C(C=C)=O)O)O)(O)=O,4,2,0,2,28,9.6e-05
G5,C=CC(CO)(C(C(C(O)=O)=O)C)O,4,1,0,1,28,4.8e-05
G5,C(C(C=CC=O)(C(C(C=C)=O)O)O)=O,8,3,0,3,20,0.000144
G5,C=CC(C(C(C=CC(C=O)=O)O)O)=O,8,2,0,2,20,9.6e-05
G5,C(C(C=CC)(C(C(C=C)=O)O)O)=O,8,2,0,2,28,9.6e-05
G5,C(C(CC=C)(C(C(C=C)=O)O)O)=O,4,2,0,2,28,9.6e-05
G5,C=CC(C(C=O)=O)C(C=C)(CO)O,4,1,0,1,28,4.8e-05
G5,C(C(C)(C(C(C=C)=O)O)O)=CC=O,8,2,0,2,28,9.6e-05
G5,C=CC(C(C(C=CC(C)=O)O)O)=O,8,2,0,2,28,9.6e-05
G5,C(C(CO)(CC(C=CC=O)=O)O)=C,4,1,0,1,28,4.8e-05
G5,C(CC(C(C(C(C=C)=O)O)O)=C)=O,4,2,0,2,28,9.6e-05
G5,C=CC(C(C(CC(C=O)=C)O)O)=O,4,2,0,2,28,9.6e-05
G5,C(C(C(C=O)=C)C(C=C)(CO)O)=O,4,1,0,1,28,4.8e-05
G5,C=CC(C(C(C(C)=CC=O)O)O)=O,8,2,0,2,28,9.6e-05
G5,C=CC(C(C(C=C(C=O)C)O)O)=O,8,2,0,2,28,9.6e-05
G5,C=CC(C(C(C=C)=O)O)O,4,4,0,4,7,0.00019099999999999998
G5,C(C)=CC(CO)(C(C(C=C)=O)O)O,8,2,0,2,28,9.6e-05
G5,C(C(CO)(C(C(C=CC)=O)O)O)=C,8,2,0,2,28,9.6e-05
G5,C(CC(CO)(C(C(C=C)=O)O)O)=C,4,2,0,2,28,9.6e-05
G5,C(CO)(C(C=C)C(C=C)(CO)O)=O,4,1,0,1,28,4.8e-05
G5,C(C(C(C=C)(CO)O)O)(CC=C)=O,4,2,0,2,28,9.6e-05
G5,C=CC(C(C)(C(C(C=C)=O)O)O)O,8,2,0,2,28,9.6e-05
G5,C(CC(C=C)(CO)O)(C(C=C)O)=O,4,1,0,1,28,4.8e-05
G5,C=C(CO)CC(C(C(C=C)=O)O)O,4,2,0,2,28,9.6e-05
G5,C(C(C(CO)=C)C(C=C)(CO)O)=O,4,1,0,1,28,4.8e-05
G5,C=CC(C(C(C=C(C)CO)O)O)=O,8,2,0,2,28,9.6e-05
G5,C=CC(C(C(C=CC)O)O)=O,8,3,0,3,7,0.000143
G5,C(CC(C(C(C=C)=O)O)O)=C,4,3,0,3,7,0.000143
G5,C(C(C=C)C(C=C)(CO)O)=O,4,2,0,2,7,9.499999999999999e-05
G5,C=CC(C(C1(C=CC(C1O)=O)O)O)=O,8,2,0,2,47,9.6e-05
G5,C(CC=CC(C(C(C=C)=O)O)O)=O,8,2,0,2,28,9.6e-05
G5,C(CC(C(C(C=C)=O)O)O)=CC=O,8,2,0,2,28,9.6e-05
G5,C(C(C=CC=O)C(C=C)(CO)O)=O,8,1,0,1,28,4.8e-05
G5,C(C(CC(C(C=O)=O)=O)O)=CC=O,4,1,0,1,43,4.8e-05
G5,C(CC(C=CC=O)O)(CCO)=O,4,4,0,4,29,0.00020099999999999998
G5,C(C)(C(CO)C(C=CC=O)O)=O,8,4,0,4,43,0.000202
G5,C(C(C(CC=O)=O)C(C=CC=O)O)=O,8,2,0,2,9,9.6e-05
G5,C(C)(CC(C=CC=O)O)=O,4,1,0,1,43,4.8e-05
G5,C(OCC(CC(C=CC=O)O)=O)=O,4,3,0,3,43,0.000143
G5,C(OC(C(C)=O)C(C=CC=O)O)=O,8,3,0,3,35,0.000143
G5,C(OC(C=O)C(C=CC=O)O)=O,8,2,0,2,43,9.6e-05
G5,C(C)(OC(C=O)C(C=CC=O)O)=O,8,2,0,2,28,9.6e-05
G5,C(CC(C(C=O)=O)C(C=CC=O)O)=O,8,2,0,2,20,9.499999999999999e-05
G5,C(C(CC(C=O)=O)C(C=CC=O)O)=O,8,2,0,2,20,9.499999999999999e-05
G5,C(CC(C=O)C(C=CC=O)O)=O,8,6,0,6,43,0.000285
G5,C(C(C(C(C(O)=O)=O)O)O)=CC=O,8,4,0,4,33,0.000202
G5,C(CC(CC(C=CC=O)O)=O)(O)=O,4,2,0,2,29,0.00010700000000000001
G5,C(C(C(C)=O)C(C=CC=O)O)(O)=O,8,3,0,3,43,0.000154
G5,C=CC(C(C(C(C=CC=O)O)O)=O)=O,8,2,0,2,7,9.6e-05
G5,C1(CC(C(C1O)=O)C(C=CC=O)O)=O,16,2,0,2,47,9.499999999999999e-05
G5,C1(CC(C(CO1)=O)C(C=CC=O)O)=O,8,1,0,1,7,4.8e-05
G5,C1(CCC(C(C(C=CC=O)O)O1)=O)=O,8,2,0,2,7,9.6e-05
G5,C1(C(C(C=CC=O)O)OCC(C1)=O)=O,8,2,0,2,54,9.6e-05
G5,C1(COCC(C1C(C=CC=O)O)=O)=O,4,2,0,2,54,9.6e-05
G5,C(C(C1C(C(OC1)=O)=O)O)=CC=O,8,2,0,2,43,9.6e-05
G5,C1(C(C(CO1)=O)C(C=CC=O)O)=O,8,2,0,2,43,9.6e-05
G5,C1(CC(C(C(C=CC=O)O)O1)=O)=O,8,2,0,2,43,9.6e-05
G5,C1OC(C(C=1)=O)C(C=CC=O)O,8,3,0,3,43,0.000143
G5,C(C(C1C(C=CC(O)O1)=O)O)=CC=O,16,2,0,2,27,9.6e-05
G5,C(C(CC(C(CC)=O)=O)O)=CC=O,4,1,0,1,43,4.8e-05
G5,C(C(C(C(C(C)=O)=O)C)O)=CC=O,8,1,0,1,43,4.8e-05
G5,C(CC(C=CC=O)O)(CC(C)=O)=O,4,1,0,1,43,4.8e-05
G5,C(C)(C(C(C)=O)C(C=CC=O)O)=O,4,2,0,2,43,9.6e-05
G5,C(C(C)C(C=O)C(C=CC=O)O)=O,16,2,0,2,28,9.499999999999999e-05
G5,C(C(C(C(C=O)=O)C)O)=CC=O,8,1,0,1,43,4.8e-05
G5,C(C(C=O)C(CC(C=CC=O)O)=O)=O,4,1,0,1,6,4.8e-05
G5,C(C(C=O)C(C=O)C(C=CC=O)O)=O,8,1,0,1,43,4.8e-05
G5,C(C(C(C(C(O)=O)=O)C)O)=CC=O,8,1,0,1,28,4.8e-05
G5,C=CC(C(C=O)=O)C(C=CC=O)O,8,1,0,1,43,4.8e-05
G5,C(C(CC(C=CC=O)=O)O)=CC=O,8,1,0,1,43,4.8e-05
G5,C(C(C(C=O)=C)C(C=CC=O)O)=O,8,1,0,1,43,4.8e-05
G5,C=C(C=O)C(C(C(C=CC=O)O)O)=O,8,2,0,2,9,9.6e-05
G5,C(C(C(C(C=CC)=O)O)O)=CC=O,16,2,0,2,43,9.6e-05
G5,C(CO)(C(C=C)C(C=CC=O)O)=O,8,1,0,1,43,4.8e-05
G5,C(C(C(C=CC=O)O)O)(CC=C)=O,8,2,0,2,43,9.6e-05
G5,C(CC(C=CC=O)O)(C(C=C)O)=O,8,1,0,1,28,4.8e-05
G5,C(C(C(CO)=C)C(C=CC=O)O)=O,8,1,0,1,28,4.8e-05
G5,C(C(C=C)C(C=CC=O)O)=O,8,2,0,2,43,9.499999999999999e-05
G5,C(C(C=CC=O)C(C=CC=O)O)=O,16,1,0,1,43,4.8e-05
G5,C(C(CC(C(CC(C)=O)O)O)O)=O,8,1,0,1,0,4.8e-05
G5,C(C(C(C(C)O)(CC(C)=O)O)O)=O,8,2,0,2,46,0.000106
G5,C(C(C(C(C)O)O)C(C(C)O)O)=O,10,2,0,2,11,9.6e-05
G5,C(C(C(CC(C(C)O)O)=O)=O)=O,4,3,0,3,29,0.000143
G5,C(CC(C(C)O)O)(CC(CO)=O)=O,4,2,0,2,11,0.00010700000000000001
G5,C(C)(C(C(CO)=O)C(C(C)O)O)=O,8,3,0,3,26,0.000155
G5,C(C(C(C(C)O)O)O)(CC(C)=O)=O,8,2,0,2,26,9.6e-05
G5,C(CC(C(C)O)O)(C(C(C)=O)O)=O,8,1,0,1,49,4.8e-05
G5,C(CC(C(C)O)O)(CCO)=O,4,2,0,2,11,0.00010700000000000001
G5,C(C)(C(CO)C(C(C)O)O)=O,8,3,0,3,28,0.000155
G5,C(C(C(CC=O)=O)C(C(C)O)O)=O,8,2,0,2,9,9.6e-05
G5,C(C)(CC(C(C)O)O)=O,4,1,0,1,11,4.8e-05
G5,C(CCC=O)(C(C(C(C)O)O)O)=O,8,2,0,2,7,9.6e-05
G5,C(CO)(C(C(C(C)O)O)CC=O)=O,8,2,0,2,11,9.6e-05
G5,C(C(C(C(C)O)O)CC(CO)=O)=O,8,2,0,2,11,9.6e-05
G5,C(C)(C(C(C(C)O)O)C(C=O)O)=O,16,2,0,2,27,9.6e-05
G5,C(CC(C=O)O)(CC(C(C)O)O)=O,8,1,0,1,27,4.8e-05
G5,C(CO)=CC(C(C(C(C)O)O)O)=O,16,3,0,3,11,0.000155
G5,C(OCC(CC(C(C)O)O)=O)=O,4,3,0,3,35,0.000143
G5,C(OC(C(C)=O)C(C(C)O)O)=O,8,3,0,3,35,0.000143
G5,C(OC(C=O)C(C(C)O)O)=O,8,3,0,3,28,0.000154
G5,C(C(C(C(C)O)O)OC(CO)=O)=O,8,2,0,2,40,9.6e-05
G5,C(C(C(C(C)O)O)OC(C)=O)=O,8,2,0,2,28,9.6e-05
G5,C(CC(C(C=O)=O)C(C(C)O)O)=O,8,3,0,3,27,0.000154
G5,C(C(C(C(C)O)O)CC(C=O)=O)=O,8,2,0,2,11,9.6e-05
G5,C(C(C(C(C)O)O)CC=O)=O,8,4,0,4,29,0.00019099999999999998
G5,C(C(C(C(C(C)O)O)O)=O)(O)=O,8,6,0,6,33,0.000319
G5,C(C(C(C(O)=O)=O)C(C(C)O)O)=O,8,3,0,3,45,0.000155
G5,C(CC(CC(C(C)O)O)=O)(O)=O,4,2,0,2,11,0.00010700000000000001
G5,C(C(C(C)=O)C(C(C)O)O)(O)=O,8,4,0,4,6,0.000202
G5,C(C(CO)=O)(C(C(C(C)O)O)O)=O,8,3,0,3,5,0.000143
G5,C=CC(C(C(C(C(C)O)O)O)=O)=O,8,3,0,3,7,0.000143
G5,C(C(C(C)O)=O)(CC(C(C)O)O)=O,8,1,0,1,49,4.8e-05
G5,C1(C(C(C(C)O)O)CC(C1O)=O)=O,16,2,0,2,47,9.6e-05
G5,C1(COC(CC1C(C(C)O)O)=O)=O,8,1,0,1,7,4.8e-05
G5,C1(CCC(OC1C(C(C)O)O)=O)=O,8,2,0,2,7,9.6e-05
G5,C1(C(C(C(C)O)O)OCC(C1)=O)=O,8,2,0,2,54,9.6e-05
G5,C1(COCC(C1C(C(C)O)O)=O)=O,4,2,0,2,54,9.6e-05
G5,C1(C(C(CO1)C(C(C)O)O)=O)=O,8,3,0,3,28,0.000143
G5,C1(C(C(CO1)=O)C(C(C)O)O)=O,8,4,0,4,28,0.00019099999999999998
G5,C1(CC(C(C(C(C)O)O)O1)=O)=O,8,3,0,3,28,0.000143
G5,C1OC(C(C=1)=O)C(C(C)O)O,8,3,0,3,28,0.000143
G5,C1C(OC(C(C=1)=O)C(C(C)O)O)O,16,2,0,2,27,9.6e-05
G5,C(C(C(C(C)O)=O)C(C(C)O)O)=O,16,3,0,3,45,0.000143
G5,C(C(CCO)O)(CC(C(C)O)O)=O,8,2,0,2,11,0.00010700000000000001
G5,C(C(CO)=O)(C(C)C(C(C)O)O)=O,8,1,0,1,42,4.8e-05
G5,C(C(C(C(C(C)O)O)O)=O)(CC)=O,8,2,0,2,42,9.6e-05
G5,C(C(C(C(C)O)O)C(C=O)CO)=O,16,2,0,2,18,9.6e-05
G5,C(C(CC)=O)(CC(C(C)O)O)=O,4,2,0,2,11,9.499999999999999e-05
G5,C(C(C)=O)(C(C)C(C(C)O)O)=O,8,2,0,2,49,9.499999999999999e-05
G5,C(CC(C(C)O)O)(CC(C)=O)=O,4,2,0,2,11,9.499999999999999e-05
G5,C(C)(C(C(C)=O)C(C(C)O)O)=O,4,3,0,3,28,0.000143
G5,C(C(C(C(C)O)O)C(C=O)C)=O,16,3,0,3,49,0.000143
G5,C(C(C(C)C(C(C)O)O)=O)=O,8,2,0,2,0,9.499999999999999e-05
G5,C(C(C=O)C(CC(C(C)O)O)=O)=O,4,1,0,1,6,4.8e-05
G5,C(C(C=O)C(C=O)C(C(C)O)O)=O,8,1,0,1,43,4.8e-05
G5,C(C(C(C)C(C(C)O)O)=O)(O)=O,8,2,0,2,33,9.499999999999999e-05
G5,C(C(C(C(C)O)O)O)(C(C=C)O)=O,16,3,0,3,31,0.000143
G5,C=CC(C(C=O)=O)C(C(C)O)O,8,2,0,2,4,9.499999999999999e-05
G5,C(C=CC(CC(C(C)O)O)=O)=O,8,2,0,2,11,9.499999999999999e-05
G5,C(C(C(C=O)=C)C(C(C)O)O)=O,8,2,0,2,11,9.499999999999999e-05
G5,C=C(C=O)C(C(C(C(C)O)O)O)=O,8,2,0,2,9,9.6e-05
G5,C=C(C(C(C(C(C)O)O)O)=O)CO,8,2,0,2,49,9.6e-05
G5,C(C)=CC(C(C(C(C)O)O)O)=O,16,3,0,3,28,0.000143
G5,C(CO)(C(C=C)C(C(C)O)O)=O,8,2,0,2,11,9.499999999999999e-05
G5,C(C(C(C(C)O)O)O)(CC=C)=O,8,3,0,3,28,0.000143
G5,C(CC(C(C)O)O)(C(C=C)O)=O,8,2,0,2,11,9.499999999999999e-05
G5,C(C(C(CO)=C)C(C(C)O)O)=O,8,2,0,2,49,9.499999999999999e-05
G5,C(C(C=C)C(C(C)O)O)=O,8,2,0,2,11,9.499999999999999e-05
G5,C1(C(O)OC(C)C1C(C(C)O)O)=O,32,3,0,3,45,0.000143
G5,C1(C(C(C(C)O)O)OC(C1O)O)=O,32,3,0,3,5,0.000143
G5,C(C(C(CCO)C(C(C)O)O)=O)=O,8,2,0,2,46,0.000106
G5,C(C(C(C(C)O)O)O)(CCCO)=O,8,3,0,3,55,0.000144
G5,C(CO)(C(CCO)C(C(C)O)O)=O,8,1,0,1,55,4.8e-05
G5,C(C(C=CC=O)C(C(C)O)O)=O,16,1,0,1,28,4.8e-05
G5,C(C(C(CO)C(C)(C)O)=O)(O)=O,2,2,0,2,7,9.499999999999999e-05
G5,C(C(CCO)(CC(C)=O)O)(O)=O,2,3,0,3,29,0.000154
G5,C=CC(C(C(C(O)=O)=O)CO)O,4,4,0,4,7,0.00018999999999999998
G5,C(C)=CC(C(C(C(O)=O)=O)CO)O,8,2,0,2,7,9.499999999999999e-05
G5,C=CCC(C(C(C(O)=O)=O)CO)O,4,2,0,2,7,9.499999999999999e-05
G5,C(C(C=C)C(C(O)=O)(CCO)O)=O,4,2,0,2,29,0.000106
G5,C(C(C(C)(C)O)C(C(O)=O)O)=O,4,2,0,2,33,9.499999999999999e-05
G5,C(C(CC(CC(C)=O)O)O)(O)=O,4,3,0,3,23,0.000165
G5,C(C(C(C=O)C(C=C)O)O)(O)=O,8,4,0,4,33,0.00018999999999999998
G5,C(C(C(C=O)C(C=CC)O)O)(O)=O,16,2,0,2,33,9.499999999999999e-05
G5,C(C(C(CC=C)O)C(C(O)=O)O)=O,8,2,0,2,33,9.499999999999999e-05
G5,C(C(C=C)C(CC(C(O)=O)O)O)=O,8,3,0,3,29,0.000165
G5,C(C)(CC(C(CO)(CO)O)O)=O,2,3,0,3,41,0.000165
G5,C(C(C=C)C(C(CO)(CO)O)O)=O,4,1,0,1,41,4.8e-05
G5,C(C)(CC(C(CO)(C(C)O)O)O)=O,8,3,0,3,29,0.000165
G5,C(C(C(CC(C)(C)O)=O)(CO)O)=O,2,1,0,1,1,4.8e-05
G5,C(C(CO)(C(C)(CC(C)=O)O)O)=O,4,3,0,3,41,0.000143
G5,C(CC(C=C)O)(C(C=O)(CO)O)=O,4,1,0,1,1,4.8e-05
G5,C(CC(C)(C)O)(C(CO)(CO)O)=O,1,1,0,1,2,4.8e-05
G5,C(C)(CC(C)(C(CO)(CO)O)O)=O,2,1,0,1,2,4.8e-05
G5,C(CC(C=C)O)(C(CO)(CO)O)=O,2,1,0,1,2,4.8e-05
G5,C(C(C=C)C(C(C=O)(CO)O)O)=O,8,1,0,1,1,4.8e-05
G5,C(C(C(C)(C)O)C(C=O)(CO)O)=O,4,2,0,2,43,9.499999999999999e-05
G5,C(C(CO)(CC(CC(C)=O)O)O)=O,4,1,0,1,43,4.8e-05
G5,C(C(CO)(C(C=O)C(C=C)O)O)=O,8,2,0,2,43,9.499999999999999e-05
G5,C(C(C=CC(CC(C)(C)O)=O)=O)=O,2,1,0,1,45,4.8e-05
G5,C(C)(CC(C(C=CC(C)=O)=O)O)=O,4,1,0,1,45,4.8e-05
G5,C(C(C=CC(C)=O)(CC(C)=O)O)=O,4,1,0,1,45,4.8e-05
G5,C(CC(C=CC(C=O)=O)(C)O)(C)=O,4,1,0,1,45,4.8e-05
G5,C=CC(CC(C=CC(C=O)=O)=O)O,4,1,0,1,45,4.8e-05
G5,C(C(CC(C=CC(C=O)=O)=O)O)=CC,8,1,0,1,45,4.8e-05
G5,C=CCC(CC(C=CC(C=O)=O)=O)O,4,1,0,1,45,4.8e-05
G5,C(C(C=C)C(C(C=CC(C)=O)=O)O)=O,8,1,0,1,45,4.8e-05
G5,C(C(C=C)C(C=O)(C=CC(C)=O)O)=O,8,1,0,1,45,4.8e-05
G5,C(C(C=C)C(C=CC(C=O)=O)(C)O)=O,8,1,0,1,45,4.8e-05
G5,C(C(C=CC(C=O)=O)C(C)(C)O)=O,4,1,0,1,45,4.8e-05
G5,C(CC=CC(C(CC(C)=O)O)=O)=O,4,1,0,1,45,4.8e-05
G5,C(C(C=CCC=O)(CC(C)=O)O)=O,4,1,0,1,45,4.8e-05
G5,C(C)(CC(CC=CC(C=O)=O)O)=O,4,1,0,1,45,4.8e-05
G5,C(C(C=CC(C=O)=O)C(C=C)O)=O,8,1,0,1,45,4.8e-05
G5,C(C(C=CC(C=O)=O)C(C=CC)O)=O,16,1,0,1,45,4.8e-05
G5,C(C(C=CC(C=O)=O)C(CC=C)O)=O,8,1,0,1,45,4.8e-05
G5,C(C(C=C)C(C(C=CCC=O)=O)O)=O,8,1,0,1,45,4.8e-05
G5,C(C(C=C)C(C=O)(C=CCC=O)O)=O,8,1,0,1,45,4.8e-05
G5,C(C(C=C)C(CC=CC(C=O)=O)O)=O,8,1,0,1,45,4.8e-05
G5,C(C(C=CC=O)=O)(CC(C)(C)O)=O,2,1,0,1,45,4.8e-05
G5,C(C)(CC(C=CC(C(C)=O)=O)O)=O,4,1,0,1,45,4.8e-05
G5,C(C)(C(C=CC=O)(CC(C)=O)O)=O,4,1,0,1,45,4.8e-05
G5,C(CC(C(C=CC=O)=O)(C)O)(C)=O,4,1,0,1,45,4.8e-05
G5,C=CC(CC(C(C=CC=O)=O)=O)O,4,1,0,1,45,4.8e-05
G5,C(C(CC(C(C=CC=O)=O)=O)O)=CC,8,1,0,1,45,4.8e-05
G5,C=CCC(CC(C(C=CC=O)=O)=O)O,4,1,0,1,45,4.8e-05
G5,C(C(C=C)C(C=CC(C(C)=O)=O)O)=O,8,1,0,1,45,4.8e-05
G5,C(C(C=C)C(C(C)=O)(C=CC=O)O)=O,8,1,0,1,45,4.8e-05
G5,C(C(C=C)C(C(C=CC=O)=O)(C)O)=O,8,1,0,1,45,4.8e-05
G5,C(C(C(C=CC=O)=O)C(C)(C)O)=O,4,2,0,2,45,9.499999999999999e-05
G5,C(CC(C=CC(CC(C)=O)O)=O)=O,4,1,0,1,45,4.8e-05
G5,C(CC(C=CC=O)(CC(C)=O)O)=O,4,1,0,1,45,4.8e-05
G5,C(C(C(C=CC=O)=O)C(C=C)O)=O,8,2,0,2,45,9.499999999999999e-05
G5,C(C(C(C=CC=O)=O)C(C=CC)O)=O,16,2,0,2,45,9.499999999999999e-05
G5,C(C(C(C=CC=O)=O)C(CC=C)O)=O,8,2,0,2,45,9.499999999999999e-05
G5,C(C(C=C)C(C=CC(CC=O)=O)O)=O,8,1,0,1,45,4.8e-05
G5,C(C(C=C)C(C=CC=O)(CC=O)O)=O,8,1,0,1,45,4.8e-05
G5,C(C(C=C)C(CC(C=CC=O)=O)O)=O,8,1,0,1,45,4.8e-05
G5,C=CC(C(C(C=O)=O)C(C)(C)O)=O,2,2,0,2,45,9.499999999999999e-05
G5,C(C(CC(C)=O)O)(CC(C=C)=O)=O,2,1,0,1,45,4.8e-05
G5,C(C(CC(C)=O)(CC(C=C)=O)O)=O,2,1,0,1,45,4.8e-05
G5,C(C)(CC(C=C)(CC(C=O)=O)O)=O,2,1,0,1,45,4.8e-05
G5,C=CC(C(C(C=C)=O)C(C=O)=O)O,4,2,0,2,45,9.499999999999999e-05
G5,C=CC(C(C(C=O)=O)C(C=CC)O)=O,8,2,0,2,45,9.499999999999999e-05
G5,C=CCC(C(C(C=C)=O)C(C=O)=O)O,4,2,0,2,45,9.499999999999999e-05
G5,C(C(C=C)C(C(CC(C=C)=O)=O)O)=O,4,1,0,1,45,4.8e-05
G5,C(C(C=C)C(C=O)(CC(C=C)=O)O)=O,4,1,0,1,45,4.8e-05
G5,C(C(C=C)C(C=C)(CC(C=O)=O)O)=O,4,1,0,1,45,4.8e-05
G5,C(C(C(C(C=C)=O)=O)C(C)(C)O)=O,2,2,0,2,45,9.499999999999999e-05
G5,C(C)(CC(CC(C(C=C)=O)=O)O)=O,2,1,0,1,45,4.8e-05
G5,C(CC(C(C=C)=O)(CC(C)=O)O)=O,2,1,0,1,45,4.8e-05
G5,C(CC=O)(C(C=C)(CC(C)=O)O)=O,2,1,0,1,45,4.8e-05
G5,C(C(C(C(C=C)=O)=O)C(C=C)O)=O,4,2,0,2,45,9.499999999999999e-05
G5,C(C(C(C(C=C)=O)=O)C(C=CC)O)=O,8,2,0,2,45,9.499999999999999e-05
G5,C(C(C(C(C=C)=O)=O)C(CC=C)O)=O,4,2,0,2,45,9.499999999999999e-05
G5,C(C(C=C)C(CC(C(C=C)=O)=O)O)=O,4,1,0,1,45,4.8e-05
G5,C(C(C=C)C(C(C=C)=O)(CC=O)O)=O,4,1,0,1,45,4.8e-05
G5,C(C(C=C)C(C(CC=O)=O)(C=C)O)=O,4,1,0,1,45,4.8e-05
G5,C(C(C(C=O)=O)C(C)(C)O)=CC=O,4,1,0,1,27,4.8e-05
G5,C(C(CC(C)=O)O)(CC=CC=O)=O,4,1,0,1,27,4.8e-05
G5,C(C(CC(C)=O)(CC=CC=O)O)=O,4,1,0,1,27,4.8e-05
G5,C(C)(CC(C=CCC(C=O)=O)O)=O,4,1,0,1,27,4.8e-05
G5,C=CC(C(C=CC=O)C(C=O)=O)O,8,1,0,1,27,4.8e-05
G5,C(C(C(C=O)=O)C(C=CC)O)=CC=O,16,1,0,1,27,4.8e-05
G5,C=CCC(C(C=CC=O)C(C=O)=O)O,8,1,0,1,27,4.8e-05
G5,C(C(C=C)C(C(CC=CC=O)=O)O)=O,8,1,0,1,27,4.8e-05
G5,C(C(C=C)C(C=O)(CC=CC=O)O)=O,8,1,0,1,27,4.8e-05
G5,C(C(C=C)C(C=CCC(C=O)=O)O)=O,8,1,0,1,27,4.8e-05
G5,C(CC(C1C(C(CO1)O)=O)O)(O)=O,8,3,0,3,10,0.000154
G5,C(C(C=O)(C1C(C(CO1)O)=O)O)=O,4,2,0,2,10,9.6e-05
G5,C1(C(C(C(C=O)=O)O)OCC1O)=O,8,2,0,2,10,9.6e-05
G5,C1(C(C(C)(CCO)O)OCC1O)=O,8,3,0,3,10,0.000154
G5,C(CC1(COCC1O)O)(CCO)=O,4,2,0,2,10,0.00010700000000000001
G5,C(C)(C(CO)C1(COCC1O)O)=O,8,3,0,3,10,0.000154
G5,C1(C(C(C)(C)O)OCC1O)=O,4,2,0,2,10,9.6e-05
G5,C(C)(CC1(COCC1O)O)=O,4,1,0,1,10,4.8e-05
G5,C(OCC(C1C(C(CO1)O)=O)O)=O,8,2,0,2,10,9.6e-05
G5,C(OC(C=O)C1(COCC1O)O)=O,8,2,0,2,10,9.6e-05
G5,C(CCC(C1C(C(CO1)O)=O)O)=O,8,3,0,3,10,0.000143
G5,C(C(C1(COCC1O)O)CC=O)=O,8,1,0,1,10,4.8e-05
G5,C1(C(C(C=CCO)O)OCC1O)=O,16,3,0,3,10,0.000154
G5,C1(C(C(C(C=C)O)O)OCC1O)=O,16,2,0,2,10,9.6e-05
G5,C1(C(C2(C=COC2)O)OCC1O)=O,8,2,0,2,10,9.6e-05
G5,C1OC(C(C=1)=O)C2(COCC2O)O,8,2,0,2,10,9.6e-05
G5,C(C(C1C(C(CO1)O)=O)O)(CC)=O,8,2,0,2,10,9.6e-05
G5,C(C(CC)(C1C(C(CO1)O)=O)O)=O,8,2,0,2,10,9.6e-05
G5,C(C(C(C)C1(COCC1O)O)=O)=O,8,1,0,1,10,4.8e-05
G5,C1(C(C(C=C)O)OCC1O)=O,8,4,0,4,10,0.00018999999999999998
G5,C1(C(C(C=CC)O)OCC1O)=O,16,3,0,3,10,0.000143
G5,C1(C(C(CC=C)O)OCC1O)=O,8,3,0,3,10,0.000143
G5,C(C(C=C)C1(COCC1O)O)=O,8,2,0,2,10,9.499999999999999e-05
G5,C(CC(C1C(C(O)OC1)=O)O)(O)=O,8,4,0,4,34,0.000202
G5,C(C(C=O)(C1C(C(O)OC1)=O)O)=O,4,2,0,2,34,9.6e-05
G5,C1(C(O)OCC1C(C(C=O)=O)O)=O,8,2,0,2,34,9.6e-05
G5,C1(C(O)OCC1C(C)(CCO)O)=O,8,3,0,3,34,0.000154
G5,C(CC1(C(O)OCC1)O)(CCO)=O,4,3,0,3,34,0.000154
G5,C(C)(C(CO)C1(C(O)OCC1)O)=O,8,3,0,3,34,0.000154
G5,C1(C(O)OCC1C(C)(C)O)=O,4,2,0,2,34,9.6e-05
G5,C(C)(CC1(C(O)OCC1)O)=O,4,1,0,1,34,4.8e-05
G5,C(OCC(C1C(C(O)OC1)=O)O)=O,8,2,0,2,34,9.6e-05
G5,C(OC(C=O)C1(C(O)OCC1)O)=O,8,2,0,2,34,9.6e-05
G5,C(CCC(C1C(C(O)OC1)=O)O)=O,8,3,0,3,34,0.000143
G5,C(C(C1(C(O)OCC1)O)CC=O)=O,8,3,0,3,29,0.000143
G5,C1(C(O)OCC1C(C=CCO)O)=O,16,3,0,3,34,0.000154
G5,C1(C(O)OCC1C(C(C=C)O)O)=O,16,2,0,2,34,9.6e-05
G5,C1(C(O)OCC1C2(C=COC2)O)=O,8,2,0,2,34,9.6e-05
G5,C1OC(C(C=1)=O)C2(C(O)OCC2)O,8,2,0,2,34,9.6e-05
G5,C(C(C1C(C(O)OC1)=O)O)(CC)=O,8,2,0,2,34,9.6e-05
G5,C(C(CC)(C1C(C(O)OC1)=O)O)=O,8,2,0,2,34,9.6e-05
G5,C(C(C(C)C1(C(O)OCC1)O)=O)=O,8,1,0,1,34,4.8e-05
G5,C1(C(O)OCC1C(C=C)O)=O,8,4,0,4,34,0.00018999999999999998
G5,C1(C(O)OCC1C(C=CC)O)=O,16,3,0,3,34,0.000143
G5,C1(C(O)OCC1C(CC=C)O)=O,8,3,0,3,34,0.000143
G5,C(C(C=C)C1(C(O)OCC1)O)=O,8,2,0,2,34,9.499999999999999e-05
G5,C(C(C1C(C(CC1O)O)O)O)(O)=O,32,2,0,2,20,0.000117
G5,C(C1(CC(C(C1CO)O)O)O)(O)=O,16,1,0,1,14,5.9e-05
G5,C(C1(C(C(CC1)O)O)O)(O)=O,8,2,0,2,12,0.000106
G5,C(C1(CC(CO)(C(C1)O)O)O)(O)=O,8,1,0,1,5,5.9e-05
G5,C(C1(C=CC(C1)O)O)(O)=O,4,3,0,3,29,0.000153
G5,C(C(C(C)O)C(C(O)=O)O)(O)=O,8,6,0,6,29,0.000331
G5,C(C(CO)(CC(CCO)O)O)(O)=O,4,3,0,3,29,0.000167
G5,C(C(C)(CC(CCO)O)O)(O)=O,4,1,0,1,18,5.9e-05
G5,C(C(C(C(CC(C)O)O)O)O)(O)=O,16,4,0,4,29,0.000223
G5,C(C(C)(CC(CC(C)O)O)O)(O)=O,8,1,0,1,14,5.9e-05
G5,C(C(C(CO)O)C(C(O)=O)O)(O)=O,8,7,0,7,29,0.000389
G5,C(C(C(C(C(C)=O)(C)O)O)O)(O)=O,8,3,0,3,14,0.000176
G5,C(C(C)(CC(C(CO)=O)O)O)(O)=O,4,3,0,3,29,0.000165
G5,C(C(C=C)(C(C(C(O)=O)O)O)O)=O,8,5,0,5,1,0.000271
G5,C(C(C(C(C=C)(CO)O)O)O)(O)=O,8,4,0,4,29,0.000223
G5,C(C(C(C(C=CC=O)O)O)O)(O)=O,16,4,0,4,29,0.000223
G5,C(C(CO)(CC(O)=O)O)(O)=O,2,5,0,5,29,0.00028399999999999996
G5,C(C(CO)(CC(C(O)=O)O)O)(O)=O,4,1,0,1,33,5.9e-05
G5,C(C(CO)(CC(C(C)O)O)O)(O)=O,8,1,0,1,11,5.9e-05
G5,C(C(C)(CC(C(O)=O)(C)O)O)(O)=O,3,1,0,1,28,5.9e-05
G5,C(C(C)(CC(O)=O)O)(O)=O,2,3,0,3,29,0.000176
G5,C(C(C=CC=O)(CC(O)=O)O)(O)=O,4,1,0,1,17,5.9e-05
G5,C(C(C=CC=O)C(C(O)=O)O)(O)=O,8,2,0,2,17,0.000117
G5,C(C(C)(CC(C(C)=O)(C)O)O)(O)=O,4,1,0,1,14,5.9e-05
G5,C(C(C)(CC(C)(CC=O)O)O)(O)=O,4,1,0,1,14,5.9e-05
G5,C(C(C)(CC(C(C=C)=O)O)O)(O)=O,4,1,0,1,14,5.9e-05
G5,C(C(C=C)(CC(C(O)=O)(C)O)O)=O,4,1,0,1,14,5.9e-05
G5,C(C(C)(CC(C=C)(CO)O)O)(O)=O,4,1,0,1,14,5.9e-05
G5,C(C(C)(CC(C=CC=O)O)O)(O)=O,8,1,0,1,21,5.9e-05
G5,C(C(C)(CC(C(C)O)O)O)(O)=O,8,1,0,1,11,5.9e-05
G5,C(C(C(C(CO)O)C(C)O)O)(O)=O,16,2,0,2,0,0.000117
G5,C(C(C)(CC(CO)(CO)O)O)(O)=O,2,2,0,2,29,0.000117
G5,C(C(C)(CC(C(CO)O)O)O)(O)=O,8,2,0,2,29,0.000117
G5,C(C(CC(CC(C)O)O)O)(O)=O,8,2,0,2,3,0.000117
G5,C(C(CC(C(C(C)O)O)O)O)(O)=O,16,2,0,2,45,0.000117
G5,C(C(CC(CC(CO)O)O)O)(O)=O,8,3,0,3,29,0.000176
G5,C(C(CO)(CC(C(O)=O)O)O)=O,4,4,0,4,2,0.000225
G5,C(C(CC(C(CO)=O)(C)O)O)(O)=O,4,3,0,3,26,0.000164
G5,C(C(C)(C(C(C=O)(C)O)O)O)(O)=O,8,2,0,2,25,0.000106
G5,C(C(CO)(CC(C=O)(C)O)O)(O)=O,4,2,0,2,29,0.00010800000000000001
G5,C(C(CC(C(C(C)O)=O)O)O)(O)=O,8,5,0,5,29,0.000271
G5,C(C(CC(C(O)=O)O)(C(C)O)O)=O,8,4,0,4,4,0.000225
G5,C(C(CC(CO)(C(C)O)O)O)(O)=O,8,2,0,2,29,0.000117
G5,C(C(CC(C(CCO)O)O)O)(O)=O,8,3,0,3,29,0.000176
G5,C(C(CC(C(O)=O)O)O)(O)=O,3,3,0,3,29,0.000176
G5,C(CC(C(CC(C(O)=O)O)O)=O)=O,4,4,0,4,29,0.000223
G5,C(C(CC(C(C)=O)(C)O)O)(O)=O,4,3,0,3,29,0.000164
G5,C(C(C)(CC(C(C)=O)O)O)(O)=O,4,1,0,1,14,5.9e-05
G5,C(C(C)(CC(C=O)(C)O)O)(O)=O,4,1,0,1,45,5.9e-05
G5,C(C(CC1(COC(C1)O)O)O)(O)=O,8,4,0,4,45,0.000223
G5,C(C(CC(C(C=C)=O)O)O)(O)=O,4,3,0,3,29,0.000164
G5,C(C(C=C)(CC(C(O)=O)O)O)=O,4,3,0,3,7,0.000164
G5,C(C(CC(C=C)(CO)O)O)(O)=O,4,3,0,3,29,0.000164
G5,C(C(CC(C=CC=O)O)O)(O)=O,8,4,0,4,29,0.000212
G5,C(C(CC(C(C)O)O)O)(O)=O,8,2,0,2,11,0.000117
G5,C(C(CC1(COCC1O)O)O)(O)=O,8,2,0,2,10,0.000117
G5,C(C(CC1(C(O)OCC1)O)O)(O)=O,8,3,0,3,29,0.000164
G5,C(C(C(C(C)O)C(C=O)O)O)(O)=O,16,4,0,4,0,0.000223
G5,C(C(CO)(CC(C=O)O)O)(O)=O,4,5,0,5,29,0.000273
G5,C(C(C)(CCO)O)(O)=O,2,3,0,3,29,0.000176
G5,C(C(C(CO)CC(C=O)O)O)(O)=O,8,3,0,3,12,0.000164
G5,C(C(CCC=O)(C(CO)O)O)(O)=O,4,2,0,2,17,0.000106
G5,C(C(CO)(C(CO)CC=O)O)(O)=O,4,3,0,3,29,0.000165
G5,C(C(C=CCO)(C(CO)O)O)(O)=O,8,1,0,1,55,5.9e-05
G5,C(C(C(CO)C(CCO)O)O)(O)=O,8,4,0,4,29,0.00023500000000000002
G5,C(C(CCO)(C(CO)CO)O)(O)=O,2,3,0,3,29,0.000176
G5,C(C(C)(C(CO)C(CO)O)O)(O)=O,8,3,0,3,29,0.000176
G5,C(C(CCO)(CC(CO)O)O)(O)=O,4,2,0,2,29,0.000117
G5,C(C1(C(CO)OC(CO)C1)O)(O)=O,8,1,0,1,2,5.9e-05
G5,C(C1(COC(CO)C1CO)O)(O)=O,8,1,0,1,54,5.9e-05
G5,C(C1(C(CO)OCC(C1)O)O)(O)=O,8,1,0,1,36,5.9e-05
G5,C(C1(COCC(C1CO)O)O)(O)=O,8,1,0,1,36,5.9e-05
G5,C(C1(CCOC(C1CO)O)O)(O)=O,8,2,0,2,2,0.000106
G5,C(C1(CC(O)OCC1CO)O)(O)=O,8,2,0,2,2,0.000106
G5,C(C(C=CC=O)(CCO)O)(O)=O,4,3,0,3,29,0.000153
G5,C(C(C(C=CC=O)CO)O)(O)=O,8,3,0,3,29,0.000164
G5,C(C(CO)C(C(O)=O)O)(O)=O,4,7,0,7,29,0.000391
G5,C(C(C(CO)C(C(O)=O)O)O)(O)=O,3,4,0,4,29,0.00023500000000000002
G5,C(C(C(CO)C(C(C)O)O)O)(O)=O,16,3,0,3,29,0.000176
G5,C(C(C(C(CO)(C)O)O)O)(O)=O,8,6,0,6,29,0.000341
G5,C(C(C)(C(C(CO)(C)O)O)O)(O)=O,8,2,0,2,49,0.000106
G5,C(C(CO)(CC(CO)(C)O)O)(O)=O,4,2,0,2,29,0.00010800000000000001
G5,C(C(C)(CC(CO)(C)O)O)(O)=O,4,1,0,1,49,5.9e-05
G5,C(C(C(C(C)O)C(C)O)O)(O)=O,6,2,0,2,4,0.000117
G5,C(C(CO)(CC(C)O)O)(O)=O,4,2,0,2,27,0.00010800000000000001
G5,C(C(C)(CC(C)O)O)(O)=O,4,1,0,1,4,5.9e-05
G5,C(C(C=CC=O)(CC(C)O)O)(O)=O,8,1,0,1,4,5.9e-05
G5,C(C(C(C=CC=O)C(C)O)O)(O)=O,16,2,0,2,29,0.000117
G5,C(C(C=O)(CC(C)=O)O)(O)=O,2,7,0,7,29,0.00035499999999999996
G5,C(C(C=O)(CCC=O)O)(O)=O,2,3,0,3,29,0.000154
G5,C(C(C=O)(C=CCO)O)(O)=O,4,3,0,3,29,0.000153
G5,C(CCC(C(O)=O)O)=O,2,5,0,5,20,0.00026000000000000003
G5,C(C(C=CCO)O)(O)=O,4,5,0,5,29,0.000259
G5,C(C(C=C)(CO)O)(O)=O,2,5,0,5,29,0.000262
G5,C(C(C=C)(C(C)O)O)(O)=O,4,4,0,4,29,0.000202
G5,C(C(COCC(C)=O)O)(O)=O,2,2,0,2,17,0.000117
G5,C(C(COCC=O)(C)O)(O)=O,2,1,0,1,36,5.9e-05
G5,C(OCCC(C(O)=O)(C)O)=O,2,1,0,1,17,5.9e-05
G5,C(C(C(C)OCC=O)O)(O)=O,4,2,0,2,29,0.000117
G5,C(CCCC(C(O)=O)O)=O,2,3,0,3,7,0.000165
G5,C(C(CC(CO)C(C=O)O)O)(O)=O,8,3,0,3,12,0.000164
G5,C(C(CCC(C(CO)=O)O)O)(O)=O,4,3,0,3,20,0.000164
G5,C(C(CO)(C(C=C)O)O)(O)=O,4,5,0,5,33,0.00024900000000000004
G5,C(C(CO)(CCCO)O)(O)=O,2,2,0,2,29,0.000117
G5,C(C(C(CCCO)O)O)(O)=O,4,3,0,3,29,0.000176
G5,C(C(C)(C(CC(O)=O)O)O)(O)=O,4,3,0,3,29,0.000165
G5,C(C(C(C)O)(CC(O)=O)O)(O)=O,4,4,0,4,29,0.000225
G5,C(C(CO)(CCC(O)=O)O)(O)=O,2,3,0,3,29,0.000165
G5,C(CCC(C(C(O)=O)O)O)(O)=O,4,4,0,4,29,0.000223
G5,C(C1(C(COCC1)O)O)(O)=O,4,1,0,1,36,5.9e-05
G5,C(C1(COCCC1O)O)(O)=O,4,1,0,1,36,5.9e-05
G5,C(C(CC(C(CO)CO)O)O)(O)=O,4,3,0,3,29,0.000176
G5,C(C(CCC(CO)O)O)(O)=O,4,3,0,3,29,0.000176
G5,C(C(C=CCCO)O)(O)=O,4,4,0,4,29,0.000223
G5,C(C(C=CCO)(C)O)(O)=O,4,4,0,4,29,0.000212
G5,C(C(C=C)(CCO)O)(O)=O,2,4,0,4,29,0.000212
G5,C(C(CC=CCO)O)(O)=O,4,4,0,4,29,0.000223
G5,C(C(C(O)=O)(CC(CO)O)O)(O)=O,2,3,0,3,29,0.000165
G5,C(C(CCC(C(O)=O)O)O)(O)=O,3,3,0,3,29,0.000176
G5,C(CC=CC(C(O)=O)O)(O)=O,4,4,0,4,29,0.000223
G5,C(C(C=CC(O)=O)(C)O)(O)=O,4,3,0,3,29,0.000165
G5,C(C(C=C)(CC(O)=O)O)(O)=O,2,3,0,3,29,0.000165
G5,C(C(CC=CC(O)=O)O)(O)=O,4,4,0,4,29,0.000223
G5,C(C(CO)(CO)C(C(O)=O)O)(O)=O,2,2,0,2,17,0.000117
G5,C(C(C(CO)(CO)CO)O)(O)=O,2,2,0,2,2,0.000117
G5,C(C(C(CO)(CO)C(C)O)O)(O)=O,4,2,0,2,4,0.000117
G5,C(C(C=O)(CC(C(O)=O)O)O)(O)=O,4,4,0,4,29,0.00022400000000000002
G5,C(C(C(C)(C(CCO)O)O)O)(O)=O,8,4,0,4,18,0.00022400000000000002
G5,C(C(CO)(CCC(C(O)=O)O)O)=O,4,3,0,3,12,0.000166
G5,C(CC(C(O)=O)O)(C(CO)(C)O)=O,4,3,0,3,24,0.000166
G5,C(CCC(CO)(C(C(O)=O)O)O)=O,4,4,0,4,27,0.000213
G5,C(C(C(C=CCO)(CO)O)O)(O)=O,8,4,0,4,29,0.00022400000000000002
G5,C(C(C1(CO)CC(CO1)O)O)(O)=O,8,2,0,2,39,0.000117
G5,C(C(C(C)(C(CO)(C)O)O)O)(O)=O,8,3,0,3,29,0.000176
G5,C(C(C(C)(C(C)O)O)O)(O)=O,8,2,0,2,4,0.000117
G5,C(C(CCOC(CO)=O)O)(O)=O,2,2,0,2,2,0.000117
G5,C(C1(CCC(C1)=O)O)(O)=O,2,3,0,3,29,0.000153
G5,C(C(CO)(C(CO)CO)O)(O)=O,2,2,0,2,29,0.00010800000000000001
G5,C(C(C)C(C(O)=O)(CO)O)=O,4,4,0,4,29,0.00021400000000000002
G5,C(C(CO)CC(C(O)=O)O)=O,4,3,0,3,29,0.000164
G5,C(C(CO)(C(C)C(C=O)O)O)(O)=O,8,1,0,1,42,5.9e-05
G5,C(C(C(C)C(C(CO)=O)O)O)(O)=O,8,2,0,2,5,0.000117
G5,C(C(CO)(C(C)C(CO)O)O)(O)=O,8,1,0,1,42,5.9e-05
G5,C(C(CCO)C(C(O)=O)(CO)O)=O,4,4,0,4,29,0.000225
G5,C(C(CO)C(CO)C(C(O)=O)O)=O,8,2,0,2,55,0.000117
G5,C(C(CO)(C(CO)CCO)O)(O)=O,4,1,0,1,55,5.9e-05
G5,C(C(CO)(C(CO)C)O)(O)=O,4,1,0,1,42,5.9e-05
G5,C(C(C)(C(CO)CO)O)(O)=O,2,2,0,2,29,0.000117
G5,C(C(CO)(CCC(C=O)O)O)(O)=O,4,3,0,3,12,0.000155
G5,C(C(CO)(CC)O)(O)=O,2,1,0,1,42,5.9e-05
G5,C(C(CCC(C(C)=O)=O)O)(O)=O,2,5,0,5,29,0.000271
G5,C(C(CC(C(C=O)=O)C)O)(O)=O,4,3,0,3,29,0.000164
G5,C(C(C(C)CC(C=O)=O)O)(O)=O,4,3,0,3,29,0.000165
G5,C(C(CC(C(CO)=O)C)O)(O)=O,4,3,0,3,29,0.000164
G5,C(C(CC(C(O)=O)O)CCO)=O,4,4,0,4,29,0.000223
G5,C(C(C)C(C(O)=O)(CCO)O)=O,4,2,0,2,29,0.000106
G5,C(C(C)CC(C(O)=O)O)=O,4,3,0,3,29,0.000164
G5,C(C(C)C(C(O)=O)(C)O)=O,4,2,0,2,29,0.000106
G5,C(C(CC(CCC=O)=O)O)(O)=O,2,3,0,3,29,0.000164
G5,C(CCC(C(O)=O)O)(CC=O)=O,2,4,0,4,29,0.000212
G5,C(CCC(C(O)=O)O)(C(C=O)O)=O,4,3,0,3,29,0.000165
G5,C(C(CC(C(O)=O)O)C(CO)O)=O,8,3,0,3,29,0.000176
G5,C(C(C)C(C(O)=O)(C(CO)O)O)=O,8,3,0,3,49,0.000166
G5,C(C(CC(C=O)C(CO)=O)O)(O)=O,4,4,0,4,29,0.00022400000000000002
G5,C(C(C)(C(CO)CC=O)O)(O)=O,4,4,0,4,29,0.000213
G5,C(C(C(C)CC(CO)=O)O)(O)=O,4,3,0,3,52,0.000165
G5,C(C(C(C)C(C(C)=O)O)O)(O)=O,8,2,0,2,28,0.000117
G5,C(C(C)(C(C)C(C=O)O)O)(O)=O,8,1,0,1,0,5.9e-05
G5,C(C(C)(CCC=O)O)(O)=O,2,3,0,3,29,0.000154
G5,C(CC(C)C(C(O)=O)O)=O,4,3,0,3,45,0.000165
G5,C(C(C)(C(C)C(CO)O)O)(O)=O,8,1,0,1,28,5.9e-05
G5,C(C(CC(C=O)O)(CC)O)(O)=O,4,1,0,1,0,5.9e-05
G5,C(C(C(CC(CO)O)=O)(C)O)(O)=O,4,1,0,1,29,5.9e-05
G5,C(C(C(C)=O)(CC(CO)O)O)(O)=O,4,1,0,1,29,5.9e-05
G5,C(C(C=CC(C=O)O)(C)O)(O)=O,8,2,0,2,29,0.000106
G5,C(C(C(CO)CC(C=O)=O)O)(O)=O,4,4,0,4,29,0.00022400000000000002
G5,C(C(C)C(CO)C(C(O)=O)O)=O,8,3,0,3,29,0.000164
G5,C(C(CCO)C(C(O)=O)(C)O)=O,4,3,0,3,29,0.000165
G5,C(C(CCO)(C(CO)C)O)(O)=O,4,1,0,1,2,5.9e-05
G5,C(C(C)(C(CO)CCO)O)(O)=O,4,1,0,1,29,5.9e-05
G5,C(C(CCO)(CC)O)(O)=O,2,1,0,1,27,5.9e-05
G5,C(C(CC(C=O)C(C=O)O)O)(O)=O,8,4,0,4,29,0.00022400000000000002
G5,C(C(C)(C(CO)C)O)(O)=O,4,1,0,1,27,5.9e-05
G5,C(C(C)(CCC(C=O)O)O)(O)=O,4,2,0,2,25,0.000106
G5,C(C(C)(CC)O)(O)=O,2,1,0,1,28,5.9e-05
G5,C(C(C(CO)O)(C(CO)C)O)(O)=O,8,1,0,1,42,5.9e-05
G5,C(C(C(CO)O)(CC)O)(O)=O,4,1,0,1,42,5.9e-05
G5,C(C(CCC(C=O)CC=O)O)(O)=O,4,3,0,3,28,0.000165
G5,C(C(CCC(CC(C)=O)=O)O)(O)=O,2,2,0,2,12,0.000117
G5,C(C(CCC(C(CC)=O)=O)O)(O)=O,2,2,0,2,29,0.000117
G5,C(C(CCC(C=O)=O)(CC)O)(O)=O,2,1,0,1,29,5.9e-05
G5,C(CC(C(O)=O)O)(C(C)CC=O)=O,4,2,0,2,29,0.000117
G5,C(C(C)(C(CC=O)CC=O)O)(O)=O,2,3,0,3,46,0.000155
G5,C(C(C(C)CC=O)(CC=O)O)(O)=O,4,2,0,2,29,0.000106
G5,C(C(CCC=O)(CC(C)=O)O)(O)=O,2,2,0,2,26,0.000106
G5,C(C(C(CC=O)CC(C)=O)O)(O)=O,4,3,0,3,27,0.000166
G5,C(C(CCC=O)(CCC=O)O)(O)=O,1,1,0,1,29,5.9e-05
G5,C(CCC(C(C(O)=O)O)CC=O)=O,4,2,0,2,44,0.000117
G5,C(C(C)(CCC(CC=O)=O)O)(O)=O,2,1,0,1,21,5.9e-05
G5,C(C(C)(CC(CCC=O)=O)O)(O)=O,2,1,0,1,21,5.9e-05
G5,C(CCC(C(O)=O)(C=CCO)O)=O,4,1,0,1,29,5.9e-05
G5,C(C(C(C=CCO)CC=O)O)(O)=O,8,2,0,2,29,0.000117
G5,C(C(C=CC(C=O)O)(CC)O)(O)=O,8,1,0,1,32,5.9e-05
G5,C(CC(CO)C(C(O)=O)O)=O,4,5,0,5,29,0.000271
G5,C(C(C(C)C(C=O)O)O)(O)=O,8,3,0,3,28,0.000164
G5,C(C(C(C)C(CO)O)O)(O)=O,8,2,0,2,28,0.000117
G5,C(C(C(CO)CCO)O)(O)=O,4,3,0,3,29,0.000176
G5,C(C(C(CO)C)O)(O)=O,4,3,0,3,29,0.000176
G5,C(C(CC)O)(O)=O,2,2,0,2,28,0.000117
G5,C(C(C(CCO)=O)(C)O)(O)=O,2,2,0,2,29,0.000106
G5,C(C(C(C)=O)(CCO)O)(O)=O,2,4,0,4,29,0.000213
G5,C(C(C=O)(CCCO)O)(O)=O,2,1,0,1,55,5.9e-05
G5,C(C(CO)(C(C)C(C(O)=O)O)O)=O,8,2,0,2,28,0.000117
G5,C(C(C=O)(CC(C(O)=O)(C)O)O)=O,2,1,0,1,1,5.9e-05
G5,C(C(C=O)(C(C)C(C(O)=O)O)O)=O,4,2,0,2,28,0.000117
G5,C(C(CC(C=O)(C(C)=O)O)O)(O)=O,4,2,0,2,25,0.000117
G5,C(C(C=O)(CC(C(O)=O)O)O)=O,2,2,0,2,1,0.000117
G5,C(C(C(C)C(C(O)=O)O)O)(O)=O,3,2,0,2,28,0.000117
G5,C(C(CC(CO)O)C(C(O)=O)O)=O,8,3,0,3,29,0.000165
G5,C(C(CC(C=O)C(C)=O)O)(O)=O,4,3,0,3,29,0.000164
G5,C(C(C=O)CC(C(O)=O)(C)O)=O,2,2,0,2,29,0.000106
G5,C(C(CC(C(C)=O)C(C)=O)O)(O)=O,2,2,0,2,29,0.000117
G5,C(C(C)(CC(C=O)C(C)=O)O)(O)=O,4,1,0,1,29,5.9e-05
G5,C(C1(C(CO)OCC1)O)(O)=O,4,1,0,1,2,5.9e-05
G5,C(C1(CCOC(C1)=O)O)(O)=O,2,2,0,2,29,0.000106
G5,C(C(CC(C=C)O)O)(O)=O,4,3,0,3,29,0.000164
G5,C(C1(C=COCC1)O)(O)=O,2,2,0,2,29,0.000106
G5,C(C1(C=CCOC1)O)(O)=O,2,2,0,2,29,0.000106
G5,C(C(C1C=CCO1)O)(O)=O,4,3,0,3,39,0.000164
G5,C(C(C1C(CCO1)O)O)(O)=O,8,2,0,2,39,0.000117
G5,C(C1(C(O)OC(CO)C1)O)(O)=O,8,2,0,2,29,0.000106
G5,C(C1(COC(C)(C1)O)O)(O)=O,4,2,0,2,33,0.000106
G5,C(C1(C(C)OC(C1)O)O)(O)=O,8,3,0,3,4,0.000165
G5,C(C1(C(O)OCC(C1)O)O)(O)=O,8,2,0,2,29,0.000106
G5,C(C1(COC(CC1)O)O)(O)=O,4,2,0,2,29,0.000106
G5,C(C)(C(CC(C(O)=O)O)CC=O)=O,4,3,0,3,46,0.000165
G5,C(CC(CC(C(O)=O)O)CC=O)=O,2,4,0,4,4,0.00021400000000000002
G5,C(C(C)(CC(C=O)CC=O)O)(O)=O,4,3,0,3,14,0.000154
G5,C(CC(C(O)=O)O)(CCCC=O)=O,2,4,0,4,27,0.000213
G5,C(C(CCCC=O)(CC=O)O)(O)=O,2,2,0,2,27,0.000106
G5,C(C(C=C(CO)CO)O)(O)=O,2,3,0,3,29,0.000164
G5,C(C(C(CO)=C(CO)CO)O)(O)=O,2,2,0,2,29,0.000117
G5,C(C(C(C(CO)(CO)O)=C)O)(O)=O,2,2,0,2,29,0.000117
G5,C(C(C(CO)=CC(CO)O)O)(O)=O,8,2,0,2,29,0.000117
G5,C(C(C(C(C(CO)O)O)=C)O)(O)=O,8,2,0,2,41,0.000117
G5,C(C(C=C(C=O)C)O)(O)=O,4,3,0,3,29,0.000164
G5,C(C(CC(C=O)=C)O)(O)=O,2,3,0,3,29,0.000164
G5,C(C(C=CCC(CO)=O)O)(O)=O,4,5,0,5,29,0.000271
G5,C(C(CC=CC(CO)=O)O)(O)=O,4,4,0,4,29,0.000223
G5,C(CC(CO)=CC(C(O)=O)O)=O,4,5,0,5,29,0.000271
G5,C(C(CC(CO)=CC=O)O)(O)=O,4,4,0,4,29,0.000223
G5,C(C(C=CC(C(C)=O)O)O)(O)=O,8,5,0,5,29,0.000271
G5,C(C(C=C(C)C(C=O)O)O)(O)=O,8,3,0,3,29,0.000164
G5,C(C(C(CC(C(O)=O)O)=C)O)=O,4,3,0,3,29,0.000164
G5,C(C(C=CC=O)O)(O)=O,4,5,0,5,29,0.000271
G5,C(C(C=C(C)C(CO)O)O)(O)=O,8,3,0,3,29,0.000164
G5,C(C(CC(C(CO)O)=C)O)(O)=O,4,3,0,3,29,0.000164
G5,C(C(C=C(C=O)CCO)O)(O)=O,4,3,0,3,29,0.000164
G5,C(C(CC(C=O)=CCO)O)(O)=O,4,3,0,3,29,0.000164
G5,C(C(C(CO)=CC(C)=O)O)(O)=O,4,3,0,3,29,0.000164
G5,C(C(C(C(C(C)=O)O)=C)O)(O)=O,4,5,0,5,29,0.000271
G5,C(C(C(C(C=O)=C)CO)O)(O)=O,4,3,0,3,29,0.000164
G5,C(C(C(CO)=C(C=O)C)O)(O)=O,4,3,0,3,29,0.000164
G5,C(C(C(C(C(O)=O)O)=C)(C)O)=O,4,4,0,4,29,0.000212
G5,C(C(C=C(CO)CCO)O)(O)=O,4,3,0,3,29,0.000164
G5,C(C(CC(CO)=CCO)O)(O)=O,4,3,0,3,29,0.000164
G5,C(C(C=C(CO)C)O)(O)=O,4,3,0,3,29,0.000164
G5,C(C(CC(CO)=C)O)(O)=O,2,3,0,3,49,0.000164
G5,C(C(C=CC(CC=O)O)O)(O)=O,8,3,0,3,20,0.000164
G5,C(C(C=CCC(C=O)O)O)(O)=O,8,3,0,3,20,0.000164
G5,C(C(C=CCC(C(O)=O)O)O)=O,8,3,0,3,20,0.000164
G5,C(C(C=CC(C(C=O)O)O)O)(O)=O,16,2,0,2,20,0.000117
G5,C(C(C=CC)O)(O)=O,4,3,0,3,29,0.000164
G5,C(C(CC=C)O)(O)=O,2,3,0,3,29,0.000164
G5,C(C(C=C(CO)C(CO)O)O)(O)=O,8,2,0,2,29,0.000117
G5,C(C(C(C(CO)O)=C)(CO)O)(O)=O,4,3,0,3,29,0.000167
G5,C(C(C(CO)=CCO)(CO)O)(O)=O,4,3,0,3,2,0.000167
G5,C(C(C(C(CCO)=O)=C)O)(O)=O,2,3,0,3,29,0.000164
G5,C(C(CC(C(CO)=C)=O)O)(O)=O,2,3,0,3,29,0.000164
G5,C(C(C(CC(CO)=O)=C)O)(O)=O,2,5,0,5,29,0.000271
G5,C(C(CC(C(CO)=O)=C)O)(O)=O,2,3,0,3,29,0.000164
G5,C(CC=C(CO)C(C(O)=O)O)=O,4,3,0,3,29,0.000164
G5,C(C(CC(C(C=O)=C)O)O)(O)=O,4,4,0,4,29,0.000212
G5,C(C(CC=C(C=O)CO)O)(O)=O,4,3,0,3,29,0.000164
G5,C(C(C(C=O)=C)(CCO)O)(O)=O,2,3,0,3,29,0.000153
G5,C(C(C(CO)=C)(CC=O)O)(O)=O,2,4,0,4,29,0.000212
G5,C(C(C(C(C=O)O)=C)(C)O)(O)=O,4,3,0,3,29,0.000153
G5,C(C(C(CO)=CC=O)(C)O)(O)=O,4,3,0,3,29,0.000153
G5,C(C(C=C)(CC(C=O)O)O)(O)=O,4,2,0,2,29,0.000106
G5,C(C(C=C(CO)C(C(O)=O)O)O)=O,8,3,0,3,29,0.000176
G5,C(C(C(C(CO)(C)O)=C)O)(O)=O,4,3,0,3,29,0.000164
G5,C(C(C(CO)=C(CO)C)O)(O)=O,4,3,0,3,29,0.000164
G5,C(C(C(C(CO)=C)CO)O)(O)=O,4,3,0,3,29,0.000164
G5,C(C(C(C(C)O)=C)O)(O)=O,4,3,0,3,4,0.000164
G5,C(C(C(CO)=CC)O)(O)=O,4,3,0,3,29,0.000164
G5,C(C(C(C=C)CO)O)(O)=O,4,3,0,3,29,0.000164
G5,C(C(CC(CCO)=CC=O)O)(O)=O,4,2,0,2,29,0.000117
G5,C(CC(CCO)=CC(C(O)=O)O)=O,4,2,0,2,29,0.000117
G5,C(CC(CC(C(O)=O)O)=CCO)=O,4,2,0,2,29,0.000117
G5,C(CCO)(C(C=C)C(C(O)=O)O)=O,4,2,0,2,29,0.000117
G5,C(C(C(C(CCO)=O)=CC)O)(O)=O,4,2,0,2,29,0.000117
G5,C(CC(C(O)=O)O)(C(C=C)CO)=O,4,2,0,2,29,0.000117
G5,C(C(CC(C(CO)=CC)=O)O)(O)=O,4,2,0,2,29,0.000117
G5,C(C(CC(C(C(C)O)=C)=O)O)(O)=O,4,2,0,2,29,0.000117
G5,C(C(CCC(CO)=CC=O)O)(O)=O,4,2,0,2,29,0.000117
G5,C(CC(CO)=CCC(C(O)=O)O)=O,4,2,0,2,29,0.000117
G5,C(C(C(C=C)CC(CO)=O)O)(O)=O,4,2,0,2,12,0.000117
G5,C(C(C(CC(CO)=O)=CC)O)(O)=O,4,2,0,2,12,0.000117
G5,C(C(CC(C(CO)=O)C=C)O)(O)=O,4,2,0,2,12,0.000117
G5,C(C(CC(C(CO)=O)=CC)O)(O)=O,4,2,0,2,12,0.000117
G5,C(CCC(C(O)=O)O)(C(C=C)O)=O,4,2,0,2,12,0.000117
G5,C(C(CC(C(C)=CC=O)O)O)(O)=O,8,2,0,2,22,0.000117
G5,C(CC(C(CC(C(O)=O)O)O)=C)=O,4,2,0,2,22,0.000117
G5,C(C(C(C=C)C(C(C)=O)O)O)(O)=O,8,2,0,2,45,0.000117
G5,C(C(C(C(C(C)=O)O)=CC)O)(O)=O,8,2,0,2,45,0.000117
G5,C(C(C(C(C)O)=CC(C)=O)O)(O)=O,8,2,0,2,29,0.000117
G5,C(C(CC(C(CC=C)=O)O)O)(O)=O,4,2,0,2,22,0.000117
G5,C(C(CC(C(C=CC)=O)O)O)(O)=O,8,2,0,2,22,0.000117
G5,C(C(CC(CC=CC=O)O)O)(O)=O,8,2,0,2,13,0.000117
G5,C(CC=CC(CC(C(O)=O)O)O)=O,8,2,0,2,13,0.000117
G5,C(CC(C(C=C)C(C(O)=O)O)O)=O,8,2,0,2,29,0.000117
G5,C(C(C(C(CC=O)O)=CC)O)(O)=O,8,2,0,2,29,0.000117
G5,C(CC=C(C(C)O)C(C(O)=O)O)=O,8,2,0,2,29,0.000117
G5,C(C(CC(C(C=O)=CC)O)O)(O)=O,8,2,0,2,29,0.000117
G5,C(C(CC=C(C=O)C(C)O)O)(O)=O,8,2,0,2,29,0.000117
G5,C(C(CCO)(CC=CC=O)O)(O)=O,4,1,0,1,53,5.9e-05
G5,C(C(C=CCC=O)(CCO)O)(O)=O,4,1,0,1,53,5.9e-05
G5,C(C(C(C=O)=CC)(CCO)O)(O)=O,4,1,0,1,4,5.9e-05
G5,C(CC(C(O)=O)(C(C=C)CO)O)=O,4,1,0,1,29,5.9e-05
G5,C(C(C(CO)=CC)(CC=O)O)(O)=O,4,1,0,1,4,5.9e-05
G5,C(C(C(C(C)O)=C)(CC=O)O)(O)=O,4,1,0,1,29,5.9e-05
G5,C(C(C)(C(C=C)C(C=O)O)O)(O)=O,8,1,0,1,29,5.9e-05
G5,C(C(C(C(C=O)O)=CC)(C)O)(O)=O,8,1,0,1,14,5.9e-05
G5,C(C(C(C(C)O)=CC=O)(C)O)(O)=O,8,1,0,1,14,5.9e-05
G5,C(C(CC(C=O)O)(CC=C)O)(O)=O,4,1,0,1,29,5.9e-05
G5,C(C(CC(C(O)=O)(C=CC)O)O)=O,8,1,0,1,29,5.9e-05
G5,C(C(C=CC(C(CO)O)O)O)(O)=O,16,2,0,2,20,0.000117
G5,C(C(C=C(C(C)=O)CO)O)(O)=O,4,3,0,3,29,0.000164
G5,C(C(C=C(C=O)CO)(C)O)(O)=O,4,2,0,2,29,0.000106
G5,C(C(CC(C(C)=O)(C=C)O)O)(O)=O,4,2,0,2,29,0.000117
G5,C(C(C=C(C(C)=O)C(C)O)O)(O)=O,8,2,0,2,29,0.000117
G5,C(C(C=C(C=O)C(C)O)(C)O)(O)=O,8,1,0,1,29,5.9e-05
G5,C(C(C1COC(C)(C1O)O)O)(O)=O,16,3,0,3,45,0.000164
G5,C(C(C1COC(C1(C)O)O)O)(O)=O,16,3,0,3,42,0.000164
G5,C(C(CC1C(CC(O)O1)O)O)(O)=O,16,3,0,3,20,0.000164
G5,C(C(CC1CC(C(O)O1)O)O)(O)=O,16,3,0,3,20,0.000164
G5,C(C(C1COC(C1O)O)O)(O)=O,16,3,0,3,0,0.000164
G5,C(C(C1COC(CO)(C1)O)O)(O)=O,8,3,0,3,12,0.000164
G5,C(C(C)(C1COC(C1O)O)O)(O)=O,16,2,0,2,29,0.000106
G5,C(C(C1CCC(O)O1)O)(O)=O,8,3,0,3,27,0.000164
G5,C(C(C1COC(CC1O)O)O)(O)=O,16,3,0,3,33,0.000164
G5,C(CC(CCC(C(O)=O)O)O)=O,4,2,0,2,7,0.000117
G5,C(C(CO)CCC(C(O)=O)O)=O,4,2,0,2,7,0.000117
G5,C(C(C(C)O)CCC(C(O)=O)O)=O,8,2,0,2,7,0.000117
G5,C(CC(CCCC(C(O)=O)O)O)=O,4,2,0,2,7,0.000117
G5,C(CC(C)(CCC(C(O)=O)O)O)=O,4,2,0,2,7,0.000117
G5,C(C(C)(CCC(C(O)=O)O)O)(O)=O,4,2,0,2,25,0.000117
G5,C(C(CCCC(C(O)=O)O)O)(O)=O,3,2,0,2,7,0.000117
G5,C(C(CCC(C(C=O)=O)O)O)(O)=O,4,2,0,2,20,0.000117
G5,C(C(C=O)CCC(C(O)=O)O)=O,2,2,0,2,45,0.000117
G5,C(C(CCCC(C(O)=O)=O)O)(O)=O,2,4,0,4,7,0.000223
G5,C(C(C)(CCCC(C=O)=O)O)(O)=O,2,2,0,2,14,0.000106
G5,C(C(CCCC(C(C)=O)=O)O)(O)=O,2,2,0,2,14,0.000117
G5,C(C(C)(CCCC(CO)=O)O)(O)=O,2,2,0,2,14,0.000106
G5,C(CCCC(C(O)=O)O)(CC=O)=O,2,2,0,2,7,0.000117
G5,C(C(CCC(C=O)C(C)=O)O)(O)=O,4,2,0,2,7,0.000117
G5,C(C(CCC(C(C=C)=O)O)O)(O)=O,4,2,0,2,7,0.000117
G5,C(C(CCCC(C=O)O)O)(O)=O,4,3,0,3,7,0.000164
G5,C(C(C)(CCC(C(O)=O)O)O)=O,4,2,0,2,29,0.000117
G5,C(C(CCC(C(CO)O)O)O)(O)=O,8,3,0,3,29,0.000176
G5,C(C(CCC(CO)(CO)O)O)(O)=O,2,2,0,2,7,0.000117
G5,C(C(CCCO)O)(O)=O,2,2,0,2,55,0.000117
G5,C(C(CCCCO)O)(O)=O,2,2,0,2,46,0.000117
G5,C(C(CCC(C)O)O)(O)=O,4,2,0,2,27,0.000117
G5,C(CCCC(C(O)=O)O)(O)=O,2,3,0,3,18,0.000165
G5,C(C(CO)(CC(CO)CO)O)(O)=O,2,1,0,1,55,5.9e-05
G5,C(C(C(CO)CC(C)=O)O)(O)=O,4,3,0,3,55,0.000165
G5,C(C(CC(C(C)=O)CO)O)(O)=O,4,2,0,2,55,0.000117
G5,C(CC(CO)CC(C(O)=O)O)=O,4,5,0,5,55,0.000271
G5,C(C(CO)CC(C(O)=O)(C)O)=O,4,1,0,1,55,5.9e-05
G5,C(CC(C(O)=O)O)(CCCO)=O,2,3,0,3,55,0.000165
G5,C(C(CCCO)(CC=O)O)(O)=O,2,1,0,1,55,5.9e-05
G5,C(C(C(CCO)CC(C)=O)O)(O)=O,4,3,0,3,46,0.000165
G5,C(C(C(C(C)O)CC(C)=O)O)(O)=O,8,3,0,3,46,0.000165
G5,C(C(CC(C(C)=O)CCO)O)(O)=O,4,2,0,2,29,0.000117
G5,C(C(CC(C(C)=O)C(C)O)O)(O)=O,8,2,0,2,46,0.000117
G5,C(CC(CC(C(O)=O)O)CCO)=O,4,3,0,3,46,0.000165
G5,C(CC(CC(C(O)=O)O)C(C)O)=O,8,3,0,3,46,0.000165
G5,C(C(CC(C(O)=O)(C)O)CCO)=O,4,1,0,1,29,5.9e-05
G5,C(C(CC(C(O)=O)(C)O)C(C)O)=O,8,1,0,1,46,5.9e-05
G5,C(C(C)(C(CCO)CC=O)O)(O)=O,4,2,0,2,46,0.000106
G5,C(C(C)(C(C(C)O)CC=O)O)(O)=O,8,2,0,2,46,0.000106
G5,C(CC(C(O)=O)O)(CCCCO)=O,2,3,0,3,46,0.000165
G5,C(CC(C(O)=O)O)(CCC(C)O)=O,4,3,0,3,46,0.000165
G5,C(C(CCCCO)(CC=O)O)(O)=O,2,1,0,1,46,5.9e-05
G5,C(C(CCC(C)O)(CC=O)O)(O)=O,4,1,0,1,46,5.9e-05
G5,C(C(CCC(C(C=O)O)O)O)(O)=O,8,3,0,3,29,0.000176
G5,C(C(C=O)(CCC(C(O)=O)O)O)=O,2,2,0,2,29,0.000117
G5,C(C(CCC(C(C)=O)O)O)(O)=O,4,2,0,2,7,0.000117
G5,C(C(CC(CO)C(CO)O)O)(O)=O,8,2,0,2,55,0.000117
G5,C1(CCC(C(C1O)=O)=O)=O,2,1,0,1,29,4.7e-05
G5,C(C(C(C(C(C=O)=O)=O)O)O)=O,4,2,0,2,29,9.499999999999999e-05
G5,C(C(C(C(C(C)O)O)=O)=O)=O,4,4,0,4,29,0.00020099999999999998
G5,C(C(C(C(C=O)=O)C(C)O)=O)=O,2,1,0,1,4,4.7e-05
G5,C(CC(C(CC(C=O)=O)=O)O)=O,2,4,0,4,29,0.00018999999999999998
G5,C(C(C(C(C=O)=O)=O)CO)=O,2,3,0,3,29,0.00014199999999999998
G5,C(C(C(C(C=O)=O)=O)C(C)O)=O,4,3,0,3,29,0.00014199999999999998
G5,C(C(C(C(CO)CO)=O)=O)=O,1,2,0,2,29,9.499999999999999e-05
G5,C(C(C(C(CO)C(C)O)=O)=O)=O,4,2,0,2,29,9.499999999999999e-05
G5,C(C(C(C(C(CO)O)O)=O)=O)=O,4,2,0,2,29,9.499999999999999e-05
G5,C(C(C(C(C(C)=O)=O)O)=O)=O,2,2,0,2,29,9.499999999999999e-05
G5,C(C(C(C=O)=O)=O)=O,1,2,0,2,29,9.499999999999999e-05
G5,C(C(C(C(C=O)=O)O)=O)=O,1,2,0,2,23,9.499999999999999e-05
G5,C(CC(C(C(C=O)=O)=O)O)=O,2,2,0,2,29,9.499999999999999e-05
G5,C(C(C)=O)(C(C(C(C)=O)=O)O)=O,1,1,0,1,25,4.7e-05
G5,C(C(C)=O)(CC(C(CO)=O)=O)=O,1,3,0,3,29,0.00014199999999999998
G5,C(C(C(C(C)=O)=O)=O)=O,1,3,0,3,29,0.00014199999999999998
G5,C(C(CC(C(CO)=O)=O)=O)=O,1,2,0,2,29,9.499999999999999e-05
G5,C(CO)(CC(C(C=O)=O)=O)=O,1,3,0,3,29,0.00014199999999999998
G5,C(C)(C(C(C(C=O)=O)=O)O)=O,2,2,0,2,29,9.499999999999999e-05
G5,C(C(C)O)(C(C(C(C)=O)=O)O)=O,4,3,0,3,29,0.00014199999999999998
G5,C(C(C(C(C)O)=O)=O)=O,2,7,0,7,0,0.000332
G5,C(C(C(C(C=O)=O)=O)O)=O,2,2,0,2,29,9.499999999999999e-05
G5,C(C(C(C(C(C=O)=O)O)=O)O)=O,4,1,0,1,5,4.7e-05
G5,C(C(O)=O)(CC(C(C)=O)=O)=O,1,5,0,5,29,0.00024900000000000004
G5,C(C(CC(C(O)=O)=O)=O)=O,1,3,0,3,29,0.00014199999999999998
G5,C(C(C(C=O)=O)C(C(C)=O)=O)=O,2,2,0,2,29,9.499999999999999e-05
G5,C(C(C)=O)(CC(C(C)=O)=O)=O,1,3,0,3,29,0.00014199999999999998
G5,C1(COC(C1C(C(C)=O)=O)O)=O,4,1,0,1,28,4.7e-05
G5,C1(CC(OC1C(C(C)=O)=O)O)=O,4,1,0,1,28,4.7e-05
G5,C=CC(C(C(C(C)=O)=O)O)=O,2,3,0,3,29,0.00014199999999999998
G5,C1(C(COC1C(C(C)=O)=O)O)=O,4,1,0,1,10,4.7e-05
G5,C1(C(O)OCC1C(C(C)=O)=O)=O,4,1,0,1,34,4.7e-05
G5,C(C(C(C=CC=O)=O)=O)=O,2,1,0,1,17,4.7e-05
G5,C=CC(C(C=O)=O)=O,1,2,0,2,55,9.499999999999999e-05
G5,C(C)(CC(C(C(C=O)=O)=O)=O)=O,1,3,0,3,29,0.00014199999999999998
G5,C(CCC(C(C(C=O)=O)=O)=O)=O,1,3,0,3,29,0.00014199999999999998
G5,C(C(C)=O)(CC(C(C=O)=O)=O)=O,1,2,0,2,29,9.499999999999999e-05
G5,C(CO)=CC(C(C(C=O)=O)=O)=O,2,3,0,3,29,0.00014199999999999998
G5,C(C(C(C(C=O)=O)=O)O)=CC=O,4,2,0,2,29,9.499999999999999e-05
G5,C=CC(C(C(C(C=O)=O)=O)O)=O,2,2,0,2,29,9.499999999999999e-05
G5,C(C(C(C=CC(CO)=O)=O)=O)=O,2,2,0,2,29,9.499999999999999e-05
G5,C(CO)(CCC(C(C=O)=O)=O)=O,1,3,0,3,29,0.00014199999999999998
G5,C(C(CO)O)=CC(C(C=O)=O)=O,4,1,0,1,29,4.7e-05
G5,C(C(C(C(CO)(CO)O)=O)=O)=O,1,2,0,2,29,9.499999999999999e-05
G5,C(C)(C(C(C=O)=O)C(C=O)=O)=O,1,1,0,1,26,4.7e-05
G5,C(CC(C=O)=O)(CC(C=O)=O)=O,1,2,0,2,29,9.499999999999999e-05
G5,C(C(C(C=O)=O)C(C=O)=O)=O,1,1,0,1,33,4.7e-05
G5,C(CC(C(CC(C=O)=O)=O)=O)=O,1,2,0,2,29,9.499999999999999e-05
G5,C1(COC(C1C(C=O)=O)O)=O,4,1,0,1,33,4.7e-05
G5,C1(CC(OC1C(C=O)=O)O)=O,4,1,0,1,33,4.7e-05
G5,C(C(C(C(C=CC=O)=O)O)=O)=O,4,1,0,1,33,4.7e-05
G5,C(C(C(C(C=O)=O)CO)=O)(O)=O,2,2,0,2,29,9.499999999999999e-05
G5,C1(C(COC1C(C=O)=O)O)=O,4,1,0,1,10,4.7e-05
G5,C1(C(O)OCC1C(C=O)=O)=O,4,1,0,1,34,4.7e-05
G5,C(CO)(C(C(C(C)=O)=O)O)=O,2,3,0,3,29,0.00014199999999999998
G5,C(C(C(CO)=O)=O)=O,1,22,0,22,0,0.001044
G5,C(CO)(C(C(C=O)=O)O)=O,2,4,0,4,4,0.00018999999999999998
G5,C(C(CC(C=O)=O)=O)=O,1,7,0,7,0,0.000332
G5,C(C(C(CO)=O)C(C(C)=O)=O)=O,2,3,0,3,29,0.00014199999999999998
G5,C(CC(C(C(C(C)=O)=O)O)=O)=O,2,2,0,2,29,9.499999999999999e-05
G5,C(CC(C(C=O)=O)=O)=O,1,4,0,4,29,0.00018999999999999998
G5,C(C(C(CO)=O)C(C=O)=O)=O,2,3,0,3,29,0.00014199999999999998
G5,C(CC(C(C(C=O)=O)O)=O)=O,2,2,0,2,29,9.499999999999999e-05
G5,C(C(C=O)O)(CC(C(C)=O)=O)=O,2,3,0,3,29,0.00014199999999999998
G5,C(C(C(CC(C=O)=O)=O)O)=O,2,3,0,3,29,0.00014199999999999998
G5,C(C(C(C(C=O)=O)CO)=O)=O,1,2,0,2,29,9.499999999999999e-05
G5,C(C(C(C(CO)O)=O)=O)=O,2,2,0,2,29,9.499999999999999e-05
G5,C(C(CO)O)(C(C(C=O)=O)O)=O,4,3,0,3,0,0.00014199999999999998
G5,C(C(CCC(C(C=O)=O)=O)=O)=O,1,3,0,3,29,0.00014199999999999998
G5,C(CC(CC(C(C=O)=O)=O)=O)=O,1,3,0,3,29,0.00014199999999999998
G5,C(C(C=CC(C(C=O)=O)=O)O)=O,4,2,0,2,29,9.499999999999999e-05
G5,C=CC(C(C(C=O)=O)=O)O,2,3,0,3,29,0.00014199999999999998
G5,C(C(C(CO)=O)=O)(C(CO)O)=O,2,3,0,3,29,0.00014199999999999998
G5,C(CO)(C(C(C=O)=O)(C)O)=O,2,2,0,2,0,9.499999999999999e-05
G5,C(C(C(O)=O)=O)=O,1,39,0,39,17,0.0018620000000000002
G5,C(C)(C(C(C=O)=O)(CO)O)=O,2,6,0,6,2,0.0003
G5,C(COC(C(C=O)=O)O)(C)=O,2,4,0,4,1,0.00018999999999999998
G5,C(COCC(C=O)=O)(CO)=O,1,1,0,1,29,4.7e-05
G5,C(C)(C(O)OCC(C=O)=O)=O,2,1,0,1,29,4.7e-05
G5,C(COC(C(C=O)=O)(C)O)=O,2,1,0,1,29,4.7e-05
G5,C(COC(CC(C=O)=O)O)=O,2,5,0,5,2,0.00023700000000000001
G5,C(C(CC(C(C=O)=O)O)O)(O)=O,4,3,0,3,29,0.000154
G5,C(CCC(C(C=O)=O)=O)(O)=O,1,3,0,3,29,0.000154
G5,C(C(C(C=O)=O)O)=CC(O)=O,4,3,0,3,29,0.000154
G5,C1(C(C(C(CC1)O)=O)=O)=O,2,2,0,2,29,9.499999999999999e-05
G5,C1C(C(C(C(C=1)O)=O)=O)O,3,2,0,2,29,9.499999999999999e-05
G5,C(C(CO)=O)(C(CO)(CO)O)=O,1,3,0,3,0,0.000146
G5,C(C)(C(C(C(CO)=O)=O)O)=O,2,3,0,3,29,0.00014199999999999998
G5,C(C(C(C(CO)=O)=O)(C)O)=O,2,1,0,1,45,4.7e-05
G5,C(C(C(C(C)=O)=O)(CO)O)=O,2,4,0,4,25,0.000205
G5,C(C(C(C(CO)=O)=O)O)=O,2,4,0,4,0,0.00018999999999999998
G5,C(C(C(C=O)=O)(CO)O)=O,2,6,0,6,5,0.0003
G5,C(C(CO)=O)(C(CO)(C)O)=O,2,4,0,4,29,0.00020299999999999997
G5,C(C)(C(C(C(C(C)=O)=O)=O)O)=O,2,1,0,1,0,4.7e-05
G5,C(C(C(C)=O)(C(C(C)=O)=O)O)=O,2,1,0,1,1,4.7e-05
G5,C(C(C(C(C(C)=O)=O)=O)(C)O)=O,2,1,0,1,45,4.7e-05
G5,C(C)(C(C(C(C)=O)=O)(CO)O)=O,2,6,0,6,29,0.0003
G5,C(C(C=O)(C(C(C)=O)=O)O)=O,1,1,0,1,1,4.7e-05
G5,C(C(C(C(C=O)=O)=O)(C)O)=O,2,1,0,1,45,4.7e-05
G5,C(C(C(C(C(C)=O)=O)=O)O)=O,2,3,0,3,29,0.00014199999999999998
G5,C(C(C(C)=O)(C(C=O)=O)O)=O,2,1,0,1,33,4.7e-05
G5,C(C(C(CO)=O)=O)(C)=O,1,7,0,7,0,0.000332
G5,C(C(C(C)=O)=O)(C(CO)(C)O)=O,2,1,0,1,49,4.7e-05
G5,C(C(C(C)=O)=O)(C(C)O)=O,2,4,0,4,29,0.00018999999999999998
G5,C(C(C=O)(C(C=O)=O)O)=O,1,2,0,2,1,9.499999999999999e-05
G5,C(C(C(C=O)=O)(C(C=O)O)O)=O,4,3,0,3,5,0.000144
G5,C(C(C(C(C(C=O)O)=O)=O)O)=O,3,1,0,1,0,4.7e-05
G5,C(CO)(C(C(C=O)=O)(CO)O)=O,2,2,0,2,33,9.499999999999999e-05
G5,C(C)(CC(C(C(CO)=O)=O)=O)=O,1,1,0,1,17,4.7e-05
G5,C(CCC(C(C(CO)=O)=O)=O)=O,1,1,0,1,17,4.7e-05
G5,C(CO)=CC(C(C(CO)=O)=O)=O,2,1,0,1,17,4.7e-05
G5,C=CC(C(C(C(CO)=O)=O)O)=O,2,1,0,1,7,4.7e-05
G5,C=CC(C(C(C=O)=O)(CO)O)=O,2,4,0,4,33,0.000194
G5,C(C(C(C(CO)=O)=O)O)=CC=O,4,1,0,1,43,4.7e-05
G5,C(C)(C(C(C(C(C)O)=O)=O)O)=O,4,1,0,1,4,4.7e-05
G5,C(C)(C(C(C=O)=O)(C(C)O)O)=O,4,3,0,3,0,0.000145
G5,C(C(C(C(CO)(C)O)=O)=O)=O,2,1,0,1,49,4.7e-05
G5,C(C(C(C(C(C)O)=O)=O)O)=O,4,3,0,3,1,0.00014199999999999998
G5,C(C(C(C=O)=O)(C(C)O)O)=O,4,4,0,4,5,0.000204
G5,C(C(C(C)=O)=O)(C(CO)O)=O,2,2,0,2,29,9.499999999999999e-05
G5,C(C(C(C=O)=O)(C(CO)O)O)=O,4,3,0,3,5,0.000144
G5,C(CC(C(C(C(C)=O)O)=O)=O)=O,2,2,0,2,29,9.499999999999999e-05
G5,C(C(C(C(C)=O)=O)(CC=O)O)=O,2,1,0,1,43,4.7e-05
G5,C(C(C(C(CC=O)=O)=O)(C)O)=O,2,1,0,1,11,4.7e-05
G5,C(CC(C(C=O)=O)(CO)O)(O)=O,2,2,0,2,29,0.000106
G5,C(C(C(C=O)=O)(CC=O)O)=O,2,1,0,1,33,4.7e-05
G5,C(CC(C(C(C=O)O)=O)=O)=O,2,3,0,3,29,0.00014199999999999998
G5,C(CO)(CC(C(CO)=O)=O)=O,1,7,0,7,2,0.000332
G5,C(CO)(CC(C(C(C)O)=O)=O)=O,2,3,0,3,29,0.00014199999999999998
G5,C(CC=O)(CC(C(CO)=O)=O)=O,1,4,0,4,29,0.00018999999999999998
G5,C(C(C=CC(CO)=O)=O)(CO)=O,2,2,0,2,29,9.499999999999999e-05
G5,C(C(C(C=O)=O)(CCO)O)(O)=O,2,3,0,3,29,0.000154
G5,C(CO)(OC(C(C=O)=O)CO)=O,2,1,0,1,29,4.7e-05
G5,C(CO)(OCC(C(C=O)=O)O)=O,2,1,0,1,40,4.7e-05
G5,C1C(C(C(C(C=1)=O)=O)O)O,4,2,0,2,29,9.499999999999999e-05
G5,C1C(COC=1C(C=O)=O)O,2,2,0,2,29,9.499999999999999e-05
G5,C1C(C(C=O)=O)(O)OCC=1,2,2,0,2,29,9.499999999999999e-05
G5,C1C(C(C=O)=O)OC(C=1)O,4,2,0,2,29,9.499999999999999e-05
G5,C1OC(C(C=O)=O)C(C=1)O,4,2,0,2,29,9.499999999999999e-05
G5,C(C(C1(C(CCO1)O)O)=O)=O,4,2,0,2,29,9.499999999999999e-05
G5,C(C(C1CC(C(O1)O)O)=O)=O,8,2,0,2,29,9.499999999999999e-05
G5,C1(CC(C(C(C=O)=O)O1)O)=O,4,2,0,2,29,9.499999999999999e-05
G5,C1(C(C(C(C(C1O)O)O)O)=O)=O,10,1,0,1,33,4.7e-05
G5,C1(C(C(C(C(C1)O)O)=O)=O)=O,4,1,0,1,17,4.7e-05
G5,C1(CCC(C(C(C1O)=O)=O)=O)=O,2,1,0,1,12,4.7e-05
G5,C(C1(C(C(C(CC1)=O)=O)=O)O)=O,2,1,0,1,12,4.7e-05
G5,C1(CC(C(C(C(C1)=O)=O)=O)O)=O,2,1,0,1,17,4.7e-05
G5,C1(C(C(C(CC(C1)O)=O)=O)=O)=O,1,1,0,1,9,4.7e-05
G5,C(C1CC(C(C(C1O)=O)=O)=O)=O,4,1,0,1,17,4.7e-05
G5,C1C(C(C(C(C(C=1)=O)=O)=O)O)O,4,1,0,1,32,4.7e-05
G5,C(C(C(C(C(CO)=O)=O)=O)O)=O,2,1,0,1,17,4.7e-05
G5,C(CO)(C(C(C(C=O)=O)=O)O)=O,2,1,0,1,5,4.7e-05
G5,C(C(C(CO)=O)=O)(C(C)O)=O,2,1,0,1,17,4.7e-05
G5,C(CC(C(C(CO)=O)=O)=O)=O,1,2,0,2,29,9.499999999999999e-05
G5,C(CC(C(C(C(C)O)=O)=O)=O)=O,2,1,0,1,17,4.7e-05
G5,C(C(C(C(CCO)=O)=O)=O)=O,1,1,0,1,17,4.7e-05
G5,C(C(C(C(CC(C)O)=O)=O)=O)=O,2,1,0,1,17,4.7e-05
G5,C(CC(C(C(C(C)=O)=O)=O)O)=O,2,1,0,1,45,4.7e-05
G5,C(CC(C(C(C=O)=O)=O)(C)O)=O,2,1,0,1,17,4.7e-05
G5,C(C(C(CO)=O)=O)(CCO)=O,1,3,0,3,29,0.00014199999999999998
G5,C(C(C(CO)=O)=O)(CC(C)O)=O,2,1,0,1,17,4.7e-05
G5,C(C(C(C)=O)=O)(C(CCO)O)=O,2,3,0,3,29,0.00014199999999999998
G5,C(C(C(C)O)=O)(C(CCO)O)=O,4,3,0,3,31,0.00014199999999999998
G5,C(C(C(C(C)O)=O)=O)(CCO)=O,2,1,0,1,4,4.7e-05
G5,C(C(C(C(CC(C)O)O)=O)=O)=O,4,1,0,1,17,4.7e-05
G5,C(C(CO)=O)(C(CC(C)O)O)=O,4,3,0,3,11,0.00014199999999999998
G5,C(C(C(C(C)=O)=O)(C(C)O)O)=O,4,4,0,4,25,0.00020299999999999997
G5,C(C(C(C(CO)=O)=O)=O)=O,1,2,0,2,29,9.499999999999999e-05
G5,C(C(C(C(C=O)=O)(CO)O)=O)=O,1,1,0,1,33,4.7e-05
G5,C(C(C(C(C=O)=O)=O)(CO)O)=O,2,1,0,1,17,4.7e-05
G5,C(C(C(C(CO)=O)=O)(CO)O)=O,2,1,0,1,33,4.7e-05
G5,C(CO)(C(C(C(CO)=O)=O)O)=O,2,1,0,1,5,4.7e-05
G5,C(C(C(C(CO)=O)=O)=O)(C)=O,1,1,0,1,17,4.7e-05
G5,C(CC(C(C(CO)=O)=O)O)=O,2,6,0,6,43,0.000285
G5,C(CC(C(C(C(C)O)=O)=O)O)=O,4,3,0,3,9,0.00014199999999999998
G5,C(C(C(CO)=O)(C(C=O)=O)O)=O,2,1,0,1,33,4.7e-05
G5,C(C(C=O)(C(C(C)=O)=O)O)(O)=O,2,3,0,3,25,0.000144
G5,C(C(C(C(C=O)=O)=O)(C)O)(O)=O,2,1,0,1,17,4.7e-05
G5,C1(C(C(C(C)=O)=O)C(CO1)O)=O,4,3,0,3,29,0.00014199999999999998
G5,C(C(C(C(C)=O)=O)(CO)O)(O)=O,2,7,0,7,17,0.000349
G5,C(C(C(C(CO)=O)=O)(C)O)(O)=O,2,3,0,3,17,0.000143
G5,C1(COCC1(C(C(C)=O)=O)O)=O,2,1,0,1,10,4.7e-05
G5,C(C(C(C(C)=O)=O)=O)(O)=O,1,2,0,2,17,9.499999999999999e-05
G5,C(C)(C(C(C(C(O)=O)=O)=O)O)=O,2,1,0,1,17,4.7e-05
G5,C(C(C(C(C(C)=O)=O)=O)O)(O)=O,2,1,0,1,33,4.7e-05
G5,C(C(C(C)=O)(C(C=O)=O)O)(O)=O,2,3,0,3,0,0.000144
G5,C(C(C(C(O)=O)=O)=O)=O,1,2,0,2,17,9.499999999999999e-05
G5,C(C(C(C(C(O)=O)=O)=O)O)=O,2,1,0,1,17,4.7e-05
G5,C(C(C(C(C=O)=O)=O)O)(O)=O,2,1,0,1,33,4.7e-05
G5,C(C(C=O)(C(C=O)=O)O)(O)=O,2,3,0,3,5,0.000144
G5,C1(C(C(C(CO1)O)=O)=O)=O,2,1,0,1,17,4.7e-05
G5,C(C(C(C(C(C)O)=O)=O)=O)=O,2,1,0,1,17,4.7e-05
G5,C=CC(C(C(C(CO)=O)=O)=O)=O,1,1,0,1,32,4.7e-05
G5,C=CC(C(C(C(C=O)=O)=O)=O)O,2,1,0,1,17,4.7e-05
G5,C(C(C(C(C)=O)=O)=O)(CCO)=O,1,1,0,1,9,4.7e-05
G5,C(C(C(C(CCCO)=O)=O)=O)=O,1,1,0,1,29,4.7e-05
G5,C=CC(C(C(C(CO)O)=O)=O)=O,2,1,0,1,17,4.7e-05
G5,C(C(C(C(C=O)=O)=O)O)=CCO,4,1,0,1,17,4.7e-05
G5,C(C(C(CO)=O)=O)(O)=O,1,4,0,4,17,0.00018999999999999998
G5,C(C(C=O)(C(C(C=O)=O)=O)O)=O,1,1,0,1,17,4.7e-05
G5,C(C(C(C(C(O)=O)=O)=O)(C)O)=O,2,1,0,1,17,4.7e-05
G5,C(C(C(C(CO)(C)O)=O)=O)(O)=O,2,1,0,1,17,4.7e-05
G5,C(C(C(C(C)O)=O)=O)(O)=O,2,1,0,1,17,4.7e-05
G5,C1(C(C(C(CC1CO)=O)=O)=O)=O,2,1,0,1,17,4.7e-05
G5,C(C)(C1C(C(C(CO1)=O)=O)=O)=O,2,1,0,1,17,4.7e-05
G5,C(CC1C(C(C(CO1)=O)=O)=O)=O,2,2,0,2,29,9.499999999999999e-05
G5,C1(CCC(C(C(CO1)=O)=O)=O)=O,1,1,0,1,17,4.7e-05
G5,C1(COCC(C(C(C1)=O)=O)=O)=O,1,2,0,2,29,9.499999999999999e-05
G5,C1(C(C(C(COCC1)=O)=O)=O)=O,1,1,0,1,36,4.7e-05
G5,C1(C(C(COC1)=O)=O)=O,1,1,0,1,17,4.7e-05
G5,C(C1C(C(C(C(C)O1)=O)=O)=O)=O,4,1,0,1,29,4.7e-05
G5,C1C(C(C(C(C=1CO)=O)=O)=O)O,2,1,0,1,17,4.7e-05
G5,C=C1C(C(C(C(C1O)O)=O)=O)=O,4,1,0,1,17,4.7e-05
G5,C=CC(C(C(C(C=O)=O)=O)O)O,4,1,0,1,28,4.7e-05
G5,C1OC(C(C(C(C=1)=O)=O)=O)CO,2,1,0,1,9,4.7e-05
G5,C1OCC(C(C(C(C=1)=O)=O)=O)O,2,1,0,1,38,4.7e-05
G5,C1COC(C(C(C(C=1)=O)=O)=O)O,2,1,0,1,19,4.7e-05
G5,C1C(O)OCC(C(C(C=1)=O)=O)=O,2,1,0,1,38,4.7e-05
G5,C1C(COC=1C(C(C=O)=O)=O)O,2,1,0,1,36,4.7e-05
G5,C1C(C(C(C=O)=O)=O)(O)OCC=1,2,1,0,1,17,4.7e-05
G5,C1C(C(C(C=O)=O)=O)OC(C=1)O,4,1,0,1,43,4.7e-05
G5,C1OC(C(C(C=O)=O)=O)C(C=1)O,4,1,0,1,36,4.7e-05
G5,C(C(C(C)=O)=O)(C(C(C)O)O)=O,4,1,0,1,11,4.7e-05
G5,C1(C(C(C=O)=O)(C(CO1)O)O)=O,4,1,0,1,33,4.7e-05
G5,C1(C(C(C=O)=O)C(CO1)O)=O,4,3,0,3,29,0.00014199999999999998
G5,C(C(C(C=O)=O)(C(C)O)O)(O)=O,4,6,0,6,17,0.0003
G5,C1(COCC1(C(C=O)=O)O)=O,2,1,0,1,10,4.7e-05
G5,C(C)(C(C(C(C=O)=O)=O)(C)O)=O,2,1,0,1,17,4.7e-05
G5,C(C)(CC(C(C(C=O)=O)=O)O)=O,2,1,0,1,17,4.7e-05
G5,C(C(C=C)(C(C(C=O)=O)=O)O)=O,2,1,0,1,17,4.7e-05
G5,C=CC(C(C(C=O)=O)=O)(CO)O,2,1,0,1,17,4.7e-05
G5,C(C)(C(C(C(CO)=O)=O)(C)O)=O,2,1,0,1,14,4.7e-05
G5,C(CC(C(C(CO)=O)=O)(C)O)=O,2,1,0,1,33,4.7e-05
G5,C(C)(CC(C(C(CO)=O)=O)O)=O,2,2,0,2,5,9.499999999999999e-05
G5,C(C(C=C)(C(C(CO)=O)=O)O)=O,2,1,0,1,7,4.7e-05
G5,C=CC(C(C(CO)=O)=O)(CO)O,2,4,0,4,29,0.000192
G5,C(C(C(C(C(C)O)=O)=O)(C)O)=O,4,1,0,1,4,4.7e-05
G5,C(C(C(C)O)=O)(C(CO)(C)O)=O,4,1,0,1,49,4.7e-05
G5,C(C(C(C)O)=O)(C(C)O)=O,3,3,0,3,29,0.000153
G5,C(C(C(CO)=O)=O)(CO)=O,1,1,0,1,2,4.7e-05
G5,C(C(C(C(CO)O)=O)=O)(O)=O,2,1,0,1,17,4.7e-05
G5,C(CC(C(C(C(C)=O)=O)=O)=O)=O,1,3,0,3,29,0.00014199999999999998
G5,C(C=CC(C(C(CO)=O)=O)=O)=O,2,2,0,2,29,9.499999999999999e-05
G5,C(C(C(C(C(C=C)=O)=O)=O)O)=O,2,2,0,2,29,9.499999999999999e-05
G5,C1(CC(C(C(C1CO)=O)=O)=O)=O,2,2,0,2,29,9.499999999999999e-05
G5,C1(C(CC(C(C(C1)=O)=O)=O)O)=O,2,1,0,1,17,4.7e-05
G5,C(C1(CC(C(C(C1)=O)=O)=O)O)=O,1,1,0,1,17,4.7e-05
G5,C(C1C(C(C(CC1O)=O)=O)=O)=O,4,2,0,2,29,9.499999999999999e-05
G5,C(C(CC(C(C=O)=O)=O)=O)=O,1,1,0,1,29,4.7e-05
G5,C(CO)(CC(C(C(C)=O)=O)=O)=O,1,2,0,2,29,9.499999999999999e-05
G5,C(CC(C(C(C)=O)=O)=O)=O,1,3,0,3,29,0.00014199999999999998
G5,C(CC(C(C)=O)(C(C=O)=O)O)=O,2,1,0,1,45,4.7e-05
G5,C(CC(C(C(CCO)=O)=O)=O)=O,1,2,0,2,29,9.499999999999999e-05
G5,C(C(C)=O)(C(CC(C)O)O)=O,4,1,0,1,25,4.7e-05
G5,C(C(C)=O)(C(CC(CO)O)O)=O,4,4,0,4,29,0.00020099999999999998
G5,C(CO)(C(C(C(C)=O)=O)(C)O)=O,2,1,0,1,25,4.7e-05
G5,C(C(C)=O)(C(CO)(C(C)O)O)=O,4,8,0,8,4,0.000408
G5,C(C(C(C(C)=O)=O)(C)O)(O)=O,2,2,0,2,25,9.6e-05
G5,C(C(C(C)=O)=O)(O)=O,1,14,0,14,0,0.000676
G5,C(C)(C(C(C(C)=O)=O)(C)O)=O,2,1,0,1,25,4.7e-05
G5,C(CC(C(C(C)=O)=O)(C)O)=O,2,1,0,1,25,4.7e-05
G5,C(C(C)=O)(C1(COC(C1)O)O)=O,4,3,0,3,29,0.00014199999999999998
G5,C(C(C=C)(C(C(C)=O)=O)O)=O,2,1,0,1,28,4.7e-05
G5,C=CC(C(C(C)=O)=O)(CO)O,2,1,0,1,29,4.7e-05
G5,C(C(C(C(C)=O)=O)O)=CC=O,4,4,0,4,29,0.00018999999999999998
G5,C(C(C)=O)(C1(COCC1O)O)=O,4,1,0,1,25,4.7e-05
G5,C(C(C)=O)(C1(C(O)OCC1)O)=O,4,1,0,1,25,4.7e-05
G5,C(C(C(CCO)=O)=O)(O)=O,1,3,0,3,17,0.00014199999999999998
G5,C(C(C(C(C(C)=O)=O)(C)O)=O)=O,2,1,0,1,25,4.7e-05
G5,C(C(C(C(C=O)=O)(C)O)=O)=O,1,1,0,1,33,4.7e-05
G5,C(CC(C(C(CC=O)O)=O)=O)=O,2,3,0,3,29,0.00014199999999999998
G5,C(C(C(C(C)=O)=O)(CCO)O)=O,2,2,0,2,29,9.499999999999999e-05
G5,C(C(C(C(C)=O)=O)(C)O)=O,2,4,0,4,29,0.00018999999999999998
G5,C1(CCOC1(C(C(C)=O)=O)O)=O,2,1,0,1,28,4.7e-05
G5,C(CO)(CC(C(C(O)=O)=O)=O)=O,1,1,0,1,17,4.7e-05
G5,C(C(CC(C(C(C)=O)=O)=O)=O)=O,1,2,0,2,29,9.499999999999999e-05
G5,C(CC(C(C(O)=O)=O)=O)=O,1,2,0,2,17,9.499999999999999e-05
G5,C(C)(C1CC(C(C(O1)=O)=O)=O)=O,2,1,0,1,22,4.7e-05
G5,C(CC1CC(C(C(O1)=O)=O)=O)=O,2,1,0,1,17,4.7e-05
G5,C1(CC(C(C(CCO1)=O)=O)=O)=O,1,1,0,1,19,4.7e-05
G5,C1(CCOC(C(C(C1)=O)=O)=O)=O,1,1,0,1,17,4.7e-05
G5,C1(COC(C(C(CC1)=O)=O)=O)=O,1,1,0,1,12,4.7e-05
G5,C1(C(C(OCC1)=O)=O)=O,1,1,0,1,17,4.7e-05
G5,C1C(CO)OC(C(C(C=1)=O)=O)=O,2,1,0,1,46,4.7e-05
G5,C1C(COC(C(C(C=1)=O)=O)=O)O,2,1,0,1,41,4.7e-05
G5,C(C(C(C=O)=O)(CC(O)=O)O)=O,2,1,0,1,33,4.7e-05
G5,C(C(C(C=O)=O)(CC=O)O)(O)=O,2,1,0,1,33,4.7e-05
G5,C1(CCOC1(C(C=O)=O)O)=O,2,1,0,1,34,4.7e-05
G5,C(C(C(C(CCO)=O)=O)(C)O)=O,2,4,0,4,29,0.00020099999999999998
G5,C(C(C)=O)(C(CO)(CO)O)=O,1,6,0,6,2,0.0003
G5,C(C(C(C(C(C)=O)=O)(C)O)O)=O,4,4,0,4,29,0.000202
G5,C(C(C)=O)(C(C)(C(CO)O)O)=O,4,3,0,3,29,0.000143
G5,C(C(CO)O)=CC(C(CO)=O)=O,4,3,0,3,29,0.00014199999999999998
G5,C(C(C)=O)(C(CO)(CCO)O)=O,2,5,0,5,29,0.000262
G5,C(C(C)=O)(C(CO)(C)O)=O,2,5,0,5,29,0.00025
G5,C(C(CCO)=O)(C(CO)(C)O)=O,2,6,0,6,29,0.000309
G5,C(C(C(C=O)=O)(CC(C)O)O)=O,4,1,0,1,33,4.7e-05
G5,C(C(C(CO)(CC(C)O)O)=O)=O,4,2,0,2,33,9.7e-05
G5,C(C(C(C=O)=O)O)(CC(C)=O)=O,2,2,0,2,29,9.499999999999999e-05
G5,C(C(C(C=O)=O)(CC(C)=O)O)=O,2,1,0,1,27,4.7e-05
G5,C(CC=O)(C(C(C=O)=O)(C)O)=O,2,2,0,2,29,9.499999999999999e-05
G5,C(C)(C(C(C=O)=O)(C)O)=O,2,5,0,5,4,0.00023700000000000001
G5,C(C(C1(COC(C1)O)O)=O)=O,4,2,0,2,33,9.499999999999999e-05
G5,C(C(C(C=O)=O)O)=CC(CO)=O,4,2,0,2,29,9.499999999999999e-05
G5,C(C(C(C=O)=O)(CO)O)=CC=O,4,3,0,3,11,0.000144
G5,C(C(C=C)(C(C=O)=O)O)=O,2,3,0,3,28,0.00014199999999999998
G5,C=CC(C(C=O)=O)(CO)O,2,4,0,4,29,0.00018999999999999998
G5,C(C(C1(COCC1O)O)=O)=O,4,1,0,1,33,4.7e-05
G5,C(C(C1(C(O)OCC1)O)=O)=O,4,2,0,2,29,9.499999999999999e-05
G5,C(CC(C(C(CC=O)=O)=O)=O)=O,1,1,0,1,17,4.7e-05
G5,C(C(C(C(C=O)=O)C)=O)=O,1,2,0,2,29,9.499999999999999e-05
G5,C(CO)(C(C(C=O)=O)C)=O,2,6,0,6,42,0.000285
G5,C=C(C=O)C(C=O)=O,1,14,0,14,0,0.000664
G5,C(CO)=C(C=O)C(C=O)=O,2,3,0,3,29,0.00014199999999999998
G5,C1(C(C(CO)OC(C1O)O)=O)=O,8,2,0,2,0,9.499999999999999e-05
G5,C(C(C1C(C(C(O1)O)O)O)=O)=O,16,2,0,2,29,9.499999999999999e-05
G5,C1(C(C(COC(C1O)O)O)=O)=O,8,2,0,2,15,9.499999999999999e-05
G5,C(C(C(C(C=O)=O)=O)CC=O)=O,2,2,0,2,29,9.499999999999999e-05
G5,C(C(CCC(C(CO)=O)=O)=O)=O,1,4,0,4,29,0.00018999999999999998
G5,C(C(C(C(CO)=O)=O)CC=O)=O,2,3,0,3,29,0.00014199999999999998
G5,C(C(C(CC(CO)CO)=O)=O)=O,1,3,0,3,29,0.000143
G5,C(CCCO)(C(C(C=O)=O)O)=O,2,3,0,3,29,0.000143
G5,C(CC(C(CO)=O)C(C=O)=O)=O,2,2,0,2,29,9.499999999999999e-05
G5,C(C(C=O)C(CO)CC(CO)=O)=O,2,5,0,5,11,0.00024900000000000004
G5,C(C(C(C)=O)(C)O)=O,2,9,0,9,11,0.00042699999999999997
G5,C(C)(C(C)O)=O,2,55,0,55,14,0.0026100000000000003
G5,C(C1(COCC1O)O)=O,4,1,0,1,10,4.7e-05
G5,C(C1(C(O)OCC1)O)=O,4,1,0,1,34,4.7e-05
G5,C(C(C(C(C=O)O)=O)O)=O,3,2,0,2,5,9.499999999999999e-05
G5,C(C1C(COC1O)=O)=O,4,6,0,6,35,0.000285
G5,C(C1C(CC(O1)O)=O)=O,4,7,0,7,35,0.000332
G5,C(CC(C=CC(C=O)=O)=O)=O,2,4,0,4,29,0.00018999999999999998
G5,C(C(C=O)C=CC(C=O)=O)=O,2,3,0,3,45,0.00014199999999999998
G5,C(CC(C(C=CC=O)=O)=O)=O,2,5,0,5,29,0.00023700000000000001
G5,C(C(C=O)C(C=CC=O)=O)=O,2,5,0,5,29,0.00023700000000000001
G5,C=CC(C)=O,1,7,0,7,45,0.000332
G5,C(C(C=O)C(C=C)=O)=O,1,2,0,2,45,9.499999999999999e-05
G5,C(C(C(C=O)=O)C(C=C)=O)=O,2,1,0,1,45,4.7e-05
G5,C=CC(C(C)=O)=O,1,19,0,19,0,0.0009019999999999999
G5,C(C(C=O)C(C(C=C)=O)=O)=O,1,4,0,4,4,0.00018999999999999998
G5,C(C(C=CC=O)C(C=O)=O)=O,4,2,0,2,27,9.499999999999999e-05
G5,C(C1C(C(CO1)O)=O)=O,4,4,0,4,10,0.00018999999999999998
G5,C(C1C(C(O)OC1)=O)=O,4,6,0,6,34,0.000285
G5,C(C)(C1C(COC1O)=O)=O,4,4,0,4,29,0.00018999999999999998
G5,C(C)(C1C(C(O)OC1)=O)=O,4,5,0,5,2,0.00023700000000000001
G5,C(C(C=CC(C)=O)O)=O,4,6,0,6,45,0.000285
G5,C(C=CC(C(C)O)=O)=O,4,4,0,4,45,0.00018999999999999998
G5,C(C(C(C(C=C)=O)=O)O)=O,2,3,0,3,0,0.00014199999999999998
G5,C(C(C=O)(C)O)=O,1,17,0,17,11,0.000807
G5,C(C(CC(C=CC=O)=O)=O)=O,2,6,0,6,29,0.000285
G5,C=CC(C(CC(C=O)=O)=O)=O,1,2,0,2,45,9.499999999999999e-05
G5,C(CO)(CC(C(O)=O)=O)=O,1,6,0,6,29,0.000296
G5,C(C(C=O)(CCO)O)=O,1,7,0,7,29,0.00035499999999999996
G5,C(CC(C=C)=O)=O,1,14,0,14,7,0.000664
G5,C(CC(CCCO)=O)=O,1,5,0,5,29,0.00024900000000000004
G5,C(CC(OCC(C)=O)O)(CC=O)=O,2,3,0,3,9,0.00014199999999999998
G5,C(C)(C(CO)OCC(CC=O)=O)=O,2,1,0,1,54,4.7e-05
G5,C(C(CO)OCC(C)=O)(CC=O)=O,2,1,0,1,54,4.7e-05
G5,C(C)(C(COCC(CC=O)=O)O)=O,2,1,0,1,36,4.7e-05
G5,C(C(COCC(C)=O)O)(CC=O)=O,2,1,0,1,36,4.7e-05
G5,C(CO)(CCOCC(CC=O)=O)=O,1,2,0,2,36,9.499999999999999e-05
G5,C(CCOCC(CO)=O)(CC=O)=O,1,2,0,2,36,9.499999999999999e-05
G5,C(C)(CCOC(C(CC=O)=O)O)=O,2,1,0,1,23,4.7e-05
G5,C(CCOC(C(C)=O)O)(CC=O)=O,2,1,0,1,30,4.7e-05
G5,C(C)(CC(OCC(CC=O)=O)O)=O,2,3,0,3,6,0.00014199999999999998
G5,C1(COC(C)(C1)O)=O,2,8,0,8,26,0.00037999999999999997
G5,C(CC(C)(OCC=O)O)(CC=O)=O,2,2,0,2,4,9.499999999999999e-05
G5,C1(COC(CC1)O)=O,2,8,0,8,37,0.00037999999999999997
G5,C(CCC(OCC=O)O)(CC=O)=O,2,2,0,2,29,9.499999999999999e-05
G5,C(CC(OCC(C=O)=O)O)=O,2,2,0,2,5,9.499999999999999e-05
G5,C(OCC(CO)=O)=O,1,3,0,3,5,0.00014199999999999998
G5,C(CO)(OCC(C)=O)=O,1,6,0,6,2,0.000285
G5,C(COCC=O)=O,1,2,0,2,37,9.499999999999999e-05
G5,C(COC(C(C)=O)=O)=O,1,2,0,2,50,9.499999999999999e-05
G5,C(COC(C=O)=O)(C)=O,1,3,0,3,2,0.00014199999999999998
G5,C(COC(C(CO)=O)O)=O,2,2,0,2,29,9.499999999999999e-05
G5,C(COC(C=O)O)=O,2,4,0,4,15,0.00018999999999999998
G5,C(C(C(C(CO)CO)O)=O)=O,2,3,0,3,30,0.000153
G5,C(CO)(C(C(CO)CO)O)=O,2,6,0,6,49,0.00031800000000000003
G5,C1(COC(C(CO)C1O)O)=O,8,3,0,3,2,0.00014199999999999998
G5,C(CO)(C(C(CO)OCC=O)O)=O,4,2,0,2,36,9.499999999999999e-05
G5,C(OCC(CO)C(C(CO)=O)O)=O,4,2,0,2,30,9.499999999999999e-05
G5,C(C(COCC=O)O)=O,2,3,0,3,2,0.00014199999999999998
G5,C(C(C)O)(OCC=O)=O,2,3,0,3,2,0.00014199999999999998
G5,C(OCC(C(C)O)=O)=O,2,2,0,2,2,9.499999999999999e-05
G5,C(CCOC(C(CO)=O)O)=O,2,4,0,4,2,0.00018999999999999998
G5,C=CC(C(C=O)=O)O,2,4,0,4,29,0.00018999999999999998
G5,C(CCCO)=O,1,11,0,11,5,0.000545
G5,C(CCC(C=O)=O)(O)=O,1,3,0,3,29,0.000154
G5,C(CCC(O)=O)=O,1,3,0,3,29,0.000154
G5,C(C(CO)(CO)C(C(CO)=O)O)=O,2,4,0,4,30,0.000192
G5,C(CO)(OCC(CO)=O)=O,1,3,0,3,50,0.00014199999999999998
G5,C1(C(C(CC1)O)=O)=O,2,6,0,6,20,0.000285
G5,C(COCCC(C=O)=O)=O,1,4,0,4,37,0.00018999999999999998
G5,C(CCOCC(C=O)=O)=O,1,3,0,3,39,0.00014199999999999998
G5,C1(C(O)OCCC1O)=O,4,4,0,4,2,0.00018999999999999998
G5,C1(CC(C(CO1)=O)O)=O,2,4,0,4,2,0.00018999999999999998
G5,C1(COC=CC1O)=O,2,3,0,3,2,0.00014199999999999998
G5,C(COC=CC=O)(CO)=O,2,5,0,5,38,0.00023700000000000001
G5,C(OC(C(CO)=O)C(CO)O)=O,4,2,0,2,5,9.499999999999999e-05
G5,C(OC(CO)C(C(CO)=O)O)=O,4,2,0,2,5,9.499999999999999e-05
G5,C(C)(OCC(C(CO)=O)O)=O,2,2,0,2,2,9.499999999999999e-05
G5,C(OC(C)C(C(CO)=O)O)=O,4,2,0,2,2,9.499999999999999e-05
G5,C(CO)(C(C(OCC=O)O)O)=O,4,2,0,2,5,9.499999999999999e-05
G5,C(CC=O)(OCC(CO)=O)=O,1,4,0,4,2,0.00018999999999999998
G5,C(CC(CO)CC=O)=O,1,4,0,4,55,0.00020299999999999997
G5,C(C(CCO)O)(CC(C)=O)=O,2,3,0,3,29,0.000154
G5,C(CCC=O)(CCO)=O,1,5,0,5,29,0.00024900000000000004
G5,C(C)(C(C)(CCO)O)=O,2,3,0,3,29,0.000154
G5,C(CO)=CC(CCO)=O,2,7,0,7,0,0.00035499999999999996
G5,C(C(CCO)O)=CC(CO)=O,4,4,0,4,2,0.00020099999999999998
G5,C(C(C=C)(CCO)O)=O,2,5,0,5,0,0.00024900000000000004
G5,C(C(CCO)O)=CC=O,4,5,0,5,29,0.00024900000000000004
G5,C(COC(CO)O)(C)=O,2,3,0,3,2,0.000154
G5,C(OCCO)=O,1,4,0,4,29,0.00020099999999999998
G5,C(CO)(OCCO)=O,1,2,0,2,29,0.000106
G5,C(C)(OCCO)=O,1,3,0,3,29,0.000154
G5,C(CCC(CO)=O)(O)=O,1,6,0,6,29,0.000296
G5,C(C)(C(C(C)=O)(C(C)O)O)=O,2,4,0,4,49,0.000192
G5,C(OC(C(C)=O)CCO)=O,2,2,0,2,17,0.000106
G5,C(CCO)(OCC(C)=O)=O,1,3,0,3,29,0.000154
G5,C(CC(CO)OCC=O)=O,2,3,0,3,29,0.000154
G5,C(C)(C(CO)OC(C)=O)=O,2,3,0,3,29,0.000154
G5,C(C)(CCOC(CO)=O)=O,1,2,0,2,30,0.000106
G5,C(OC(CO)CC(C)=O)=O,2,2,0,2,37,0.000106
G5,C(CC(CO)CC(CO)=O)=O,2,10,0,10,29,0.0005
G5,C(C)(C(C(C(O)=O)=O)O)=O,2,4,0,4,29,0.00020099999999999998
G5,C(C(C(C(O)=O)=O)O)=O,2,6,0,6,0,0.000296
G5,C(C(O)OCC(C)=O)(O)=O,2,3,0,3,29,0.000154
G5,C(OCC(O)=O)=O,1,4,0,4,29,0.00020099999999999998
G5,C(CO)(OCC(O)=O)=O,1,3,0,3,29,0.000154
G5,C(C)(OCC(O)=O)=O,1,3,0,3,29,0.000154
G5,C(C(C(C(O)=O)=O)(C)O)=O,2,2,0,2,11,0.000106
G5,C(C(C(CO)(C)O)=O)(O)=O,2,4,0,4,29,0.00021400000000000002
G5,C(OC(C(C)=O)CC(O)=O)=O,2,2,0,2,29,0.000106
G5,C(CC(O)=O)(OCC(C)=O)=O,1,3,0,3,29,0.000154
G5,C(C(CC=O)OCC=O)(O)=O,2,3,0,3,29,0.000154
G5,C(C(C(C)=O)OC(C)=O)(O)=O,2,2,0,2,26,0.000106
G5,C(C)(CCOC(C(O)=O)=O)=O,1,2,0,2,2,0.000106
G5,C(OC(C(O)=O)CC(C)=O)=O,2,2,0,2,2,0.000106
G5,C(C(C=O)(CO)C(C(C)=O)O)=O,2,3,0,3,23,0.000145
G5,C(C(C(C(C)=O)=O)(CO)CO)=O,1,2,0,2,2,9.7e-05
G5,C(C(C=O)(CO)CC(CO)=O)=O,1,3,0,3,2,0.000144
G5,C(C)(C(C=O)(CO)C(C=O)O)=O,4,4,0,4,2,0.000192
G5,C(CCC(C(C(C)O)=O)=O)(CO)=O,2,3,0,3,12,0.00014199999999999998
G5,C(C(CCC(C(C(C)O)=O)=O)O)=O,4,3,0,3,12,0.000143
G5,C(C(C=O)(C(C)O)C(C(C)=O)O)=O,4,3,0,3,4,0.000144
G5,C(C(C(C(C)=O)=O)(CO)C(C)O)=O,4,3,0,3,4,0.000146
G5,C(C(C=O)(C(C)O)CC(CO)=O)=O,2,3,0,3,46,0.000144
G5,C(C)(C(C=O)(C(C)O)C(C=O)O)=O,8,3,0,3,4,0.000144
G5,C1(C(C(CCC1)O)=O)=O,2,3,0,3,7,0.00014199999999999998
G5,C(CO)(CCC(C(C(O)=O)=O)=O)=O,1,3,0,3,12,0.00014199999999999998
G5,C(C(CCC(C(C(O)=O)=O)=O)O)=O,2,2,0,2,12,9.499999999999999e-05
G5,C(C(C=O)(C=O)C(C(C)=O)O)(O)=O,2,3,0,3,17,0.000144
G5,C(C(C=O)(C(C(C)=O)=O)CO)(O)=O,2,3,0,3,17,0.000145
G5,C(C(C=O)(C=O)CC(CO)=O)(O)=O,1,3,0,3,17,0.000143
G5,C(C(C=O)(C(C)=O)C(C=O)O)(O)=O,4,3,0,3,17,0.000144
G5,C1(C(COC1)=O)=O,1,21,0,21,10,0.000997
G5,C1(C(C=O)(C(CO1)O)O)=O,4,2,0,2,40,9.499999999999999e-05
G5,C1(C(C=O)C(CO1)O)=O,4,7,0,7,8,0.000332
G5,C(C1(C(COC1)=O)O)=O,2,5,0,5,10,0.00023700000000000001
G5,C(C(C(O)=O)=O)(O)=O,1,8,0,8,17,0.00037999999999999997
G5,C(C(C(C)=O)(C(C)=O)O)(O)=O,1,5,0,5,49,0.00025
G5,C(C(C(C)=O)(C(C=O)=O)CO)(O)=O,2,3,0,3,17,0.000145
G5,C(C1(C(CCC1=O)=O)O)(O)=O,1,4,0,4,47,0.00019099999999999998
G5,C(C)(COCC(C(C(O)=O)=O)=O)=O,1,3,0,3,17,0.00014199999999999998
G5,C(C(C(C)=O)(C(C)=O)OC=O)(O)=O,1,3,0,3,9,0.000144
G5,C(C(C=O)(C(C)=O)OC(C)=O)(O)=O,2,3,0,3,26,0.000144
G5,C(COC(C(C(C(O)=O)=O)=O)C)=O,2,2,0,2,29,9.499999999999999e-05
G5,C(C1(C(C=CC1O)=O)O)(O)=O,4,6,0,6,17,0.000286
G5,C(C)(C1(C(COC1)=O)O)=O,2,3,0,3,29,0.00014199999999999998
G5,C1(C(C(CO1)O)=O)=O,2,8,0,8,45,0.00037999999999999997
G5,C(CO)(C(CO)(COCC=O)O)=O,2,4,0,4,36,0.000194
G5,C(C)(C(C(C=O)=O)(CO)CO)=O,1,3,0,3,2,0.000144
G5,C(COCC(C(CO)=O)=O)(C)=O,1,3,0,3,17,0.00014199999999999998
G5,C(OC(C(C)=O)(C(C)=O)CO)=O,1,4,0,4,9,0.000194
G5,C1(COC(CO)C1(CO)O)=O,4,5,0,5,2,0.000241
G5,C(C)(C(CO)(CO)OC(CO)=O)=O,1,4,0,4,2,0.000194
G5,C(C(C(C)=O)(CO)OC(C)=O)=O,2,3,0,3,26,0.000146
G5,C(COC(C(C(CO)=O)=O)C)=O,2,2,0,2,29,9.499999999999999e-05
G5,C(COC(C(CO)=O)(CO)CO)=O,1,4,0,4,2,0.000194
G5,C1(COCC(C1(CO)O)O)=O,4,5,0,5,2,0.000241
G5,C(C)(C(CO)(COC(CO)=O)O)=O,2,4,0,4,2,0.000194
G5,C(C(C=O)(CO)O)(OCC(C)=O)=O,2,5,0,5,2,0.000241
G5,C(C)(C(CO)(CO)OC(C=O)=O)=O,1,3,0,3,2,0.000146
G5,C(C)(C(C(OCC=O)=O)(CO)O)=O,2,3,0,3,2,0.000146
G5,C(C)(C(CO)(COC(C=O)=O)O)=O,2,3,0,3,2,0.000146
G5,C(CO)(CCOC(C(CO)=O)=O)=O,1,2,0,2,2,9.499999999999999e-05
G5,C(C(CO)C(C=O)O)(OCC=O)=O,4,3,0,3,8,0.000144
G5,C(C)(C(C(C=O)=O)(CO)C(C)O)=O,4,3,0,3,4,0.000146
G5,C1(CCC(C1(C(C)O)O)=O)=O,2,4,0,4,47,0.000192
G5,C(COCC(C(C(C)O)=O)=O)(C)=O,2,3,0,3,17,0.00014199999999999998
G5,C(OC(C(C)=O)(C(C)=O)C(C)O)=O,2,3,0,3,9,0.000145
G5,C(C(C(C)=O)(C(C)O)OC(C)=O)=O,4,3,0,3,26,0.000145
G5,C(COC(C(C(C(C)O)=O)=O)C)=O,4,2,0,2,29,9.499999999999999e-05
G5,C1C(C(C(C=1)=O)(C(C)O)O)O,8,6,0,6,4,0.00028700000000000004
G5,C=CC(C(C(O)=O)=O)=O,1,2,0,2,17,9.499999999999999e-05
G5,C1(C(CCC1(CO)O)=O)=O,2,5,0,5,29,0.000259
G5,C(C)(C(CC(C(C(C)=O)=O)O)O)=O,4,1,0,1,45,4.7e-05
G5,C(C)(C(C)(CC(C(C=O)=O)O)O)=O,4,2,0,2,21,9.499999999999999e-05
G5,C(C)(CC(CC(C(C=O)=O)O)O)=O,4,2,0,2,6,9.499999999999999e-05
G5,C(CCO)(CC(C(C(O)=O)=O)=O)=O,1,3,0,3,17,0.00014199999999999998
G5,C(C1(C(CC(C1)=O)=O)O)(O)=O,2,6,0,6,17,0.000285
G5,C(C)(C(CC(C(C(O)=O)=O)=O)O)=O,2,2,0,2,22,9.499999999999999e-05
G5,C(C(C=O)C(C(O)=O)(C(C)=O)O)=O,2,2,0,2,17,9.6e-05
G5,C(CC(CC(C(C(O)=O)=O)=O)O)=O,2,3,0,3,17,0.00014199999999999998
G5,C(C(C(CCO)O)=O)(O)=O,2,3,0,3,29,0.000154
G5,C(C)(C(CC(C)O)O)=O,4,1,0,1,25,4.7e-05
G5,C(C(C(C)=O)(C)O)(O)=O,2,5,0,5,25,0.00023700000000000001
G5,C(C)(C(C(C)=O)(C)O)=O,1,1,0,1,25,4.7e-05
G5,C(C)(C(C(CO)=O)(C)O)=O,2,3,0,3,25,0.00014199999999999998
G5,C(C(C=O)(CC(O)=O)O)=O,1,2,0,2,29,0.000106
G5,C(CC(C(C(O)=O)=O)O)=O,2,2,0,2,33,9.499999999999999e-05
G5,C(C1(C(CCO1)=O)O)=O,2,4,0,4,34,0.00018999999999999998
G5,C(C(C(C)=O)(CCO)O)=O,2,4,0,4,29,0.000212
G5,C(CCC(C(O)=O)=O)=O,1,5,0,5,29,0.00024900000000000004
G5,C(CO)=CC(C(O)=O)=O,2,4,0,4,29,0.00020099999999999998
G5,C(C)(C(C(C(C(O)=O)=O)=O)CO)=O,2,1,0,1,17,4.7e-05
G5,C(C(C(C)=O)(CC=O)OC=O)(O)=O,2,2,0,2,17,9.6e-05
G5,C(C(C=O)(CC=O)OCC=O)(O)=O,2,3,0,3,40,0.000143
G5,C(C(C(C=O)=O)(C)OCC=O)(O)=O,2,3,0,3,29,0.000143
G5,C(C(C=O)(CC(C)=O)OC=O)(O)=O,2,2,0,2,37,9.6e-05
G5,C1(CCOC1(C(C)=O)O)=O,2,4,0,4,29,0.00018999999999999998
G5,C1(COC(CC1(CO)O)O)=O,4,4,0,4,2,0.000192
G5,C(OCCC(C(CO)=O)(CO)O)=O,2,3,0,3,19,0.000144
G5,C(C)(C(CO)(CC=O)OC=O)=O,2,3,0,3,2,0.000144
G5,C(COC(C=O)(CO)CC=O)=O,2,3,0,3,40,0.000144
G5,C(COC(C(C=O)=O)(CO)C)=O,2,3,0,3,29,0.000144
G5,C(C(CO)(CC(C)=O)OC=O)=O,2,2,0,2,37,9.7e-05
G5,C(C)(C(CO)OC(C(CO)=O)=O)=O,2,1,0,1,2,4.7e-05
G5,C1(C(CO)(CC(CO1)=O)O)=O,2,4,0,4,2,0.000192
G5,C(C)(C(COC(C(CO)=O)=O)O)=O,2,1,0,1,2,4.7e-05
G5,C(OC(C(CO)=O)(CO)CCO)=O,2,3,0,3,2,0.000144
G5,C(CO)(C(CO)(C)OC(C=O)O)=O,4,3,0,3,24,0.000144
G5,C(C)(C(CO)(C)O)=O,2,2,0,2,27,9.499999999999999e-05
G5,C(CCO)(CC(C(C(C)O)=O)=O)=O,2,3,0,3,30,0.00014199999999999998
G5,C1(C(C(C)O)(CC(C1)=O)O)=O,4,7,0,7,4,0.000333
G5,C(C(C)O)(CC(C)=O)=O,2,3,0,3,29,0.00014199999999999998
G5,C(CCC=O)(C(C)O)=O,2,2,0,2,27,9.499999999999999e-05
G5,C(CO)=CC(C(C)O)=O,4,2,0,2,29,9.499999999999999e-05
G5,C(C)(C(C(C(C(C)O)=O)=O)CO)=O,4,1,0,1,4,4.7e-05
G5,C(C)(C(C(C)O)(CC=O)OC=O)=O,4,2,0,2,4,9.6e-05
G5,C(COC(C=O)(C(C)O)CC=O)=O,4,3,0,3,40,0.000144
G5,C(COC(C(C=O)=O)(C)C(C)O)=O,4,3,0,3,29,0.000144
G5,C(C(C(C)O)(CC(C)=O)OC=O)=O,4,2,0,2,25,9.6e-05
G5,C(CCO)(OCC=O)=O,1,5,0,5,48,0.00023700000000000001
G5,C(CO)(OC(CO)=O)=O,1,1,0,1,17,4.7e-05
G5,C(C)(OC(CO)=O)=O,1,2,0,2,14,9.499999999999999e-05
G5,C(CC)(C(C(C=O)=O)O)=O,2,3,0,3,42,0.00014199999999999998
G5,C(CO)(CC)=O,1,8,0,8,28,0.000391
G5,C(CC)=O,1,18,0,18,49,0.0008539999999999999
G5,C(C(C(C)=O)=O)(C)=O,1,5,0,5,0,0.00023700000000000001
G5,C(C(C)=O)(CCCO)=O,1,4,0,4,29,0.00020099999999999998
G5,C(CCC(C=O)O)=O,2,7,0,7,17,0.000344
G5,C(C(C(CC)=O)O)=O,2,3,0,3,42,0.00014199999999999998
G5,C(CCC(CO)O)=O,2,4,0,4,29,0.00018999999999999998
G5,C(CC(OCC(C)=O)O)=O,2,4,0,4,45,0.00018999999999999998
G5,C1(C=CC(C1)=O)=O,1,5,0,5,2,0.00023700000000000001
G5,C1(C(CO)CC(CO1)=O)=O,2,3,0,3,48,0.00014199999999999998
G5,C(C(CO)OCC(CC=O)=O)=O,2,3,0,3,29,0.00014199999999999998
G5,C(OC(CO)C(C=O)C(C)=O)=O,4,2,0,2,9,9.499999999999999e-05
G5,C(OC(CO)CC(CC=O)=O)=O,2,3,0,3,29,0.00014199999999999998
G5,C(C(COCC(CC=O)=O)O)=O,2,3,0,3,29,0.00014199999999999998
G5,C(CC(OCC=O)O)(CC=O)=O,2,3,0,3,38,0.00014199999999999998
G5,C(C)(C(C=O)C(OCC=O)O)=O,4,2,0,2,19,9.499999999999999e-05
G5,C(C)(C(C=O)COC(C=O)O)=O,4,2,0,2,2,9.499999999999999e-05
G5,C(CCOC(C=O)O)(CC=O)=O,2,5,0,5,30,0.00023700000000000001
G5,C(C)(CC(C=CC=O)=O)=O,2,7,0,7,29,0.000332
G5,C(C)(CC(C=C)=O)=O,1,4,0,4,0,0.00018999999999999998
G5,C(C(C(CO)=O)C)=O,2,6,0,6,49,0.000296
G5,C(C(CO)OC(C=O)C(C)=O)=O,4,2,0,2,29,9.499999999999999e-05
G5,C(C(COC(C=O)C(C)=O)O)=O,4,2,0,2,29,9.499999999999999e-05
G5,C(C(CCCO)=O)(O)=O,1,4,0,4,29,0.00020099999999999998
G5,C(C1CC(CO1)=O)=O,2,4,0,4,2,0.00018999999999999998
G5,C(C(C(C)=O)OCC=O)=O,2,2,0,2,2,9.499999999999999e-05
G5,C(CC(COCC=O)=O)=O,1,4,0,4,37,0.00018999999999999998
G5,C(C(C=O)OCC(C)=O)=O,1,2,0,2,2,9.499999999999999e-05
G5,C1(C(COCC1)=O)=O,1,4,0,4,2,0.00018999999999999998
G5,C1CC(C(C=1)=O)=O,1,4,0,4,2,0.00018999999999999998
G5,C=C(C(C)=O)C(C=O)=O,1,5,0,5,7,0.00023700000000000001
G5,C=C(C=O)C(C(C)=O)=O,1,6,0,6,14,0.000285
G5,C(C(C=O)=CC(C)=O)=O,1,4,0,4,29,0.00018999999999999998
G5,C(C(C(C)=O)=CC=O)=O,2,5,0,5,29,0.00023700000000000001
G5,C(C=CC(C)=O)(O)=O,2,5,0,5,29,0.00024900000000000004
G5,C(C1C(OCC(C1)=O)O)=O,4,4,0,4,2,0.00018999999999999998
G5,C(C1(CC(CO1)=O)O)=O,2,4,0,4,2,0.00018999999999999998
G5,C(COC(C(C)=O)=O)(C)=O,1,2,0,2,2,9.499999999999999e-05
G5,C1(COCC1)=O,1,3,0,3,4,0.00014199999999999998
G5,C1(CC(C(O1)=O)O)=O,2,4,0,4,4,0.00018999999999999998
G5,C(CCO)(OC(C(C)=O)=O)=O,1,1,0,1,2,4.7e-05
G5,C(C)(C1COCC(O1)=O)=O,2,1,0,1,36,4.7e-05
G5,C1(CCOC(C(C)=O)O1)=O,2,1,0,1,30,4.7e-05
G5,C(OC(CO)CC(C=O)=O)=O,2,1,0,1,0,4.7e-05
G5,C1(COC(C(C1)=O)O)=O,2,7,0,7,51,0.000332
G5,C(C(C(CO)=O)OCC=O)=O,2,2,0,2,2,9.499999999999999e-05
G5,C(C(C(C)=O)(O)OCC=O)=O,2,1,0,1,15,4.7e-05
G5,C(C(O)OCCC(C=O)=O)=O,2,5,0,5,0,0.00023700000000000001
G5,C(CC(COC(C=O)O)=O)=O,2,5,0,5,15,0.00023700000000000001
G5,C(C(C=O)(O)OCC(C)=O)=O,1,1,0,1,15,4.7e-05
G5,C(CCC(OCC=O)=O)=O,1,3,0,3,37,0.00014199999999999998
G5,C(C)(OCC(C(C)=O)=O)=O,1,1,0,1,26,4.7e-05
G5,C(OC(C(C(C)=O)=O)C)=O,2,1,0,1,4,4.7e-05
G5,C(C(C)(OCC(C)=O)O)=O,2,1,0,1,45,4.7e-05
G5,C(C)(OCCC(CO)=O)=O,1,3,0,3,9,0.00014199999999999998
G5,C(C)(C(COC(C)=O)O)=O,2,2,0,2,29,9.499999999999999e-05
G5,C(C)(C(C)(OCC=O)O)=O,2,2,0,2,29,9.499999999999999e-05
G5,C(COC(C(CO)=O)C)=O,2,4,0,4,4,0.00020099999999999998
G5,C(CC(C)=O)(OC(CO)=O)=O,1,1,0,1,17,4.7e-05
G5,C(C(C)(O)OC(C(C)=O)=O)=O,2,1,0,1,14,4.7e-05
G5,C(CC(CO)=O)(OC(C)=O)=O,1,2,0,2,17,9.499999999999999e-05
G5,C(C(C(C)=O)O)(OC(C)=O)=O,2,1,0,1,14,4.7e-05
G5,C(C)(C(C)(O)OC(C=O)=O)=O,2,1,0,1,14,4.7e-05
G5,C(CO)(C(C)OC(C=O)=O)=O,2,2,0,2,2,9.499999999999999e-05
G5,C(COC1C(COC1)=O)=O,2,2,0,2,17,9.499999999999999e-05
G5,C(C)(C1COC(CO1)=O)=O,2,1,0,1,54,4.7e-05
G5,C(COC(C(C(C)=O)=O)O)=O,2,1,0,1,2,4.7e-05
G5,C(C)(CC(OCC=O)O)=O,2,4,0,4,6,0.00018999999999999998
G5,C(CCOCC(CO)=O)=O,1,3,0,3,4,0.00014199999999999998
G5,C(CCOC(C(C)=O)O)=O,2,2,0,2,41,9.499999999999999e-05
G5,C(OCCC(C(C)=O)O)=O,2,1,0,1,4,4.7e-05
G5,C(OCCCC(CO)=O)=O,1,2,0,2,29,9.499999999999999e-05
G5,C(C)(CCOC(C=O)O)=O,2,1,0,1,29,4.7e-05
G5,C(CC(O)OC(C(C)=O)=O)=O,2,1,0,1,45,4.7e-05
G5,C(C)(CC(O)OC(C=O)=O)=O,2,1,0,1,2,4.7e-05
G5,C(OC(C(CC(C)=O)O)=O)=O,2,1,0,1,2,4.7e-05
G5,C(CC=O)(OC(C(C)=O)O)=O,2,1,0,1,28,4.7e-05
G5,C(OC(CC(C(C)=O)O)=O)=O,2,1,0,1,29,4.7e-05
G5,C(OC(CCC(CO)=O)=O)=O,1,2,0,2,29,9.499999999999999e-05
G5,C(CC(C)=O)(OC(C=O)O)=O,2,1,0,1,17,4.7e-05
G5,C(CC1OCC(CO1)=O)=O,1,2,0,2,17,9.499999999999999e-05
G5,C=C(C(CO)=O)C(CO)=O,1,4,0,4,2,0.00018999999999999998
G5,C=C(C=O)C=O,1,10,0,10,5,0.000475
G5,C=C(C=O)C(C)=O,1,4,0,4,7,0.00018999999999999998
G5,C(OC(C(C=C)=O)C(CO)O)=O,4,2,0,2,0,9.499999999999999e-05
G5,C=C1C(COC1O)=O,2,6,0,6,0,0.000285
G5,C1OCC(C=1CO)=O,1,3,0,3,0,0.00014199999999999998
G5,C(C(C(OCC(C=C)=O)O)O)=O,4,4,0,4,0,0.00018999999999999998
G5,C(C(CO)OC(C(C=C)=O)O)=O,4,2,0,2,41,9.499999999999999e-05
G5,C(OC(CO)C(C(C=C)=O)O)=O,4,2,0,2,9,9.499999999999999e-05
G5,C(OC(C(C(CO)=O)=C)CO)=O,2,3,0,3,54,0.00014199999999999998
G5,C=C1C(COC(C1O)O)=O,4,4,0,4,47,0.00018999999999999998
G5,C1C(O)OCC(C=1CO)=O,2,3,0,3,2,0.00014199999999999998
G5,C(C(COC(C(C=C)=O)O)O)=O,4,2,0,2,41,9.499999999999999e-05
G5,C(COC(C(C(CO)=O)=C)O)=O,2,3,0,3,38,0.00014199999999999998
G5,C(COC=C(C(CO)=O)CO)=O,2,3,0,3,38,0.00014199999999999998
G5,C(OCC(C(C(CO)=O)=C)O)=O,2,3,0,3,19,0.00014199999999999998
G5,C(COC(C(C(C=C)=O)O)O)=O,4,2,0,2,19,9.499999999999999e-05
G5,C(OCC=C(C(CO)=O)CO)=O,2,3,0,3,19,0.00014199999999999998
G5,C(C(O)OCC(C(C=C)=O)O)=O,4,6,0,6,12,0.000285
G5,C(C(O)OCC(C(CO)=O)=C)=O,2,4,0,4,30,0.00018999999999999998
G5,C(C(C=O)=CC=O)=O,1,8,0,8,29,0.00037999999999999997
G5,C(C)(CC(C=O)=CC=O)=O,2,2,0,2,23,9.499999999999999e-05
G5,C(CC(C=O)=CC(C)=O)=O,2,3,0,3,29,0.00014199999999999998
G5,C(C)(C(C=C)C(C=O)=O)=O,2,3,0,3,29,0.00014199999999999998
G5,C(C)=C(C(C)=O)C(C=O)=O,2,2,0,2,29,9.499999999999999e-05
G5,C(CC(C=O)=O)(CC=C)=O,1,4,0,4,29,0.00018999999999999998
G5,C(C)=CC(CC(C=O)=O)=O,2,3,0,3,29,0.00014199999999999998
G5,C(CC(C=O)=CC=O)=O,2,10,0,10,29,0.000475
G5,C(C(C=C)C(C=O)=O)=O,2,5,0,5,29,0.00023700000000000001
G5,C(C)=C(C=O)C(C=O)=O,2,3,0,3,4,0.00014199999999999998
G5,C(C(C=O)C=C)=O,1,3,0,3,29,0.00014199999999999998
G5,C(C)=C(C=O)C=O,1,2,0,2,29,9.499999999999999e-05
G5,C(CC(C(C)=O)=O)=CC=O,2,4,0,4,29,0.00018999999999999998
G5,C(CC=CC(C(C)=O)=O)=O,2,2,0,2,53,9.499999999999999e-05
G5,C(CC(C(C)=O)=CC=O)=O,2,2,0,2,29,9.499999999999999e-05
G5,C(C(C=C)C(C(C)=O)=O)=O,2,4,0,4,29,0.00018999999999999998
G5,C(C)=C(C=O)C(C(C)=O)=O,2,2,0,2,4,9.499999999999999e-05
G5,C(CC(C(CC=C)=O)=O)=O,1,4,0,4,29,0.00018999999999999998
G5,C(CC(C(C=CC)=O)=O)=O,2,3,0,3,29,0.00014199999999999998
G5,C(C=C(C(C)=O)C)=O,2,3,0,3,29,0.00014199999999999998
G5,C(CC(C(C)=O)=C)=O,1,3,0,3,29,0.00014199999999999998
G5,C=CCC(C(C)=O)=O,1,4,0,4,29,0.00018999999999999998
G5,C(C)=CC(C(C)=O)=O,2,4,0,4,0,0.00018999999999999998
G5,C(C)(CC=CC=O)=O,2,2,0,2,26,9.499999999999999e-05
G5,C(CC=CC(C)=O)=O,2,2,0,2,29,9.499999999999999e-05
G5,C(CC(CC=C)=O)=O,1,3,0,3,29,0.00014199999999999998
G5,C(CC(C=CC)=O)=O,2,3,0,3,29,0.00014199999999999998
G5,C(C(C(C)=O)C=C)=O,2,3,0,3,29,0.00014199999999999998
G5,C(C)=C(C=O)C(C)=O,2,2,0,2,29,9.499999999999999e-05
G5,C(C=CC=CC(CO)=O)=O,4,5,0,5,21,0.00023700000000000001
G5,C=CC(C=O)=CC=O,2,6,0,6,29,0.000285
G5,C(C=CC=CC=O)=O,3,4,0,4,29,0.00018999999999999998
G5,C1(C(C=CC1O)O)=O,3,4,0,4,2,0.00018999999999999998
G5,C=CC(C(C=CC=O)=O)O,4,4,0,4,29,0.00018999999999999998
G5,C=CC(C(C=C)=O)=O,1,4,0,4,7,0.00018999999999999998
G5,C=CC(C(C=C)=O)O,2,4,0,4,7,0.00018999999999999998
G5,C1(CO)OCC(C=1)=O,1,3,0,3,2,0.00014199999999999998
G5,C1COC(C(C=1)=O)O,2,3,0,3,46,0.00014199999999999998
G5,C1(C=CC(CO1)=O)=O,1,3,0,3,2,0.00014199999999999998
G5,C(COC(C=C)=O)(CO)=O,1,5,0,5,32,0.00023700000000000001
G5,C(OC(C(CO)=O)C=C)=O,2,3,0,3,2,0.00014199999999999998
G5,C(C(O)OCC=CC=O)=O,4,4,0,4,30,0.00018999999999999998
G5,C(COC(C=O)=C)(CO)=O,1,3,0,3,24,0.00014199999999999998
G5,C(COC(C=CC=O)=O)=O,2,3,0,3,8,0.00014199999999999998
G5,C(OCC(CO)O)=O,2,3,0,3,29,0.000153
G5,C(COC(C(CO)O)O)=O,4,3,0,3,2,0.000153
G5,C(CC(CO)(OCC(CO)=O)O)=O,2,6,0,6,20,0.000285
G5,C(CO)(CC(OCC(CO)=O)O)=O,2,8,0,8,5,0.00037999999999999997
G5,C1(COC(CO)(C1O)O)=O,4,2,0,2,5,9.499999999999999e-05
G5,C(OCC(CO)(CC(CO)=O)O)=O,2,4,0,4,5,0.00018999999999999998
G5,C(CC(CO)(COC(CO)=O)O)=O,2,2,0,2,20,9.499999999999999e-05
G5,C(C(C(C)(OCC(CO)=O)O)O)=O,4,7,0,7,5,0.000332
G5,C(C(C(CO)(OCC(C)=O)O)O)=O,4,3,0,3,5,0.00014199999999999998
G5,C(C)(C(C(OCC(CO)=O)O)O)=O,4,8,0,8,5,0.00037999999999999997
G5,C(C)(C(C(CO)(OCC=O)O)O)=O,4,2,0,2,5,9.499999999999999e-05
G5,C1(CC(CO1)(CO)O)=O,2,4,0,4,5,0.00018999999999999998
G5,C(C(C(OCC(CO)=O)O)O)=O,4,7,0,7,5,0.000332
G5,C(C(C(CO)(OCC=O)O)O)=O,4,2,0,2,5,9.499999999999999e-05
G5,C(CC(CO)(CO)OC(C=O)O)=O,2,2,0,2,5,9.499999999999999e-05
G5,C(OC(CO)C(CC(CO)=O)O)=O,4,4,0,4,19,0.00018999999999999998
G5,C(CC(C(CO)OC(CO)=O)O)=O,4,2,0,2,40,9.499999999999999e-05
G5,C1(CC(C(CO)O1)O)=O,4,4,0,4,29,0.00018999999999999998
G5,C(CC(C(CO)O)OC(C=O)O)=O,8,2,0,2,41,9.499999999999999e-05
G5,C(C(CC=O)(O)OCC(C)=O)=O,2,3,0,3,20,0.00014199999999999998
G5,C(COC(C=O)(CC(C)=O)O)=O,2,2,0,2,26,9.499999999999999e-05
G5,C(C(C)(O)OCCC(C=O)=O)=O,2,2,0,2,45,9.499999999999999e-05
G5,C(C(O)OCCC(C=O)=O)(C)=O,2,3,0,3,42,0.00014199999999999998
G5,C(C(C)(O)OCCC(CO)=O)=O,2,4,0,4,45,0.00018999999999999998
G5,C(CO)(CCOC(C(C)=O)O)=O,2,5,0,5,45,0.00023700000000000001
G5,C(CC(C=O)(O)OCC=O)=O,2,2,0,2,15,9.499999999999999e-05
G5,C(CC(C=O)OC(C=O)(C)O)=O,4,2,0,2,45,9.499999999999999e-05
G5,C(C(O)OC(C(C)=O)CC=O)=O,4,2,0,2,45,9.499999999999999e-05
G5,C(CC(C=O)OC(C(C)=O)O)=O,4,4,0,4,45,0.00018999999999999998
G5,C(CC(C=O)(C)OC(C=O)O)=O,4,2,0,2,45,9.499999999999999e-05
G5,C(C(C=O)OC(CC(CO)=O)O)=O,2,7,0,7,1,0.000332
G5,C(CO)(C(C=O)C(OCC=O)O)=O,4,2,0,2,1,9.499999999999999e-05
G5,C(C(C=O)OC(CO)(CC=O)O)=O,2,5,0,5,40,0.00023700000000000001
G5,C(C(C=O)C(CO)(OCC=O)O)=O,2,2,0,2,40,9.499999999999999e-05
G5,C(C(C(OCC(CC=O)=O)O)O)=O,4,10,0,10,1,0.000475
G5,C(CC(C(C=O)O)(OCC=O)O)=O,4,4,0,4,1,0.00018999999999999998
G5,C(CO)(CC(OCC(C)=O)O)=O,2,7,0,7,49,0.000332
G5,C(CC(C)(COC(CO)=O)O)=O,2,2,0,2,49,9.499999999999999e-05
G5,C(CC(CO)(OCC(C)=O)O)=O,2,5,0,5,49,0.00023700000000000001
G5,C1(CC(C(C=O)O1)O)=O,4,4,0,4,1,0.00018999999999999998
G5,C1(CC(C)(CO1)O)=O,2,4,0,4,49,0.00018999999999999998
G5,C(C)(CC(CO)(OCC=O)O)=O,2,2,0,2,55,9.499999999999999e-05
G5,C(C(C(C)(OCC(C)=O)O)O)=O,4,6,0,6,49,0.000285
G5,C(C)(C(C(C)(OCC=O)O)O)=O,4,2,0,2,49,9.499999999999999e-05
G5,C(C)(C(C(OCC(C)=O)O)O)=O,4,7,0,7,49,0.000332
G5,C(C(O)OC(C=O)CC(CO)=O)=O,4,4,0,4,0,0.00018999999999999998
G5,C(C(CC=O)OC(C=O)O)=O,4,2,0,2,43,9.499999999999999e-05
G5,C(CC(C(CO)O)(OCC=O)O)=O,4,2,0,2,41,9.499999999999999e-05
G5,C(CO)(CC(C)OC(C=O)O)=O,4,4,0,4,11,0.00018999999999999998
G5,C(CCOC(C=O)O)=O,2,2,0,2,27,9.499999999999999e-05
G5,C(CCOC(C=O)(C(CO)O)O)=O,4,2,0,2,2,9.499999999999999e-05
G5,C(C(CO)CO)(OCC(CO)=O)=O,1,3,0,3,2,0.000144
G5,C(C1COC(C1O)=O)=O,4,3,0,3,29,0.00014199999999999998
G5,C(CC(C=O)(O)OCCC=O)=O,2,4,0,4,23,0.00018999999999999998
G5,C(CCO)(OC(C=O)C(C)=O)=O,2,3,0,3,30,0.00014199999999999998
G5,C(C1COC(C1)=O)=O,2,3,0,3,55,0.00014199999999999998
G5,C(C(O)OCCC(C(C)=O)=O)=O,2,3,0,3,30,0.00014199999999999998
G5,C1(C(C)(O)OCC1)=O,2,4,0,4,14,0.00018999999999999998
G5,C(COC(C=O)(C(C=O)CO)O)=O,4,2,0,2,15,9.499999999999999e-05
G5,C(C(C(CCO)(OCC=O)O)O)=O,4,2,0,2,30,9.499999999999999e-05
G5,C(COC(C(C=O)C(C=O)O)O)=O,8,2,0,2,43,9.499999999999999e-05
G5,C(CC(C(C=O)O)OC(C=O)O)=O,8,2,0,2,43,9.499999999999999e-05
G5,C(CC(OCC=O)O)=O,2,2,0,2,0,9.499999999999999e-05
G5,C(CC(CO)(C)OC(C=O)O)=O,4,2,0,2,49,9.499999999999999e-05
G5,C(CC(C)OC(C=O)O)=O,4,2,0,2,4,9.499999999999999e-05
G5,C(CCO)(OC(C(C)=O)CC=O)=O,2,1,0,1,30,4.7e-05
G5,C(C)(C1C(C(O)OC1C)=O)=O,8,3,0,3,30,0.00014199999999999998
G5,C(C(C)(O)OC(C)CC(C=O)=O)=O,4,2,0,2,45,9.499999999999999e-05
G5,C(C1C(C(O)OC1C)=O)=O,8,3,0,3,25,0.00014199999999999998
G5,C(C)(C(CCO)(CC=O)OC=O)=O,2,1,0,1,53,4.7e-05
G5,C1(C(C(CO)C(C)O1)=O)=O,4,2,0,2,4,9.499999999999999e-05
G5,C(CC1(C(CC(C)O1)=O)O)=O,4,3,0,3,4,0.00014199999999999998
G5,C(C1C(C)OC(C1O)=O)=O,8,2,0,2,4,9.499999999999999e-05
G5,C(CC(C=O)(O)OC(C)CC=O)=O,4,4,0,4,23,0.00018999999999999998
G5,C(CC(OCC(CC(C)=O)=O)O)=O,2,2,0,2,26,9.499999999999999e-05
G5,C(C)(CC(CC(OCC=O)O)=O)=O,2,2,0,2,27,9.499999999999999e-05
G5,C(CC(C)O)(OC(C=O)C(C)=O)=O,4,2,0,2,4,9.499999999999999e-05
G5,C(CC(OCC(CCC=O)=O)O)=O,2,2,0,2,45,9.499999999999999e-05
G5,C(COC(CC(CCC=O)=O)O)=O,2,2,0,2,44,9.499999999999999e-05
G5,C(CC1CCC(O1)=O)=O,2,3,0,3,44,0.00014199999999999998
G5,C(C1C(C)OC(C1)=O)=O,4,3,0,3,46,0.00014199999999999998
G5,C(C(O)OC(C)CC(C(C)=O)=O)=O,4,2,0,2,14,9.499999999999999e-05
G5,C1(C(C)(O)OC(C)C1)=O,4,3,0,3,14,0.00014199999999999998
G5,C(CC(C)OC(C=O)O)(CC=O)=O,4,2,0,2,37,9.499999999999999e-05
G5,C(CC(OCC(C=CCO)=O)O)=O,4,2,0,2,11,9.499999999999999e-05
G5,C(COC(CC(C=CCO)=O)O)=O,4,2,0,2,0,9.499999999999999e-05
G5,C(CO)(CC(CO)OC(C=O)O)=O,4,6,0,6,0,0.000285
G5,C(C(C(OCC=O)O)O)=O,4,5,0,5,1,0.00023700000000000001
G5,C(C)(OCC(CO)=O)=O,1,2,0,2,0,9.499999999999999e-05
G5,C(OC(C(CO)=O)C)=O,2,2,0,2,0,9.499999999999999e-05
G5,C(C)(OC(C(CO)=O)CO)=O,2,2,0,2,0,9.499999999999999e-05
G5,C(C(C)O)(OCC(CO)=O)=O,2,4,0,4,2,0.00018999999999999998
G5,C(CO)(C(C)OC(CO)=O)=O,2,3,0,3,2,0.00014199999999999998
G5,C(OC(C(CO)=O)C(C)O)=O,4,2,0,2,2,9.499999999999999e-05
G5,C(C)(C(C)OC(C=O)=O)=O,2,1,0,1,24,4.7e-05
G5,C1(CCCO1)=O,1,3,0,3,29,0.00014199999999999998
G5,C1(CCC(O1)=O)=O,1,3,0,3,45,0.00014199999999999998
G5,C(OCC(CO)(C(C(C)=O)O)O)=O,4,4,0,4,5,0.00018999999999999998
G5,C(C(C(CO)(COC(C)=O)O)O)=O,4,3,0,3,5,0.00014199999999999998
G5,C(OCC(CO)(C(C=O)O)O)=O,4,3,0,3,5,0.00014199999999999998
G5,C(C(COC(C=O)(C)O)O)=O,4,4,0,4,24,0.00018999999999999998
G5,C1(COC(C1(CO)O)O)=O,4,4,0,4,5,0.000194
G5,C(OC(CO)C(C(C(C)=O)O)O)=O,8,4,0,4,19,0.00018999999999999998
G5,C(C(C(C(CO)OC(C)=O)O)O)=O,8,3,0,3,1,0.00014199999999999998
G5,C(C(COC(C=O)O)O)=O,4,3,0,3,34,0.00014199999999999998
G5,C(C(COC(C=O)(CCO)O)O)=O,4,3,0,3,7,0.00014199999999999998
G5,C(C(C(OC(C=O)CO)O)O)=O,8,7,0,7,1,0.000332
G5,C(OC(CO)C(C(C=O)O)O)=O,8,3,0,3,1,0.00014199999999999998
G5,C(C(C(OCC=O)O)(CO)O)=O,4,2,0,2,1,9.499999999999999e-05
G5,C(C(C)(O)OCC(C(C)=O)O)=O,4,4,0,4,0,0.00018999999999999998
G5,C(C)(C(COC(C(C)=O)O)O)=O,4,5,0,5,45,0.00023700000000000001
G5,C(COC(C(C(C=O)=O)O)O)(C)=O,4,3,0,3,0,0.00014199999999999998
G5,C(C(C(C=O)O)OC(C=O)(C)O)=O,8,3,0,3,0,0.00014199999999999998
G5,C(COC(C)(C(C(C=O)=O)O)O)=O,4,2,0,2,0,9.499999999999999e-05
G5,C(C(C)OC(C(C(C=O)=O)O)O)=O,8,2,0,2,45,9.499999999999999e-05
G5,C(C(OC(C=O)(C)C(C=O)O)O)=O,8,3,0,3,45,0.00014199999999999998
G5,C(COC(C(C(C=O)=O)(C)O)O)=O,4,2,0,2,45,9.499999999999999e-05
G5,C(C(C)(O)OCC(C(CO)=O)O)=O,4,5,0,5,0,0.00023700000000000001
G5,C(CO)(C(COC(C(C)=O)O)O)=O,4,6,0,6,42,0.000285
G5,C(C1(C(COC1O)=O)O)=O,4,2,0,2,1,9.499999999999999e-05
G5,C(CC(COC=O)(C(C=O)O)O)=O,4,3,0,3,1,0.00014199999999999998
G5,C(C(C=O)(C(OCC(C)=O)O)O)=O,2,3,0,3,1,0.00014199999999999998
G5,C(C(C(OC(C=O)C(C)=O)O)O)=O,8,10,0,10,1,0.000475
G5,C(C(C=O)OC(C)(C(C=O)O)O)=O,4,6,0,6,1,0.000285
G5,C(C)(C(C=O)(C(OCC=O)O)O)=O,4,4,0,4,1,0.00018999999999999998
G5,C(C(C=O)OC(C(C(C)=O)O)O)=O,4,7,0,7,1,0.000332
G5,C(C(C=O)(C(C)(OCC=O)O)O)=O,2,2,0,2,1,9.499999999999999e-05
G5,C(C(C(C)(COC(C)=O)O)O)=O,4,3,0,3,49,0.00014199999999999998
G5,C(COC(C(C(C(C)=O)=O)O)O)=O,4,2,0,2,0,9.499999999999999e-05
G5,C(C(O)OC(C=O)C(C(C)=O)O)=O,8,4,0,4,0,0.00018999999999999998
G5,C(COC(C(C(C=O)=O)O)O)=O,4,2,0,2,0,9.499999999999999e-05
G5,C(C(C(C=O)O)OC(C=O)O)=O,8,3,0,3,0,0.00014199999999999998
G5,C(CO)(C(COC(C=O)O)O)=O,4,6,0,6,5,0.000285
G5,C(OC(CO)C(C)(C(C=O)O)O)=O,8,3,0,3,35,0.00014199999999999998
G5,C(C(CO)(CO)O)(OCC(C)=O)=O,1,3,0,3,2,0.000146
G5,C(C(COC(C=O)(C(C)O)O)O)=O,8,3,0,3,25,0.00014199999999999998
G5,C(C(COC(C=O)O)O)(C(C)O)=O,8,3,0,3,12,0.00014199999999999998
G5,C(C(C=C)(O)OCC(C=O)O)=O,4,3,0,3,7,0.00014199999999999998
G5,C(OCC(CCO)(C(C=O)O)O)=O,4,3,0,3,1,0.00014199999999999998
G5,C(C(C(C)OC(C=O)(C)O)O)=O,8,3,0,3,0,0.00014199999999999998
G5,C(C)(C(C(C)OC(C=O)O)O)=O,8,4,0,4,11,0.00018999999999999998
G5,C(C(C=O)(C(OCC=O)O)O)=O,2,2,0,2,1,9.499999999999999e-05
G5,C(C(C=O)OC(C(C=O)O)O)=O,4,6,0,6,1,0.000285
G5,C(CC(C(C(C=O)O)O)OC=O)=O,8,3,0,3,43,0.00014199999999999998
G5,C(CC(C=O)OC(C(C=O)O)O)=O,8,10,0,10,43,0.000475
G5,C1(C(O)OCC1(C)O)=O,4,4,0,4,49,0.00018999999999999998
G5,C(C(C(CO)(C)OC(C=O)O)O)=O,8,3,0,3,49,0.00014199999999999998
G5,C(C(C(C)OC(C=O)O)O)=O,8,4,0,4,25,0.00018999999999999998
G5,C(C(C=C)(O)OC(C)C(C=O)O)=O,8,3,0,3,7,0.00014199999999999998
G5,C(C(O)OC(C)C(C(C=C)=O)O)=O,8,4,0,4,12,0.00018999999999999998
G5,C(C(C(CO)OC(C=O)(C)O)O)=O,8,3,0,3,0,0.00014199999999999998
G5,C1(C(C)(O)OCC1O)=O,4,4,0,4,0,0.00018999999999999998
G5,C(C)(C(C(CO)OC(C=O)O)O)=O,8,4,0,4,0,0.00018999999999999998
G5,C(C(C(CO)OC(C(C)=O)O)O)=O,8,4,0,4,45,0.00018999999999999998
G5,C1(C(O)OCC1(CO)O)=O,4,4,0,4,0,0.000194
G5,C1(C(O)OC(CO)C1O)=O,8,2,0,2,41,9.499999999999999e-05
G5,C(COC(CC(C=O)=O)O)(C)=O,2,4,0,4,49,0.00018999999999999998
G5,C(C(C)OC(CC(C=O)=O)O)=O,4,4,0,4,49,0.00018999999999999998
G5,C(COC(CO)(CC(C=O)=O)O)=O,2,2,0,2,51,9.499999999999999e-05
G5,C(CO)(C1(COC(C1)O)O)=O,4,4,0,4,2,0.00018999999999999998
G5,C1(C(CO)(CCO1)O)=O,2,4,0,4,2,0.000192
G5,C(C1(COC(C1)=O)O)=O,2,3,0,3,34,0.00014199999999999998
G5,C(C(C(OCC=O)O)(CC=O)O)=O,4,2,0,2,1,9.499999999999999e-05
G5,C(C1C(C(C(O)O1)=O)O)=O,8,2,0,2,1,9.499999999999999e-05
G5,C(C1(C(C)OC(C1)=O)O)=O,4,3,0,3,29,0.00014199999999999998
G5,C(CO)(C1COC(C1)=O)=O,2,3,0,3,47,0.00014199999999999998
G5,C(C)(C1(COC(C1)=O)O)=O,2,2,0,2,2,9.499999999999999e-05
G5,C(CC1COC(C1)=O)=O,2,3,0,3,55,0.000144
G5,C(OC(CO)(CO)C(C(C)=O)O)=O,2,1,0,1,2,4.7e-05
G5,C(OC(CO)(CO)CC(CO)=O)=O,1,2,0,2,5,9.499999999999999e-05
G5,C(C(O)OCC(CO)=O)=O,2,2,0,2,5,9.499999999999999e-05
G5,C(C(CCO)(OCC(CO)=O)O)=O,2,2,0,2,5,9.499999999999999e-05
G5,C(C(CCOC(C=O)(CO)O)O)=O,4,4,0,4,5,0.000192
G5,C(C(CC(OCC(CO)=O)O)O)=O,4,4,0,4,51,0.00018999999999999998
G5,C(CC(C(OCC(CO)=O)O)O)=O,4,4,0,4,51,0.00018999999999999998
G5,C(CC(CO)(COC(C=O)O)O)=O,4,2,0,2,51,9.499999999999999e-05
G5,C(C(COC(CC(CO)=O)O)O)=O,4,5,0,5,41,0.00023700000000000001
G5,C(OCC(C(CC(CO)=O)O)O)=O,4,2,0,2,41,9.499999999999999e-05
G5,C(CC(CO)(O)OCC(C=O)O)=O,4,5,0,5,30,0.00023700000000000001
G5,C(CC(C(COC(CO)=O)O)O)=O,4,2,0,2,30,9.499999999999999e-05
G5,C(OC(C(CO)O)C(C(C)=O)O)=O,8,1,0,1,49,4.7e-05
G5,C1(CC(C(CO1)O)O)=O,4,5,0,5,29,0.000248
G5,C(OC(C(CO)O)CC(CO)=O)=O,4,2,0,2,29,9.499999999999999e-05
G5,C(CC(C(CO)OC(C=O)O)O)=O,8,2,0,2,37,9.499999999999999e-05
G5,C(CC(COC(C(C)=O)O)=O)=O,2,3,0,3,16,0.00014199999999999998
G5,C(C(C)(OCC(CC=O)=O)O)=O,2,2,0,2,24,9.499999999999999e-05
G5,C(C(C)(C(C(C)=O)O)OC=O)=O,4,1,0,1,49,4.7e-05
G5,C(C(C(C)=O)OC(C(C)=O)O)=O,4,3,0,3,16,0.00014199999999999998
G5,C(CC(C(O)OCC(C)=O)=O)=O,2,2,0,2,49,9.499999999999999e-05
G5,C(COC(C(CC(C)=O)=O)O)=O,2,2,0,2,26,9.499999999999999e-05
G5,C(C(C)(OC(C=O)C(C)=O)O)=O,4,1,0,1,29,4.7e-05
G5,C(OC(C(C)=O)CC(CO)=O)=O,2,2,0,2,29,9.499999999999999e-05
G5,C(C(C)(CC(CO)=O)OC=O)=O,2,2,0,2,16,9.499999999999999e-05
G5,C(C)(C(CO)OC(C(C)=O)O)=O,4,2,0,2,29,9.499999999999999e-05
G5,C(C(C)(OC(C(C)=O)CO)O)=O,4,1,0,1,45,4.7e-05
G5,C(COC(C(C)=O)O)(CCO)=O,2,3,0,3,16,0.00014199999999999998
G5,C(C(C)(OCC(CCO)=O)O)=O,2,2,0,2,45,9.499999999999999e-05
G5,C(C(C=O)OC(C(C)=O)O)=O,2,1,0,1,15,4.7e-05
G5,C(CC(C(O)OCC=O)=O)=O,2,2,0,2,15,9.499999999999999e-05
G5,C(COC(C(C)=O)O)(C)=O,2,4,0,4,41,0.00018999999999999998
G5,C(C(CC(C=O)(OCC=O)O)O)=O,4,2,0,2,0,9.499999999999999e-05
G5,C(OCC(C(C)=O)O)=O,2,1,0,1,27,4.7e-05
G5,C(C(C(C(C(C)=O)O)OC=O)O)=O,8,1,0,1,1,4.7e-05
G5,C(OC(CO)(C)C(C(C)=O)O)=O,4,1,0,1,49,4.7e-05
G5,C(OC(C)C(C(C)=O)O)=O,4,1,0,1,4,4.7e-05
G5,C(C(C(C)=O)OC(C=O)O)=O,4,1,0,1,15,4.7e-05
G5,C(OC(C=O)CC(CO)=O)=O,2,2,0,2,15,9.499999999999999e-05
G5,C(OCCC(CO)=O)=O,1,2,0,2,27,9.499999999999999e-05
G5,C(C(C(CC(CO)=O)OC=O)O)=O,4,2,0,2,1,9.499999999999999e-05
G5,C(OC(CO)(C)CC(CO)=O)=O,2,2,0,2,49,9.499999999999999e-05
G5,C(OC(C)CC(CO)=O)=O,2,2,0,2,4,9.499999999999999e-05
G5,C(CO)(C(CO)OC(C=O)O)=O,4,3,0,3,5,0.00014199999999999998
G5,C(C)(C(C(CO)O)(OCC=O)O)=O,4,2,0,2,0,9.6e-05
G5,C(C(CO)O)(OCC(C(C)=O)O)=O,4,2,0,2,2,9.7e-05
G5,C(CCO)(OCC(C(CO)=O)O)=O,2,3,0,3,5,0.00014199999999999998
G5,C(C(CO)O)(OCCC(CO)=O)=O,2,3,0,3,9,0.000144
G5,C(C(C(CO)O)(OCC(C)=O)O)=O,4,2,0,2,32,9.6e-05
G5,C(CCOC(CO)(C(C=O)O)O)=O,4,2,0,2,5,9.499999999999999e-05
G5,C(CC(O)OCCC(C=O)=O)=O,2,2,0,2,33,9.499999999999999e-05
G5,C(C)(C(C=O)COC(CO)=O)=O,2,1,0,1,30,4.7e-05
G5,C(OCC(C(C)=O)C(CO)=O)=O,2,3,0,3,12,0.00014199999999999998
G5,C1(CC(C(CO1)O)=O)=O,2,3,0,3,29,0.00014199999999999998
G5,C(CC=O)(OCC(C(C)=O)O)=O,2,1,0,1,3,4.7e-05
G5,C(C)(OCC(C=O)C(CO)=O)=O,2,2,0,2,26,9.499999999999999e-05
G5,C1(C(C(CCO1)=O)O)=O,2,3,0,3,29,0.00014199999999999998
G5,C(CC=O)(OCCC(CO)=O)=O,1,2,0,2,9,9.499999999999999e-05
G5,C1(CCOC(C1)=O)=O,1,3,0,3,41,0.00014199999999999998
G5,C(C(C=O)O)(OCCC(C)=O)=O,2,1,0,1,41,4.7e-05
G5,C(CO)(C(COC=O)CC=O)=O,2,2,0,2,43,9.499999999999999e-05
G5,C1(CCOC(C1)O)=O,2,5,0,5,2,0.00023700000000000001
G5,C(C)(C(COC=O)C(C=O)O)=O,4,1,0,1,2,4.7e-05
G5,C(C(C(O)OCCC(C=O)=O)O)=O,4,8,0,8,3,0.00037999999999999997
G5,C(C(C=O)OC(C(CCO)=O)O)=O,2,2,0,2,15,9.499999999999999e-05
G5,C(COC(C(C(C=O)CO)=O)O)=O,4,2,0,2,15,9.499999999999999e-05
G5,C(COC(C(CCO)=O)O)(C)=O,2,3,0,3,49,0.00014199999999999998
G5,C(C(CCO)(OCC(C)=O)O)=O,2,1,0,1,3,4.7e-05
G5,C(C(CCOC(C=O)(C)O)O)=O,4,2,0,2,3,9.499999999999999e-05
G5,C(C(C(O)OCCC(CO)=O)O)=O,4,5,0,5,12,0.00023700000000000001
G5,C(C(CC(OCC(C)=O)O)O)=O,4,4,0,4,43,0.00018999999999999998
G5,C(C(C)(CC(OCC=O)O)O)=O,4,2,0,2,16,9.499999999999999e-05
G5,C(C(C=O)C(C(OCC=O)O)O)=O,4,2,0,2,43,9.499999999999999e-05
G5,C(C(C=O)OC(C(CC=O)O)O)=O,4,5,0,5,43,0.00023700000000000001
G5,C(CC(C(C=O)OC(C=O)O)O)=O,8,2,0,2,43,9.499999999999999e-05
G5,C(C(CC(CO)(OCC=O)O)O)=O,4,4,0,4,51,0.00018999999999999998
G5,C(C(C(C(C)(OCC=O)O)O)O)=O,8,5,0,5,24,0.00023700000000000001
G5,C(C)(C(CO)C(C)OC(C=O)=O)=O,4,1,0,1,4,4.7e-05
G5,C1(CC(C=O)(O)OC(C)C1)=O,4,3,0,3,4,0.00014199999999999998
G5,C(CC(C(C)=O)OC(C=O)(C)O)=O,4,1,0,1,45,4.7e-05
G5,C(CC(C=O)(C)OC(C(C)=O)O)=O,4,1,0,1,22,4.7e-05
G5,C(CC(O)OC(C)CC(C=O)=O)=O,4,2,0,2,4,9.499999999999999e-05
G5,C(C)(CC(CC=O)OC(CO)=O)=O,2,1,0,1,26,4.7e-05
G5,C(CC(CO)(CC(C)=O)OC=O)=O,2,1,0,1,26,4.7e-05
G5,C(C)(C(C=O)C(C)OC(CO)=O)=O,4,1,0,1,4,4.7e-05
G5,C(OC(C)C(C(C)=O)C(CO)=O)=O,4,3,0,3,2,0.00014199999999999998
G5,C1(CC(C(C(C)O1)O)=O)=O,4,4,0,4,29,0.00018999999999999998
G5,C(CC=O)(OC(C)C(C(C)=O)O)=O,4,1,0,1,4,4.7e-05
G5,C(C)(OC(CC=O)CC(CO)=O)=O,2,2,0,2,9,9.499999999999999e-05
G5,C(CC(C)(C(C(C)=O)O)OC=O)=O,4,1,0,1,6,4.7e-05
G5,C(C)(OC(C)C(C=O)C(CO)=O)=O,4,2,0,2,9,9.499999999999999e-05
G5,C1(C(C(CC(C)O1)=O)O)=O,4,2,0,2,9,9.499999999999999e-05
G5,C(CC=O)(OC(C)CC(CO)=O)=O,2,2,0,2,9,9.499999999999999e-05
G5,C(CC(C(C(C)=O)O)OC(C)=O)=O,4,1,0,1,26,4.7e-05
G5,C(CC(C)(CC(CO)=O)OC=O)=O,2,2,0,2,6,9.499999999999999e-05
G5,C1(CC(C)OC(C1)=O)=O,2,3,0,3,4,0.00014199999999999998
G5,C(C(C=O)O)(OC(C)CC(C)=O)=O,4,1,0,1,4,4.7e-05
G5,C(CO)(C(C(C)OC=O)CC=O)=O,4,2,0,2,4,9.499999999999999e-05
G5,C(C)(C(C)(OC(C=O)CC=O)O)=O,4,1,0,1,21,4.7e-05
G5,C(C)(C(C)(CC=O)OC(C=O)O)=O,4,1,0,1,21,4.7e-05
G5,C1(CC(C)OC(C1)O)=O,4,3,0,3,4,0.00014199999999999998
G5,C(C)(C(C(C)OC=O)C(C=O)O)=O,8,1,0,1,4,4.7e-05
G5,C(C(CC(OCC(C=C)=O)O)O)=O,4,2,0,2,7,9.499999999999999e-05
G5,C(C(C=C)(CC(OCC=O)O)O)=O,4,2,0,2,7,9.499999999999999e-05
G5,C(CO)(CC(C(OCC=O)O)O)=O,4,4,0,4,20,0.00018999999999999998
G5,C(CO)(CC(COC(C=O)O)O)=O,4,4,0,4,20,0.00018999999999999998
G5,C(C)(C(C(C(OCC=O)O)O)O)=O,8,5,0,5,26,0.00023700000000000001
G5,C(C(C)(C(C(OCC=O)O)O)O)=O,8,2,0,2,0,9.499999999999999e-05
G5,C(C(C(C(OCC=O)O)O)O)=O,8,5,0,5,15,0.00023700000000000001
G5,C(OCC(C(CO)=O)C(CO)O)=O,4,2,0,2,27,9.499999999999999e-05
G5,C(C(C(C(OCC=O)O)CO)O)=O,8,3,0,3,55,0.00014199999999999998
G5,C(C(COC(C(C(C)=O)O)O)O)=O,8,6,0,6,1,0.000285
G5,C(OCC(C(C(C(C)=O)O)O)O)=O,8,3,0,3,1,0.00014199999999999998
G5,C(C(C(C)(O)OCC(C=O)O)O)=O,8,6,0,6,26,0.000285
G5,C(C(C(C(COC(C)=O)O)O)O)=O,8,3,0,3,26,0.00014199999999999998
G5,C(C(CCOC(C(CO)=O)O)O)=O,4,2,0,2,3,9.499999999999999e-05
G5,C(C(C(O)OCC(C=O)O)O)=O,8,7,0,7,1,0.000332
G5,C(OCC(C(C(C=O)O)O)O)=O,8,3,0,3,1,0.00014199999999999998
G5,C(COC(C=O)O)(C(CO)O)=O,4,3,0,3,5,0.00014199999999999998
G5,C(C(C(O)OCC(C(C)=O)O)O)=O,8,6,0,6,12,0.000285
G5,C(OCC(C(C)(C(C=O)O)O)O)=O,8,3,0,3,12,0.00014199999999999998
G5,C(CO)(COC(C(CO)=O)(C)O)=O,2,2,0,2,5,9.499999999999999e-05
G5,C(CO)(C(C)OC(C(CO)=O)O)=O,4,2,0,2,25,9.499999999999999e-05
G5,C(CC(O)OCC(C(CO)=O)O)=O,4,3,0,3,12,0.00014199999999999998
G5,C(OCC(C(C)=O)(C(C)=O)O)=O,1,1,0,1,12,4.7e-05
G5,C(C(C(C)=O)(COC(C)=O)O)=O,2,1,0,1,26,4.7e-05
G5,C(C(CCOC(C(C=O)=O)O)O)=O,4,2,0,2,3,9.499999999999999e-05
G5,C(C(CCOC=O)(C(C=O)O)O)=O,4,3,0,3,3,0.00014199999999999998
G5,C(OCCC(CO)(C(C=O)O)O)=O,4,3,0,3,12,0.00014199999999999998
G5,C(C(C=O)OC(CC(C=O)O)O)=O,4,5,0,5,43,0.00023700000000000001
G5,C(C(C(CC(C=O)OC=O)O)O)=O,8,3,0,3,43,0.00014199999999999998
G5,C(OC(C)C(C(C)=O)(C(C)=O)O)=O,2,1,0,1,9,4.7e-05
G5,C(C(C(C)=O)(C(C)OC(C)=O)O)=O,4,1,0,1,2,4.7e-05
G5,C(C(C(COC(C=O)(C)O)O)O)=O,8,3,0,3,24,0.00014199999999999998
G5,C(C)(C(C(COC(C=O)O)O)O)=O,8,3,0,3,26,0.00014199999999999998
G5,C(OCC(C(C)=O)(C(CO)O)O)=O,4,1,0,1,12,4.7e-05
G5,C1(C(O)OCC(C1O)O)=O,8,2,0,2,41,9.499999999999999e-05
G5,C(C(C(C(O)OCC(C)=O)=O)O)=O,4,1,0,1,51,4.7e-05
G5,C(COC(C(C(C)O)=O)O)(C)=O,4,1,0,1,41,4.7e-05
G5,C(OCC(C(CO)=O)(CCO)O)=O,2,2,0,2,2,9.499999999999999e-05
G5,C(COC(C(CO)=O)(CO)O)(C)=O,2,2,0,2,32,9.7e-05
G5,C(CC(CO)(C(OCC=O)O)O)=O,4,2,0,2,43,9.499999999999999e-05
G5,C(C)(C(O)OCC(C(C)=O)=O)=O,2,1,0,1,45,4.7e-05
G5,C(C)(C(COC=O)(CC=O)O)=O,2,1,0,1,12,4.7e-05
G5,C1(C(COC(C1)O)=O)=O,2,3,0,3,12,0.00014199999999999998
G5,C(C)(C(C)(OCC(C=O)=O)O)=O,2,1,0,1,14,4.7e-05
G5,C(C(C=O)(CC(OCC=O)O)O)=O,2,2,0,2,1,9.499999999999999e-05
G5,C(C(OC(C(C(C)=O)=O)C)O)(C)=O,4,1,0,1,45,4.7e-05
G5,C(C)(C(C(C)OC=O)(CC=O)O)=O,4,1,0,1,4,4.7e-05
G5,C(C)(C(C)(OC(C(C=O)=O)C)O)=O,4,1,0,1,14,4.7e-05
G5,C(CC1C(OCC(C1)=O)O)=O,4,4,0,4,43,0.00019099999999999998
G5,C1(COC(CC1CC=O)O)=O,4,3,0,3,46,0.00014199999999999998
G5,C(COC(CC(C=O)CC=O)O)=O,4,2,0,2,43,9.499999999999999e-05
G5,C(CC(C(O)OCC(C=O)O)O)=O,8,5,0,5,43,0.00023700000000000001
G5,C(CC(C(COC(C=O)O)O)O)=O,8,2,0,2,30,9.499999999999999e-05
G5,C(CC(OCC=O)O)(C(C=O)O)=O,4,2,0,2,1,9.499999999999999e-05
G5,C(C(C(OCC=O)O)O)(CC=O)=O,4,2,0,2,1,9.499999999999999e-05
G5,C(COC(C(CC(C=O)=O)O)O)=O,4,2,0,2,0,9.499999999999999e-05
G5,C(C(C=O)COC(C(C)=O)O)=O,2,2,0,2,41,9.499999999999999e-05
G5,C(CCOC(C(CC=O)=O)O)=O,2,2,0,2,23,9.499999999999999e-05
G5,C(C(COC=O)C(C(C)=O)O)=O,4,1,0,1,23,4.7e-05
G5,C(CCOC(CC(C=O)=O)O)=O,2,2,0,2,23,9.499999999999999e-05
G5,C(C(COC=O)CC(CO)=O)=O,2,2,0,2,55,9.499999999999999e-05
G5,C1(CC(C)OC(C(C1)=O)O)=O,4,4,0,4,4,0.00018999999999999998
G5,C(CC(C(C)=O)OC(CC=O)O)=O,4,1,0,1,13,4.7e-05
G5,C(CC(CC=O)OC(C(C)=O)O)=O,2,1,0,1,13,4.7e-05
G5,C(C(C=O)C(C)OC(C(C)=O)O)=O,4,1,0,1,23,4.7e-05
G5,C(CC(C)OC(C(CC=O)=O)O)=O,4,2,0,2,23,9.499999999999999e-05
G5,C(OC(C)C(C(C(C)=O)=O)CO)=O,4,1,0,1,4,4.7e-05
G5,C1(C(CC(O)OC(C)C1)=O)=O,4,4,0,4,4,0.00018999999999999998
G5,C(CC(OC(C(C)=O)C(C)=O)O)=O,2,1,0,1,9,4.7e-05
G5,C(CC(CC(C(C)=O)O)OC=O)=O,4,1,0,1,13,4.7e-05
G5,C(C(C(C)OC=O)C(C(C)=O)O)=O,8,1,0,1,4,4.7e-05
G5,C(CC(C)OC(CC(C=O)=O)O)=O,4,2,0,2,4,9.499999999999999e-05
G5,C(C(C(C)=O)OC(CC(C)=O)O)=O,4,1,0,1,6,4.7e-05
G5,C(CC(CCC(CO)=O)OC=O)=O,2,2,0,2,44,9.499999999999999e-05
G5,C(C(C(C)OC=O)CC(CO)=O)=O,4,2,0,2,46,9.499999999999999e-05
G5,C(C)(CC(OC(C=O)CC=O)O)=O,4,1,0,1,6,4.7e-05
G5,C(CC(C(CC(C)=O)O)OC=O)=O,4,1,0,1,6,4.7e-05
G5,C(C)(CC(CC=O)OC(C=O)O)=O,4,1,0,1,26,4.7e-05
G5,C(C)(C(C=O)C(C)OC(C=O)O)=O,8,1,0,1,37,4.7e-05
G5,C(CCOC(C(C(C=O)O)O)O)=O,8,2,0,2,23,9.499999999999999e-05
G5,C(CO)(CCOC(C(CO)=O)O)=O,2,2,0,2,2,9.499999999999999e-05
G5,C(C(CC(O)OCC(C=O)O)O)=O,8,5,0,5,38,0.00023700000000000001
G5,C(CO)(CCOC(C(C=O)=O)O)=O,2,2,0,2,3,9.499999999999999e-05
G5,C(OCCC(C(C(C=O)O)O)=O)=O,4,3,0,3,3,0.00014199999999999998
G5,C(CO)(C(COC(C=O)O)(C)O)=O,4,2,0,2,30,9.499999999999999e-05
G5,C(C)(CC(OCC(C=O)=O)O)=O,2,1,0,1,38,4.7e-05
G5,C(C(COC=O)(CC(C)=O)O)=O,2,1,0,1,38,4.7e-05
G5,C(C)(CC(OC(C(C=O)=O)C)O)=O,4,1,0,1,25,4.7e-05
G5,C(C(C(C)OC=O)(CC(C)=O)O)=O,4,1,0,1,25,4.7e-05
G5,C(C)(C(COC(C(CO)=O)O)O)=O,4,1,0,1,43,4.7e-05
G5,C(CC(COC=O)CC(CO)=O)=O,2,3,0,3,55,0.000144
G5,C(C1CC(OCC(C1)=O)O)=O,4,4,0,4,43,0.00018999999999999998
G5,C1(COC(CCC1)O)=O,2,3,0,3,27,0.00014199999999999998
G5,C1(C(C(CO1)=O)O)=O,2,3,0,3,29,0.00014199999999999998
G5,C(C(C=O)O)(OCC=O)=O,2,2,0,2,17,9.499999999999999e-05
G5,C(C(CO)OC(C(CO)=O)=O)=O,2,2,0,2,29,9.499999999999999e-05
G5,C(C(CC=O)O)(OCC=O)=O,2,2,0,2,29,9.499999999999999e-05
G5,C(C(CCOC(C=O)=O)O)=O,2,3,0,3,29,0.00014199999999999998
G5,C(C(C(C=O)O)O)(OCC=O)=O,4,5,0,5,29,0.00023799999999999998
G5,C(C(COC(C(CO)=O)=O)O)=O,2,2,0,2,29,9.499999999999999e-05
G5,C(C(C(C(C)=O)CC(CO)=O)O)=O,4,4,0,4,32,0.000202
G5,C(C)(C(CO)CC(C(C=O)O)=O)=O,4,4,0,4,29,0.00018999999999999998
G5,C(C)(C(C(CCC=O)=O)(CO)O)=O,2,4,0,4,49,0.000205
G5,C(C(C(C(CCC(C)=O)=O)O)O)=O,4,6,0,6,7,0.000285
G5,C1(C(CCC1(C)O)=O)=O,2,3,0,3,7,0.00014199999999999998
G5,C1(C(C(CC1)(C)O)O)=O,4,4,0,4,7,0.00018999999999999998
G5,C(C)(CCC(C=O)=O)=O,1,15,0,15,7,0.000712
G5,C(C)(CCC(CO)=O)=O,1,6,0,6,7,0.000285
G5,C(CCC(C=O)=O)(OCC(C)=O)=O,1,1,0,1,35,4.7e-05
G5,C(COC=O)(CCCC(C=O)=O)=O,1,2,0,2,7,9.499999999999999e-05
G5,C(C)(C(CCC(C=O)=O)OC=O)=O,2,2,0,2,7,9.499999999999999e-05
G5,C(CCC(CO)=O)(OCC(C)=O)=O,1,1,0,1,35,4.7e-05
G5,C(CO)(CCCC(COC=O)=O)=O,1,2,0,2,7,9.499999999999999e-05
G5,C(C)(C(CCC(CO)=O)OC=O)=O,2,2,0,2,7,9.499999999999999e-05
G5,C(C(C(OCC(C)=O)=O)CC=O)=O,2,1,0,1,35,4.7e-05
G5,C(OCC(CC(C=O)CC=O)=O)=O,2,2,0,2,35,9.499999999999999e-05
G5,C(OC(C(C)=O)C(C=O)CC=O)=O,4,2,0,2,43,9.499999999999999e-05
G5,C(C(CC(CO)CO)=O)=O,1,4,0,4,55,0.000212
G5,C(C(CC(CO)CCO)=O)=O,2,5,0,5,29,0.00026000000000000003
G5,C(C(CC(CO)C(C)O)=O)=O,4,2,0,2,46,9.499999999999999e-05
G5,C(CO)(CC(CO)CO)=O,1,7,0,7,55,0.00035499999999999996
G5,C(C(CO)CC(CO)=O)(O)=O,2,4,0,4,29,0.00020099999999999998
G5,C(CO)(C(CO)CC(O)=O)=O,2,5,0,5,29,0.00024900000000000004
G5,C(C(CO)CC(O)=O)=O,2,5,0,5,55,0.00024900000000000004
G5,C1(COC(C(CO)C1)O)=O,4,4,0,4,55,0.00018999999999999998
G5,C(OCC(CO)CC(CO)=O)=O,2,3,0,3,55,0.000143
G5,C(CO)(CC(CO)CCO)=O,2,4,0,4,46,0.00020099999999999998
G5,C(CO)(CC(CO)C(C)O)=O,4,4,0,4,46,0.00020099999999999998
G5,C1(COC(C(CCO)C1)O)=O,4,4,0,4,46,0.00018999999999999998
G5,C1(COC(C(C(C)O)C1)O)=O,8,4,0,4,46,0.00018999999999999998
G5,C(OCC(CCO)CC(CO)=O)=O,2,3,0,3,46,0.000143
G5,C(OCC(C(C)O)CC(CO)=O)=O,4,3,0,3,46,0.000143
G5,C1(C(C(C(C1(CCO)O)O)O)O)=O,16,2,0,2,5,9.499999999999999e-05
G5,C(C1(C(C(CC(C1)O)O)=O)O)=O,8,1,0,1,20,4.7e-05
G5,C(C1(CC(C(C(C1)O)=O)O)O)=O,3,1,0,1,51,4.7e-05
G5,C1(C(C(CO)C(C(C1)=O)O)O)=O,3,2,0,2,5,9.499999999999999e-05
G5,C1(C(C(C)(C(CO)C1O)O)O)=O,16,1,0,1,3,4.7e-05
G5,C1(C(C(CC1O)(CCO)O)O)=O,8,1,0,1,3,4.7e-05
G5,C1(C(C(CO)C(C1(C)O)O)O)=O,16,2,0,2,45,9.499999999999999e-05
G5,C1(C(CC(C1(C)O)O)O)=O,8,2,0,2,45,9.499999999999999e-05
G5,C1(C(CC(CC1(CO)O)O)O)=O,8,1,0,1,49,4.7e-05
G5,C1(C(CC(CO)(CC1O)O)O)=O,3,1,0,1,49,4.7e-05
G5,C1(C(CC(C(C1(C)O)O)O)O)=O,16,2,0,2,49,9.499999999999999e-05
G5,C1(C(CC(CC1O)O)O)=O,3,1,0,1,2,4.7e-05
G5,C(C(C1C(C(CC1O)O)O)O)=O,32,1,0,1,21,4.7e-05
G5,C1(C(CC(C(CC1O)O)O)O)=O,10,1,0,1,21,4.7e-05
G5,C1(C(CC(C1(C(CO)O)O)O)O)=O,16,5,0,5,0,0.000239
G5,C1(CC(CO)C(C(C1O)=O)O)=O,8,2,0,2,5,9.499999999999999e-05
G5,C(C1(C(C(CC1CO)O)=O)O)=O,8,1,0,1,12,4.7e-05
G5,C(C1(C(C(C(CO)C1)O)=O)O)=O,8,1,0,1,12,4.7e-05
G5,C1(C(CC(C1(CCO)O)O)O)=O,8,1,0,1,3,4.7e-05
G5,C(C(C1C(C(C(C1O)O)O)O)O)=O,20,3,0,3,29,0.000164
G5,C1(C(CC(C(C(C=O)O)C1)O)O)=O,16,1,0,1,7,4.7e-05
G5,C1(C(CC(C(C(CC1)O)=O)O)O)=O,8,1,0,1,7,4.7e-05
G5,C(C1(CC(C(C1)O)C(C=O)O)O)=O,16,1,0,1,29,4.7e-05
G5,C(C1(CC(C(C(CC1)O)=O)O)O)=O,8,1,0,1,29,4.7e-05
G5,C1(CC(C(C)O)C(C(C1O)=O)O)=O,16,1,0,1,12,4.7e-05
G5,C(C1(C(C(CC1C(C)O)O)=O)O)=O,16,1,0,1,12,4.7e-05
G5,C(C1(C(C(C(C1)C(C)O)O)=O)O)=O,16,1,0,1,12,4.7e-05
G5,C1(C(CC(CC(C(C1)=O)O)O)O)=O,3,1,0,1,22,4.7e-05
G5,C1(C(C(C(C)O)C(C(C1)=O)O)O)=O,6,1,0,1,22,4.7e-05
G5,C(CC1C(CC(C(C1O)=O)O)O)=O,16,1,0,1,18,4.7e-05
G5,C(C(C(C1C(CC(C1)O)O)O)=O)=O,16,1,0,1,44,4.7e-05
G5,C1(C(CC(C(C=CC1O)O)O)O)=O,16,1,0,1,32,4.7e-05
G5,C1(C(C(C(CO)C1O)O)=O)=O,3,1,0,1,2,4.7e-05
G5,C(C1(C(C(CC1O)O)=O)O)=O,8,3,0,3,5,0.00014199999999999998
G5,C1(C(CC(C(C1O)=O)O)O)=O,3,2,0,2,5,9.499999999999999e-05
G5,C(C(C1COC(C1O)O)O)=O,16,2,0,2,29,9.499999999999999e-05
G5,C1(C(CCC1(CO)O)O)=O,4,2,0,2,12,0.000106
G5,C(C1(C(C(CC1)O)=O)O)(O)=O,4,2,0,2,12,0.000106
G5,C1(C(CC(C1(C(C)=O)O)O)O)=O,8,3,0,3,0,0.00014199999999999998
G5,C(C1(C(C(CC1(C)O)O)=O)O)=O,8,1,0,1,26,4.7e-05
G5,C1(C(CC(C)(C1(CO)O)O)O)=O,8,1,0,1,25,4.7e-05
G5,C1(C(C(CC1O)O)(C(C=O)O)O)=O,16,5,0,5,0,0.000239
G5,C(C1(C(C(CC(C1O)O)O)=O)O)=O,16,3,0,3,0,0.00014199999999999998
G5,C(C1(C(CC(C(C1O)=O)O)O)O)=O,16,5,0,5,0,0.00023700000000000001
G5,C(C1(C(C(C(CO)C1O)O)=O)O)=O,16,1,0,1,15,4.7e-05
G5,C1(C(CC(C1(C(C)O)O)O)O)=O,16,5,0,5,4,0.00023999999999999998
G5,C1(C(C(CC1O)O)(CC=O)O)=O,8,1,0,1,20,4.7e-05
G5,C(C1(C(C(C(C(C1)O)=O)O)O)O)=O,16,2,0,2,51,9.499999999999999e-05
G5,C1(C(C(CC1O)(C(C)O)O)O)=O,16,1,0,1,41,4.7e-05
G5,C1(C(CO)(CC(C(C1)=O)O)O)=O,4,4,0,4,29,0.000192
G5,C1(C(CC(C(C1)=O)O)(C(C)O)O)=O,8,2,0,2,4,9.6e-05
G5,C1(C(C(C=CC1O)(C(C)O)O)O)=O,16,1,0,1,32,4.7e-05
G5,C(C1C(C(CC1C(CO)O)O)=O)=O,16,2,0,2,46,9.499999999999999e-05
G5,C(CCC1C(C(C(C1O)=O)O)O)=O,16,2,0,2,4,9.499999999999999e-05
G5,C(C(C1CC(C(C(C1)O)=O)O)O)=O,6,1,0,1,32,4.7e-05
G5,C(C1C(C(C(C(C1)=O)O)=O)O)(O)=O,8,1,0,1,12,4.7e-05
G5,C(C1CC(C=O)(C(C1O)=O)O)(O)=O,8,1,0,1,12,4.7e-05
G5,C(C1C(C(CC(C1O)=O)=O)O)(O)=O,3,1,0,1,17,4.7e-05
G5,C(C1C(C(C(C1C=O)O)=O)O)(O)=O,16,1,0,1,17,4.7e-05
G5,C(CC(C(CC(CO)=O)=O)O)(O)=O,2,2,0,2,29,0.000106
G5,C(C)(C(CC(C(C(O)=O)=O)O)O)=O,4,2,0,2,45,0.000106
G5,C(C(C)(CC(C(C(O)=O)=O)O)O)=O,4,2,0,2,16,0.000106
G5,C(CC(C(C(C(C)=O)O)=O)O)(O)=O,4,2,0,2,0,0.000106
G5,C(CC(C(C(C=O)(C)O)=O)O)(O)=O,4,2,0,2,9,0.000106
G5,C(C(C(C(CC(C)O)O)=O)CO)=O,8,1,0,1,4,4.7e-05
G5,C(C(C=O)C(C(CC(C)O)O)=O)=O,4,1,0,1,4,4.7e-05
G5,C(CC(C(CC(C(C)O)O)O)=O)=O,8,1,0,1,11,4.7e-05
G5,C(C(CO)C(C(C(O)=O)=O)O)=O,4,1,0,1,17,4.7e-05
G5,C(C(C(C)O)C(C(C(O)=O)=O)O)=O,8,1,0,1,17,4.7e-05
G5,C(CC(CC(C(C(O)=O)=O)O)O)=O,4,1,0,1,17,4.7e-05
G5,C(C(CO)C(C(C=O)=O)O)(O)=O,4,2,0,2,17,9.499999999999999e-05
G5,C(C(C(C)O)C(C(C=O)=O)O)(O)=O,8,2,0,2,4,9.499999999999999e-05
G5,C(CC(C(C(CC=O)O)=O)O)(O)=O,4,1,0,1,17,4.7e-05
G5,C(C(CO)C(C(CO)=O)O)(O)=O,4,5,0,5,29,0.000262
G5,C(C(C(C)O)C(C(CO)=O)O)(O)=O,8,4,0,4,4,0.00020299999999999997
G5,C(C(C(C(CO)CO)O)=O)(O)=O,2,1,0,1,17,4.7e-05
G5,C(C(C(C(CCO)O)C(C)O)O)=O,16,2,0,2,4,0.000106
G5,C(C(CC(C)O)O)(C(CCO)O)=O,8,2,0,2,3,9.499999999999999e-05
G5,C(C(CC(CCO)O)O)(C(C)O)=O,8,1,0,1,18,4.7e-05
G5,C(CC(C(C(CCO)O)=O)O)(O)=O,4,1,0,1,17,4.7e-05
G5,C(C(C(CC(CCO)O)O)=O)(O)=O,4,1,0,1,18,4.7e-05
G5,C(C(CCO)O)(C(C=CC=O)O)=O,8,3,0,3,29,0.000153
G5,C(C(CCO)O)(C(C=C)O)=O,4,1,0,1,7,4.7e-05
G5,C1(COC(C(CCO)O)C1O)=O,8,1,0,1,10,4.7e-05
G5,C1(C(C(CO1)C(CCO)O)O)=O,8,1,0,1,34,4.7e-05
G5,C(C(CO)C(C(C(C)O)=O)O)(O)=O,8,3,0,3,2,0.000154
G5,C(C(C(C(CO)C(C)O)O)=O)(O)=O,8,1,0,1,17,4.7e-05
G5,C(C(C(CC(CO)(C)O)O)=O)(O)=O,4,2,0,2,49,0.000106
G5,C(CC(C(C(CO)(C)O)=O)O)(O)=O,4,2,0,2,49,0.000106
G5,C(C(C(CC(C)O)O)=O)(O)=O,4,2,0,2,33,0.000106
G5,C(C(C(C(C(C)O)O)C(C)O)O)=O,32,1,0,1,11,4.7e-05
G5,C(CC(C(C(C)O)=O)O)(O)=O,4,3,0,3,28,0.000154
G5,C(C(CC(C(C)O)O)O)(C(C)O)=O,16,1,0,1,11,4.7e-05
G5,C(C(CC(C)O)O)(C(C(C)=O)O)=O,8,2,0,2,25,9.499999999999999e-05
G5,C(C(CC(C)O)O)(C(C=C)O)=O,8,1,0,1,7,4.7e-05
G5,C1(COC(C(CC(C)O)O)C1O)=O,16,1,0,1,10,4.7e-05
G5,C1(C(C(CO1)C(CC(C)O)O)O)=O,16,1,0,1,34,4.7e-05
G5,C(C(CC(CO)O)O)(C(C=C)O)=O,8,1,0,1,7,4.7e-05
G5,C(C(C(C(C=O)O)=O)(CO)O)=O,4,2,0,2,1,0.000106
G5,C(C(C(C(C(CO)=O)O)=O)O)=O,4,3,0,3,0,0.00014199999999999998
G5,C(C(C=O)O)(C(C(C)=O)(CO)O)=O,4,4,0,4,1,0.000205
G5,C(C(C=O)O)(C(C(CO)=O)(C)O)=O,4,2,0,2,25,9.499999999999999e-05
G5,C(C(C(C(C(C)=O)O)=O)(CO)O)=O,4,4,0,4,1,0.000205
G5,C(C(CO)O)(C(C(C(C)=O)=O)O)=O,4,1,0,1,5,4.7e-05
G5,C(C(C(CO)=O)O)(C(C(C)=O)O)=O,4,2,0,2,5,9.499999999999999e-05
G5,C(C(CO)O)(CC(C(CO)=O)=O)=O,2,1,0,1,1,4.7e-05
G5,C(C(C(C(C(C(C)O)=O)O)=O)O)=O,8,2,0,2,25,9.499999999999999e-05
G5,C(C(C(C)O)O)(C(C(C=O)=O)O)=O,8,1,0,1,25,4.7e-05
G5,C(C(C(C(C=O)O)=O)(C(C)O)O)=O,8,2,0,2,1,0.000106
G5,C(C(C(C(C(CC=O)=O)O)=O)O)=O,4,1,0,1,1,4.7e-05
G5,C(CC(C(C(C(C=O)=O)O)=O)O)=O,4,1,0,1,1,4.7e-05
G5,C(C(C(C(C=O)O)=O)(CC=O)O)=O,4,1,0,1,23,4.7e-05
G5,C(C(C(C(CO)O)=O)C(C=O)=O)=O,4,1,0,1,23,4.7e-05
G5,C(C(C=O)O)(C(C(C)=O)(C)O)=O,4,3,0,3,29,0.000153
G5,C(C(C(C1(COC(C1)O)O)=O)O)=O,8,1,0,1,35,4.7e-05
G5,C(C(CO)O)(C1C(COC1O)=O)=O,8,1,0,1,5,4.7e-05
G5,C1(CC(OC1C(C(CO)O)=O)O)=O,8,1,0,1,5,4.7e-05
G5,C(C(C(C(C(C=C)=O)O)=O)O)=O,4,1,0,1,5,4.7e-05
G5,C(C(C(C=O)=O)O)(C(C=C)O)=O,4,1,0,1,5,4.7e-05
G5,C(C(C(C(C=O)O)=O)(C=C)O)=O,4,1,0,1,1,4.7e-05
G5,C(C(C(CO)=O)O)(C(C=C)O)=O,4,2,0,2,5,9.499999999999999e-05
G5,C(C(C(C(C=CC=O)O)=O)O)=O,8,4,0,4,29,0.00018999999999999998
G5,C(C(C(C1(COCC1O)O)=O)O)=O,8,1,0,1,10,4.7e-05
G5,C(C(CO)(C1C(C(CO1)=O)O)O)=O,8,1,0,1,10,4.7e-05
G5,C(C(CO)O)(C1C(C(CO1)O)=O)=O,8,1,0,1,10,4.7e-05
G5,C(CO)(C(C1C(C(CO1)=O)O)O)=O,8,1,0,1,10,4.7e-05
G5,C(C(C(C1(C(O)OCC1)O)=O)O)=O,8,1,0,1,34,4.7e-05
G5,C(C(CO)(C1COC(C1O)=O)O)=O,8,1,0,1,34,4.7e-05
G5,C(C(CO)O)(C1C(C(O)OC1)=O)=O,8,2,0,2,34,9.499999999999999e-05
G5,C1(C(C(CO1)C(C(CO)=O)O)O)=O,8,1,0,1,34,4.7e-05
G5,C(C(C(C(C(C)=O)O)=O)(C)O)(O)=O,4,2,0,2,25,9.6e-05
G5,C(C(C(C)=O)O)(C(C(C)=O)(C)O)=O,4,1,0,1,14,4.7e-05
G5,C(C(C(C)=O)O)(C(C(C=C)=O)O)=O,4,1,0,1,25,4.7e-05
G5,C(C(C=C)O)(C(C(C(C)=O)=O)O)=O,4,1,0,1,25,4.7e-05
G5,C(C(C=C)O)(CC(C(CO)=O)=O)=O,2,1,0,1,25,4.7e-05
G5,C(C(C(C(C(C)=O)O)=O)(C=C)O)=O,4,1,0,1,25,4.7e-05
G5,C(C(C(C)=O)O)(C(C=C)(CO)O)=O,4,2,0,2,29,0.000106
G5,C(C(C=C)O)(C(C(C)=O)(CO)O)=O,4,1,0,1,7,4.7e-05
G5,C(C(C=C)O)(C(C(CO)=O)(C)O)=O,4,1,0,1,25,4.7e-05
G5,C(C(C(C)=O)O)(C(C=CC=O)O)=O,8,2,0,2,25,9.499999999999999e-05
G5,C(CC(C(C(CO)=O)=O)O)(O)=O,2,1,0,1,17,4.7e-05
G5,C(C(C(C)O)O)(CC(C(O)=O)=O)=O,4,1,0,1,49,4.7e-05
G5,C(C(C(C(C)O)=O)O)(C(C=C)O)=O,8,1,0,1,25,4.7e-05
G5,C(C(C(C)O)O)(C(C(C)=O)(C)O)=O,8,1,0,1,25,4.7e-05
G5,C(C)(C(C)(C(C(C(C)=O)O)O)O)=O,8,2,0,2,14,0.000106
G5,C(C(C(C(C(C)O)O)=O)(C=C)O)=O,8,2,0,2,29,0.000106
G5,C(C(CO)(C(C)O)O)(C(C=C)O)=O,8,4,0,4,2,0.000204
G5,C(C(C=O)C(C(C=C)O)=O)=O,2,3,0,3,29,0.00014199999999999998
G5,C(CC(C(C(C=C)O)=O)O)=O,4,2,0,2,4,9.499999999999999e-05
G5,C(C(C=O)C(C(C=CC(C)=O)O)=O)=O,4,1,0,1,45,4.7e-05
G5,C(C(C=O)C(C(C=CCC=O)O)=O)=O,4,1,0,1,45,4.7e-05
G5,C(C(C=O)C(C(CC(C=C)=O)O)=O)=O,2,1,0,1,45,4.7e-05
G5,C(C(C=O)C(C(CC=CC=O)O)=O)=O,4,1,0,1,45,4.7e-05
G5,C(CC(C1C(C(CO1)=O)O)O)=O,8,1,0,1,10,4.7e-05
G5,C(CC(C1COC(C1O)=O)O)=O,8,2,0,2,33,9.499999999999999e-05
G5,C(CC(C(CC(C(O)=O)=O)=O)O)=O,2,1,0,1,23,4.7e-05
G5,C(CC(C(O)=O)=O)(C(C=C)O)=O,2,1,0,1,7,4.7e-05
G5,C(C(C(C(C=C)O)=O)(C)O)(O)=O,4,1,0,1,7,4.7e-05
G5,C(C(C)(C1C(C(CO1)=O)O)O)(O)=O,8,1,0,1,10,4.7e-05
G5,C(C(C)(C1COC(C1O)=O)O)(O)=O,8,1,0,1,34,4.7e-05
G5,C(CC(C(C(O)=O)=O)O)(O)=O,2,1,0,1,17,4.7e-05
G5,C(C(CC(C(C(O)=O)=O)O)O)(O)=O,4,1,0,1,33,4.7e-05
G5,C(C(C(C(O)=O)=O)O)=CC=O,4,3,0,3,29,0.000154
G5,C=CC(C(C(O)=O)=O)O,2,1,0,1,17,4.7e-05
G5,C(C(C(C(O)=O)=O)O)(CC(C)=O)=O,2,1,0,1,26,4.7e-05
G5,C(CCC(C(C(C(O)=O)=O)O)=O)=O,2,1,0,1,17,4.7e-05
G5,C(C(C(CC(C(C)=O)=O)O)=O)(O)=O,2,1,0,1,24,4.7e-05
G5,C(CO)=CC(C(C(C(O)=O)=O)O)=O,4,1,0,1,55,4.7e-05
G5,C(C(C(C(O)=O)=O)O)=CC(CO)=O,4,1,0,1,32,4.7e-05
G5,C(CO)(CCC(C(C(O)=O)=O)O)=O,2,3,0,3,29,0.000154
G5,C(C(CC(CO)=O)C(C=O)O)(O)=O,4,3,0,3,29,0.000155
G5,C(C(CO)C(C(C(C)=O)=O)O)(O)=O,4,5,0,5,29,0.000262
G5,C(C(CC=O)C(C(CO)=O)O)(O)=O,4,3,0,3,5,0.000154
G5,C(C(CCO)C(C(C=O)=O)O)(O)=O,4,1,0,1,17,4.7e-05
G5,C(C(C(C(O)=O)=O)O)=CC(CO)O,8,1,0,1,29,4.7e-05
G5,C(C1C(C(C(C1CO)=O)=O)O)(O)=O,8,1,0,1,17,4.7e-05
G5,C(C1C(C(C(C(C)=O)O1)=O)O)(O)=O,8,1,0,1,17,4.7e-05
G5,C(C1C(C(C(CC=O)O1)=O)O)(O)=O,8,1,0,1,9,4.7e-05
G5,C1(C(C(C(O)=O)C(C(C)=O)O1)O)=O,8,1,0,1,22,4.7e-05
G5,C(C1C(CC=O)OC(C1O)=O)(O)=O,8,1,0,1,23,4.7e-05
G5,C1(CC(C(O)=O)C(C(CO1)=O)O)=O,4,1,0,1,17,4.7e-05
G5,C(C1COC(CC(C1O)=O)=O)(O)=O,4,1,0,1,19,4.7e-05
G5,C(C1C(C(C(CCO1)=O)=O)O)(O)=O,4,1,0,1,36,4.7e-05
G5,C(C1COCC(C(C1O)=O)=O)(O)=O,4,1,0,1,36,4.7e-05
G5,C(C1C(C(CC(CO1)=O)=O)O)(O)=O,4,1,0,1,17,4.7e-05
G5,C1(C(C(C(O)=O)CC(CO1)=O)O)=O,4,1,0,1,12,4.7e-05
G5,C(C1C(C(CO1)=O)O)(O)=O,4,2,0,2,17,9.499999999999999e-05
G5,C(C1COC(C1O)=O)(O)=O,4,1,0,1,17,4.7e-05
G5,C(C(C(CC(C(C)O)O)O)=O)(O)=O,8,1,0,1,11,4.7e-05
G5,C(C(C1C(C(CO1)=O)O)O)(O)=O,8,2,0,2,29,9.499999999999999e-05
G5,C1(C(C(CO1)C(C(O)=O)O)O)=O,8,1,0,1,34,4.7e-05
G5,C(C(C=C)O)(C(C(C)=O)C(C=O)=O)=O,4,1,0,1,7,4.7e-05
G5,C(CC(C(C=C)O)=O)(CC(C=O)=O)=O,2,1,0,1,7,4.7e-05
G5,C(C(C(C(C=C)O)=O)C(C=O)=O)=O,4,1,0,1,23,4.7e-05
G5,C(CC(C(C(C(C=C)O)=O)O)=O)=O,4,1,0,1,23,4.7e-05
G5,C(C(C(C(C=C)O)=O)(CC=O)O)=O,4,1,0,1,23,4.7e-05
G5,C(C(CC(C=O)=O)O)(C(C=C)O)=O,4,1,0,1,23,4.7e-05
G5,C(C(C(C(C=C)O)=O)C(C(C)=O)=O)=O,4,1,0,1,14,4.7e-05
G5,C(CC(C(CC(C(C=C)O)=O)=O)=O)=O,2,1,0,1,14,4.7e-05
G5,C(C(C=C)O)(CC(C(C)=O)=O)=O,2,2,0,2,24,9.499999999999999e-05
G5,C(C(C=C)O)(C(C(C)=O)(C)O)=O,4,1,0,1,14,4.7e-05
G5,C(C)(C(C)(C1C(C(CO1)=O)O)O)=O,8,1,0,1,10,4.7e-05
G5,C1(C(C(CO1)C(C(C)=O)(C)O)O)=O,8,1,0,1,34,4.7e-05
G5,C(C(C(C(C=C)O)=O)C(C)=O)=O,4,2,0,2,2,9.499999999999999e-05
G5,C(C(C)(CC=O)O)(C(C=C)O)=O,4,1,0,1,7,4.7e-05
G5,C(C(CC(C)=O)O)(C(C=C)O)=O,4,1,0,1,7,4.7e-05
G5,C(C)(CC(C1C(C(CO1)=O)O)O)=O,8,1,0,1,10,4.7e-05
G5,C(CC(C)(C1COC(C1O)=O)O)=O,8,1,0,1,34,4.7e-05
G5,C1(C(C(C(CC(C)=O)O)CO1)O)=O,8,1,0,1,34,4.7e-05
G5,C(C(C=C)O)(C1C(COC1O)=O)=O,8,1,0,1,7,4.7e-05
G5,C(C1C(CC(O1)O)=O)(C(C=C)O)=O,8,1,0,1,7,4.7e-05
G5,C(C1(COC(C1)O)O)(C(C=C)O)=O,8,1,0,1,7,4.7e-05
G5,C(C(C(C=C)=O)O)(C(C=CC=O)O)=O,8,1,0,1,7,4.7e-05
G5,C(C(C(C=CC=O)=O)O)(C(C=C)O)=O,8,1,0,1,7,4.7e-05
G5,C(C(C(C(C=CC=O)O)=O)(C=C)O)=O,8,1,0,1,7,4.7e-05
G5,C(C(C=CC=O)O)(C(C=CC=O)O)=O,10,1,0,1,43,4.7e-05
G5,C(C(C=C)O)(C(C(C=C)=O)O)=O,4,2,0,2,32,9.499999999999999e-05
G5,C(C(C(C(C=C)O)=O)(C=C)O)=O,4,2,0,2,2,9.499999999999999e-05
G5,C(C1C(C(CO1)O)=O)(C(C=C)O)=O,8,1,0,1,10,4.7e-05
G5,C1(COC(C1O)C(C(C=C)=O)O)=O,8,1,0,1,10,4.7e-05
G5,C(C(C=C)(C1C(C(CO1)=O)O)O)=O,8,1,0,1,10,4.7e-05
G5,C(C(C=C)O)(C1C(C(O)OC1)=O)=O,8,1,0,1,7,4.7e-05
G5,C1(C(C(CO1)C(C(C=C)=O)O)O)=O,8,1,0,1,7,4.7e-05
G5,C(C(C=C)(C1COC(C1O)=O)O)=O,8,1,0,1,34,4.7e-05
G5,C(C(C=C)O)(C(C=C)(CO)O)=O,4,1,0,1,7,4.7e-05
G5,C(C(C=C)O)(C(C=CC=O)O)=O,8,3,0,3,29,0.00014199999999999998
G5,C(C1(COCC1O)O)(C(C=C)O)=O,8,1,0,1,10,4.7e-05
G5,C1(COC(C1O)C(C=C)(CO)O)=O,8,1,0,1,10,4.7e-05
G5,C(C1(C(O)OCC1)O)(C(C=C)O)=O,8,1,0,1,7,4.7e-05
G5,C1(C(C(CO1)C(C=C)(CO)O)O)=O,8,1,0,1,34,4.7e-05
G5,C1(COC(C1O)C(C=CC=O)O)=O,16,1,0,1,10,4.7e-05
G5,C1(C(C(CO1)C(C=CC=O)O)O)=O,16,1,0,1,34,4.7e-05
G5,C1(COC(C(C(C)O)O)C1O)=O,16,1,0,1,10,4.7e-05
G5,C1(C(C(CO1)C(C(C)O)O)O)=O,16,1,0,1,34,4.7e-05
G5,C(CO)(C1(C(C(C(C1)O)O)O)O)=O,16,2,0,2,0,9.499999999999999e-05
G5,C(C(CC(C=O)(C(CO)=O)O)O)=O,4,3,0,3,51,0.000153
G5,C(C(C(CO)=O)(CC(C)O)O)=O,4,1,0,1,0,4.7e-05
G5,C(CC(C(CC(CO)O)O)=O)=O,4,3,0,3,29,0.000154
G5,C(CO)(C(C(CO)O)(CCO)O)=O,4,3,0,3,0,0.000155
G5,C(C(C(CO)=O)(C(CO)CO)O)=O,2,2,0,2,29,0.000106
G5,C(CO)(C(CO)(C(CO)CO)O)=O,2,3,0,3,29,0.000164
G5,C(CO)(C(CO)(CC(C)O)O)=O,4,2,0,2,0,9.7e-05
G5,C(C(C(C(CO)O)C(C)O)O)=O,16,2,0,2,11,0.000106
G5,C(C(CC(CO)O)O)(C(C)O)=O,8,3,0,3,49,0.000154
G5,C(C(C(CO)=O)(CC(CO)O)O)=O,4,2,0,2,29,0.000106
G5,C(C(C(C(CO)O)C(CO)O)O)=O,6,2,0,2,0,0.000106
G5,C(CO)(C(C(CO)=O)(C)O)=O,1,1,0,1,0,4.7e-05
G5,C(C(CO)=O)(C(CC(CO)O)O)=O,4,4,0,4,2,0.00018999999999999998
G5,C(CO)(C(CO)(CC(O)=O)O)=O,2,3,0,3,0,0.000156
G5,C(C(C(CO)=O)(CC(C)=O)O)=O,2,3,0,3,29,0.000153
G5,C(CC(C(CO)=O)(C(C)=O)O)=O,2,3,0,3,29,0.00014199999999999998
G5,C(CC=O)(C(C(CO)=O)(C)O)=O,2,3,0,3,29,0.000153
G5,C(C(C(CO)=O)(C=C)O)=O,2,3,0,3,29,0.00014199999999999998
G5,C(C(C(CO)=O)(CCO)O)(O)=O,2,4,0,4,29,0.000213
G5,C(CO)(C(C(C=CC(C)=O)=O)O)=O,4,1,0,1,45,4.7e-05
G5,C(C(C=O)O)(C(C=CC(C)=O)O)=O,8,1,0,1,45,4.7e-05
G5,C(C(C(CO)=O)(C=CC(C)=O)O)=O,4,1,0,1,45,4.7e-05
G5,C(CO)(C(C=CC(C=O)=O)(C)O)=O,4,1,0,1,45,4.7e-05
G5,C(CC=CC(C(C(CO)=O)O)=O)=O,4,1,0,1,29,4.7e-05
G5,C(C(C(C(C=CCC=O)O)=O)O)=O,8,1,0,1,29,4.7e-05
G5,C(C(C(CO)=O)(C=CCC=O)O)=O,4,1,0,1,45,4.7e-05
G5,C(CO)(C(CC=CC(C=O)=O)O)=O,4,1,0,1,45,4.7e-05
G5,C(CO)(C(C=CC(C(C)=O)=O)O)=O,4,1,0,1,45,4.7e-05
G5,C(CO)(C(C(C)=O)(C=CC=O)O)=O,4,1,0,1,45,4.7e-05
G5,C(CO)(C(C(C=CC=O)=O)(C)O)=O,4,1,0,1,45,4.7e-05
G5,C(CC(C=CC(C(CO)=O)O)=O)=O,4,1,0,1,45,4.7e-05
G5,C(CC(C(CO)=O)(C=CC=O)O)=O,4,1,0,1,45,4.7e-05
G5,C(C(C(CO)=O)O)(CC(C=C)=O)=O,2,1,0,1,27,4.7e-05
G5,C(C(C(C(CC(C=C)=O)O)=O)O)=O,4,1,0,1,27,4.7e-05
G5,C(C(C(CO)=O)(CC(C=C)=O)O)=O,2,1,0,1,0,4.7e-05
G5,C(CO)(C(CC(C(C=C)=O)=O)O)=O,2,1,0,1,0,4.7e-05
G5,C(CC(C(CO)=O)(C(C=C)=O)O)=O,2,1,0,1,0,4.7e-05
G5,C(CC(C(C(CO)=O)(C=C)O)=O)=O,2,1,0,1,0,4.7e-05
G5,C(C(C(CO)=O)O)(CC=CC=O)=O,4,1,0,1,27,4.7e-05
G5,C(C(C(C(CC=CC=O)O)=O)O)=O,8,1,0,1,27,4.7e-05
G5,C(C(C(CO)=O)(CC=CC=O)O)=O,4,1,0,1,27,4.7e-05
G5,C(CO)(C(C=CCC(C=O)=O)O)=O,4,1,0,1,27,4.7e-05
G5,C(CO)(C1(COCC1O)O)=O,4,3,0,3,36,0.00014199999999999998
G5,C(CO)(C1(C(O)OCC1)O)=O,4,2,0,2,55,9.499999999999999e-05
G5,C1(C(C(CO1)C(CO)O)O)=O,8,2,0,2,29,9.499999999999999e-05
G5,C(C(C(C(CO)(CO)O)=O)O)=O,2,4,0,4,2,0.000205
G5,C(C(CO)O)(C(C(CO)=O)(C)O)=O,4,3,0,3,2,0.000153
G5,C(CC(C(C(C(CO)=O)O)=O)O)=O,4,2,0,2,5,9.499999999999999e-05
G5,C(C(CO)O)(C(C(C)=O)(C)O)=O,4,2,0,2,5,9.499999999999999e-05
G5,C(C(C(C(C(C)=O)(C)O)O)O)=O,8,3,0,3,29,0.000153
G5,C(C(C(C(CO)O)=O)(C=C)O)=O,4,2,0,2,55,9.499999999999999e-05
G5,C(C(CO)(CO)O)(C(C=C)O)=O,2,6,0,6,2,0.0003
G5,C(C(CO)O)(C1(COCC1O)O)=O,8,1,0,1,10,4.7e-05
G5,C(C(C(C1(COCC1O)O)O)O)=O,16,2,0,2,10,0.000106
G5,C1(COC(C(CO)(CO)O)C1O)=O,4,2,0,2,10,0.000106
G5,C(C(CO)O)(C1(C(O)OCC1)O)=O,8,2,0,2,55,9.499999999999999e-05
G5,C(C(C(C1(C(O)OCC1)O)O)O)=O,16,3,0,3,5,0.000153
G5,C1(C(C(CO1)C(CO)(CO)O)O)=O,4,1,0,1,5,4.7e-05
G5,C1(COC(C(C(CO)O)O)C1O)=O,16,2,0,2,10,0.000106
G5,C1(C(C(CO1)C(C(CO)O)O)O)=O,16,4,0,4,41,0.00018999999999999998
G5,C(C(C)(CC(C(CC=O)=O)O)O)=O,4,1,0,1,4,4.7e-05
G5,C(C(C(C(C)O)C(C(C)=O)O)O)=O,16,1,0,1,45,4.7e-05
G5,C(C(C)(C(C(C)O)C(C=O)O)O)=O,16,1,0,1,45,4.7e-05
G5,C(C(C(C(CC(C)O)O)=O)(C)O)=O,8,1,0,1,45,4.7e-05
G5,C(C(C)O)(C(CC(C(C)=O)O)O)=O,8,2,0,2,45,9.499999999999999e-05
G5,C(C(C)(CC(C(C(C)O)=O)O)O)=O,8,2,0,2,45,9.499999999999999e-05
G5,C(C(C(C(C=O)O)=O)(C)O)=O,4,1,0,1,45,4.7e-05
G5,C(C(C(C)=O)O)(C(C(C)=O)O)=O,3,2,0,2,0,9.499999999999999e-05
G5,C(C(C(C(C(C)=O)O)=O)(C)O)=O,4,3,0,3,29,0.000153
G5,C(C(C)O)(CC(C(CO)=O)=O)=O,2,3,0,3,5,0.00014199999999999998
G5,C(C(C)O)(C(C(C(C)O)=O)O)=O,3,1,0,1,25,4.7e-05
G5,C(C(C=O)C(C(C)O)=O)=O,2,3,0,3,29,0.00014199999999999998
G5,C(C(C)(C(C(C(C=O)=O)O)O)O)=O,8,2,0,2,5,9.499999999999999e-05
G5,C(C(CC(C)=O)O)(CC(C=O)=O)=O,2,1,0,1,26,4.7e-05
G5,C(C(C)O)(C(C(C)=O)C(C=O)=O)=O,4,1,0,1,45,4.7e-05
G5,C(CC(C(C)O)=O)(CC(C=O)=O)=O,2,1,0,1,45,4.7e-05
G5,C(C(C(C(C)O)=O)C(C=O)=O)=O,4,2,0,2,23,9.499999999999999e-05
G5,C(C(C)O)(C(C=O)C(C(C)=O)=O)=O,4,1,0,1,45,4.7e-05
G5,C(CC(C(CC(C(C)O)=O)=O)=O)=O,2,1,0,1,45,4.7e-05
G5,C(C(C)O)(CC(C(C)=O)=O)=O,2,4,0,4,29,0.00018999999999999998
G5,C(CC(CC(C(C)O)=O)=O)=O,2,4,0,4,29,0.00018999999999999998
G5,C(C(C)O)(C(C=O)C(C)=O)=O,4,4,0,4,29,0.00018999999999999998
G5,C(C(C)O)(C1C(COC1O)=O)=O,8,2,0,2,11,9.499999999999999e-05
G5,C1(CC(OC1C(C(C)O)=O)O)=O,8,2,0,2,35,9.499999999999999e-05
G5,C(C(C)O)(C(C(C=CC=O)=O)O)=O,8,1,0,1,45,4.7e-05
G5,C(C(C(C(C=CC=O)O)=O)(C)O)=O,8,1,0,1,45,4.7e-05
G5,C(CC(C=O)=O)(C(C=C)O)=O,2,2,0,2,7,9.499999999999999e-05
G5,C(C(C)O)(C(C(C=C)=O)O)=O,4,2,0,2,25,9.499999999999999e-05
G5,C(C(C(C)=O)O)(C(C=C)O)=O,4,3,0,3,29,0.00014199999999999998
G5,C(C(C(C(C=C)O)=O)(C)O)=O,4,2,0,2,45,9.499999999999999e-05
G5,C(C(C=CC(C)=O)O)(CC(C=O)=O)=O,4,1,0,1,45,4.7e-05
G5,C(C(C)O)(CC(C=CC(C=O)=O)=O)=O,4,1,0,1,45,4.7e-05
G5,C(CC=CC(C(CC(C=O)=O)=O)O)=O,4,1,0,1,45,4.7e-05
G5,C(C(C(C(C)O)=O)C=CC(C=O)=O)=O,8,1,0,1,45,4.7e-05
G5,C(C(C)O)(CC(C(C=CC=O)=O)=O)=O,4,1,0,1,45,4.7e-05
G5,C(C(C(C(C)O)=O)C(C=CC=O)=O)=O,8,1,0,1,45,4.7e-05
G5,C(C(CC(C=C)=O)O)(CC(C=O)=O)=O,2,1,0,1,45,4.7e-05
G5,C(C(C)O)(C(C(C=O)=O)C(C=C)=O)=O,4,1,0,1,45,4.7e-05
G5,C(C(C(C(C)O)=O)C(C(C=C)=O)=O)=O,4,1,0,1,45,4.7e-05
G5,C(C(CC=CC=O)O)(CC(C=O)=O)=O,4,1,0,1,45,4.7e-05
G5,C(C(C)O)(C(C=CC=O)C(C=O)=O)=O,8,1,0,1,45,4.7e-05
G5,C1(C(COC1C(C(C)O)=O)O)=O,8,1,0,1,10,4.7e-05
G5,C(C)(C(C1C(C(CO1)=O)O)O)=O,8,2,0,2,10,9.499999999999999e-05
G5,C(C(C)(C1C(C(CO1)=O)O)O)=O,8,1,0,1,10,4.7e-05
G5,C(C(C)O)(C1C(C(O)OC1)=O)=O,8,3,0,3,12,0.00014199999999999998
G5,C1(C(C(CO1)C(C(C)=O)O)O)=O,8,2,0,2,29,9.499999999999999e-05
G5,C(C(C)(C1COC(C1O)=O)O)=O,8,2,0,2,29,9.499999999999999e-05
G5,C(CC(C(C(C=O)(CO)O)=O)O)=O,4,4,0,4,5,0.000205
G5,C(C(CO)(CC=O)O)(C(C=O)O)=O,4,3,0,3,1,0.000155
G5,C(CC(C(C(CC=O)O)=O)O)=O,3,2,0,2,49,9.499999999999999e-05
G5,C(CC(C(C(C(C)=O)(C)O)=O)O)=O,4,1,0,1,14,4.7e-05
G5,C(C(C(C(C=C)O)=O)C(CO)=O)=O,4,1,0,1,7,4.7e-05
G5,C(C(C(C(CC=O)O)=O)(C=C)O)=O,4,1,0,1,7,4.7e-05
G5,C(CC(C(C(C=C)(CO)O)=O)O)=O,4,3,0,3,29,0.000164
G5,C(C(CC(CO)=O)O)(C(C=C)O)=O,4,1,0,1,49,4.7e-05
G5,C(C(C(CC(CCO)O)O)=O)=O,4,1,0,1,18,4.7e-05
G5,C(C(C(CC(CC(C)O)O)O)=O)=O,8,1,0,1,1,4.7e-05
G5,C(C(CO)(CC(C(C=O)=O)O)O)=O,4,2,0,2,2,9.7e-05
G5,C(CO)(C(CC(C(C=O)=O)O)O)=O,4,3,0,3,1,0.00014199999999999998
G5,C(CC(CC(C(C=O)=O)O)O)=O,4,3,0,3,29,0.000153
G5,C(C(C)(CC(C(C=O)=O)O)O)(O)=O,4,2,0,2,16,0.000106
G5,C(CC(C(C=O)=O)O)(O)=O,2,1,0,1,17,4.7e-05
G5,C=CC(C(CC(C(C=O)=O)O)O)=O,4,1,0,1,1,4.7e-05
G5,C(C(C(CC(C(C=C)O)=O)=O)O)=O,4,1,0,1,1,4.7e-05
G5,C(C(C=C)(CC(C(C=O)=O)O)O)=O,4,1,0,1,25,4.7e-05
G5,C(C(CO)(CC(C(C=O)=O)O)O)=C,4,1,0,1,25,4.7e-05
G5,C(C(C)(C(C=O)O)O)(C(C=C)O)=O,8,1,0,1,1,4.7e-05
G5,C(C(CC(C(C=O)=O)O)O)=CC=O,8,1,0,1,1,4.7e-05
G5,C(C(C(CC(C(C)O)O)O)=O)=O,8,1,0,1,11,4.7e-05
G5,C(C(C(CO)C(C(C=O)=O)O)O)=O,8,2,0,2,15,9.499999999999999e-05
G5,C(C(C(CO)=O)O)(CC(CO)=O)=O,2,2,0,2,0,9.499999999999999e-05
G5,C(CO)(C(C(CO)=O)C(CO)=O)=O,1,1,0,1,0,4.7e-05
G5,C(C(CC(C(C(CO)=O)=O)O)O)=O,4,2,0,2,0,9.499999999999999e-05
G5,C(C(C(C(CC(O)=O)O)=O)O)=O,4,3,0,3,29,0.000154
G5,C(C(CC(C(C(O)=O)=O)O)O)=O,4,3,0,3,29,0.000154
G5,C(C)(C(C(CO)=O)C(C=O)=O)=O,2,2,0,2,0,9.499999999999999e-05
G5,C(CC(CO)=O)(CC(C=O)=O)=O,1,4,0,4,29,0.00018999999999999998
G5,C(CC(C(CC(CO)=O)=O)=O)=O,1,3,0,3,29,0.00014199999999999998
G5,C(CO)(C1C(COC1O)=O)=O,4,2,0,2,2,9.499999999999999e-05
G5,C1(CC(OC1C(CO)=O)O)=O,4,3,0,3,15,0.00014199999999999998
G5,C(CO)(C1C(COC(C1O)O)=O)=O,8,2,0,2,0,9.499999999999999e-05
G5,C1(CC(C(OC1C(CO)=O)O)O)=O,8,2,0,2,0,9.499999999999999e-05
G5,C(CO)(C(C(C=CC=O)=O)O)=O,4,2,0,2,0,9.499999999999999e-05
G5,C(CO)(C(C(C(O)=O)=O)CO)=O,2,3,0,3,29,0.000154
G5,C(C(C(CC(CO)=O)=O)(CO)O)=O,2,4,0,4,15,0.000205
G5,C(CO)(CC(C=CC(C=O)=O)=O)=O,2,1,0,1,0,4.7e-05
G5,C(C(C(CO)=O)C=CC(C=O)=O)=O,4,1,0,1,45,4.7e-05
G5,C(CO)(CC(C(C=CC=O)=O)=O)=O,2,1,0,1,0,4.7e-05
G5,C(C(C(CO)=O)C(C=CC=O)=O)=O,4,1,0,1,45,4.7e-05
G5,C(CO)(C(C(C=O)=O)C(C=C)=O)=O,2,1,0,1,45,4.7e-05
G5,C(C(C(CO)=O)C(C(C=C)=O)=O)=O,2,1,0,1,0,4.7e-05
G5,C(CO)(C(C=CC=O)C(C=O)=O)=O,4,1,0,1,0,4.7e-05
G5,C1(C(COC1C(CO)=O)O)=O,4,1,0,1,10,4.7e-05
G5,C(C(C1C(C(CO1)=O)O)O)=O,8,2,0,2,15,9.499999999999999e-05
G5,C(CO)(C1C(C(O)OC1)=O)=O,4,3,0,3,5,0.00014199999999999998
G5,C1(C(C(CO1)C(C=O)O)O)=O,8,2,0,2,34,9.499999999999999e-05
G5,C(CO)(C(CC(CCO)O)O)=O,4,2,0,2,18,0.000106
G5,C(CO)(C(CC(CC(C)O)O)O)=O,8,1,0,1,28,4.7e-05
G5,C(C)(C(C)(CC(C(CO)=O)O)O)=O,4,1,0,1,14,4.7e-05
G5,C(CO)(C(CC(C(C=C)=O)O)O)=O,4,1,0,1,7,4.7e-05
G5,C(C(C=C)O)(CC(C(CO)O)=O)=O,4,2,0,2,7,0.000106
G5,C(C(C=C)(CC(C(CO)=O)O)O)=O,4,2,0,2,32,0.000106
G5,C(CO)(C(CC(C=C)(CO)O)O)=O,4,1,0,1,7,4.7e-05
G5,C(C(C)(C(CO)O)O)(C(C=C)O)=O,8,1,0,1,7,4.7e-05
G5,C(CO)(C(CC(C=CC=O)O)O)=O,8,2,0,2,32,0.000106
G5,C(CO)(C(CC(C(C)O)O)O)=O,8,1,0,1,11,4.7e-05
G5,C(C(C(C(CO)C(C)O)O)=O)=O,8,1,0,1,4,4.7e-05
G5,C(CO)(C(C(CO)C(C)O)O)=O,8,2,0,2,2,0.000106
G5,C(C(C(CO)CO)O)(C(C)O)=O,4,2,0,2,4,0.000106
G5,C(C(C(C(C(CO)CO)O)=O)=O)=O,2,1,0,1,2,4.7e-05
G5,C(C(CCO)O)(C(C(C=O)=O)O)=O,4,1,0,1,3,4.7e-05
G5,C(C(CCO)O)(OC(C=O)CO)=O,4,1,0,1,2,4.7e-05
G5,C(OC(C(C(CCO)O)=O)CO)=O,4,1,0,1,9,4.7e-05
G5,C(OC(CO)CC(C(CO)=O)O)=O,4,1,0,1,2,4.7e-05
G5,C(OC(CO)C(CO)C(C=O)O)=O,8,1,0,1,2,4.7e-05
G5,C(C(C(CO)OCC(C=O)O)O)=O,8,1,0,1,36,4.7e-05
G5,C(C(COCC(C(CO)=O)O)O)=O,4,1,0,1,36,4.7e-05
G5,C(C(CCO)O)(OCC(C=O)O)=O,4,1,0,1,41,4.7e-05
G5,C(OCC(C(C(CCO)O)=O)O)=O,4,1,0,1,28,4.7e-05
G5,C(CO)(C(CC(OCC=O)O)O)=O,4,1,0,1,38,4.7e-05
G5,C(OCC(CC(C(CO)=O)O)O)=O,4,1,0,1,19,4.7e-05
G5,C(OCC(C(CO)C(C=O)O)O)=O,8,1,0,1,19,4.7e-05
G5,C(COC(C(C(CCO)O)=O)O)=O,4,1,0,1,19,4.7e-05
G5,C(COC(C=O)O)(C(CCO)O)=O,4,1,0,1,2,4.7e-05
G5,C(CO)(C(CCOC(C=O)O)O)=O,4,1,0,1,30,4.7e-05
G5,C(C(C(CO)COC(C=O)O)O)=O,8,1,0,1,30,4.7e-05
G5,C(CO)(C(C(C=CCO)=O)O)=O,4,4,0,4,29,0.00018999999999999998
G5,C(CO)(C(C1(CC(CO1)O)O)O)=O,8,3,0,3,0,0.00014199999999999998
G5,C(C(C)=O)(C(C(CO)CO)O)=O,2,3,0,3,29,0.000154
G5,C(C(C(C(CO)CCO)O)=O)=O,4,3,0,3,29,0.000165
G5,C(CO)(C(C=CC(CO)O)O)=O,8,4,0,4,29,0.00020099999999999998
G5,C(C(C(CO)CC(C(O)=O)=O)O)=O,4,2,0,2,29,0.000106
G5,C(CO)(C(CCC(C(O)=O)=O)O)=O,2,3,0,3,29,0.000154
G5,C(C(CCO)O)(CC(C(O)=O)=O)=O,2,2,0,2,29,0.000106
G5,C(CC(CO)C(C(C(O)=O)=O)O)=O,4,3,0,3,43,0.000154
G5,C(CC(CO)C(C(C=O)=O)O)(O)=O,4,3,0,3,29,0.000154
G5,C(C(C=CC(C(CO)=O)O)O)(O)=O,8,2,0,2,29,0.000106
G5,C(C(CO)(C(CO)C(C=O)O)O)=O,8,5,0,5,29,0.000273
G5,C1(C(C(CO)OC1C(C)=O)O)=O,8,2,0,2,27,9.499999999999999e-05
G5,C(CC1C(C(C(CO)O1)O)=O)=O,8,3,0,3,29,0.00014199999999999998
G5,C1(C(C(CO)C(C(C)=O)O1)O)=O,8,3,0,3,29,0.00014199999999999998
G5,C(CC1C(CO)C(C(O1)=O)O)=O,8,3,0,3,41,0.00014199999999999998
G5,C1(CC(CO)C(C(CO1)=O)O)=O,4,2,0,2,2,9.499999999999999e-05
G5,C1(CC(C(C(CO)CO1)O)=O)=O,4,2,0,2,19,9.499999999999999e-05
G5,C1(C(C(C(CO)OCC1)O)=O)=O,4,2,0,2,36,9.499999999999999e-05
G5,C1(C(COCC(CO)C1O)=O)=O,4,2,0,2,36,9.499999999999999e-05
G5,C1(C(C(CO)OCC(C1)=O)O)=O,4,3,0,3,0,0.00014199999999999998
G5,C1(C(C(CO)CC(CO1)=O)O)=O,4,4,0,4,41,0.00018999999999999998
G5,C1(C(C(CO)CO1)O)=O,4,2,0,2,29,9.499999999999999e-05
G5,C1(C(CO)(O)OCC(CO)C1O)=O,8,2,0,2,30,9.499999999999999e-05
G5,C1(C(CO)C(C(C(CO)O1)=O)O)=O,8,2,0,2,2,9.7e-05
G5,C1(C(C(C(CO)C(CO)O1)O)=O)=O,8,1,0,1,50,4.7e-05
G5,C1(C(CO)C(C(C(CO1)O)=O)O)=O,8,2,0,2,2,9.7e-05
G5,C1(C(C(C(CO)C(CO1)O)O)=O)=O,8,1,0,1,2,4.7e-05
G5,C1(C(C(CO)C(C(CO1)=O)O)O)=O,8,1,0,1,2,4.7e-05
G5,C1(C(C(C(C(CO)CO1)O)=O)O)=O,8,1,0,1,2,4.7e-05
G5,C1(C(CCO)(O)OC(CO)C1O)=O,8,2,0,2,2,9.499999999999999e-05
G5,C1(C(C(CO)OC(CO)(C1)O)O)=O,8,2,0,2,32,9.499999999999999e-05
G5,C1(C(C(CO)OC(C)(C1O)O)O)=O,16,2,0,2,24,9.499999999999999e-05
G5,C1(C(CC(O)OC(CO)C1O)O)=O,16,3,0,3,38,0.00014199999999999998
G5,C(C(C(C(C=O)O)=O)(CCO)O)=O,4,1,0,1,1,4.7e-05
G5,C(C(CCO)O)(CC(C(C)=O)=O)=O,2,1,0,1,14,4.7e-05
G5,C(CC(CC(C(CCO)O)=O)=O)=O,2,3,0,3,29,0.000164
G5,C(C(CCO)O)(C(C=O)C(C)=O)=O,4,2,0,2,29,0.000106
G5,C(C(C=C)O)(C(C(C=O)=O)CO)=O,4,1,0,1,7,4.7e-05
G5,C(C(CCO)O)(C(C(C=C)=O)O)=O,4,1,0,1,3,4.7e-05
G5,C(C(C(CCO)=O)O)(C(C=C)O)=O,4,1,0,1,3,4.7e-05
G5,C(C(C(C(C=C)O)=O)(CCO)O)=O,4,1,0,1,7,4.7e-05
G5,C(C(CCO)O)(C(CCO)O)=O,3,1,0,1,3,4.7e-05
G5,C(C(C(CO)C(CCO)O)O)=O,8,3,0,3,29,0.000165
G5,C(C(C(CO)C(CC(C)O)O)O)=O,16,2,0,2,3,0.000106
G5,C(C(C(C(CCO)O)=O)(C)O)(O)=O,4,3,0,3,45,0.000154
G5,C(C(CCO)O)(C(C(C)=O)(C)O)=O,4,1,0,1,14,4.7e-05
G5,C(C(C(CO)C(C(C)=O)(C)O)O)=O,8,2,0,2,14,0.000106
G5,C(CC(C)(C(CO)C(C=O)O)O)=O,8,2,0,2,3,0.000106
G5,C(C(C(CO)C(C(C=C)=O)O)O)=O,8,2,0,2,7,0.000106
G5,C(C(C=C)O)(C(C(CO)=O)CO)=O,4,1,0,1,7,4.7e-05
G5,C(C(C(C(CCO)O)=O)(C=C)O)=O,4,2,0,2,29,0.000106
G5,C(C(C=C)(C(CO)C(C=O)O)O)=O,8,2,0,2,7,0.000106
G5,C(C(CCO)O)(C(C=C)(CO)O)=O,4,1,0,1,7,4.7e-05
G5,C(C(C(CO)C(C=C)(CO)O)O)=O,8,2,0,2,7,0.000106
G5,C(C(CO)(CCO)O)(C(C=C)O)=O,4,1,0,1,7,4.7e-05
G5,C(C(C(CO)C(C=CC=O)O)O)=O,16,2,0,2,43,0.000106
G5,C(C(C(CO)C(C(C)O)O)O)=O,16,2,0,2,11,0.000106
G5,C(C(C(C1C(C(CO1)=O)O)O)O)=O,16,1,0,1,10,4.7e-05
G5,C1(C(C(CO1)C(C(C=O)O)O)O)=O,16,1,0,1,34,4.7e-05
G5,C(C(CC(C)O)O)(CC(CO)=O)=O,4,2,0,2,22,0.000106
G5,C(C(CC(C=O)O)(CC(C)O)O)=O,8,1,0,1,49,4.7e-05
G5,C(C(C(C(C)O)=O)(CC(C)O)O)=O,8,1,0,1,4,4.7e-05
G5,C(C(CC(CC(C(C)=O)O)O)O)=O,8,1,0,1,49,4.7e-05
G5,C(CC(C(CC(CO)(C)O)O)=O)=O,4,1,0,1,49,4.7e-05
G5,C(C(C)(CC(CC(C=O)O)O)O)=O,8,1,0,1,49,4.7e-05
G5,C(C(CC(CO)(CC(C)O)O)O)=O,8,1,0,1,49,4.7e-05
G5,C(C(C)O)(C(CO)(CC(C)O)O)=O,8,1,0,1,11,4.7e-05
G5,C(C(C(C(C)O)C(CO)(C)O)O)=O,16,1,0,1,49,4.7e-05
G5,C(C(CC(C)O)O)(C(CO)(C)O)=O,8,1,0,1,11,4.7e-05
G5,C(C(CC(C)(C(C(C)O)O)O)O)=O,16,1,0,1,49,4.7e-05
G5,C(C(C)O)(C(C)(C(C(C)O)O)O)=O,16,2,0,2,49,9.499999999999999e-05
G5,C(C(CC(CO)(C)O)O)(C(C)O)=O,8,2,0,2,49,9.499999999999999e-05
G5,C(C(CC(CC(CO)(C)O)O)O)=O,8,1,0,1,49,4.7e-05
G5,C(C(CC(CC(C)O)O)O)=O,8,1,0,1,28,4.7e-05
G5,C(C(CC(C)O)O)(C(C)O)=O,8,2,0,2,28,9.499999999999999e-05
G5,C(C(CC(C(C(C)O)O)O)O)=O,16,1,0,1,49,4.7e-05
G5,C(C(CC(CC(CO)O)O)O)=O,8,2,0,2,21,0.000106
G5,C(C(CC(C(C)=O)(CO)O)O)=O,4,3,0,3,29,0.000144
G5,C(C(CC(C(CO)=O)(C)O)O)=O,4,2,0,2,25,9.499999999999999e-05
G5,C(C(C)O)(C(C(CO)=O)(C)O)=O,4,2,0,2,49,9.499999999999999e-05
G5,C(C(CO)(C)O)(C(C(C)=O)O)=O,4,3,0,3,49,0.000144
G5,C(C(CC(CO)(C(C)O)O)O)=O,8,2,0,2,29,0.000106
G5,C(C(C)O)(C(CO)(C(C)O)O)=O,8,6,0,6,4,0.000303
G5,C(C(CC(C(CCO)O)O)O)=O,8,2,0,2,29,0.000106
G5,C(C(C(C(C)O)=O)(C)O)(O)=O,4,3,0,3,49,0.000154
G5,C(C(CO)(CC(O)=O)O)(C(C)O)=O,4,2,0,2,29,0.000106
G5,C(C(C(C)(CC(C=O)O)O)O)(O)=O,8,3,0,3,33,0.000154
G5,C(C(C)(C(C(O)=O)O)O)(C(C)O)=O,8,4,0,4,49,0.000202
G5,C(CC(C(CC(C=O)O)O)O)(O)=O,8,2,0,2,29,0.000106
G5,C(C(CC(C(CC(C)=O)=O)O)O)=O,4,3,0,3,29,0.000164
G5,C(C(C(C(C)O)=O)O)(CC(C)=O)=O,4,2,0,2,26,9.499999999999999e-05
G5,C(C(C)O)(C(C=O)(CC(C)=O)O)=O,4,1,0,1,26,4.7e-05
G5,C(C)(C(C(C(C)O)=O)(CC=O)O)=O,4,1,0,1,14,4.7e-05
G5,C(C(C)(CC(C=O)O)O)(CC=O)=O,4,1,0,1,14,4.7e-05
G5,C(CC=O)(C(C(C(C)O)=O)(C)O)=O,4,1,0,1,14,4.7e-05
G5,C(C(CC(C(C)=O)(C)O)O)=O,4,2,0,2,52,9.499999999999999e-05
G5,C(C(C)O)(C(C(C)=O)(C)O)=O,4,2,0,2,49,9.499999999999999e-05
G5,C(C(C)O)(C1(COC(C1)O)O)=O,8,2,0,2,49,9.499999999999999e-05
G5,C(C(CC(C=CC(CO)=O)O)O)=O,8,2,0,2,49,0.000106
G5,C(C(C)O)(C(C=CC(CO)=O)O)=O,8,3,0,3,32,0.00014199999999999998
G5,C(C(CC(C=CC=O)(CO)O)O)=O,8,1,0,1,49,4.7e-05
G5,C(C(C)O)(C(C=CC=O)(CO)O)=O,8,1,0,1,49,4.7e-05
G5,C(C(CO)(C)O)(C(C=CC=O)O)=O,8,1,0,1,49,4.7e-05
G5,C(C(CC(C(C=C)=O)O)O)=O,4,4,0,4,29,0.00018999999999999998
G5,C(C(C=C)O)(CC(CO)=O)=O,2,4,0,4,29,0.00018999999999999998
G5,C(C(C=C)(CC(C=O)O)O)=O,4,3,0,3,29,0.00014199999999999998
G5,C(C(C(C(C)O)=O)(C=C)O)=O,4,3,0,3,29,0.00014199999999999998
G5,C(C(CC(C=C)(CO)O)O)=O,4,2,0,2,29,9.499999999999999e-05
G5,C(C(C)O)(C(C=C)(CO)O)=O,4,2,0,2,3,9.499999999999999e-05
G5,C(C(CO)(C)O)(C(C=C)O)=O,4,2,0,2,3,9.499999999999999e-05
G5,C(C(CC(C=CC=O)O)O)=O,8,3,0,3,29,0.00014199999999999998
G5,C(C(C)O)(C(C=CC=O)O)=O,8,4,0,4,29,0.00018999999999999998
G5,C(C(CC(C(C)O)O)O)=O,8,1,0,1,11,4.7e-05
G5,C(C(C(C(C)O)=O)(CCO)O)(O)=O,4,3,0,3,29,0.000154
G5,C(C(CC1(COCC1O)O)O)=O,8,1,0,1,10,4.7e-05
G5,C(C(C)O)(C1(COCC1O)O)=O,8,1,0,1,10,4.7e-05
G5,C1(COC(C(CO)(C)O)C1O)=O,8,1,0,1,10,4.7e-05
G5,C(C(CC1(C(O)OCC1)O)O)=O,8,2,0,2,34,9.499999999999999e-05
G5,C(C(C)O)(C1(C(O)OCC1)O)=O,8,2,0,2,34,9.499999999999999e-05
G5,C1(C(C(CO1)C(CO)(C)O)O)=O,8,2,0,2,29,9.499999999999999e-05
G5,C(C(CC(C(C(C=C)O)=O)O)O)=O,8,2,0,2,29,0.000106
G5,C(CC(C(CC(C)O)O)=O)=O,4,1,0,1,4,4.7e-05
G5,C(C(C(C(C(C)O)C(C)O)O)=O)=O,6,1,0,1,4,4.7e-05
G5,C(CO)(C(C(C(C)O)C(C)O)O)=O,6,1,0,1,4,4.7e-05
G5,C(C(C(CO)C(C)O)O)(C(C)O)=O,16,2,0,2,4,0.000106
G5,C(C(C(C(C)O)C(C)O)O)=O,6,1,0,1,4,4.7e-05
G5,C(C(C)O)(C(C=C)O)=O,4,3,0,3,29,0.00014199999999999998
G5,C(CC(C(CCC(C=O)O)O)=O)=O,4,3,0,3,29,0.000153
G5,C(CC(C(CC=O)=O)O)(C(C)O)=O,4,2,0,2,45,9.499999999999999e-05
G5,C(C(C)O)(C(C(CCC=O)=O)O)=O,4,2,0,2,17,0.000106
G5,C(C(C)O)(C(C(C=CCO)=O)O)=O,8,1,0,1,55,4.7e-05
G5,C(C(C)=O)(C(C(CO)C(C)O)O)=O,8,2,0,2,25,0.000106
G5,C(C(C(CC(C)O)O)=O)(CCO)=O,4,3,0,3,34,0.000154
G5,C(C(C(C(C(C)O)CCO)O)=O)=O,8,2,0,2,4,0.000106
G5,C(C(C)O)(C(C=CC(CO)O)O)=O,16,2,0,2,32,0.000106
G5,C1(C(C(C(C(C)O)C1CO)O)=O)=O,16,1,0,1,4,4.7e-05
G5,C1(C(C(C(C)O)OC1C(C)=O)O)=O,16,1,0,1,4,4.7e-05
G5,C(CC1C(C(C(C(C)O)O1)O)=O)=O,16,1,0,1,9,4.7e-05
G5,C1(C(C(C(C)O)C(C(C)=O)O1)O)=O,16,1,0,1,22,4.7e-05
G5,C(CC1C(C(C)O)C(C(O1)=O)O)=O,16,1,0,1,4,4.7e-05
G5,C1(CC(C(C)O)C(C(CO1)=O)O)=O,8,1,0,1,46,4.7e-05
G5,C1(CC(C(C(CO1)C(C)O)O)=O)=O,8,1,0,1,19,4.7e-05
G5,C1(C(C(C(C(C)O)OCC1)O)=O)=O,8,1,0,1,36,4.7e-05
G5,C1(C(COCC(C(C)O)C1O)=O)=O,8,1,0,1,36,4.7e-05
G5,C1(C(C(C(C)O)OCC(C1)=O)O)=O,8,1,0,1,4,4.7e-05
G5,C1(C(C(C(C)O)CC(CO1)=O)O)=O,8,2,0,2,12,9.499999999999999e-05
G5,C(CC(C(C=CC(C)=O)O)=O)=O,4,4,0,4,29,0.00018999999999999998
G5,C(CC(C(CC(C=C)=O)O)=O)=O,2,2,0,2,7,9.499999999999999e-05
G5,C1(COC(C(C)O)C1O)=O,8,1,0,1,4,4.7e-05
G5,C1(C(C(CO1)C(C)O)O)=O,8,2,0,2,29,9.499999999999999e-05
G5,C(CC(C(C1CC(CO1)O)O)=O)=O,8,1,0,1,39,4.7e-05
G5,C(C(CC(C=O)=O)C(C=O)O)(O)=O,4,2,0,2,12,0.000106
G5,C(C=O)(CCC(C(C(O)=O)=O)O)=O,2,3,0,3,12,0.000154
G5,C(CC(C(CC(C=O)=O)=O)O)(O)=O,2,1,0,1,17,4.7e-05
G5,C(CC(CC(C(C(O)=O)=O)O)=O)=O,2,1,0,1,17,4.7e-05
G5,C(CC(C(C(CC(O)=O)O)=O)=O)=O,2,1,0,1,17,4.7e-05
G5,C(C(CC=O)C(C(C=O)=O)O)(O)=O,4,3,0,3,17,0.000154
G5,C(C(C=CC(C(C(O)=O)=O)O)O)=O,8,1,0,1,32,4.7e-05
G5,C(C(C=O)CC(C=O)O)=O,2,2,0,2,2,9.499999999999999e-05
G5,C(C(C=CCO)O)=O,4,6,0,6,17,0.000296
G5,C(OCCC(C(C=O)O)O)=O,4,1,0,1,19,4.7e-05
G5,C(OCCC(C(CO)O)=O)=O,2,3,0,3,29,0.000153
G5,C(CC(O)OCC(C=O)O)=O,4,2,0,2,29,9.499999999999999e-05
G5,C(C(C=CC(O)=O)O)=O,4,4,0,4,29,0.00020099999999999998
G5,C(CO)(C(C(CO)=O)(CO)CO)=O,1,2,0,2,2,9.7e-05
G5,C(C(C(CO)(CO)C(C=O)O)O)=O,3,2,0,2,2,0.000106
G5,C(C)(C(CO)(OCC(CO)=O)O)=O,2,2,0,2,41,9.7e-05
G5,C1(C(CC(CO)O1)O)=O,4,3,0,3,29,0.00014199999999999998
G5,C1(C(COCC1O)O)=O,3,1,0,1,27,4.7e-05
G5,C1(C(CC(CO1)O)O)=O,4,3,0,3,29,0.00014199999999999998
G5,C(CO)(OCC(C(C)O)=O)=O,2,2,0,2,2,9.499999999999999e-05
G5,C(C(CCOC(CO)=O)O)=O,2,3,0,3,30,0.00014199999999999998
G5,C(C)(COC(C(CO)=O)=O)=O,1,1,0,1,2,4.7e-05
G5,C(COC(C(C)=O)=O)(CO)=O,1,1,0,1,27,4.7e-05
G5,C(COC(C(C(C)O)=O)=O)=O,2,1,0,1,2,4.7e-05
G5,C(COC(C=O)=O)(C(C)O)=O,2,1,0,1,2,4.7e-05
G5,C(OCC=CC(C=O)O)=O,4,2,0,2,19,9.499999999999999e-05
G5,C(COC(C(CO)=O)=C)=O,1,2,0,2,2,9.499999999999999e-05
G5,C(CC(CO)OC(CO)=O)=O,2,4,0,4,29,0.00020099999999999998
G5,C(CCO)(OCC(C=O)O)=O,2,2,0,2,29,9.499999999999999e-05
G5,C(OC(CCO)C(C=O)O)=O,4,1,0,1,2,4.7e-05
G5,C(C(CO)O)(OC(C=O)CO)=O,4,2,0,2,50,0.000106
G5,C(C(CO)O)(OCC(C=O)O)=O,4,2,0,2,2,0.000106
G5,C(C(O)OCC(CO)=O)(CO)=O,2,1,0,1,2,4.7e-05
G5,C(CC(C(C=O)O)CC=O)=O,2,3,0,3,46,0.000145
G5,C(CCCC(C=O)O)=O,2,2,0,2,27,9.499999999999999e-05
G5,C1(C(C(CCC1O)O)=O)=O,3,1,0,1,32,4.7e-05
G5,C(CC(C(C=O)=O)O)(C(C)O)=O,4,3,0,3,45,0.00014199999999999998
G5,C(CC(C(CO)=O)O)(C(C)O)=O,4,3,0,3,49,0.00014199999999999998
G5,C(C(CO)C(C=O)O)(C(C)O)=O,8,4,0,4,29,0.00020099999999999998
G5,C(CC(C=O)O)(C(C)O)=O,4,4,0,4,29,0.00020099999999999998
G5,C1(C(C(C(CO)C(CO)O1)O)O)=O,16,2,0,2,19,0.000106
G5,C1(C(C(C(CO)OCC1O)O)O)=O,16,2,0,2,36,0.000106
G5,C1(C(C(C(CO)C(CO1)O)O)O)=O,16,2,0,2,19,0.000106
G5,C1(C(O)OCC(CO)C(C1O)O)=O,16,3,0,3,30,0.000153
G5,C(OCC(C(C(C)O)O)=O)=O,4,2,0,2,2,0.000106
G5,C(C(C(C)O)O)(OCC=O)=O,4,5,0,5,4,0.00025
G5,C(C(CCC(C=O)O)O)=O,3,2,0,2,7,0.000106
G5,C(C(C)O)(C(C=O)(C(CO)=O)O)=O,4,2,0,2,5,9.499999999999999e-05
G5,C(CO)(C(C(CO)=O)(C(C)=O)O)=O,1,1,0,1,0,4.7e-05
G5,C(C(C(CO)=O)(C(CO)=O)O)=O,1,1,0,1,0,4.7e-05
G5,C(C(C(CO)O)=O)(C(CO)(C)O)=O,4,4,0,4,29,0.00021400000000000002
G5,C(CO)(OCC(C(CO)O)=O)=O,2,3,0,3,40,0.000153
G5,C1(C(C(C(CCO1)O)O)=O)=O,4,3,0,3,29,0.000153
G5,C1(C(C(C=CCO1)O)O)=O,4,4,0,4,29,0.00020099999999999998
G5,C1(C(O)OC(C)C(C1O)O)=O,16,3,0,3,2,0.000153
G5,C(CCCC(C(C(CO)O)=O)=O)=O,2,4,0,4,32,0.000202
G5,C(CCCC(C(C(CO)=O)=O)O)=O,2,3,0,3,27,0.000143
G5,C(CCCC(C(C(C=O)=O)O)O)=O,4,3,0,3,27,0.000154
G5,C1(C(CC(CO)C1O)O)=O,8,2,0,2,32,0.000106
G5,C(C(C)O)(CCO)=O,2,3,0,3,29,0.000154
G5,C(CO)(C(C)(CCO)O)=O,2,2,0,2,28,0.000106
G5,C(C(C(CC(CO)CO)O)=O)=O,2,2,0,2,55,0.000106
G5,C(C(CCO)O)(CCC(C=O)O)=O,4,2,0,2,7,0.000106
G5,C(C(CCO)(CCC(C=O)O)O)=O,4,2,0,2,29,0.000106
G5,C(C(CC(C(C)=O)O)O)(CCO)=O,4,2,0,2,45,0.000106
G5,C(C(CCO)O)(CC(C(C)O)=O)=O,4,2,0,2,45,0.000106
G5,C(C(CCO)(CC(C(C)O)=O)O)=O,4,2,0,2,29,0.000106
G5,C(C(C)=O)(C(CC(CCO)O)O)=O,4,2,0,2,49,0.000106
G5,C(CC(C(C(C)(CCO)O)=O)O)=O,4,2,0,2,28,0.000106
G5,C(C(C(CC(C)(CCO)O)O)=O)=O,4,2,0,2,29,0.000106
G5,C(CCC(C(C(CCO)O)=O)O)=O,4,3,0,3,7,0.000154
G5,C(CCC(C(CO)=O)(CCO)O)=O,2,3,0,3,27,0.000154
G5,C(C(CO)=O)(CCC(CCO)O)=O,2,3,0,3,29,0.000154
G5,C(C(C(CCC(CCO)O)O)=O)=O,4,2,0,2,29,0.000106
G5,C(C(C(CC(CO)C(C)O)O)=O)=O,8,2,0,2,46,0.000106
G5,C(C(C)(CCO)O)(CC(CO)=O)=O,2,2,0,2,29,0.000106
G5,C(CCO)(C(C=CC(CO)O)O)=O,8,2,0,2,29,0.000106
G5,C(C(CCO)O)(C(C=CCO)O)=O,8,2,0,2,29,0.000106
G5,C(CO)(C(C=CCO)(CCO)O)=O,4,2,0,2,0,0.000106
G5,C(CO)(C(C=CC(CCO)O)O)=O,8,3,0,3,32,0.000154
G5,C(C(C(C=C)(CCO)O)O)(CO)=O,4,2,0,2,7,0.000106
G5,C(C(C=CC(C(CCO)O)O)O)=O,16,2,0,2,29,0.000106
G5,C(C(CO)(CCO)O)=CC(CO)=O,4,2,0,2,29,0.000106
G5,C(C(COC(CO)CO)O)=O,2,2,0,2,2,0.000106
G5,C(C(C)O)(OC(CO)CO)=O,2,2,0,2,29,0.000106
G5,C(C(COCC(CO)O)O)=O,4,2,0,2,36,0.000106
G5,C(C(C)O)(OCC(CO)O)=O,4,2,0,2,41,0.000106
G5,C(C(O)OCCO)(C(C)O)=O,4,2,0,2,19,0.000106
G5,C(COC(CO)O)(C(C)O)=O,4,2,0,2,29,0.000106
G5,C(C(CCOC(CO)O)O)=O,4,2,0,2,30,0.000106
G5,C(CO)(C(C)(O)OCCO)=O,2,2,0,2,29,0.000106
G5,C(CO)(C(CCCO)O)=O,2,3,0,3,29,0.000165
G5,C(C(C(CCCO)O)=O)(O)=O,2,3,0,3,29,0.000165
G5,C(CCC(C(CO)=O)O)(O)=O,2,4,0,4,29,0.000213
G5,C(C(C=CC(CO)(CO)O)O)=O,4,4,0,4,29,0.00020099999999999998
G5,C(C(CC(C(C)=O)(C(C)O)O)O)=O,8,2,0,2,45,9.6e-05
G5,C(C(C=CC(CO)(C(C)O)O)O)=O,16,2,0,2,29,0.000106
G5,C1(C(CC(CCO)O1)O)=O,4,3,0,3,29,0.000154
G5,C(C(C1CC(CO1)O)O)=O,8,1,0,1,4,4.7e-05
G5,C1(C(CO)OC(C)C1O)=O,8,2,0,2,29,0.000106
G5,C(CC(CC(C=O)O)C(CO)O)=O,8,4,0,4,27,0.000202
G5,C(C(C(CC(CO)CCO)O)=O)=O,4,2,0,2,46,0.000106
G5,C(CC(CO)CC(C(CO)=O)O)=O,4,4,0,4,29,0.000213
G5,C(C(CC(C(CO)=O)O)CCO)=O,4,2,0,2,25,0.000106
G5,C(C(C(C(CCCCO)O)=O)O)=O,4,2,0,2,46,0.000106
G5,C(CCCC(C(C(CO)O)=O)O)=O,4,3,0,3,27,0.000154
G5,C(C(C(CC(C=O)O)CCO)O)=O,8,2,0,2,46,0.000106
G5,C(C1CC(C(C1O)=O)O)(O)=O,8,2,0,2,29,0.000106
G5,C(C(C)O)(C(C(O)=O)C(C=O)O)=O,8,2,0,2,45,0.000106
G5,C(CC(C(C)O)=O)(O)=O,2,3,0,3,29,0.000154
G5,C(CO)(C(C)(CC(O)=O)O)=O,2,2,0,2,6,0.000106
G5,C(C(CO)CC(C(CO)=O)=O)(O)=O,2,3,0,3,29,0.000165
G5,C(C(CO)CC(C(C=O)=O)O)(O)=O,4,3,0,3,29,0.000165
G5,C(C(C(C(CCO)O)=O)=O)(O)=O,2,2,0,2,29,0.000106
G5,C(C(C)O)(C(C(C(O)=O)=O)O)=O,4,2,0,2,33,0.000106
G5,C(C(COC(C(O)=O)CO)O)=O,4,2,0,2,29,0.000106
G5,C(C(C)O)(OC(C(O)=O)CO)=O,4,2,0,2,29,0.000106
G5,C(C(COCC(C=O)O)O)(O)=O,4,2,0,2,36,0.000106
G5,C(C(C)O)(OCC(C(O)=O)O)=O,4,2,0,2,29,0.000106
G5,C(COC(C(C(C)O)=O)O)(O)=O,4,2,0,2,19,0.000106
G5,C(COC(C(O)=O)O)(C(C)O)=O,4,2,0,2,29,0.000106
G5,C(C(CCOC(C(O)=O)O)O)=O,4,2,0,2,29,0.000106
G5,C(COC(C(CO)=O)(C)O)(O)=O,2,2,0,2,29,0.000106
G5,C(CCC(C(C(O)=O)=O)O)(O)=O,2,4,0,4,29,0.000213
G5,C(C(C(C(C)O)=O)(CO)O)(O)=O,4,7,0,7,17,0.00036
G5,C(C(C)O)(C(C(O)=O)(C(C)=O)O)=O,4,4,0,4,25,0.00020299999999999997
G5,C(C(C(C(C=C)O)=O)(CO)O)(O)=O,4,7,0,7,17,0.00036
G5,C(C(C(C(C)O)=O)(C(C)O)O)(O)=O,8,6,0,6,4,0.0003
G5,C(C(C)O)(C(C(O)=O)(CC=O)O)=O,4,3,0,3,29,0.000154
G5,C(C(C)O)(C(C=O)(CC(O)=O)O)=O,4,2,0,2,17,0.000106
G5,C(C(C(CO)=O)(CC(O)=O)O)=O,2,2,0,2,0,0.000106
G5,C(C(CC(C=O)O)(C(C)O)O)(O)=O,8,3,0,3,4,0.000155
G5,C(C(C=CC(C=O)O)(CO)O)(O)=O,8,4,0,4,29,0.00021400000000000002
G5,C(CC1CC(C(O1)=O)O)(O)=O,4,3,0,3,29,0.000154
G5,C(C1C(C(C(C)O1)O)=O)(O)=O,8,2,0,2,29,0.000106
G5,C1(CCC(C(C1(CO)O)=O)O)=O,4,5,0,5,32,0.000241
G5,C(C1(CO)CC(C(C1O)=O)O)=O,8,3,0,3,5,0.000144
G5,C1(CCC(C(C1(C(C)O)O)=O)O)=O,8,4,0,4,32,0.000192
G5,C(C1(CC(C(C1O)=O)O)C(C)O)=O,16,3,0,3,46,0.000144
G5,C1(CC(C(C1(CO)O)=O)O)=O,4,2,0,2,5,9.499999999999999e-05
G5,C(C1(C(C(CCCC1O)O)=O)O)=O,8,3,0,3,27,0.00014199999999999998
G5,C1(CCCC(C1(C(CO)=O)O)O)=O,4,4,0,4,32,0.00018999999999999998
G5,C1(CCC(C(C1(C(O)=O)O)=O)O)=O,4,4,0,4,32,0.00019099999999999998
G5,C(C1(C=O)CC(C(C1O)=O)O)(O)=O,8,3,0,3,17,0.000143
G5,C(C(C(CO)=O)(C(CO)=O)O)(O)=O,1,3,0,3,5,0.000144
G5,C(C(CO)(CO)C(C=O)O)(O)=O,2,4,0,4,29,0.00021400000000000002
G5,C(C(CO)(C(C)O)C(C=O)O)(O)=O,8,5,0,5,29,0.000263
G5,C1(C(C(C(CO)O)=O)C(CO1)O)=O,8,1,0,1,8,4.7e-05
G5,C(C(CO)O)(C1(C(COC1)=O)O)=O,4,1,0,1,10,4.7e-05
G5,C(C(C(O)=O)(C(C(C)O)=O)O)(O)=O,2,4,0,4,17,0.00020299999999999997
G5,C(C(C(O)=O)(C(CO)=O)O)(O)=O,1,4,0,4,17,0.00020299999999999997
G5,C(C1(C(C(C(C1)O)=O)=O)CO)(O)=O,4,2,0,2,17,9.6e-05
G5,C(C1(CO)C(C(C(C1)=O)=O)O)(O)=O,4,1,0,1,17,4.7e-05
G5,C1(C(COC1(C(O)=O)C(C)=O)O)=O,4,3,0,3,4,0.000144
G5,C(C1(C=O)C(C(C(C)O1)O)=O)(O)=O,8,3,0,3,17,0.000144
G5,C1(C(C(C(C=C)O)=O)C(CO1)O)=O,8,1,0,1,8,4.7e-05
G5,C(C(C=C)O)(C1(C(COC1)=O)O)=O,4,1,0,1,10,4.7e-05
G5,C(C(C(CO)(CO)C(CO)O)O)=O,4,2,0,2,2,0.000106
G5,C(C(C)O)(C(C(C)=O)(C(C)O)O)=O,8,3,0,3,25,0.000145
G5,C(C(C)O)(C(C(C=O)=O)(CO)O)=O,4,3,0,3,1,0.000146
G5,C1(C(C(C(C)O)=O)(C(CO1)O)O)=O,8,1,0,1,45,4.7e-05
G5,C1(C(C(C(C)O)=O)C(CO1)O)=O,8,2,0,2,8,9.499999999999999e-05
G5,C(C(C)O)(C1(C(COC1)=O)O)=O,4,2,0,2,10,9.499999999999999e-05
G5,C(C(C(C(C=C)O)=O)(C(C)=O)O)=O,4,1,0,1,1,4.7e-05
G5,C(CO)(C(C(CO)=O)(C(C)O)O)=O,2,3,0,3,5,0.000145
G5,C(C(C(CO)=O)(C(CO)=O)CO)=O,1,2,0,2,2,9.7e-05
G5,C(CC=O)(C(C(CO)=O)(CO)O)=O,2,4,0,4,2,0.000205
G5,C(CO)(C(C(C=O)=O)(CO)CO)=O,1,2,0,2,0,9.7e-05
G5,C1(C(C(CO)=O)(C(CO1)O)O)=O,4,2,0,2,40,9.499999999999999e-05
G5,C(CO)(C1(C(COC1)=O)O)=O,2,2,0,2,5,9.499999999999999e-05
G5,C(C(C(CO)(CO)CO)O)=O,2,2,0,2,2,0.000106
G5,C(C(C(CO)(CO)C(C)O)O)=O,4,2,0,2,4,0.000106
G5,C(C(CO)(CO)OCC(C=O)O)=O,2,3,0,3,2,0.000146
G5,C(C(CO)(CO)OC(C(C)O)=O)=O,2,3,0,3,2,0.000146
G5,C(C(COCC(C=O)O)(CO)O)=O,4,3,0,3,36,0.000146
G5,C(C(CO)(COC(C(C)O)=O)O)=O,4,3,0,3,41,0.000146
G5,C(C(C(C)O)=O)(C(CO)(CO)O)=O,2,4,0,4,0,0.000205
G5,C(C(CO)=O)(C(CO)(C(C)O)O)=O,4,6,0,6,4,0.000302
G5,C1(COC(CO)(C(CO)O)C1O)=O,8,2,0,2,10,0.000106
G5,C1(C(CO)OCC(CO)(C1O)O)=O,8,1,0,1,2,4.7e-05
G5,C1(COC(CO)C(CO)(C1O)O)=O,8,2,0,2,2,0.000106
G5,C1(C(C(COCC1O)(CO)O)O)=O,8,1,0,1,36,4.7e-05
G5,C1(COCC(C(CO)(C1O)O)O)=O,8,3,0,3,29,0.000164
G5,C(C(C1(CO)C(CC(O)O1)O)O)=O,16,2,0,2,38,9.499999999999999e-05
G5,C1(C(C(CC1(CO)CO)O)=O)=O,2,2,0,2,2,9.7e-05
G5,C1(C(C(C(CO)(CO)C1)O)=O)=O,2,2,0,2,2,9.499999999999999e-05
G5,C1(C(COC1(C(C)=O)CO)O)=O,4,4,0,4,4,0.000194
G5,C1(C(CO)OC(CO)(CO)C1O)=O,4,1,0,1,2,4.7e-05
G5,C(C1(C(C(C(C)O1)O)=O)CO)=O,8,3,0,3,17,0.000146
G5,C1(C(C(CO)(CO)OCC1O)O)=O,4,1,0,1,2,4.7e-05
G5,C1(C(C(C(CCO1)O)=O)(CO)O)=O,4,3,0,3,2,0.000146
G5,C1(C(CO)C(C(C(CO)=O)O1)O)=O,8,2,0,2,8,9.7e-05
G5,C(C(C=O)(C(C(CC=O)O)=O)O)=O,2,1,0,1,23,4.7e-05
G5,C(C(C=O)(C(C(C=C)O)=O)O)=O,2,2,0,2,3,9.499999999999999e-05
G5,C(C(C(CO)(C(C)O)C(C)O)O)=O,6,2,0,2,4,0.000106
G5,C1(C(C(CC1(CO)C(C)O)O)=O)=O,8,2,0,2,47,9.6e-05
G5,C1(C(C(C(CO)(C(C)O)C1)O)=O)=O,8,1,0,1,47,4.7e-05
G5,C1(C(COC1(C(C)=O)C(C)O)O)=O,8,3,0,3,4,0.000145
G5,C(C1(C(C(C(C)O1)O)=O)C(C)O)=O,16,3,0,3,17,0.000145
G5,C1(C(CC(C(C)=O)(C(C1)O)O)O)=O,8,2,0,2,45,9.499999999999999e-05
G5,C(C1(C(CC(C(C1)O)=O)=O)O)(O)=O,4,2,0,2,17,9.6e-05
G5,C(C(CC(C(O)=O)(C(C)=O)O)O)=O,4,2,0,2,17,9.6e-05
G5,C(C(C(CC(C(C)O)=O)O)(C)O)=O,8,2,0,2,11,9.499999999999999e-05
G5,C(C(C(C)(C(CC(C)O)O)O)O)=O,16,1,0,1,25,4.7e-05
G5,C(C(CO)O)(C(C(C=O)=O)(C)O)=O,4,1,0,1,5,4.7e-05
G5,C1(CCOC1(C(C(CO)O)=O)O)=O,4,1,0,1,5,4.7e-05
G5,C(C(C=C)O)(C(C(C=O)=O)(C)O)=O,4,1,0,1,25,4.7e-05
G5,C(C(C(C)(C(C(C)=O)(C)O)O)O)=O,8,1,0,1,25,4.7e-05
G5,C(C(C(O)=O)(CC(C=O)O)O)(O)=O,2,3,0,3,17,0.000154
G5,C(C(C=CC=O)(C(C=O)O)O)(O)=O,8,2,0,2,32,0.000106
G5,C(C(C=C)(C(C(CO)=O)=O)O)(O)=O,2,2,0,2,17,9.6e-05
G5,C1(C(CC(C(O)=O)(C(C)=O)O1)O)=O,4,2,0,2,17,9.6e-05
G5,C(C1(CC=O)C(C(CO1)=O)O)(O)=O,4,1,0,1,17,4.7e-05
G5,C(C1(C)C(C(C(C=O)O1)=O)O)(O)=O,8,1,0,1,29,4.7e-05
G5,C(C(C)(C(C=CC(C=O)O)O)O)=O,16,2,0,2,11,9.499999999999999e-05
G5,C(C1(C(CCO1)=O)O)(C(C=C)O)=O,4,1,0,1,7,4.7e-05
G5,C(C(CO)=O)(C(C)(C(CO)O)O)=O,4,3,0,3,0,0.000154
G5,C(C(C)O)(C(C(C=O)=O)(C)O)=O,4,1,0,1,49,4.7e-05
G5,C1(CCOC1(C(C(C)O)=O)O)=O,4,1,0,1,34,4.7e-05
G5,C(C(C(CO)=O)(CC(C=O)=O)O)=O,2,1,0,1,0,4.7e-05
G5,C(CC(C(CO)=O)(C(CO)=O)O)=O,1,1,0,1,0,4.7e-05
G5,C(C(C(C(C(CO)=O)=O)(C)O)O)=O,4,2,0,2,25,9.6e-05
G5,C1(CCOC1(C(CO)=O)O)=O,2,1,0,1,34,4.7e-05
G5,C(C(CO)(CC(C(C)O)=O)O)(O)=O,4,2,0,2,5,9.7e-05
G5,C(C(CC(C(C=O)=O)(CO)O)O)=O,4,3,0,3,29,0.000155
G5,C(C(CO)(OCC(C(C)O)=O)O)=O,4,2,0,2,2,9.7e-05
G5,C1(C(C(CO)(O)OC(CO)C1)O)=O,8,2,0,2,0,9.499999999999999e-05
G5,C1(C(C(CO)(CC(CO)O1)O)O)=O,8,1,0,1,2,4.7e-05
G5,C1(C(C(CO)(O)OCC(C1)O)O)=O,8,2,0,2,41,9.499999999999999e-05
G5,C1(C(C(CO)(CC(CO1)O)O)O)=O,8,1,0,1,41,4.7e-05
G5,C1(C(O)OCCC(CO)(C1O)O)=O,8,2,0,2,19,9.499999999999999e-05
G5,C1(C(CC(C(C)=O)(CO)O1)O)=O,4,3,0,3,22,0.000144
G5,C(CC1(CO)C(C(CO1)=O)O)=O,4,1,0,1,9,4.7e-05
G5,C(C1C(C(C(CO)(C)O1)O)=O)=O,8,1,0,1,29,4.7e-05
G5,C1(C(CO)(CC(C(CO1)=O)O)O)=O,4,2,0,2,2,9.7e-05
G5,C1(C(O)OC(CO)(CCO)C1O)=O,8,2,0,2,2,9.499999999999999e-05
G5,C1(C(C(CO)(C)OC(C1O)O)O)=O,16,2,0,2,24,9.499999999999999e-05
G5,C(C(C(C)(C(CO)(C)O)O)O)=O,8,2,0,2,25,0.000106
G5,C(C(C(C)(C(C)O)O)O)=O,8,1,0,1,4,4.7e-05
G5,C(C(CO)=O)(C(C)(C(C)O)O)=O,4,2,0,2,4,9.6e-05
G5,C(C(C(C(C)(C(C)O)O)O)=O)=O,8,1,0,1,4,4.7e-05
G5,C(C(C(C=CC=O)(C(C)O)O)O)=O,16,2,0,2,32,0.000106
G5,C=CC(C(C(CO)=O)=O)(C(C)O)O,4,2,0,2,4,9.6e-05
G5,C(C(C(C)O)(C(C(C=O)=O)O)O)=C,8,1,0,1,4,4.7e-05
G5,C1(C(CC(C(C)=O)(C(C)O)O1)O)=O,8,2,0,2,4,9.6e-05
G5,C(CC1(C(C)O)C(C(CO1)=O)O)=O,8,1,0,1,9,4.7e-05
G5,C(C1C(C(C(C)(C(C)O)O1)O)=O)=O,16,1,0,1,29,4.7e-05
G5,C(C(C)O)(CC(C(C(O)=O)O)O)=O,8,2,0,2,45,9.499999999999999e-05
G5,C(C(C=CC(C(C(O)=O)O)O)O)=O,16,2,0,2,11,9.499999999999999e-05
G5,C(CO)(C(C)(O)OC(CO)=O)=O,2,1,0,1,14,4.7e-05
G5,C(CO)(CC(O)OC(CO)=O)=O,2,2,0,2,43,9.499999999999999e-05
G5,C1(C(C(C(C)C1O)O)=O)=O,3,1,0,1,42,4.7e-05
G5,C1CC(C(C(C=1)=O)=O)O,2,2,0,2,9,9.499999999999999e-05
G5,C1CC(C(C(C=1)O)=O)=O,2,4,0,4,29,0.00018999999999999998
G5,C(C(C(C(C=O)O)=O)C)=O,4,3,0,3,29,0.00014199999999999998
G5,C(CO)(C(C(C(CO)=O)=O)C)=O,2,2,0,2,42,9.499999999999999e-05
G5,C(C(CO)O)(C(C(C=O)=O)C)=O,4,3,0,3,29,0.00014199999999999998
G5,C(C(C(C(C)C(CO)O)=O)O)=O,8,4,0,4,29,0.000212
G5,C(C(CO)O)(C(C(CO)=O)C)=O,4,3,0,3,29,0.00014199999999999998
G5,C(C(C(C(C(CO)=O)C)O)O)=O,8,4,0,4,29,0.000212
G5,C(C(C(C)C(C(CO)=O)O)O)=O,8,2,0,2,5,0.000106
G5,C(C(C(C(CO)O)=O)CCO)=O,4,6,0,6,29,0.00031800000000000003
G5,C(C(C(C(C=O)O)O)CCO)=O,8,4,0,4,29,0.000212
G5,C(C(CO)C(CO)C(C=O)O)=O,8,3,0,3,29,0.000154
G5,C(C(C(C(CO)C)=O)O)=O,4,2,0,2,11,9.499999999999999e-05
G5,C(C(C(C(CO)O)=O)C)=O,4,4,0,4,29,0.00020099999999999998
G5,C(C(C)C(C(C=O)O)O)=O,8,3,0,3,29,0.000153
G5,C(C(CO)CC(C=O)O)=O,4,2,0,2,29,9.499999999999999e-05
G5,C(CCC(C(C(CO)=O)=O)O)=O,2,2,0,2,51,9.499999999999999e-05
G5,C(CCC(C=O)O)(C(C=O)O)=O,4,5,0,5,55,0.00024900000000000004
G5,C(C(C(C)CC(C=O)=O)O)=O,4,2,0,2,52,9.6e-05
G5,C(C(C(C(C(CO)=O)O)=O)C)=O,4,4,0,4,29,0.00018999999999999998
G5,C(C(C)O)(C(C=O)CC=O)=O,4,3,0,3,29,0.00014199999999999998
G5,C(C(C)CC(C(CO)=O)=O)=O,2,2,0,2,49,9.499999999999999e-05
G5,C(C(C)CC(C(C=O)=O)O)=O,4,2,0,2,49,9.499999999999999e-05
G5,C(C(CC(C(C=O)=O)C)O)=O,4,2,0,2,0,9.499999999999999e-05
G5,C(C)(CC(C(C(C)O)=O)=O)=O,2,2,0,2,25,9.499999999999999e-05
G5,C(C(C)O)(C(C(C=O)=O)C)=O,4,3,0,3,29,0.00014199999999999998
G5,C(CO)(C(C(C(C)=O)=O)C)=O,2,2,0,2,0,9.499999999999999e-05
G5,C(C(C)CC(C(CO)=O)O)=O,4,2,0,2,49,9.499999999999999e-05
G5,C(C(C(C)CC(CO)=O)O)=O,4,2,0,2,52,9.6e-05
G5,C(C(CC(C(CO)=O)C)O)=O,4,2,0,2,52,9.499999999999999e-05
G5,C(C(C(C)C(C(C)=O)O)O)=O,8,1,0,1,2,4.7e-05
G5,C(C(C)O)(C(C(CO)=O)C)=O,4,3,0,3,29,0.00014199999999999998
G5,C(CC(C)C(C=O)O)=O,4,2,0,2,0,9.6e-05
G5,C(CO)(CC(C(CC)=O)=O)=O,1,2,0,2,4,9.499999999999999e-05
G5,C(CCC(C=O)O)(CC=O)=O,2,2,0,2,21,9.499999999999999e-05
G5,C(CCC(CC(C=O)O)=O)=O,2,2,0,2,4,9.499999999999999e-05
G5,C(CC(C=CC(CO)=O)=O)=O,2,5,0,5,29,0.00023700000000000001
G5,C(C(C=CC(CO)=O)=O)(C)=O,2,4,0,4,29,0.00018999999999999998
G5,C(C(C(C(CCO)O)=O)C)=O,4,3,0,3,29,0.00014199999999999998
G5,C(C(C)C(CO)C(C=O)O)=O,8,3,0,3,29,0.000154
G5,C(C(CC(C=O)O)CCO)=O,4,3,0,3,29,0.000154
G5,C(C(C(C(C)O)=O)CCO)=O,4,3,0,3,29,0.00014199999999999998
G5,C(CCC(C(C(C)=O)=O)O)=O,2,2,0,2,49,9.499999999999999e-05
G5,C(CCC(C(C(C)O)=O)=O)=O,2,2,0,2,25,9.499999999999999e-05
G5,C(CC(C(C(CO)=O)=O)C)=O,2,3,0,3,29,0.00014199999999999998
G5,C(CC(C)C(C(C=O)=O)O)=O,4,2,0,2,16,9.499999999999999e-05
G5,C(C(C)CC(C=O)O)=O,4,2,0,2,49,9.499999999999999e-05
G5,C(C(C(C(C)O)=O)C)=O,4,3,0,3,29,0.00014199999999999998
G5,C(C(CC(C=O)O)C(CO)O)=O,8,4,0,4,29,0.000212
G5,C(C(C(C(C(CO)O)O)=O)C)=O,8,5,0,5,29,0.00026000000000000003
G5,C(C(C)C(C(C(CO)=O)O)O)=O,8,2,0,2,49,9.499999999999999e-05
G5,C(C(CO)C)(C(C(CO)=O)O)=O,4,2,0,2,5,9.499999999999999e-05
G5,C(CC(CO)C(C=O)O)=O,4,7,0,7,29,0.000367
G5,C(CC)(C(C(CO)=O)O)=O,2,2,0,2,11,9.499999999999999e-05
G5,C(CC(C=CC=O)C(C=O)O)=O,8,2,0,2,29,9.499999999999999e-05
G5,C(CCC(C(C(C=C)=O)=O)O)=O,2,2,0,2,7,9.499999999999999e-05
G5,C(CCC(C(C(C=C)O)=O)=O)=O,2,3,0,3,29,0.00014199999999999998
G5,C(CC(C=C)C(C(CO)=O)=O)=O,2,3,0,3,29,0.00014199999999999998
G5,C(CC(C=C)C(C(C=O)=O)O)=O,4,2,0,2,29,9.499999999999999e-05
G5,C(CC(CC=CC(C=O)O)=O)=O,4,3,0,3,29,0.00014199999999999998
G5,C(C(C=CC(CCC=O)=O)O)=O,4,2,0,2,32,9.499999999999999e-05
G5,C(C(C=CC(CO)=O)CC=O)=O,4,4,0,4,29,0.00018999999999999998
G5,C(C)(CC(C=CC(CO)=O)=O)=O,2,4,0,4,29,0.00018999999999999998
G5,C(C(C=CC(CO)=O)=O)(CC)=O,2,2,0,2,32,9.499999999999999e-05
G5,C(CCC(C(C=CC=O)=O)O)=O,4,3,0,3,29,0.000143
G5,C(CO)(C(C(CO)=O)C)=O,1,2,0,2,0,9.499999999999999e-05
G5,C(C(C(C)C(C=O)O)O)=O,3,2,0,2,28,0.000106
G5,C(CO)(C(C(CO)=O)C(C)=O)=O,1,3,0,3,29,0.00014199999999999998
G5,C(CC(C(CO)=O)C(CO)=O)=O,1,3,0,3,29,0.00014199999999999998
G5,C(CC(C(C=O)O)C(C=O)O)=O,3,3,0,3,0,0.000143
G5,C(C(C(CO)=O)CCO)=O,2,7,0,7,29,0.000366
G5,C(C(C=O)O)(C(C(CO)=O)C)=O,4,3,0,3,29,0.00014199999999999998
G5,C(C(C(C)C(C(C=O)=O)O)O)=O,8,2,0,2,26,0.000106
G5,C(CCC(C(C(C=O)O)=O)O)=O,4,4,0,4,29,0.00020099999999999998
G5,C(C(C(CO)=O)=O)(CC)=O,1,2,0,2,42,9.499999999999999e-05
G5,C=CC(C(C(C)=O)=O)O,2,4,0,4,29,0.00018999999999999998
G5,C(C(CC(C=O)(C(C)=O)O)O)=O,4,2,0,2,0,9.499999999999999e-05
G5,C(C(CO)(C(C)C(C=O)O)O)=O,8,1,0,1,28,4.7e-05
G5,C(C(C=O)(CC(C=O)O)O)=O,2,1,0,1,1,4.7e-05
G5,C(C(C=O)C(C(C(C)O)=O)=O)=O,2,2,0,2,1,9.499999999999999e-05
G5,C(C(C(C)=O)C(C(CO)=O)=O)=O,2,2,0,2,1,9.499999999999999e-05
G5,C(C(C=O)(C(C)C(C=O)O)O)=O,4,1,0,1,28,4.7e-05
G5,C1(C(CO)CC(C(CO1)=O)O)=O,4,2,0,2,43,9.499999999999999e-05
G5,C(C(C(CO)=O)C(C=C)=O)=O,2,4,0,4,29,0.00018999999999999998
G5,C(C)(C(C(C)=O)C(CO)=O)=O,1,2,0,2,28,9.499999999999999e-05
G5,C(C(C=O)C(C(CO)=O)=O)=O,1,2,0,2,1,9.499999999999999e-05
G5,C(C(C)C(C=O)(C(CO)=O)O)=O,4,3,0,3,29,0.000153
G5,C(C(C)C(CO)(C(C=O)O)O)=O,8,5,0,5,29,0.000271
G5,C(C)(C(C(CO)=O)C(C=C)=O)=O,2,2,0,2,32,9.499999999999999e-05
G5,C(C)(C(C(C)=O)(C(CO)=O)O)=O,1,2,0,2,0,9.499999999999999e-05
G5,C1(C(C(CC1(C)O)O)=O)=O,4,1,0,1,25,4.7e-05
G5,C(CO)(C(C(C(O)=O)=O)C)=O,2,2,0,2,28,9.499999999999999e-05
G5,C(C(C(C=O)=O)CC(C=O)O)=O,4,2,0,2,51,9.499999999999999e-05
G5,C(C(CC(C=O)C(C)=O)O)=O,4,2,0,2,4,9.499999999999999e-05
G5,C(C(CCO)C(C(C=O)=O)O)=O,4,4,0,4,29,0.000212
G5,C(C(C)C(C(C(C=O)O)=O)O)=O,8,3,0,3,29,0.000153
G5,C(C(C=O)C=CC(C=O)O)=O,4,4,0,4,29,0.00018999999999999998
G5,C(C(C(C)=O)C=CC(C=O)O)=O,8,3,0,3,29,0.00014199999999999998
G5,C(C1C(C(CCO1)O)=O)=O,4,3,0,3,29,0.00014199999999999998
G5,C=C1C(C(C(C1)O)=O)=O,2,2,0,2,47,9.499999999999999e-05
G5,C=C1CC(C(C1O)=O)=O,2,4,0,4,29,0.00018999999999999998
G5,C(C(CC=CC(O)=O)O)=O,4,4,0,4,29,0.00020099999999999998
G5,C(C=CC(C(C)O)=O)(O)=O,4,2,0,2,45,9.499999999999999e-05
G5,C=CCC(C(CO)=O)=O,1,4,0,4,29,0.00018999999999999998
G5,C=CCC(C(C=O)=O)O,2,3,0,3,29,0.00014199999999999998
G5,C1(C(C(OC1C(C)=O)O)O)=O,8,3,0,3,5,0.00014199999999999998
G5,C(CC1C(C(C(O1)O)O)=O)=O,8,3,0,3,5,0.00014199999999999998
G5,C(C1C(C(C(CO)O1)=O)O)=O,8,2,0,2,2,9.499999999999999e-05
G5,C1(CCOC1C(CO)=O)=O,2,4,0,4,29,0.00018999999999999998
G5,C1(C(C(C(CCO)O1)O)=O)=O,4,2,0,2,2,9.499999999999999e-05
G5,C1(C(C2CC(CO2)O1)O)=O,8,2,0,2,39,9.499999999999999e-05
G5,C1(C2OCCC(C1O)O2)=O,8,1,0,1,4,4.7e-05
G5,C1(C(C(C=O)OCC1O)O)=O,8,1,0,1,2,4.7e-05
G5,C(C1(CC(C(CO1)=O)O)O)=O,4,2,0,2,2,9.499999999999999e-05
G5,C(C1(C(C(CCO1)O)=O)O)=O,4,2,0,2,2,9.499999999999999e-05
G5,C1(C(CCC(C=O)O1)O)=O,4,3,0,3,12,0.00014199999999999998
G5,C1(C(C(C)OCC1O)=O)=O,4,2,0,2,2,9.499999999999999e-05
G5,C1(C(COC(C)C1O)=O)=O,4,2,0,2,2,9.499999999999999e-05
G5,C1(CC(C(OC1C)=O)O)=O,4,3,0,3,24,0.00014199999999999998
G5,C1(C(C)(O)OCCC1O)=O,4,2,0,2,9,9.499999999999999e-05
G5,C1(COC(C)(CC1O)O)=O,4,2,0,2,26,9.499999999999999e-05
G5,C1(C(C(C)OCC1O)O)=O,8,1,0,1,4,4.7e-05
G5,C1(CC(C(C(C)(O)O1)=O)O)=O,4,2,0,2,17,9.499999999999999e-05
G5,C1(C(C(CC(C)(O)O1)O)=O)=O,4,2,0,2,14,9.499999999999999e-05
G5,C1(C(C(C(C(C)O1)O)=O)O)=O,8,2,0,2,2,9.499999999999999e-05
G5,C1(COC(C(CC1O)=O)O)=O,4,3,0,3,5,0.00014199999999999998
G5,C1(C(C(C(O)OCC1)O)=O)=O,4,3,0,3,2,0.00014199999999999998
G5,C1(C(C(O)OCCC1O)=O)=O,4,2,0,2,31,9.499999999999999e-05
G5,C1(C(C(OCC(C1)=O)O)O)=O,4,4,0,4,29,0.00018999999999999998
G5,C1(COC(CCC1O)O)=O,4,2,0,2,7,9.499999999999999e-05
G5,C1(C(CCOCC1O)O)=O,4,1,0,1,4,4.7e-05
G5,C1(C(CC(CCO1)O)O)=O,4,2,0,2,29,9.499999999999999e-05
G5,C1(C(O)OCCCC1O)=O,4,2,0,2,29,9.499999999999999e-05
G5,C1(C(C(CCC(O)O1)O)=O)=O,4,2,0,2,17,9.499999999999999e-05
G5,C1(CC(CC(C(O1)=O)O)O)=O,4,3,0,3,29,0.00014199999999999998
G5,C1(CCC(C(C(O)O1)=O)O)=O,4,2,0,2,29,9.499999999999999e-05
G5,C(C(C(C(C=O)=C)O)O)=O,4,4,0,4,29,0.00020099999999999998
G5,C(CO)(CO)=CC(C(CO)=O)=O,1,3,0,3,29,0.00014199999999999998
G5,C(C(C(C=O)=O)O)=C(CO)CO,2,3,0,3,29,0.00014199999999999998
G5,C(C(C(C(C(CO)O)=C)O)O)=O,8,5,0,5,29,0.000271
G5,C(CO)(C(C=C(CO)CO)O)=O,2,4,0,4,29,0.00020099999999999998
G5,C(C(C(C(C=O)=CCO)O)O)=O,8,5,0,5,29,0.00026000000000000003
G5,C(C(C(C(CO)=CCO)O)O)=O,8,3,0,3,29,0.000153
G5,C(C(C(CO)=C(CO)CO)O)=O,2,4,0,4,29,0.00020099999999999998
G5,C(C(C(C(CO)(CO)O)=C)O)=O,2,4,0,4,29,0.00020099999999999998
G5,C(C(C(C(CO)=C)O)O)=O,4,3,0,3,29,0.000153
G5,C(C(C=C(CO)CO)O)=O,2,2,0,2,29,9.499999999999999e-05
G5,C(C(C(C=O)=O)O)=CC(CO)O,8,3,0,3,29,0.00014199999999999998
G5,C(C(C(CO)=CC(CO)O)O)=O,8,5,0,5,29,0.00026000000000000003
G5,C(C(C(C(C(CO)O)O)=C)O)=O,8,6,0,6,29,0.00031800000000000003
G5,C(C(C=CC(C(C)O)=O)=O)=O,4,2,0,2,49,9.499999999999999e-05
G5,C(C(C=C(C(CO)=O)C)=O)=O,2,2,0,2,26,9.499999999999999e-05
G5,C(C(C=CC(C)=O)=O)(CO)=O,2,2,0,2,5,9.499999999999999e-05
G5,C(C(C(C=O)=O)O)=CC(C)=O,4,3,0,3,29,0.00014199999999999998
G5,C=C(C=O)CC(C(CO)=O)=O,1,4,0,4,29,0.00018999999999999998
G5,C=C(C=O)CC(C(C=O)=O)O,2,3,0,3,29,0.00014199999999999998
G5,C(C(C)=CC(C(CO)=O)=O)=O,2,2,0,2,25,9.499999999999999e-05
G5,C(C(C(C=O)=O)O)=C(C=O)C,4,2,0,2,16,9.499999999999999e-05
G5,C(CO)(C(C=CC(C)=O)O)=O,4,3,0,3,29,0.00014199999999999998
G5,C(CO)(C(CC(C=O)=C)O)=O,2,2,0,2,16,9.499999999999999e-05
G5,C(CO)(C(C=C(C=O)C)O)=O,4,2,0,2,16,9.499999999999999e-05
G5,C=C(C(C(C)O)=O)C(C=O)=O,2,2,0,2,24,9.499999999999999e-05
G5,C=C(C=O)C(C(CCO)O)=O,2,4,0,4,29,0.00020099999999999998
G5,C(C(C(CO)=CC(C)=O)O)=O,4,3,0,3,29,0.000154
G5,C=C(C(C(C)O)=O)C(CO)=O,2,2,0,2,24,9.499999999999999e-05
G5,C(C(C(C(C=O)=C)CO)O)=O,4,3,0,3,29,0.000154
G5,C(C(C(CO)=C(C=O)C)O)=O,4,3,0,3,29,0.000154
G5,C(C(C(C(C=O)O)=C)(C)O)=O,4,3,0,3,29,0.00014199999999999998
G5,C(C(CC(C=O)=C)O)=O,2,2,0,2,16,9.499999999999999e-05
G5,C(C(C=C(C=O)C)O)=O,4,2,0,2,16,9.499999999999999e-05
G5,C=C(C=O)C(C(C)O)=O,2,2,0,2,49,9.499999999999999e-05
G5,C(C(C(C(C)O)=O)=CC=O)=O,4,3,0,3,29,0.00014199999999999998
G5,C(CO)(C(C=CC(C=O)=O)O)=O,4,2,0,2,5,9.499999999999999e-05
G5,C(C(C(CO)=O)=CC(CO)=O)=O,2,4,0,4,29,0.00018999999999999998
G5,C(C=CC(CO)=O)(C(C)O)=O,4,2,0,2,49,9.499999999999999e-05
G5,C(C(CO)=CC=O)(C(C)O)=O,4,2,0,2,49,9.499999999999999e-05
G5,C(C=CC(C(CO)=O)=O)=O,2,7,0,7,55,0.000332
G5,C(C(C=CC(C(CO)=O)=O)O)=O,4,2,0,2,29,9.499999999999999e-05
G5,C(C(C=CC(C(C=O)=O)O)O)=O,8,3,0,3,29,0.00014199999999999998
G5,C(C(C(C=CC(CO)=O)=O)O)=O,4,2,0,2,1,9.499999999999999e-05
G5,C(C)(CO)=CC(C(CO)=O)=O,2,2,0,2,49,9.499999999999999e-05
G5,C(C(C(C=O)=O)O)=C(CO)C,4,2,0,2,49,9.499999999999999e-05
G5,C=C(CO)CC(C(CO)=O)=O,1,3,0,3,29,0.00014199999999999998
G5,C=C(CO)CC(C(C=O)=O)O,2,2,0,2,49,9.499999999999999e-05
G5,C(CO)(CC(C(CO)=O)=C)=O,1,7,0,7,29,0.00035499999999999996
G5,C(C(C(CC(C=O)O)=C)O)=O,4,2,0,2,55,9.499999999999999e-05
G5,C(C(C)=CC(CO)=O)(CO)=O,2,3,0,3,29,0.00014199999999999998
G5,C(C(C=C(C)C(C=O)O)O)=O,8,2,0,2,0,9.499999999999999e-05
G5,C(C(C(C(C(C)O)=O)=C)O)=O,4,2,0,2,49,9.499999999999999e-05
G5,C(C)=CC(C(CO)=O)=O,2,2,0,2,4,9.499999999999999e-05
G5,C(C(C(C=O)=O)O)=CC,4,2,0,2,33,9.499999999999999e-05
G5,C(CC(C(CO)=O)=C)=O,1,6,0,6,29,0.000285
G5,C(C=C(C(CO)=O)C)=O,2,3,0,3,29,0.00014199999999999998
G5,C(C=C(C(CO)=O)C(CO)=O)=O,1,2,0,2,0,9.499999999999999e-05
G5,C(C(C(C(C=O)O)=CC=O)O)=O,3,2,0,2,0,9.499999999999999e-05
G5,C=C(C(CO)=O)C(C=O)=O,1,2,0,2,51,9.499999999999999e-05
G5,C(CO)(C(C=C(CO)C)O)=O,4,2,0,2,49,9.499999999999999e-05
G5,C(CO)(C(CC(CO)=C)O)=O,2,2,0,2,49,9.499999999999999e-05
G5,C(C(CC(C(CO)O)=C)O)=O,4,2,0,2,52,9.499999999999999e-05
G5,C(C(C=C(C)C(CO)O)O)=O,8,2,0,2,52,9.499999999999999e-05
G5,C=C(C(C(C)O)=O)C(CO)O,4,2,0,2,49,9.499999999999999e-05
G5,C(CO)(C(C=CC)O)=O,4,2,0,2,11,9.499999999999999e-05
G5,C(CO)(C(CC=C)O)=O,2,2,0,2,11,9.499999999999999e-05
G5,C(C(C(C(C)O)=CC=O)O)=O,8,3,0,3,29,0.00014199999999999998
G5,C(C)=C(C(CO)=O)C(CO)=O,1,2,0,2,27,9.499999999999999e-05
G5,C(C(C(C(C=O)O)=CC)O)=O,3,2,0,2,11,9.499999999999999e-05
G5,C(CO)(C(C(CO)=O)C=C)=O,1,2,0,2,27,9.499999999999999e-05
G5,C(C(C(C=C)C(C=O)O)O)=O,3,2,0,2,11,9.499999999999999e-05
G5,C=C(C(C(C(CO)O)=O)=O)CO,2,3,0,3,29,0.000153
G5,C=C(CO)C(C(C(CO)=O)=O)O,2,2,0,2,30,9.499999999999999e-05
G5,C(C(C(CO)=CC(CO)=O)O)=O,4,5,0,5,29,0.00024900000000000004
G5,C(C(CC(C(C=O)=O)=C)O)=O,2,2,0,2,12,9.499999999999999e-05
G5,C=C(C=O)C(C(C(C)=O)=O)O,2,4,0,4,29,0.00018999999999999998
G5,C=C(C=O)C(C(C(C)O)=O)=O,2,2,0,2,9,9.499999999999999e-05
G5,C(CC(C(C(C=C)=O)=O)O)=O,2,2,0,2,9,9.499999999999999e-05
G5,C(CC(C(C(C=C)O)=O)=O)=O,2,2,0,2,31,9.499999999999999e-05
G5,C=C(C(C)=O)C(C(CO)=O)=O,1,3,0,3,29,0.00014199999999999998
G5,C=C(C(C)=O)C(C(C=O)=O)O,2,3,0,3,29,0.00014199999999999998
G5,C=CC(CC(C(CO)=O)=O)=O,1,3,0,3,29,0.00014199999999999998
G5,C=CC(CC(C(C=O)=O)O)=O,2,2,0,2,2,9.499999999999999e-05
G5,C(CC(C(C(CO)=O)=O)=C)=O,1,3,0,3,29,0.00014199999999999998
G5,C(CC(C(C(C=O)=O)O)=C)=O,2,3,0,3,29,0.00014199999999999998
G5,C=C(C(CO)=O)C(C(C)=O)=O,1,3,0,3,29,0.00014199999999999998
G5,C(CO)(CC(C(C=C)=O)=O)=O,1,3,0,3,29,0.00014199999999999998
G5,C1(C(C(C(C(CO)O)O1)=C)O)=O,8,2,0,2,41,9.499999999999999e-05
G5,C1(C(C(C(C(CO)O1)O)=C)O)=O,8,2,0,2,41,9.499999999999999e-05
G5,C1(C(C(CO)=CC(CO)O1)O)=O,4,2,0,2,2,9.499999999999999e-05
G5,C1(C(CO)OC(C(C1O)=C)O)=O,8,4,0,4,29,0.00018999999999999998
G5,C1(C(CO)OC=C(CO)C1O)=O,4,2,0,2,9,9.499999999999999e-05
G5,C1(C(OC(C(C1O)=C)CO)O)=O,8,2,0,2,19,9.499999999999999e-05
G5,C1(C(C(C(C(CO1)O)O)=C)O)=O,8,2,0,2,41,9.499999999999999e-05
G5,C1(C(C(CO)=CC(CO1)O)O)=O,4,2,0,2,41,9.499999999999999e-05
G5,C1(C(COC(C(C1O)=C)O)O)=O,8,4,0,4,29,0.00018999999999999998
G5,C1(C(COC=C(CO)C1O)O)=O,4,2,0,2,5,9.499999999999999e-05
G5,C1(C(O)OCC(C(C1O)=C)O)=O,8,2,0,2,19,9.499999999999999e-05
G5,C1(C(O)OCC=C(CO)C1O)=O,4,2,0,2,19,9.499999999999999e-05
G5,C1(COC(C(C(C1O)=C)O)O)=O,8,4,0,4,29,0.00018999999999999998
G5,C1(COC(C=C(CO)C1O)O)=O,4,3,0,3,29,0.00014199999999999998
G5,C1(C(C(OCC(C1O)=C)O)O)=O,8,2,0,2,30,9.499999999999999e-05
G5,C(CO)(C(C(C(C=O)=O)=C)O)=O,2,3,0,3,29,0.00014199999999999998
G5,C(C(C(CO)=CC(CO)=O)=O)=O,2,3,0,3,29,0.00014199999999999998
G5,C(C(C=CC(CCO)=O)O)=O,4,3,0,3,29,0.000154
G5,C(C(CC(C=O)=CCO)O)=O,4,2,0,2,29,9.499999999999999e-05
G5,C(C(C=C(C=O)CCO)O)=O,4,2,0,2,29,9.499999999999999e-05
G5,C(CO)=C(C(C(C)O)=O)C=O,4,2,0,2,29,9.499999999999999e-05
G5,C=C(C(C(CCO)O)=O)CO,2,2,0,2,3,9.499999999999999e-05
G5,C(C(C(C(CO)(C)O)=C)O)=O,4,2,0,2,29,9.499999999999999e-05
G5,C(C(C(CO)=C(CO)C)O)=O,4,3,0,3,29,0.000154
G5,C(C(C(C(CO)=C)CO)O)=O,4,3,0,3,29,0.000154
G5,C(C(CC(CO)=CCO)O)=O,4,3,0,3,29,0.000154
G5,C(C(C=C(CO)CCO)O)=O,4,3,0,3,29,0.000154
G5,C(CO)=C(C(C(C)O)=O)CO,4,2,0,2,3,9.499999999999999e-05
G5,C=CC(C(CCO)O)=O,2,4,0,4,29,0.00020099999999999998
G5,C(C(C(C(C)O)=C)O)=O,4,2,0,2,29,9.499999999999999e-05
G5,C(C(C(CO)=CC)O)=O,4,3,0,3,29,0.000154
G5,C(C(C(C=C)CO)O)=O,4,3,0,3,29,0.000154
G5,C(CO)(C(C(C=CC)=O)O)=O,4,2,0,2,11,9.499999999999999e-05
G5,C(C(C=O)O)(C(C=CC)O)=O,8,2,0,2,11,9.499999999999999e-05
G5,C(C(C(CO)=O)O)(CC=C)=O,2,3,0,3,29,0.00014199999999999998
G5,C(C(C(C(CC=C)O)=O)O)=O,4,2,0,2,11,9.499999999999999e-05
G5,C(CC(C(C(CO)=O)O)=C)=O,2,4,0,4,29,0.00018999999999999998
G5,C(CO)(C(C(C)=CC=O)O)=O,4,2,0,2,28,9.499999999999999e-05
G5,C(CO)(C(C(C=O)=CC=O)O)=O,4,3,0,3,29,0.00014199999999999998
G5,C(C(C=C(CO)C)O)=O,4,2,0,2,49,9.499999999999999e-05
G5,C(C(CC(CO)=C)O)=O,2,2,0,2,49,9.499999999999999e-05
G5,C=C(C(C(C)O)=O)CO,2,2,0,2,49,9.499999999999999e-05
G5,C(C(C=CCC(C=O)O)O)=O,8,3,0,3,21,0.00014199999999999998
G5,C(C(C=CC(C(C)O)=O)O)=O,8,2,0,2,49,9.499999999999999e-05
G5,C(C(C=CC)O)=O,4,2,0,2,11,9.499999999999999e-05
G5,C(C(CC=C)O)=O,2,2,0,2,11,9.499999999999999e-05
G5,C=CC(C(C)O)=O,2,2,0,2,49,9.499999999999999e-05
G5,C(C(C=C(CO)C(CO)O)O)=O,8,4,0,4,29,0.000212
G5,C(CO)(C(C(C(CO)=C)O)O)=O,4,4,0,4,29,0.00020099999999999998
G5,C(C(CCC(C=CC=O)=O)O)=O,4,2,0,2,7,9.499999999999999e-05
G5,C(C(CCC(C=O)=CC=O)O)=O,4,2,0,2,29,9.499999999999999e-05
G5,C(CC(C=O)=CCC(C=O)O)=O,4,3,0,3,29,0.00014199999999999998
G5,C(C(CC(C=C)C(C=O)=O)O)=O,4,2,0,2,12,9.499999999999999e-05
G5,C(C(CC(C(C=O)=O)=CC)O)=O,4,2,0,2,12,9.499999999999999e-05
G5,C(C(C(C=C)CC(C=O)=O)O)=O,4,2,0,2,12,9.499999999999999e-05
G5,C(C(C(CC(C=O)=O)=CC)O)=O,4,2,0,2,12,9.499999999999999e-05
G5,C(C(C)O)(CC(C=CC=O)=O)=O,4,4,0,4,29,0.00018999999999999998
G5,C(C(C)O)(CC(C=O)=CC=O)=O,4,2,0,2,29,9.499999999999999e-05
G5,C(CC(C=O)=CC(C(C)O)=O)=O,4,3,0,3,29,0.00014199999999999998
G5,C(C(C)O)(C(C=C)C(C=O)=O)=O,4,2,0,2,45,9.499999999999999e-05
G5,C(C)=C(C(C(C)O)=O)C(C=O)=O,4,2,0,2,45,9.499999999999999e-05
G5,C(C(CC=C)O)(CC(C=O)=O)=O,2,2,0,2,22,9.499999999999999e-05
G5,C(C(C=CC)O)(CC(C=O)=O)=O,4,2,0,2,22,9.499999999999999e-05
G5,C(CC(C(C(C)=O)=O)O)=CC=O,4,2,0,2,9,9.499999999999999e-05
G5,C(CC(C(C(C)O)=O)=O)=CC=O,4,3,0,3,29,0.00014199999999999998
G5,C(CC=CC(C(C(C)=O)=O)O)=O,4,2,0,2,9,9.499999999999999e-05
G5,C(CC=CC(C(C(C)O)=O)=O)=O,4,2,0,2,4,9.499999999999999e-05
G5,C(CC(C(C(C)O)=O)=CC=O)=O,4,2,0,2,29,9.499999999999999e-05
G5,C(CC(C(C(C)=CC=O)=O)O)=O,4,2,0,2,29,9.499999999999999e-05
G5,C(CC(C(C(CC=O)O)=O)=C)=O,2,2,0,2,29,9.499999999999999e-05
G5,C(C(C=C)C(C(C(C)O)=O)=O)=O,4,3,0,3,29,0.00014199999999999998
G5,C(C)=C(C=O)C(C(C(C)=O)=O)O,4,2,0,2,9,9.499999999999999e-05
G5,C(C)=C(C=O)C(C(C(C)O)=O)=O,4,2,0,2,9,9.499999999999999e-05
G5,C(CC(C(C(CC=C)=O)=O)O)=O,2,2,0,2,9,9.499999999999999e-05
G5,C(CC(C(C(CC=C)O)=O)=O)=O,2,2,0,2,9,9.499999999999999e-05
G5,C(CC(C(C(C=CC)=O)=O)O)=O,4,2,0,2,9,9.499999999999999e-05
G5,C(CC(C(C(C=CC)O)=O)=O)=O,4,2,0,2,9,9.499999999999999e-05
G5,C(C)(CC(C(CO)=O)=CC=O)=O,2,2,0,2,29,9.499999999999999e-05
G5,C(CC(C(CO)=O)=CC(C)=O)=O,2,3,0,3,29,0.00014199999999999998
G5,C(C)(CC(C(CO)=O)=O)=CC=O,2,2,0,2,29,9.499999999999999e-05
G5,C(C)(CC(C(C=O)=O)O)=CC=O,4,2,0,2,29,9.499999999999999e-05
G5,C(CC(C)=CC(C(CO)=O)=O)=O,2,2,0,2,6,9.499999999999999e-05
G5,C(CC(C)=CC(C(C=O)=O)O)=O,4,2,0,2,6,9.499999999999999e-05
G5,C(CC(CC(C(CO)=O)=O)=C)=O,1,3,0,3,29,0.00014199999999999998
G5,C(CC(CC(C(C=O)=O)O)=C)=O,2,3,0,3,29,0.00014199999999999998
G5,C(C)(C(C=C)C(C(CO)=O)=O)=O,2,2,0,2,26,9.499999999999999e-05
G5,C(C)(C(C=C)C(C(C=O)=O)O)=O,4,2,0,2,29,9.499999999999999e-05
G5,C(C)=C(C(C)=O)C(C(CO)=O)=O,2,2,0,2,29,9.499999999999999e-05
G5,C(C)=C(C(C)=O)C(C(C=O)=O)O,4,2,0,2,29,9.499999999999999e-05
G5,C(CC=C)(CC(C(CO)=O)=O)=O,1,2,0,2,4,9.499999999999999e-05
G5,C(CC(C(C=O)=O)O)(CC=C)=O,2,2,0,2,4,9.499999999999999e-05
G5,C(C)=CC(CC(C(CO)=O)=O)=O,2,2,0,2,29,9.499999999999999e-05
G5,C(C)=CC(CC(C(C=O)=O)O)=O,4,2,0,2,29,9.499999999999999e-05
G5,C(CCC(C(CO)=O)=CC=O)=O,2,2,0,2,29,9.499999999999999e-05
G5,C(CC=C(C(CO)=O)CC=O)=O,2,3,0,3,29,0.00014199999999999998
G5,C(CCC(C(CO)=O)=O)=CC=O,2,2,0,2,44,9.499999999999999e-05
G5,C(CCC(C(C=O)=O)O)=CC=O,4,2,0,2,44,9.499999999999999e-05
G5,C(CC=CCC(C(CO)=O)=O)=O,2,2,0,2,44,9.499999999999999e-05
G5,C(CC=CCC(C(C=O)=O)O)=O,4,2,0,2,27,9.499999999999999e-05
G5,C(CC(C(C(CO)=O)=O)=CC)=O,2,2,0,2,4,9.499999999999999e-05
G5,C(CC(C(C(C=O)=O)O)=CC)=O,4,2,0,2,4,9.499999999999999e-05
G5,C(C(C=C)CC(C(CO)=O)=O)=O,2,3,0,3,29,0.00014199999999999998
G5,C(C(C=C)CC(C(C=O)=O)O)=O,4,2,0,2,29,9.499999999999999e-05
G5,C(C)=C(C=O)CC(C(CO)=O)=O,2,2,0,2,46,9.499999999999999e-05
G5,C(C)=C(C=O)CC(C(C=O)=O)O,4,2,0,2,46,9.499999999999999e-05
G5,C(CO)(CC(C(C)=O)=CC=O)=O,2,2,0,2,29,9.499999999999999e-05
G5,C(CC(C(C)=O)=CC(CO)=O)=O,2,2,0,2,24,9.499999999999999e-05
G5,C(CO)(CC(C(C)=CC=O)=O)=O,2,2,0,2,29,9.499999999999999e-05
G5,C(CC(C(CC(CO)=O)=O)=C)=O,1,2,0,2,21,9.499999999999999e-05
G5,C(CO)(C(C=C)C(C(C)=O)=O)=O,2,2,0,2,29,9.499999999999999e-05
G5,C(C)=C(C(CO)=O)C(C(C)=O)=O,2,2,0,2,14,9.499999999999999e-05
G5,C(CO)(CC(C(CC=C)=O)=O)=O,1,2,0,2,4,9.499999999999999e-05
G5,C(CO)(CC(C(C=CC)=O)=O)=O,2,2,0,2,29,9.499999999999999e-05
G5,C(C(C(C=CC=O)=O)O)=CCO,8,3,0,3,29,0.00014199999999999998
G5,C(CO)=CC(C(CO)=O)=CC=O,4,2,0,2,29,9.499999999999999e-05
G5,C(CO)(C(C=CC=CC=O)O)=O,8,3,0,3,32,0.00014199999999999998
G5,C(CO)(C(C(C=C)=CC=O)O)=O,4,2,0,2,29,9.499999999999999e-05
G5,C(C(C=CC(C=CC=O)O)O)=O,16,2,0,2,32,9.499999999999999e-05
G5,C(C=C(C=CC(CO)=O)CO)=O,4,2,0,2,29,9.499999999999999e-05
G5,C=CC(C(C=CC(CO)=O)=O)O,4,2,0,2,29,9.499999999999999e-05
G5,C(C(C=CC(C(C=C)=O)O)O)=O,8,3,0,3,29,0.00014199999999999998
G5,C(CO)=C(C(CO)=O)C(CO)=O,1,2,0,2,0,9.499999999999999e-05
G5,C(C(C(C(C=O)O)=CCO)O)=O,3,3,0,3,29,0.00014199999999999998
G5,C(C(C(C(CO)O)=CC=O)O)=O,8,3,0,3,29,0.00014199999999999998
G5,C(C(C=O)O)(C(C=CCO)O)=O,8,3,0,3,29,0.00014199999999999998
G5,C(C(C=CC(C(CO)O)O)O)=O,16,5,0,5,29,0.000259
G5,C(CO)=C(CO)C(C(C=O)=O)O,4,3,0,3,29,0.00014199999999999998
G5,C=C(C(CO)O)C(C(C=O)=O)O,4,3,0,3,29,0.00014199999999999998
G5,C(C(C(C(C(CO)=C)O)=O)O)=O,4,3,0,3,29,0.00014199999999999998
G5,C(C(C)=CC(CO)=O)(O)=O,2,3,0,3,29,0.000154
G5,C(CO)(CC(C(O)=O)=C)=O,1,3,0,3,29,0.000154
G5,C(C(C(C(CO)=O)=C)(CO)O)=O,2,4,0,4,29,0.000192
G5,C(C(C(CO)=O)(C(C=O)=C)O)=O,2,2,0,2,29,9.499999999999999e-05
G5,C(C(C=O)(C(C(CO)=O)=C)O)=O,1,2,0,2,29,9.499999999999999e-05
G5,C(CO)(C(C(C)=O)(C=C)O)=O,2,2,0,2,4,9.499999999999999e-05
G5,C(C(C(CO)=O)(C(CO)=C)O)=O,2,2,0,2,49,9.499999999999999e-05
G5,C(CO)(C(C=C)(C(C=C)=O)O)=O,2,2,0,2,32,9.499999999999999e-05
G5,C(C(C(C(CO)=O)=C)O)(O)=O,2,4,0,4,29,0.00020099999999999998
G5,C(C(C=C(C=O)CO)O)=O,4,3,0,3,29,0.00014199999999999998
G5,C(C(C=C(C=O)C(C)O)O)=O,8,3,0,3,29,0.00014199999999999998
G5,C(C(C=C)(C=CC(C=O)O)O)=O,8,2,0,2,32,9.499999999999999e-05
G5,C(C(C=C(C=O)C(CO)O)O)=O,8,4,0,4,29,0.00020099999999999998
G5,C1C(C(C(OCC=1)=O)=O)O,2,2,0,2,27,9.499999999999999e-05
G5,C1(COC(C=CC1O)=O)=O,2,4,0,4,29,0.00018999999999999998
G5,C(CO)=C1C(C(CO1)O)=O,4,2,0,2,2,9.499999999999999e-05
G5,C1(C(COC1(C=C)O)O)=O,4,3,0,3,2,0.00014199999999999998
G5,C1(C(O)OC(C=C)C1O)=O,8,3,0,3,18,0.00014199999999999998
G5,C1(C(COC(C1O)=C)O)=O,4,2,0,2,2,9.499999999999999e-05
G5,C(CO)(C1C=CC(O1)=O)=O,2,4,0,4,29,0.00018999999999999998
G5,C(C(O)OCC(CO)O)(CO)=O,4,3,0,3,29,0.000165
G5,C(COC(C(CO)O)O)(CO)=O,4,3,0,3,29,0.000164
G5,C1(C(CC(CO)(CO)O1)O)=O,2,2,0,2,29,9.499999999999999e-05
G5,C(C(C1C(CO)(CC(O)O1)O)O)=O,16,3,0,3,1,0.000154
G5,C(CO)(C1(CC(CO)(CO1)O)O)=O,4,2,0,2,5,9.499999999999999e-05
G5,C1(C(C(CO)C(CO)(CO)O1)O)=O,4,1,0,1,5,4.7e-05
G5,C(CO)(C1(CC(C(CO)O1)O)O)=O,8,4,0,4,41,0.00018999999999999998
G5,C(C1(C)CC(C(O1)=O)O)=O,4,2,0,2,29,9.499999999999999e-05
G5,C1(C(CC(CC(CO)=O)O1)O)=O,4,2,0,2,20,9.499999999999999e-05
G5,C(CC1(CO)CC(C(O1)=O)O)=O,4,2,0,2,51,9.499999999999999e-05
G5,C1(C(CC(C(C(C)=O)O)O1)O)=O,8,2,0,2,20,9.499999999999999e-05
G5,C1(C(OC(C(C(C)O)=O)C1)O)=O,8,2,0,2,20,9.499999999999999e-05
G5,C1(C(CC(C)(C(C=O)O)O1)O)=O,8,2,0,2,26,9.499999999999999e-05
G5,C(CO)(C1(C)CC(C(O1)O)=O)=O,4,2,0,2,26,9.499999999999999e-05
G5,C1(C(CC(C=O)O1)O)=O,4,3,0,3,33,0.00014199999999999998
G5,C1(C(CC(C)(C(CO)O)O1)O)=O,8,2,0,2,16,9.499999999999999e-05
G5,C(C1(CC(C(O1)=O)O)CCO)=O,4,2,0,2,29,9.499999999999999e-05
G5,C(C1(C)C(CO)C(C(O1)=O)O)=O,8,2,0,2,4,9.499999999999999e-05
G5,C1(C(CC(CO)(CCO)O1)O)=O,4,2,0,2,29,9.499999999999999e-05
G5,C(C(C1COC(C)(C1O)O)O)=O,16,2,0,2,45,9.499999999999999e-05
G5,C(C(C1COC(C1(C)O)O)O)=O,16,2,0,2,42,9.499999999999999e-05
G5,C1(C(O)OC(C(CO)=O)C1)=O,4,3,0,3,15,0.00014199999999999998
G5,C1(C(CC(CO)(C)O1)O)=O,4,2,0,2,29,9.499999999999999e-05
G5,C(CC(C1CC(C(O1)=O)O)O)=O,8,2,0,2,20,9.499999999999999e-05
G5,C1(C(CC(CC(C=O)O)O1)O)=O,8,2,0,2,20,9.499999999999999e-05
G5,C1(C(CC(C(C(C=O)O)O)O1)O)=O,16,1,0,1,0,4.7e-05
G5,C(CO)(C(C1CC(C(O)O1)=O)O)=O,8,2,0,2,0,9.499999999999999e-05
G5,C(C1(CC(C(C(CO)=O)O1)O)O)=O,8,2,0,2,0,9.499999999999999e-05
G5,C1(C(CC(C)O1)O)=O,4,2,0,2,27,9.499999999999999e-05
G5,C1(C(CC(CO)(C(CO)O)O1)O)=O,8,1,0,1,51,4.7e-05
G5,C(C1C(CC(C(CO)=O)(O1)O)O)=O,8,2,0,2,1,9.499999999999999e-05
G5,C(CO)(C1(CC(CO1)(C)O)O)=O,4,2,0,2,49,9.499999999999999e-05
G5,C(C(C1C(C(OC1C=O)O)O)O)=O,32,2,0,2,0,9.499999999999999e-05
G5,C1(C(C(CO)C(C=O)O1)O)=O,8,2,0,2,29,9.499999999999999e-05
G5,C(C(C1C(C)OC(C1O)O)O)=O,32,2,0,2,11,9.499999999999999e-05
G5,C(C(CC1C(CC(O)O1)O)O)=O,16,2,0,2,21,9.499999999999999e-05
G5,C1(COC(CC(CO)O)(C1O)O)=O,8,2,0,2,0,9.499999999999999e-05
G5,C1(C(C(CO)CO)(O)OCC1O)=O,4,2,0,2,2,9.499999999999999e-05
G5,C(C(C1COC(CO)(C1O)O)O)=O,16,2,0,2,30,9.499999999999999e-05
G5,C(C1COC(C1O)=O)(CCO)=O,4,2,0,2,2,9.499999999999999e-05
G5,C1(C(C(CO1)CC(CO)=O)O)=O,4,2,0,2,12,9.499999999999999e-05
G5,C(C(CC1C(C(O)OC1)=O)O)=O,8,3,0,3,12,0.00014199999999999998
G5,C(C(C1COC(C=O)(C1)O)O)=O,8,2,0,2,12,9.499999999999999e-05
G5,C(C(CO)=O)(C1COC(C1)O)=O,4,3,0,3,43,0.00014199999999999998
G5,C(C(C(C1COC(C1)O)O)=O)=O,8,2,0,2,43,9.499999999999999e-05
G5,C(C1COC(C(CO)=O)(C1)O)=O,4,2,0,2,5,9.499999999999999e-05
G5,C1(C(C)(O)OCC1C(CO)=O)=O,4,3,0,3,0,0.00014199999999999998
G5,C(CC1(C(CCO1)=O)O)(CO)=O,2,3,0,3,14,0.00014199999999999998
G5,C1(C(C(CO)C(C(C=O)O)O1)O)=O,16,1,0,1,15,4.7e-05
G5,C(C1C(C(C(O1)O)=O)CO)(CO)=O,8,2,0,2,15,9.499999999999999e-05
G5,C1(C(C(CO)C(CO)(C)O1)O)=O,8,2,0,2,49,9.499999999999999e-05
G5,C1(C(C(CO)C(C)O1)O)=O,8,2,0,2,4,9.499999999999999e-05
G5,C(C1C(CC(O1)O)O)(C(C)O)=O,16,2,0,2,49,9.499999999999999e-05
G5,C(CO)(C1C(C)(CC(O1)O)O)=O,8,2,0,2,16,9.499999999999999e-05
G5,C(C1C(C(OC1C(CO)=O)O)O)=O,16,2,0,2,43,9.499999999999999e-05
G5,C(C(CC1CC(C(O)O1)O)O)=O,16,2,0,2,21,9.499999999999999e-05
G5,C(C1CC(C(O1)O)O)(C(C)O)=O,16,2,0,2,49,9.499999999999999e-05
G5,C(C(CC1C(C(C(O)O1)O)O)O)=O,32,3,0,3,20,0.000153
G5,C(C1C(C(C(O1)O)O)O)(C(C)O)=O,32,3,0,3,20,0.000153
G5,C(CC1(CC(C(O1)=O)O)CCO)=O,4,1,0,1,30,4.7e-05
G5,C(C1C(C)OC(C1O)=O)(CCO)=O,8,1,0,1,30,4.7e-05
G5,C1(C(C(C(C)O1)CC(CO)=O)O)=O,8,1,0,1,12,4.7e-05
G5,C(C(CC1C(C(O)OC1C)=O)O)=O,16,2,0,2,12,9.499999999999999e-05
G5,C(C(C1CC(C=O)(O)OC1C)O)=O,16,2,0,2,12,9.499999999999999e-05
G5,C1(C(C(C(C)O1)C(C(C)=O)O)O)=O,16,1,0,1,45,4.7e-05
G5,C(C(C)O)(C1C(C(O)OC1C)=O)=O,16,2,0,2,45,9.499999999999999e-05
G5,C(CC(C1C(C)OC(C1O)=O)O)=O,16,1,0,1,45,4.7e-05
G5,C(CO)(C1(CCC(O1)O)CC=O)=O,4,2,0,2,29,9.499999999999999e-05
G5,C(CC1CCC(C(CO)=O)(O)O1)=O,4,2,0,2,44,9.499999999999999e-05
G5,C(C(CO)=O)(C1C(C)OC(C1)O)=O,8,2,0,2,46,9.499999999999999e-05
G5,C(C(C(C1C(C)OC(C1)O)O)=O)=O,16,2,0,2,46,9.499999999999999e-05
G5,C(C1CC(C(CO)=O)(O)OC1C)=O,8,2,0,2,46,9.499999999999999e-05
G5,C1(C(C)(O)OC(C)C1C(CO)=O)=O,8,2,0,2,14,9.499999999999999e-05
G5,C(CC1(C(CC(C)O1)=O)O)(CO)=O,4,2,0,2,14,9.499999999999999e-05
G5,C(C1C(CC(O1)O)O)(C(C=C)O)=O,16,2,0,2,7,9.499999999999999e-05
G5,C(C1C(C=C)(CC(O1)O)O)(CO)=O,8,2,0,2,7,9.499999999999999e-05
G5,C(C(C=CC1C(CC(O1)O)O)O)=O,32,2,0,2,32,9.499999999999999e-05
G5,C(C1(COC(C1)O)O)=CC(CO)=O,8,2,0,2,32,9.499999999999999e-05
G5,C(CO)(C1C(CO)(O)OCC1O)=O,8,2,0,2,0,9.499999999999999e-05
G5,C(C(C1C(CO)OC(C1O)O)O)=O,32,2,0,2,0,9.499999999999999e-05
G5,C(CO)(CC1(C(C(CO1)O)O)O)=O,8,2,0,2,0,9.499999999999999e-05
G5,C1(C(C(CO)C(CO)O1)O)=O,8,2,0,2,0,9.499999999999999e-05
G5,C(CO)(C1(C)C(C(C(O1)O)O)O)=O,16,2,0,2,26,9.499999999999999e-05
G5,C1(C(CC(C(C(CO)O)O)O1)O)=O,16,1,0,1,20,4.7e-05
G5,C(CO)(C(C1COC(C1O)O)O)=O,16,2,0,2,30,9.499999999999999e-05
G5,C(CO)(C1(C(C(CO1)O)O)O)=O,8,3,0,3,2,0.00014199999999999998
G5,C1(C(O)OC(C)C1O)=O,8,2,0,2,0,9.499999999999999e-05
G5,C1(C(C(C)O)(O)OCC1O)=O,8,3,0,3,2,0.000144
G5,C1(C(CO)(O)OC(C)C1O)=O,8,2,0,2,2,9.499999999999999e-05
G5,C1(C(O)OC(C(C)O)C1O)=O,16,2,0,2,2,9.499999999999999e-05
G5,C(CO)(C1(CCCO1)O)=O,2,2,0,2,29,9.499999999999999e-05
G5,C1(CCC(C(CO)=O)(O)O1)=O,2,2,0,2,45,9.499999999999999e-05
G5,C(C(C1(COC(C1(C)O)O)O)O)=O,16,3,0,3,42,0.000153
G5,C(CO)(C1(C(O)OCC1(C)O)O)=O,8,2,0,2,49,9.499999999999999e-05
G5,C(C(C)O)(C1(C(O)OCC1O)O)=O,16,2,0,2,0,9.499999999999999e-05
G5,C(CO)(C1(C(C)(O)OCC1O)O)=O,8,2,0,2,0,9.499999999999999e-05
G5,C(CO)(C1(C(O)OCC1O)O)=O,8,2,0,2,0,9.499999999999999e-05
G5,C1(C(C(CO1)(CC(CO)O)O)O)=O,8,1,0,1,20,4.7e-05
G5,C(CO)(C1(C(CO)(CCO1)O)O)=O,4,2,0,2,2,9.499999999999999e-05
G5,C(C1(CC(OC1C(CO)=O)O)O)=O,8,2,0,2,1,9.499999999999999e-05
G5,C(C(CC1(C(O)OCC1O)O)O)=O,16,2,0,2,51,9.499999999999999e-05
G5,C1(C2(CC(CO2)C1O)O)=O,8,3,0,3,55,0.00014199999999999998
G5,C(C(CO)=O)(CC1COC(C1)O)=O,4,2,0,2,55,9.499999999999999e-05
G5,C(C(C(CC1COC(C1)O)O)=O)=O,8,2,0,2,55,9.499999999999999e-05
G5,C(CC1COC(C(CO)=O)(C1)O)=O,4,2,0,2,55,9.499999999999999e-05
G5,C(C(CC1CC(OC1C=O)O)O)=O,16,2,0,2,32,9.499999999999999e-05
G5,C(CC1CC(OC1C(CO)=O)O)=O,8,2,0,2,43,9.499999999999999e-05
G5,C1(C(COC(C1(C)O)O)O)=O,8,2,0,2,2,9.499999999999999e-05
G5,C1(C(CC(CO)(CO1)O)O)=O,4,2,0,2,29,9.499999999999999e-05
G5,C1(C(O)OC(CO)(CO)CC1O)=O,4,2,0,2,5,9.499999999999999e-05
G5,C1(C(C(O)OCC1O)O)=O,8,2,0,2,5,9.499999999999999e-05
G5,C1(C(COC(C1(CCO)O)O)O)=O,8,2,0,2,5,9.499999999999999e-05
G5,C1(C(C(CO)C(CO)(CO1)O)O)=O,8,1,0,1,5,4.7e-05
G5,C(C(C1C(C(CC(O)O1)O)O)O)=O,32,2,0,2,51,9.499999999999999e-05
G5,C(C(C1C(CC(C(O)O1)O)O)O)=O,32,2,0,2,51,9.499999999999999e-05
G5,C(CO)(C1(CC(C(CO1)O)O)O)=O,8,4,0,4,2,0.00018999999999999998
G5,C1(C(O)OC(CC1O)C(CO)O)=O,16,2,0,2,29,9.499999999999999e-05
G5,C1(C(CC(OC1C(C)=O)O)O)=O,8,2,0,2,49,9.499999999999999e-05
G5,C(C1(C(C(CC(O1)O)O)=O)C)=O,8,2,0,2,49,9.499999999999999e-05
G5,C1(C(CC(C(C(C)=O)O1)O)O)=O,8,2,0,2,49,9.499999999999999e-05
G5,C1(C(CC(C)(C(C=O)O1)O)O)=O,8,2,0,2,26,9.499999999999999e-05
G5,C(C)(C1CC(C(C(O1)O)=O)O)=O,8,2,0,2,29,9.499999999999999e-05
G5,C(C1(C)CC(C(C(O1)O)=O)O)=O,8,2,0,2,16,9.499999999999999e-05
G5,C1(C(CC(C)(C(CO)O1)O)O)=O,8,2,0,2,29,9.499999999999999e-05
G5,C1(C(CC(CO1)(CCO)O)O)=O,4,2,0,2,29,9.499999999999999e-05
G5,C1(C(CC(C)(CO1)O)O)=O,4,2,0,2,29,9.499999999999999e-05
G5,C(CC1C(CC(C(O1)=O)O)O)=O,8,2,0,2,20,9.499999999999999e-05
G5,C1(C(CC(C(C(C=O)O)O1)O)O)=O,16,1,0,1,0,4.7e-05
G5,C(CO)(C1C(CC(C(O1)O)=O)O)=O,8,2,0,2,0,9.499999999999999e-05
G5,C1(C(CC(CO1)(C(CO)O)O)O)=O,8,1,0,1,51,4.7e-05
G5,C1(C(CC(CO)(C(CO)O1)O)O)=O,8,1,0,1,51,4.7e-05
G5,C1(C(C(CO)OC(C1(C)O)O)O)=O,16,3,0,3,9,0.000153
G5,C(C1C(C(CC(O1)O)O)=O)=O,8,2,0,2,2,9.499999999999999e-05
G5,C1(C(C(C(CO)=O)OC(C1)O)O)=O,8,2,0,2,1,9.499999999999999e-05
G5,C1(C(CC(OC1(CO)C)O)O)=O,8,2,0,2,49,9.499999999999999e-05
G5,C1(C(C)OC(CC1O)O)=O,8,2,0,2,4,9.499999999999999e-05
G5,C(C1CC(C(C(O1)O)=O)O)=O,8,2,0,2,15,9.499999999999999e-05
G5,C(C(C1CC(C(C(O)O1)=O)O)O)=O,16,2,0,2,1,9.499999999999999e-05
G5,C1(CC(C(CO)=O)OC(C1O)O)=O,8,2,0,2,1,9.499999999999999e-05
G5,C1(C(O)OC(CO)(C)CC1O)=O,8,2,0,2,49,9.499999999999999e-05
G5,C1(C(O)OC(C)CC1O)=O,8,2,0,2,33,9.499999999999999e-05
G5,C1(C(CCO)(O)OCC(C1O)O)=O,8,2,0,2,5,9.499999999999999e-05
G5,C1(C(C(CO)O)(O)OCCC1O)=O,8,2,0,2,9,9.499999999999999e-05
G5,C1(C(CC(C(CO)=O)CO1)O)=O,4,2,0,2,12,9.499999999999999e-05
G5,C(C(C1COC(C(C1)=O)O)O)=O,8,2,0,2,12,9.499999999999999e-05
G5,C(CC1(CC(C(CO1)=O)O)O)=O,4,3,0,3,2,0.00014199999999999998
G5,C(C1COC(C(C1O)=O)(C)O)=O,8,2,0,2,26,9.499999999999999e-05
G5,C(CC1(C(C(CCO1)O)=O)O)=O,4,2,0,2,9,9.499999999999999e-05
G5,C(C)(C1COC(C(C1O)=O)O)=O,8,2,0,2,12,9.499999999999999e-05
G5,C1(CC(C(CO)=O)(O)OCC1)=O,2,2,0,2,2,9.499999999999999e-05
G5,C(CC1COC(C(C1O)=O)O)=O,8,2,0,2,43,9.499999999999999e-05
G5,C1(C(C(CO)C(C(C=O)O1)O)O)=O,16,1,0,1,15,4.7e-05
G5,C1(C(C(CO)C(C)(CO1)O)O)=O,8,2,0,2,29,9.499999999999999e-05
G5,C(C(C1COC(C(C1O)O)O)O)=O,32,3,0,3,12,0.000153
G5,C(CC1(CO)CCC(C(O1)=O)O)=O,4,1,0,1,29,4.7e-05
G5,C1(C(CC(C(CO)=O)C(C)O1)O)=O,8,1,0,1,12,4.7e-05
G5,C(C(C1C(C)OC(C(C1)=O)O)O)=O,16,2,0,2,12,9.499999999999999e-05
G5,C(CC1(C)C(CC(C(O1)=O)O)O)=O,8,1,0,1,22,4.7e-05
G5,C(CC1(CC(C(C(C)O1)=O)O)O)=O,8,2,0,2,4,9.499999999999999e-05
G5,C(CC1CC(C(C(C)(O)O1)=O)O)=O,8,2,0,2,9,9.499999999999999e-05
G5,C1(C(C)(CC=O)OC(CC1O)O)=O,8,2,0,2,6,9.499999999999999e-05
G5,C(C1C(C)OC(C(C1O)=O)(C)O)=O,16,2,0,2,9,9.499999999999999e-05
G5,C(CC1(C(C(CC(C)O1)O)=O)O)=O,8,2,0,2,9,9.499999999999999e-05
G5,C(CC1C(C(CC(C)(O1)O)O)=O)=O,8,2,0,2,26,9.499999999999999e-05
G5,C(CC1(C)CC(C(C(O)O1)=O)O)=O,8,2,0,2,6,9.499999999999999e-05
G5,C(C)(C1C(C)OC(C(C1O)=O)O)=O,16,2,0,2,2,9.499999999999999e-05
G5,C1(CC(C(CO)=O)(O)OC(C)C1)=O,4,2,0,2,4,9.499999999999999e-05
G5,C(CC1C(C)OC(C(C1O)=O)O)=O,16,2,0,2,4,9.499999999999999e-05
G5,C(C(C1C(C(O)OCC1O)O)O)=O,32,2,0,2,20,9.499999999999999e-05
G5,C1(C(C(CO)C(CO1)O)O)=O,8,2,0,2,29,9.499999999999999e-05
G5,C1(C(CC(C(C(CO)O)O1)O)O)=O,16,1,0,1,20,4.7e-05
G5,C1(C(O)OCC(C(CO)O)C1O)=O,16,2,0,2,27,9.499999999999999e-05
G5,C1(C(COC(C)(C1(CO)O)O)O)=O,8,4,0,4,2,0.000194
G5,C1(C(C(C)OC(C1(CO)O)O)O)=O,16,4,0,4,2,0.000194
G5,C(CO)(C1(C(OCC(C1)=O)O)O)=O,4,2,0,2,51,9.499999999999999e-05
G5,C1(C(O)OCC(CCO)(C1O)O)=O,8,2,0,2,2,9.499999999999999e-05
G5,C1(C(CC(C(C)=O)(CO1)O)O)=O,4,2,0,2,45,9.499999999999999e-05
G5,C1(C(CC(C(C)=O)(C(C)O1)O)O)=O,8,1,0,1,45,4.7e-05
G5,C(CC1CC(C(OC1CO)=O)O)=O,8,1,0,1,46,4.7e-05
G5,C1(C(COC(C(C1(C)O)O)O)O)=O,16,3,0,3,5,0.000153
G5,C1(C(O)OCC(CO)(CC1O)O)=O,8,2,0,2,5,9.499999999999999e-05
G5,C1(C(CCOC(CO)(C1O)O)O)=O,8,2,0,2,5,9.499999999999999e-05
G5,C1(C(O)OC(CO)C(CC1O)O)=O,16,2,0,2,19,9.499999999999999e-05
G5,C1(C(CC(C)(C(CO1)O)O)O)=O,8,2,0,2,29,9.499999999999999e-05
G5,C1(COC(C)(C(CC1O)O)O)=O,8,2,0,2,45,9.499999999999999e-05
G5,C1(COC(C(C)(CC1O)O)O)=O,8,2,0,2,16,9.499999999999999e-05
G5,C1(CC(C=O)(O)OCCC1O)=O,4,2,0,2,20,9.499999999999999e-05
G5,C(C1(CC(C(OCC1)=O)O)O)=O,4,2,0,2,29,9.499999999999999e-05
G5,C1(C(CC(CO)(CCO1)O)O)=O,4,2,0,2,29,9.499999999999999e-05
G5,C1(C(CCOC(C)(C1O)O)O)=O,8,2,0,2,45,9.499999999999999e-05
G5,C1(C(CCOC(C1(C)O)O)O)=O,8,2,0,2,45,9.499999999999999e-05
G5,C1(C(CC(CC(C=O)O1)O)O)=O,8,2,0,2,20,9.499999999999999e-05
G5,C1(C(CC(C(C(C=O)O1)O)O)O)=O,16,1,0,1,0,4.7e-05
G5,C1(C(CC(CO)(C(CO1)O)O)O)=O,8,1,0,1,51,4.7e-05
G5,C1(C(C(COC(C)(C1O)O)O)O)=O,16,2,0,2,0,9.499999999999999e-05
G5,C1(C(C(COC(C1(C)O)O)O)O)=O,16,3,0,3,42,0.000153
G5,C1(COC(C(C)(C(C1O)O)O)O)=O,16,2,0,2,42,9.499999999999999e-05
G5,C1(C(C(C=O)OC(CC1O)O)O)=O,16,2,0,2,1,9.499999999999999e-05
G5,C1(C(CC(O)OCC1(C)O)O)=O,8,2,0,2,49,9.499999999999999e-05
G5,C(C1C(CC(C(C(O1)O)=O)O)O)=O,16,2,0,2,1,9.499999999999999e-05
G5,C1(C(O)OCC(C)(CC1O)O)=O,8,2,0,2,49,9.499999999999999e-05
G5,C1(C(C(OC(C=O)CC1O)O)O)=O,16,2,0,2,0,9.499999999999999e-05
G5,C(C1C(C(CC(C(O1)O)O)O)=O)=O,16,2,0,2,0,9.499999999999999e-05
G5,C1(C(C)OC(C(CC1O)O)O)=O,16,2,0,2,11,9.499999999999999e-05
G5,C1(C(C(COC(CO)(C1)O)O)O)=O,8,2,0,2,32,9.499999999999999e-05
G5,C1(COC(CO)(C(CC1O)O)O)=O,8,2,0,2,2,9.499999999999999e-05
G5,C(C1(CCC(C(CO1)=O)O)O)=O,4,2,0,2,12,9.499999999999999e-05
G5,C(C1COC(C(CC1O)O)=O)=O,8,2,0,2,23,9.499999999999999e-05
G5,C(C1COC(C(C(C1)O)=O)O)=O,8,2,0,2,55,9.499999999999999e-05
G5,C1(C(CCOC(CO)(C1)O)O)=O,4,2,0,2,20,9.499999999999999e-05
G5,C1(C(CC(C)OC(C1O)O)O)=O,16,2,0,2,11,9.499999999999999e-05
G5,C1(CC(C(OC(C)C1CO)=O)O)=O,8,1,0,1,4,4.7e-05
G5,C1(C(CCC(C=O)(OC1C)O)O)=O,8,2,0,2,12,9.499999999999999e-05
G5,C1(C(CC(C(C)=O)OC(C1)O)O)=O,8,2,0,2,45,9.499999999999999e-05
G5,C1(CC(C=O)(O)OC(C)CC1O)=O,8,2,0,2,22,9.499999999999999e-05
G5,C(CC1CC(CC(C(O1)=O)O)O)=O,8,1,0,1,13,4.7e-05
G5,C(C1C(CC(C(OC1C)=O)O)O)=O,16,1,0,1,23,4.7e-05
G5,C(CC1C(C(CCC(O1)O)O)=O)=O,8,2,0,2,45,9.499999999999999e-05
G5,C(CC1CCC(C(C(O)O1)=O)O)=O,8,2,0,2,44,9.499999999999999e-05
G5,C(C1CC(C(C(O)OC1C)=O)O)=O,16,2,0,2,46,9.499999999999999e-05
G5,C1(C(CC(CO)OC(C1O)O)O)=O,16,2,0,2,0,9.499999999999999e-05
G5,C1(C(CC(C(C(CO)O1)O)O)O)=O,16,1,0,1,12,4.7e-05
G5,C(C1(C(C(CCOC1O)O)=O)O)=O,8,2,0,2,3,9.499999999999999e-05
G5,C1(C(C(COC(C1O)O)(C)O)O)=O,16,2,0,2,30,9.499999999999999e-05
G5,C(CC1CC(C(OCC1O)=O)O)=O,8,1,0,1,46,4.7e-05
G5,C(CC1COC(C(C(C1)O)=O)O)=O,8,2,0,2,55,9.499999999999999e-05
G5,C(CC1C(OCC(C(C1)O)=O)O)=O,8,2,0,2,38,9.499999999999999e-05
G5,C(CC1CC(OCC(C1O)=O)O)=O,8,2,0,2,46,9.499999999999999e-05
G5,C1(CCCC(OC1C(CO)=O)O)=O,4,2,0,2,27,9.499999999999999e-05
G5,C(CO)(C1CC(OCC(C1)=O)O)=O,4,2,0,2,32,9.499999999999999e-05
G5,C1(C(C(C(C(CO)O)O1)=O)O)=O,8,2,0,2,29,9.499999999999999e-05
G5,C1(C(C(C(C(CO)=O)O1)O)O)=O,8,2,0,2,29,9.499999999999999e-05
G5,C1(C(C(C(C(CO)O1)O)=O)O)=O,8,2,0,2,29,9.499999999999999e-05
G5,C1(C(C(C(C(CO1)O)O)=O)O)=O,8,2,0,2,29,9.499999999999999e-05
G5,C(C(C1CC(C(C1O)=O)O)O)=O,16,1,0,1,12,4.7e-05
G5,C(CO)(C1C(C)(C(C(C1)=O)O)O)=O,8,2,0,2,32,9.499999999999999e-05
G5,C1(C(CC(C(C=O)O)C1(C)O)O)=O,16,1,0,1,32,4.7e-05
G5,C(C1(C(C(CCC1O)O)=O)O)=O,8,1,0,1,20,4.7e-05
G5,C1(CCC(C1(C(CO)=O)O)O)=O,4,5,0,5,51,0.00023700000000000001
G5,C(C1(C(C(CCC1(C)O)O)=O)O)=O,8,1,0,1,7,4.7e-05
G5,C1(CCC(C)(C1(C(CO)=O)O)O)=O,4,2,0,2,32,9.499999999999999e-05
G5,C1(C(C(C(CO)CC1O)O)O)=O,16,1,0,1,55,4.7e-05
G5,C1(C(C(C(CC1O)CCO)O)O)=O,16,1,0,1,46,4.7e-05
G5,C1(C(C(C(CC1O)C(C)O)O)O)=O,32,1,0,1,46,4.7e-05
G5,C(CC(C(C=O)CC(C=O)O)O)=O,8,1,0,1,18,4.7e-05
G5,C(CC(C(C=O)O)C(C=O)CO)=O,8,2,0,2,46,9.499999999999999e-05
G5,C(CC(CCC(C=O)O)O)=O,4,1,0,1,7,4.7e-05
G5,C(C(CO)CCC(C=O)O)=O,4,1,0,1,7,4.7e-05
G5,C(C(C(C)O)CCC(C=O)O)=O,8,1,0,1,7,4.7e-05
G5,C(CC(CCCC(C=O)O)O)=O,4,1,0,1,7,4.7e-05
G5,C(CC(C)(CCC(C=O)O)O)=O,4,1,0,1,7,4.7e-05
G5,C(C(C(C)O)(CCC(C=O)O)O)=O,8,1,0,1,7,4.7e-05
G5,C(C(C(CCCC(C=O)O)O)O)=O,8,1,0,1,27,4.7e-05
G5,C(C(C(C)(CCC(C=O)O)O)O)=O,8,1,0,1,7,4.7e-05
G5,C(CC(C(CCC(C=O)O)O)O)=O,8,1,0,1,7,4.7e-05
G5,C(C(C(CO)O)CCC(C=O)O)=O,8,1,0,1,7,4.7e-05
G5,C(C(CCC(C(C=O)=O)O)O)=O,4,2,0,2,20,0.000106
G5,C(CCC(C=O)=O)(C(C(C)=O)O)=O,2,1,0,1,25,4.7e-05
G5,C(C)(C(C(CCC(CO)=O)=O)O)=O,2,1,0,1,25,4.7e-05
G5,C(C(CCC(C(C(C)=O)=O)O)O)=O,4,1,0,1,25,4.7e-05
G5,C(C(CCCC(C(CO)=O)=O)O)=O,2,2,0,2,7,9.499999999999999e-05
G5,C(C(C(C(C(C)=O)O)=O)CC=O)=O,4,1,0,1,25,4.7e-05
G5,C(C(CCC(C(C=O)=O)(C)O)O)=O,4,1,0,1,7,4.7e-05
G5,C(C(CCCC(C(C=O)=O)O)O)=O,4,1,0,1,7,4.7e-05
G5,C(C(CCC(C(C(C)O)=O)O)O)=O,8,1,0,1,7,4.7e-05
G5,C(C(CCC(C(CO)=O)(C)O)O)=O,4,1,0,1,7,4.7e-05
G5,C(C(CCCC(C(CO)=O)O)O)=O,4,1,0,1,7,4.7e-05
G5,C(C(CC(C=O)C(C=O)C=O)O)=O,4,1,0,1,45,4.7e-05
G5,C(CC(C(C=O)O)C(C=O)C=O)=O,4,2,0,2,45,9.499999999999999e-05
G5,C(C(C=O)CCC(C=O)O)=O,2,1,0,1,45,4.7e-05
G5,C(C(C(CO)CCC(C=O)O)O)=O,8,1,0,1,7,4.7e-05
G5,C(C(CCC(CC(C=O)O)O)O)=O,8,1,0,1,7,4.7e-05
G5,C(C(CCCC(C(O)=O)=O)O)=O,2,3,0,3,7,0.000154
G5,C(C(C=O)(CCC(C=O)O)O)(O)=O,4,1,0,1,7,4.7e-05
G5,C(C(C(C=O)=O)CCC(C=O)O)=O,4,1,0,1,23,4.7e-05
G5,C(C(CCCC(C(C)=O)=O)O)=O,2,1,0,1,14,4.7e-05
G5,C(CCCC(C=O)O)(CC=O)=O,2,1,0,1,7,4.7e-05
G5,C(C(CCC(C=O)C(C)=O)O)=O,4,1,0,1,7,4.7e-05
G5,C(C(CCC1(CC(CO1)=O)O)O)=O,4,1,0,1,35,4.7e-05
G5,C(C(CCC1C(COC1O)=O)O)=O,8,1,0,1,7,4.7e-05
G5,C(C(CCC1C(CC(O1)O)=O)O)=O,8,1,0,1,7,4.7e-05
G5,C(CCC(C=O)=O)(C(C=CC=O)O)=O,4,1,0,1,7,4.7e-05
G5,C(C(C(C(C=CC=O)O)=O)CC=O)=O,8,1,0,1,43,4.7e-05
G5,C(C(CC(C=O)O)CC(C=O)O)=O,3,1,0,1,11,4.7e-05
G5,C(C(CC(C=O)C(C=O)(C)O)O)=O,8,1,0,1,11,4.7e-05
G5,C(CC(C(C=O)O)C(C=O)(C)O)=O,8,2,0,2,7,9.499999999999999e-05
G5,C(CC(CCO)C(C=O)O)=O,4,2,0,2,46,9.499999999999999e-05
G5,C(C(CC(C=O)O)C(C)O)=O,8,1,0,1,46,4.7e-05
G5,C(CC(C(C)O)C(C=O)O)=O,8,2,0,2,46,9.499999999999999e-05
G5,C(C(CC(C=O)CC(O)=O)O)=O,4,4,0,4,29,0.000202
G5,C(CC(C(C=O)O)CC=O)(O)=O,4,2,0,2,18,9.499999999999999e-05
G5,C1(C(C(CCC(C=O)=O)CO1)O)=O,4,2,0,2,7,9.499999999999999e-05
G5,C1(C(CC(CCC(C=O)=O)O1)O)=O,4,2,0,2,7,9.499999999999999e-05
G5,C(C(CCC(C(C=C)=O)O)O)=O,4,1,0,1,7,4.7e-05
G5,C(CCC(CO)=O)(C(C=C)O)=O,2,4,0,4,29,0.00020099999999999998
G5,C(C(C(C(C=C)O)=O)CC=O)=O,4,1,0,1,7,4.7e-05
G5,C1(C(C(CO1)O)CCC(C=O)O)=O,8,1,0,1,8,4.7e-05
G5,C1(CC(CO1)(CCC(C=O)O)O)=O,4,1,0,1,8,4.7e-05
G5,C1(CC(C(CCC(C=O)O)O1)O)=O,8,1,0,1,7,4.7e-05
G5,C(C(CCCC(C=O)O)O)=O,3,1,0,1,11,4.7e-05
G5,C(C(C)(CCC(C=O)O)O)=O,4,1,0,1,11,4.7e-05
G5,C(C(CCC(C(CO)O)O)O)=O,8,2,0,2,29,0.000106
G5,C(C(CCC(CO)(CO)O)O)=O,2,1,0,1,7,4.7e-05
G5,C(C(CCCO)O)=O,2,1,0,1,55,4.7e-05
G5,C(C(CCCCO)O)=O,2,1,0,1,27,4.7e-05
G5,C(C(CCC(C)O)O)=O,4,1,0,1,27,4.7e-05
G5,C(C(C(CCC(C=O)O)O)O)(O)=O,8,1,0,1,20,4.7e-05
G5,C(CCCC(C=O)O)(O)=O,2,2,0,2,18,9.499999999999999e-05
G5,C(C(CCC1C(C(CO1)O)=O)O)=O,8,1,0,1,10,4.7e-05
G5,C(C(CCC1(C(COC1)=O)O)O)=O,4,1,0,1,10,4.7e-05
G5,C(C(CCC1C(C(CO1)=O)O)O)=O,8,1,0,1,10,4.7e-05
G5,C(C(CCC1(C(CCO1)=O)O)O)=O,4,1,0,1,34,4.7e-05
G5,C(C(CCC1C(C(O)OC1)=O)O)=O,8,1,0,1,7,4.7e-05
G5,C1(C(C(CCC(CO)=O)CO1)O)=O,4,2,0,2,7,9.499999999999999e-05
G5,C(C(CCC1CC(C(O)O1)=O)O)=O,8,1,0,1,7,4.7e-05
G5,C1(C(CC(CCC(CO)=O)O1)O)=O,4,2,0,2,7,9.499999999999999e-05
G5,C1(C(C(CO1)C(C=O)CC=O)O)=O,8,2,0,2,34,9.499999999999999e-05
G5,C1(C(CC(C(C=O)CC=O)O1)O)=O,8,2,0,2,34,9.499999999999999e-05
G5,C(C(CO)=O)(C(CCCO)O)=O,2,1,0,1,29,4.7e-05
G5,C(C(C(CO)O)=O)(CCCCO)=O,2,3,0,3,46,0.000154
G5,C(C(CO)=O)(C(CCCCO)O)=O,2,1,0,1,46,4.7e-05
G5,C(C(C(CO)O)=O)(CCC(C)O)=O,4,3,0,3,46,0.000154
G5,C(C(CO)=O)(C(CCC(C)O)O)=O,4,1,0,1,46,4.7e-05
G5,C(C(CC(C(CO)=O)CCO)O)=O,4,2,0,2,46,0.000106
G5,C(C(CC(CO)C(CO)O)O)=O,8,1,0,1,29,4.7e-05
G5,C(CO)(C(CC(CO)CO)O)=O,2,1,0,1,29,4.7e-05
G5,C(C(CCCO)O)(C(CO)O)=O,4,1,0,1,55,4.7e-05
G5,C(C(C(CC(CO)CO)O)=O)(O)=O,2,1,0,1,55,4.7e-05
G5,C(C(CO)CC(C(CO)=O)O)(O)=O,4,1,0,1,29,4.7e-05
G5,C(CC(CO)C(C(CO)=O)O)(O)=O,4,5,0,5,29,0.00024900000000000004
G5,C(C(C(C(CCCO)O)=O)O)(O)=O,4,1,0,1,55,4.7e-05
G5,C1(C(C(CO)C(CO)C1O)O)=O,10,1,0,1,55,4.7e-05
G5,C1(C(CC(CO)C(CO)O1)O)=O,8,1,0,1,46,4.7e-05
G5,C1(C(CC(CO)C(CO1)O)O)=O,8,1,0,1,41,4.7e-05
G5,C1(C(O)OCC(CO)CC1O)=O,8,1,0,1,55,4.7e-05
G5,C1(COC(C(CO)CC1O)O)=O,8,1,0,1,38,4.7e-05
G5,C(C(CC(C(CO)O)CCO)O)=O,8,1,0,1,46,4.7e-05
G5,C(C(CC(C(CO)O)C(C)O)O)=O,16,1,0,1,46,4.7e-05
G5,C(CO)(C(CC(CO)CCO)O)=O,4,1,0,1,46,4.7e-05
G5,C(CO)(C(CC(CO)C(C)O)O)=O,8,1,0,1,46,4.7e-05
G5,C(C(CCCCO)O)(C(CO)O)=O,4,1,0,1,46,4.7e-05
G5,C(C(CCC(C)O)O)(C(CO)O)=O,8,1,0,1,27,4.7e-05
G5,C1(C(C(CCO)C(CO)C1O)O)=O,16,1,0,1,46,4.7e-05
G5,C1(C(C(C(C)O)C(CO)C1O)O)=O,32,1,0,1,46,4.7e-05
G5,C1(C(C(C(C1O)O)CCCO)O)=O,16,1,0,1,46,4.7e-05
G5,C1(C(C(C(C1O)O)CC(C)O)O)=O,32,1,0,1,46,4.7e-05
G5,C1(C(CC(CCO)C(CO)O1)O)=O,8,1,0,1,46,4.7e-05
G5,C1(C(CC(C(C)O)C(CO)O1)O)=O,16,1,0,1,46,4.7e-05
G5,C1(C(CC(CCO)C(CO1)O)O)=O,8,1,0,1,46,4.7e-05
G5,C1(C(CC(C(C)O)C(CO1)O)O)=O,16,1,0,1,46,4.7e-05
G5,C1(C(O)OCC(CC1O)CCO)=O,8,1,0,1,46,4.7e-05
G5,C1(C(O)OCC(CC1O)C(C)O)=O,16,1,0,1,46,4.7e-05
G5,C1(COC(C(CC1O)CCO)O)=O,8,1,0,1,38,4.7e-05
G5,C1(COC(C(CC1O)C(C)O)O)=O,16,1,0,1,38,4.7e-05
G5,C(CO)(C(C(C=O)=O)CC(C)=O)=O,2,1,0,1,0,4.7e-05
G5,C(C)(C(C(CO)=O)CC(C=O)=O)=O,2,1,0,1,0,4.7e-05
G5,C(C(C(CO)=O)CC(C(C)=O)=O)=O,2,1,0,1,0,4.7e-05
G5,C(CC(C(CO)=O)C(C(C)=O)=O)=O,2,1,0,1,46,4.7e-05
G5,C(C(C(CO)=O)CC(CC=O)=O)=O,2,1,0,1,0,4.7e-05
G5,C(CC=O)(C(C(CO)=O)CC=O)=O,2,1,0,1,0,4.7e-05
G5,C(CCC(CO)=O)(CC(C=O)=O)=O,1,1,0,1,0,4.7e-05
G5,C(CC(C(CCC(CO)=O)=O)=O)=O,1,1,0,1,0,4.7e-05
G5,C(C(CCC(C(CO)=O)O)O)=O,4,2,0,2,7,0.000106
G5,C(C(CO)(CCC(C=O)O)O)=O,4,1,0,1,7,4.7e-05
G5,C(C(C(CCC(C=O)O)O)O)=O,8,2,0,2,7,0.000106
G5,C(C(CC(C=O)CC(C=O)=O)O)=O,4,3,0,3,45,0.000144
G5,C(C(CCC(C=O)C(CO)=O)O)=O,4,2,0,2,7,9.499999999999999e-05
G5,C(C(CCC(C=O)(C(C)=O)O)O)=O,4,1,0,1,1,4.7e-05
G5,C(CCCC(C=O)O)(C(C=O)O)=O,4,3,0,3,44,0.000154
G5,C(C(CCC(C(C)=O)(CO)O)O)=O,4,1,0,1,7,4.7e-05
G5,C(C(CCC(C(C(C)=O)O)O)O)=O,8,1,0,1,7,4.7e-05
G5,C(C(CCC(CC(C=O)=O)O)O)=O,4,2,0,2,13,0.000106
G5,C(CCC(C=O)=O)(C(CCO)O)=O,2,2,0,2,7,0.000106
G5,C(C(CCC(C=O)O)O)(CCO)=O,4,1,0,1,7,4.7e-05
G5,C(C(CCC(CC(CO)=O)O)O)=O,4,1,0,1,7,4.7e-05
G5,C(C(CCO)O)(C(C=O)CC=O)=O,4,1,0,1,3,4.7e-05
G5,C(C(C=O)(CCC(C=O)O)O)=O,2,1,0,1,29,4.7e-05
G5,C(C(C)O)(C(C=O)CC(CO)=O)=O,4,1,0,1,49,4.7e-05
G5,C(C(CC(C=O)C(C(C)=O)O)O)=O,8,2,0,2,49,9.6e-05
G5,C(CO)(C(C(C(C)O)=O)CC=O)=O,4,1,0,1,11,4.7e-05
G5,C(CC(C(C=O)O)C(C(C)=O)O)=O,8,5,0,5,29,0.000261
G5,C(CCC(C=O)=O)(C(C)O)=O,2,2,0,2,45,9.499999999999999e-05
G5,C(CCC(C(C)O)=O)(CO)=O,2,2,0,2,49,9.499999999999999e-05
G5,C(C(CCC(C(C)=O)O)O)=O,4,1,0,1,7,4.7e-05
G5,C(C(CCC(C=O)C(C=O)O)O)=O,8,2,0,2,7,9.499999999999999e-05
G5,C(CC1C(CO)C(C(C1O)=O)O)=O,16,1,0,1,43,4.7e-05
G5,C(CC(C(CO)O)C(C=O)O)=O,8,3,0,3,46,0.000144
G5,C(C(CCC(CO)O)O)=O,4,1,0,1,46,4.7e-05
G5,C(C(CC(C=O)C(C(O)=O)O)O)=O,8,3,0,3,29,0.000155
G5,C(CC(C(C(O)=O)O)C(C=O)O)=O,8,2,0,2,33,9.499999999999999e-05
G5,C(C(C(C(CCCO)O)=O)O)=O,4,1,0,1,55,4.7e-05
G5,C(C(C(C(CCC(C)O)O)=O)O)=O,8,1,0,1,46,4.7e-05
G5,C(C(CC(CO)C(C=O)O)O)=O,8,3,0,3,29,0.000165
G5,C(C(C(CC(C=O)O)C(C)O)O)=O,16,1,0,1,46,4.7e-05
G5,C1C(C(C(C=1)=O)=O)O,2,2,0,2,55,9.499999999999999e-05
G5,C(CO)(OCC(C=C)=O)=O,1,2,0,2,12,9.499999999999999e-05
G5,C(CC(C(CO)=O)=O)=CC=O,2,5,0,5,29,0.00023700000000000001
G5,C(CC(C(C=O)=O)O)=CC=O,4,2,0,2,55,9.499999999999999e-05
G5,C(CC=CC(C(CO)=O)=O)=O,2,3,0,3,55,0.00014199999999999998
G5,C(CC=CC(C(C=O)=O)O)=O,4,1,0,1,55,4.7e-05
G5,C(C1(C(C(C(C1CO)O)O)O)O)O,32,4,0,4,29,0.000234
G5,C(C1(CC(C(C1CO)O)O)O)=O,16,1,0,1,20,5.9e-05
G5,C(C1(CC(C(C1CO)O)O)O)O,16,1,0,1,21,5.9e-05
G5,CC1(C(C(C(C1CO)O)O)O)O,32,1,0,1,16,5.9e-05
G5,C(C1C(C(CC1O)O)O)O,16,1,0,1,43,5.9e-05
G5,C1(C(C(CO)C(CCO)(C1)O)O)=O,8,2,0,2,29,0.000117
G5,C1(C(C(CO)C(CC1)(CO)O)O)=O,8,1,0,1,7,5.9e-05
G5,C(C1(CCC(CO)(C1CO)O)O)=O,8,1,0,1,29,5.9e-05
G5,C1(C(C(CO)C(C(C1)O)(C)O)O)=O,16,1,0,1,22,5.9e-05
G5,C(C1(CC(C(C)(C1CO)O)O)O)=O,16,1,0,1,22,5.9e-05
G5,C1(C(C(CO)C(CC(C1)O)O)O)=O,16,1,0,1,13,5.9e-05
G5,C(C1(CC(C(CO)C(C1)O)O)O)=O,3,1,0,1,13,5.9e-05
G5,C(C1(CC(CC(C1CO)O)O)O)=O,16,1,0,1,13,5.9e-05
G5,C1(CC(C(CO)C1(CCO)O)O)=O,8,2,0,2,29,0.000117
G5,C1(C(C(C)(C(C(C1)O)CO)O)O)=O,16,1,0,1,6,5.9e-05
G5,C1(C(C(C(CO)C(C)(C1)O)O)O)=O,16,1,0,1,26,5.9e-05
G5,C1(C(C(CC(C(CO)C1)O)O)O)=O,16,2,0,2,11,0.000106
G5,C1(C(C(C(CO)C(CC1)O)O)O)=O,16,1,0,1,44,5.9e-05
G5,C(C(C1(CC(C(CO)C1)O)O)O)=O,16,1,0,1,44,5.9e-05
G5,C(C(C1(CCC(C1CO)O)O)O)=O,16,1,0,1,44,5.9e-05
G5,C(C)(C1(CC(C(C1CO)O)O)O)=O,16,1,0,1,21,5.9e-05
G5,C1(CC(C(C(CO)C1(C)O)O)O)=O,16,1,0,1,21,5.9e-05
G5,C1(CC(C(CO)C(C(C1)O)O)O)=O,16,1,0,1,6,5.9e-05
G5,C1C(C(CO)O)(C(CO)C(C=1)O)O,16,1,0,1,21,5.9e-05
G5,C=CC1(C(C(C(C1CO)O)O)O)O,32,1,0,1,7,5.9e-05
G5,C1C(CO)(C(CO)C(C(C=1)O)O)O,16,1,0,1,32,5.9e-05
G5,C1C(C(CO)C(C(C(C=1)O)O)O)O,32,1,0,1,43,5.9e-05
G5,C(C1(C(C(C(CO)C1O)O)O)O)O,32,3,0,3,29,0.000176
G5,C1(CC(CO)C(C1(C(C)O)O)O)=O,16,4,0,4,55,0.000204
G5,C(C1(C(C(C(C1CO)O)O)O)O)=O,32,5,0,5,29,0.00028199999999999997
G5,C1(CC(C(CO)C1(C(C)O)O)O)=O,16,2,0,2,4,0.00010700000000000001
G5,C1C(CO)C(C(C=1)=O)O,4,2,0,2,29,0.000106
G5,C1(C(C(CO)C(C(CO)O)C1)O)=O,16,2,0,2,29,0.000106
G5,C1(C(C(C(CO)C(CO)C1)O)O)=O,16,2,0,2,11,0.000106
G5,C(CC1C(C(C(C1CO)O)O)O)=O,32,2,0,2,29,0.000106
G5,C(C(CO)C(CO)(CO)O)(O)=O,2,4,0,4,29,0.000215
G5,C(C(CO)C(C(CO)O)O)(O)=O,8,5,0,5,29,0.000273
G5,C(C(C(CO)CO)O)(CC(C)O)=O,4,1,0,1,4,5.9e-05
G5,C(C(CC(C)O)(C(CO)CO)O)=O,4,1,0,1,4,5.9e-05
G5,C(C)(C(C(CO)C(CCO)O)O)=O,8,1,0,1,45,5.9e-05
G5,C(CC(C(C)(C(CO)CO)O)O)=O,4,1,0,1,45,5.9e-05
G5,C(C)(C(CC(C(CO)CO)O)O)=O,4,1,0,1,45,5.9e-05
G5,C(C(CO)C(C(C)=O)O)(O)=O,4,4,0,4,29,0.000215
G5,C(C)(C(C(CO)C(C(C)O)O)O)=O,16,1,0,1,45,5.9e-05
G5,C(C(C)(C(CO)C(CCO)O)O)=O,8,1,0,1,45,5.9e-05
G5,C(CC(C)(C(C(CO)CO)O)O)=O,4,1,0,1,45,5.9e-05
G5,C(C(C)(CC(C(CO)CO)O)O)=O,4,1,0,1,18,5.9e-05
G5,C(C(CO)C(C=O)(C)O)(O)=O,4,4,0,4,29,0.000215
G5,C(C(C)(C(CO)C(C(C)O)O)O)=O,16,1,0,1,11,5.9e-05
G5,C(C(CO)C(C)(C(C=O)O)O)(O)=O,8,4,0,4,29,0.000215
G5,C(C(CO)C(C)(C(CO)O)O)(O)=O,8,4,0,4,29,0.000215
G5,C(C(CO)C(CCO)O)O,2,1,0,1,18,5.9e-05
G5,CC(CC(CO)(C(CO)CO)O)O,4,1,0,1,11,5.9e-05
G5,CC(C(C(C)O)O)(C(CO)CO)O,8,1,0,1,4,5.9e-05
G5,CC(CO)(CC(C(CO)CO)O)O,4,1,0,1,18,5.9e-05
G5,CC(CO)(C(CO)C(CCO)O)O,8,1,0,1,49,5.9e-05
G5,CC(CC(C(CO)CO)O)O,4,1,0,1,28,5.9e-05
G5,CC(C(CO)C(CCO)O)O,8,1,0,1,18,5.9e-05
G5,CC(C(C(C(CO)CO)O)O)O,8,1,0,1,28,5.9e-05
G5,C(C(CC(C(CO)CO)O)O)O,4,1,0,1,6,5.9e-05
G5,C(C(C(CO)C(CCO)O)O)O,8,1,0,1,18,5.9e-05
G5,C(C(C(CO)O)(C(CO)CO)O)=O,4,5,0,5,29,0.000283
G5,C(C(CO)(C(CO)CO)O)=O,2,3,0,3,49,0.000167
G5,C(C)(C(CO)(C(CO)CO)O)=O,2,2,0,2,49,0.000117
G5,C(CO)(C(C)(C(CO)CO)O)=O,2,1,0,1,25,5.9e-05
G5,C(C(C(C)O)(C(CO)CO)O)=O,4,2,0,2,4,0.00010800000000000001
G5,CC(C(CO)(C(CO)CO)O)O,4,1,0,1,25,5.9e-05
G5,C(C(CO)C(C(CCO)O)O)O,4,1,0,1,29,5.9e-05
G5,C(C(CO)CO)(O)=O,1,3,0,3,29,0.000167
G5,C(CC(CO)(C(CO)CO)O)(O)=O,2,2,0,2,29,0.000117
G5,C(C(C(C)(C(CO)CO)O)O)(O)=O,4,1,0,1,33,5.9e-05
G5,C(C(C(C(CO)CO)O)O)(O)=O,4,2,0,2,18,0.00010700000000000001
G5,C(CC(C(C(CO)CO)O)O)(O)=O,4,1,0,1,29,5.9e-05
G5,C(C(C(CO)CO)O)(CC(C)=O)=O,2,1,0,1,26,5.9e-05
G5,C(C(CC(C)(C(CO)CO)O)=O)=O,2,1,0,1,6,5.9e-05
G5,C(CC(C(C)(C(CO)CO)O)=O)=O,2,1,0,1,14,5.9e-05
G5,C(C)(C(C)(C(CO)CO)O)=O,2,1,0,1,14,5.9e-05
G5,C(CC(C)(C(CO)CO)O)=O,2,1,0,1,6,5.9e-05
G5,C1C(CC(O)O1)(C(CO)CO)O,4,2,0,2,29,0.000106
G5,C(C(C(CO)CO)O)=CC(CO)=O,4,1,0,1,21,5.9e-05
G5,C(C(CO)(C(CO)CO)O)=CC=O,4,1,0,1,11,5.9e-05
G5,C=CC(C(C(CO)CO)O)=O,2,1,0,1,7,5.9e-05
G5,C(C(C=C)(C(CO)CO)O)=O,2,1,0,1,7,5.9e-05
G5,C=CC(CO)(C(CO)CO)O,2,1,0,1,7,5.9e-05
G5,C(C(C(CO)CO)O)=CC=O,4,1,0,1,43,5.9e-05
G5,CC(C(C(CO)CO)O)O,4,1,0,1,11,5.9e-05
G5,C(C(CO)(C(C(CO)CO)O)O)O,2,1,0,1,18,5.9e-05
G5,C(C(CO)(C(C(CO)CO)O)O)=O,4,3,0,3,18,0.000154
G5,C1C(C(CO1)O)(C(CO)CO)O,4,1,0,1,10,5.9e-05
G5,C1CC(C(O)O1)(C(CO)CO)O,4,1,0,1,34,5.9e-05
G5,C(C(CO)C(C(CCO)=O)O)(O)=O,4,5,0,5,29,0.000273
G5,C(C(CO)C(C=O)(CCO)O)(O)=O,4,4,0,4,29,0.000215
G5,C(C(CO)C(CO)(CCO)O)(O)=O,4,4,0,4,29,0.000215
G5,C(C(CO)C(C)(CO)O)(O)=O,4,4,0,4,29,0.000215
G5,CC(CO)(C(CO)C(C(C)O)O)O,16,1,0,1,49,5.9e-05
G5,C(C(CO)C(CC(C=O)O)O)(O)=O,8,4,0,4,29,0.000215
G5,CC(CC(C(CO)C(C)O)O)O,16,1,0,1,28,5.9e-05
G5,CC(C(CO)C(C(C(C)O)O)O)O,32,1,0,1,28,5.9e-05
G5,CC(C(CO)C(CC(CO)O)O)O,16,1,0,1,6,5.9e-05
G5,CC(CC(C(CO)C(CO)O)O)O,16,1,0,1,6,5.9e-05
G5,C(C(CO)(C(CO)C(C)O)O)=O,8,2,0,2,29,0.00010800000000000001
G5,C(C)(C(CO)(C(CO)C(C)O)O)=O,8,1,0,1,25,5.9e-05
G5,C(CO)(C(C)(C(CO)C(C)O)O)=O,8,1,0,1,25,5.9e-05
G5,C(C(C(C)O)(C(CO)C(C)O)O)=O,16,2,0,2,29,0.00010700000000000001
G5,CC(C(CO)(C(CO)C(C)O)O)O,16,1,0,1,25,5.9e-05
G5,CC(C(CO)C(C(CCO)O)O)O,16,1,0,1,29,5.9e-05
G5,C(C(C)(C(CO)C(C)O)O)(O)=O,8,1,0,1,28,5.9e-05
G5,C(C(CO)C(C)O)(O)=O,4,4,0,4,29,0.00021600000000000002
G5,C(C(C(C(CO)C(C)O)O)O)(O)=O,16,2,0,2,17,0.00010700000000000001
G5,C(C)(C(C)(C(CO)C(C)O)O)=O,8,1,0,1,14,5.9e-05
G5,C(CC(C)(C(CO)C(C)O)O)=O,8,1,0,1,6,5.9e-05
G5,C1C(CC(O)O1)(C(CO)C(C)O)O,16,2,0,2,35,0.000106
G5,C=CC(C(C(CO)C(C)O)O)=O,8,1,0,1,7,5.9e-05
G5,C(C(C=C)(C(CO)C(C)O)O)=O,8,1,0,1,7,5.9e-05
G5,C=CC(CO)(C(CO)C(C)O)O,8,1,0,1,7,5.9e-05
G5,C(C(C(CO)C(C)O)O)=CC=O,16,1,0,1,43,5.9e-05
G5,CC(C(C(CO)C(C)O)O)O,16,1,0,1,11,5.9e-05
G5,C1C(C(CO1)O)(C(CO)C(C)O)O,16,1,0,1,10,5.9e-05
G5,CC(C(CO)C1(C(O)OCC1)O)O,16,1,0,1,34,5.9e-05
G5,C(C(CO)(C(CO)C(CO)O)O)=O,8,4,0,4,29,0.000225
G5,C(C(CO)C(CO)O)(O)=O,4,5,0,5,29,0.00027400000000000005
G5,C(C)(C(C)(C(CO)C(CO)O)O)=O,8,1,0,1,14,5.9e-05
G5,C(CC(C)(C(CO)C(CO)O)O)=O,8,1,0,1,6,5.9e-05
G5,C=CC(C(C(CO)C(CO)O)O)=O,8,1,0,1,7,5.9e-05
G5,C(C(C=C)(C(CO)C(CO)O)O)=O,8,1,0,1,7,5.9e-05
G5,C=CC(CO)(C(CO)C(CO)O)O,8,1,0,1,7,5.9e-05
G5,C(C(C(CO)C(CO)O)O)=CC=O,16,1,0,1,43,5.9e-05
G5,CC(C(C(CO)C(CO)O)O)O,16,1,0,1,6,5.9e-05
G5,C(C(CO)C(C=O)(CO)O)(O)=O,4,5,0,5,29,0.000264
G5,C(C(CO)C(C=O)(C(C)O)O)(O)=O,8,5,0,5,29,0.000263
G5,C(C(CO)C1C(CC(O1)=O)O)(O)=O,8,3,0,3,29,0.000167
G5,C(C(CO)C1C(C(CO1)=O)O)(O)=O,8,3,0,3,29,0.000167
G5,C(C(CO)C1CC(C(O)O1)=O)(O)=O,8,4,0,4,29,0.00021400000000000002
G5,C(C(CO)C1C(CC(O1)O)=O)(O)=O,8,4,0,4,29,0.00021400000000000002
G5,C(C(C=CC(C=O)=O)CO)(O)=O,4,3,0,3,29,0.000165
G5,C(C(CO)C1C(C(CO1)O)=O)(O)=O,8,3,0,3,29,0.000167
G5,C(C(CO)C1(C(CCO1)=O)O)(O)=O,4,4,0,4,29,0.00021400000000000002
G5,C(C(CO)C1(CC(CO1)=O)O)(O)=O,4,4,0,4,29,0.00021400000000000002
G5,C(C(C1(CC(C(C1O)O)O)O)O)O,32,3,0,3,29,0.000176
G5,CC(C(C(CO)(C(CO)O)O)O)O,16,6,0,6,29,0.000352
G5,C(C(C(CC(CO)(CO)O)O)O)O,4,4,0,4,29,0.00023500000000000002
G5,C(C(CO)(C(CO)C(CO)O)O)O,4,2,0,2,29,0.000117
G5,C(C(C(CC(C(CO)O)O)O)O)O,10,3,0,3,29,0.000176
G5,C(C(C(CO)O)C(C(CO)O)O)O,16,4,0,4,29,0.00023500000000000002
G5,C(C(C(CO)O)(CC(C)O)O)=O,8,3,0,3,0,0.000166
G5,C(C)(C(CC(C(CO)O)O)O)=O,8,3,0,3,29,0.000176
G5,C(C)(C(C(CO)C(CO)O)O)=O,8,4,0,4,29,0.00023500000000000002
G5,C(C(C)(CC(C(CO)O)O)O)=O,8,3,0,3,29,0.000176
G5,C(C(C)(C(CO)C(CO)O)O)=O,8,2,0,2,29,0.000117
G5,C(C(C(CCO)(C(CO)O)O)O)O,3,3,0,3,29,0.000176
G5,C(C(C(CO)O)(C(CO)CO)O)O,4,3,0,3,29,0.000176
G5,C(C(CO)C(CO)O)O,2,2,0,2,29,0.000117
G5,CC(CC(CO)(C(CO)O)O)O,8,2,0,2,29,0.000117
G5,CC(C(CO)O)(C(C(C)O)O)O,16,2,0,2,29,0.000117
G5,CC(CO)(CC(C(CO)O)O)O,8,2,0,2,29,0.000117
G5,CC(CO)(C(CO)C(CO)O)O,8,2,0,2,29,0.000117
G5,CC(CC(C(CO)O)O)O,8,3,0,3,29,0.000176
G5,CC(C(CO)C(CO)O)O,8,2,0,2,29,0.000117
G5,C(C(C(CO)O)(CC(CO)O)O)=O,8,4,0,4,29,0.00022400000000000002
G5,C(C(CC(CO)(C(CO)O)O)O)O,8,3,0,3,29,0.000176
G5,C(C(C(CO)O)C(CO)O)O,3,2,0,2,29,0.000117
G5,C(CC(C(C)(C(CO)O)O)=O)=O,4,5,0,5,29,0.000261
G5,C(C)(C(C)(C(CO)O)O)=O,4,3,0,3,29,0.000165
G5,C1C(CC(C(O)O1)O)(C(CO)O)O,16,3,0,3,27,0.000165
G5,C(C(CO)(C(CO)O)O)=CC=O,8,4,0,4,29,0.000212
G5,C=CC(CO)(C(CO)O)O,4,7,0,7,29,0.000388
G5,CC(C(CO)(C(C(CO)O)O)O)O,16,8,0,8,29,0.000469
G5,C(C(C=CC(C)=O)(C(CO)O)O)=O,8,2,0,2,29,0.000117
G5,C(C(C)(C(CO)O)O)=CC(C=O)=O,8,2,0,2,29,0.000117
G5,C(C(C=CCC=O)(C(CO)O)O)=O,8,3,0,3,29,0.000166
G5,C(CC(C(CO)O)O)=CC(C=O)=O,8,2,0,2,29,0.000117
G5,C(C(CO)C(CO)O)=CC(C=O)=O,8,1,0,1,45,5.9e-05
G5,C(C(C(CO)O)O)=CC(C(C)=O)=O,8,2,0,2,29,0.000117
G5,C(C)(C(C=CC=O)(C(CO)O)O)=O,8,3,0,3,45,0.000166
G5,C(C=CC(C(C)(C(CO)O)O)=O)=O,8,2,0,2,29,0.000117
G5,C(CC(C=CC(C(CO)O)O)=O)=O,8,2,0,2,29,0.000117
G5,C(C(C(CO)O)(CC(C=C)=O)O)=O,4,3,0,3,0,0.000166
G5,C=CC(C(CC(C(CO)O)O)=O)=O,4,2,0,2,29,0.000117
G5,C(CC=O)(C(C=C)(C(CO)O)O)=O,4,5,0,5,4,0.000283
G5,C(C(C(CO)O)(CC=CC=O)O)=O,8,3,0,3,27,0.000166
G5,C(CC(C=O)=O)=CC(C(CO)O)O,8,2,0,2,29,0.000117
G5,C1C(C(CO1)O)(C(CO)O)O,8,2,0,2,29,0.000117
G5,C1CC(C(O)O1)(C(CO)O)O,8,3,0,3,34,0.000165
G5,C(C(CO)(C(CO)CO)O)O,1,1,0,1,5,5.9e-05
G5,CC(C(CO)C(CO)(CO)O)O,4,1,0,1,5,5.9e-05
G5,C(C(CO)C(C(CO)O)O)O,4,1,0,1,41,5.9e-05
G5,CC(C(CO)C(C(CO)O)O)O,16,1,0,1,41,5.9e-05
G5,C(C)(C(C(CO)C(C(C)=O)O)O)=O,3,1,0,1,45,5.9e-05
G5,C(C(C)(C(CO)C(C(C)=O)O)O)=O,8,1,0,1,45,5.9e-05
G5,C(C(C)(C(CO)C(C=O)(C)O)O)=O,3,1,0,1,45,5.9e-05
G5,C(C)(C(C(CO)CO)O)=O,2,2,0,2,2,0.000117
G5,C(C(C)(C(CO)CO)O)=O,2,1,0,1,45,5.9e-05
G5,C(C)(C(C(CO)C(CO)(C)O)O)=O,8,1,0,1,49,5.9e-05
G5,C(C(C)(C(CO)C(CO)(C)O)O)=O,8,1,0,1,49,5.9e-05
G5,C(C)(C(C(CO)C(C)O)O)=O,8,1,0,1,45,5.9e-05
G5,C(C(C)(C(CO)C(C)O)O)=O,8,1,0,1,45,5.9e-05
G5,C(C(C(C)(C(CO)CO)O)O)=O,4,1,0,1,6,5.9e-05
G5,C(C(C(C)(C(CO)C(C)O)O)O)=O,16,1,0,1,1,5.9e-05
G5,C(C(C(C=CC(C=O)=O)CO)O)=O,8,1,0,1,45,5.9e-05
G5,CC(C(CO)O)(C(CO)CO)O,4,1,0,1,18,5.9e-05
G5,CC(C(CO)O)(C(CO)C(C)O)O,16,1,0,1,28,5.9e-05
G5,C(C(CO)CO)O,1,1,0,1,18,5.9e-05
G5,C(C(C(CO)CO)O)(CCO)=O,2,4,0,4,29,0.000223
G5,C(C(CCO)(C(CO)CO)O)=O,2,2,0,2,29,0.000117
G5,C(C(CCO)(C(CO)CO)O)O,2,2,0,2,29,0.000117
G5,CC(CO)(C(CO)CO)O,2,1,0,1,49,5.9e-05
G5,C(C(CC(C(CO)CO)O)O)=O,4,1,0,1,43,5.9e-05
G5,CC(C(CO)CO)O,2,1,0,1,18,5.9e-05
G5,C(CO)(CC(O)OC(CO)CO)=O,2,1,0,1,38,5.9e-05
G5,C(C)(C(C(O)OC(CO)CO)O)=O,4,1,0,1,19,5.9e-05
G5,C(CC(CO)(O)OC(CO)CO)=O,2,1,0,1,40,5.9e-05
G5,C(COC(CO)(C(CO)CO)O)=O,2,1,0,1,40,5.9e-05
G5,C(C(C(C)(O)OC(CO)CO)O)=O,4,1,0,1,1,5.9e-05
G5,C(C(CC(O)OC(CO)CO)O)=O,4,1,0,1,37,5.9e-05
G5,C(CC(C(C(CO)CO)O)=O)(O)=O,2,2,0,2,29,0.000117
G5,C1(CC(C(C(CO)CO)O1)O)=O,4,2,0,2,29,0.000106
G5,C1(COC(C(CO)CO)C1O)=O,4,2,0,2,29,0.000106
G5,C1(C(O)OC(C(CO)CO)C1)=O,4,3,0,3,29,0.000154
G5,C1(C(C(CO)CO)OC(C1)O)=O,4,3,0,3,29,0.000154
G5,C(C(CO)CO)=CC(C=O)=O,2,2,0,2,29,0.000106
G5,C1(C(C(CO)CO)OCC1O)=O,4,2,0,2,29,0.000106
G5,C1(C(C(CO)CO)(O)OCC1)=O,2,3,0,3,29,0.000154
G5,C1(COC(C(CO)CO)(C1)O)=O,2,3,0,3,29,0.000154
G5,C1(C(C(C(C(CO)CO)O1)O)O)=O,8,1,0,1,27,5.9e-05
G5,C(C(C(CO)C(C)O)O)(CCO)=O,8,2,0,2,29,0.000117
G5,C(C(CCO)(C(CO)C(C)O)O)=O,8,2,0,2,29,0.000117
G5,CC(C(CO)C(CO)(CCO)O)O,8,2,0,2,29,0.000117
G5,CC(CO)(C(CO)C(C)(CO)O)O,3,1,0,1,49,5.9e-05
G5,CC(CO)(C(CO)C(C)O)O,8,1,0,1,49,5.9e-05
G5,C(C(CC(C(CO)C(C)O)O)O)=O,16,1,0,1,43,5.9e-05
G5,C(CC1(CC(C(C1O)O)O)O)O,16,1,0,1,4,5.9e-05
G5,C(C1(C(C(CC1)(CCO)O)O)O)=O,8,1,0,1,29,5.9e-05
G5,C(C1(CC(C(C1)O)(CCO)O)O)=O,8,1,0,1,22,5.9e-05
G5,C1(C(C(C(C(CCO)O)C1)O)O)=O,16,3,0,3,18,0.000154
G5,C1C(C(C(C(C=1)O)O)O)(CCO)O,16,1,0,1,32,5.9e-05
G5,CC(C(C(CO)(CCO)O)O)O,8,2,0,2,29,0.000117
G5,C(C(CO)(CC(CCO)O)O)O,2,1,0,1,4,5.9e-05
G5,C(C(C(CC(CCO)O)O)O)O,8,1,0,1,29,5.9e-05
G5,C(C(C)(CC(C=O)(CCO)O)O)=O,4,1,0,1,4,5.9e-05
G5,C(C(CCO)(CC(CO)(C)O)O)=O,4,1,0,1,4,5.9e-05
G5,C(C)(C(CC(CO)(CCO)O)O)=O,4,2,0,2,29,0.000117
G5,C(C(C)(CC(CO)(CCO)O)O)=O,4,1,0,1,4,5.9e-05
G5,C(C(C)(C(C(C)(CCO)O)O)O)=O,8,2,0,2,11,0.00010700000000000001
G5,C(C(CCO)(CC(C)O)O)=O,4,1,0,1,4,5.9e-05
G5,C(C)(C(CC(CCO)O)O)=O,4,1,0,1,45,5.9e-05
G5,C(C(C)(CC(CCO)O)O)=O,4,1,0,1,18,5.9e-05
G5,C(C(C(CCO)(CCO)O)O)=O,2,1,0,1,0,5.9e-05
G5,C(C(C(CC(C)O)(CCO)O)O)=O,8,1,0,1,4,5.9e-05
G5,C(C(C(C)(CC(CCO)O)O)O)=O,8,1,0,1,4,5.9e-05
G5,C(C(C(CCO)(CCO)O)O)O,2,1,0,1,29,5.9e-05
G5,CC(CC(CCO)(C(CO)O)O)O,8,1,0,1,4,5.9e-05
G5,CC(CC(CCO)O)(C(CO)O)O,8,1,0,1,4,5.9e-05
G5,C(CC(CCO)O)O,1,1,0,1,18,5.9e-05
G5,C(C(CC(CCO)O)O)(CCO)=O,4,2,0,2,29,0.000117
G5,C(C(CCO)(CC(CCO)O)O)=O,4,2,0,2,29,0.000117
G5,CC(C(C(CCO)(CCO)O)O)O,4,1,0,1,4,5.9e-05
G5,C(CC(CC(CO)(CCO)O)O)O,4,1,0,1,4,5.9e-05
G5,CC(CO)(CC(CO)(CCO)O)O,4,1,0,1,4,5.9e-05
G5,CC(CCO)(C(C(C)(CO)O)O)O,8,1,0,1,4,5.9e-05
G5,CC(CC(CO)(CCO)O)O,4,1,0,1,11,5.9e-05
G5,CC(C(C(C)(CCO)O)O)O,8,1,0,1,4,5.9e-05
G5,CC(CO)(CC(CCO)O)O,4,1,0,1,18,5.9e-05
G5,C(C(CC(CC(CCO)O)O)O)=O,8,1,0,1,4,5.9e-05
G5,CC(CC(CCO)O)O,4,1,0,1,28,5.9e-05
G5,CC(C(CO)C(C)O)O,3,1,0,1,4,5.9e-05
G5,C(C(C(C(C(CCO)O)O)O)O)O,16,6,0,6,29,0.00035099999999999997
G5,C(C(CCO)(CC(CO)O)O)=O,4,2,0,2,29,0.000117
G5,CC(CO)(C(C(CCO)O)O)O,8,2,0,2,29,0.000117
G5,C(C(CC(CO)(CCO)O)O)O,4,2,0,2,29,0.000117
G5,CC(CCO)(C(C(CO)O)O)O,8,2,0,2,29,0.000117
G5,CC(C(C(CCO)O)O)O,8,1,0,1,28,5.9e-05
G5,C(C(CC(CCO)O)O)O,4,2,0,2,29,0.000117
G5,C(C)(C(CO)(CCO)O)=O,2,4,0,4,29,0.00021400000000000002
G5,CC(C(CO)(CCO)O)O,4,2,0,2,29,0.000117
G5,C(CC(C(CCO)O)O)O,3,1,0,1,29,5.9e-05
G5,C(C(C(C)(CCO)O)O)(O)=O,4,3,0,3,29,0.000165
G5,C(C(C(C(C)(CCO)O)O)O)(O)=O,8,3,0,3,29,0.000165
G5,C(CC(C(CCO)O)O)(O)=O,4,2,0,2,29,0.000117
G5,C(CC(C(C)(CCO)O)=O)=O,2,2,0,2,29,0.000106
G5,C1C(CCO)(CC(C(O)O1)O)O,8,2,0,2,29,0.000106
G5,C(C(CO)(CCO)O)=CC=O,4,2,0,2,29,0.000106
G5,C=CC(CO)(CCO)O,2,2,0,2,29,0.000106
G5,C(C(C(C(C)O)(CCO)O)O)=O,8,1,0,1,45,5.9e-05
G5,CC(C(CCO)O)O,4,1,0,1,11,5.9e-05
G5,C(C(CCC(C(CCO)O)O)=O)=O,4,2,0,2,7,0.00010700000000000001
G5,C(C(CC(CCO)(C(C)O)O)=O)=O,4,2,0,2,45,0.000117
G5,C(CC(C(C(C)=O)(CCO)O)O)=O,4,2,0,2,45,0.00010700000000000001
G5,C(C(CO)(CCO)O)(CC(C)=O)=O,2,1,0,1,26,5.9e-05
G5,C(CCC=O)(C(CO)(CCO)O)=O,2,1,0,1,4,5.9e-05
G5,C(C(C(CCC=O)O)(CCO)O)=O,4,3,0,3,29,0.000154
G5,C(CO)=CC(C(CO)(CCO)O)=O,4,1,0,1,4,5.9e-05
G5,C(C(CCO)(C(C=CCO)O)O)=O,8,3,0,3,29,0.000165
G5,C(C(C(CO)(CCO)O)O)=CC=O,8,2,0,2,29,0.000117
G5,C(CO)(CC(CCO)(CCO)O)=O,1,2,0,2,29,0.000117
G5,C(CO)(CCC(CO)(CCO)O)=O,2,4,0,4,29,0.00022400000000000002
G5,C(CCO)(C(CCO)(CCO)O)=O,1,2,0,2,29,0.000117
G5,C(C)(C(C(CCO)(CCO)O)O)=O,2,1,0,1,49,5.9e-05
G5,C(CCC(CCO)(C(CO)O)O)=O,4,3,0,3,29,0.000165
G5,C(C(CO)O)(CCC(CCO)O)=O,4,3,0,3,29,0.000165
G5,C(C(C(CCCO)(CCO)O)O)=O,4,2,0,2,29,0.000117
G5,C(C)(C(CCO)(CC(CO)O)O)=O,4,2,0,2,29,0.000117
G5,C(CC(CO)O)(C(C)(CCO)O)=O,4,2,0,2,29,0.000117
G5,C(CC(CCO)O)(CC(CO)O)=O,4,2,0,2,29,0.000117
G5,C(C(CC(CCO)(CCO)O)O)=O,2,1,0,1,29,5.9e-05
G5,C(C(CO)(CCO)O)=CC(CO)O,8,3,0,3,29,0.000176
G5,C(C(C(CO)O)(CCO)O)=CCO,8,3,0,3,29,0.000176
G5,C=CC(CCO)(C(C(CO)O)O)O,8,2,0,2,29,0.000117
G5,C(C(CCO)O)=CC(C(CO)O)O,16,2,0,2,29,0.000117
G5,C(C(C(C(CCO)O)O)O)=CCO,16,2,0,2,29,0.000117
G5,C1(CCC(C1(C(CCO)O)O)O)=O,8,3,0,3,7,0.000154
G5,C(C1(C(CCC1(CCO)O)O)O)=O,8,3,0,3,29,0.000154
G5,C1C(CCO)(C(CO)(C(C=1)O)O)O,8,1,0,1,4,5.9e-05
G5,C1C(C(C(CCO)O)(C(C=1)O)O)O,6,1,0,1,43,5.9e-05
G5,C(C(CO)(C(CCO)O)O)O,2,3,0,3,29,0.000176
G5,CC(C(CO)(C(CCO)O)O)O,8,3,0,3,29,0.000176
G5,C(C(CO)(C(C)(CCO)O)O)=O,4,5,0,5,28,0.00025299999999999997
G5,C(C(C(C)O)(C(C)(CCO)O)O)=O,8,5,0,5,28,0.000252
G5,CC(CCO)(C(CO)(CO)O)O,2,1,0,1,29,5.9e-05
G5,CC(CCO)(C(CO)(C(C)O)O)O,8,1,0,1,4,5.9e-05
G5,C(C(C(CO)(C(CCO)O)O)O)O,8,5,0,5,29,0.000293
G5,C1(CC(C(C1)O)(C(CCO)O)O)=O,8,1,0,1,26,5.9e-05
G5,C(C1(CC(CC1O)(CCO)O)O)=O,8,2,0,2,29,0.000106
G5,C(C(CO)(CC(CCO)O)O)=O,4,2,0,2,29,0.00010800000000000001
G5,C(C(C(C)O)(CC(CCO)O)O)=O,8,2,0,2,4,0.00010700000000000001
G5,C1(C(CC(CCO)(C1CO)O)O)=O,8,1,0,1,30,5.9e-05
G5,C1(CC(C(CCO)(C1CO)O)O)=O,8,1,0,1,30,5.9e-05
G5,C1(C(C(CC1CO)(CCO)O)O)=O,8,1,0,1,47,5.9e-05
G5,C1(C(C(C(CO)C1)(CCO)O)O)=O,8,2,0,2,11,0.000106
G5,C1(CCC(CCO)(C1(CO)O)O)=O,4,1,0,1,21,5.9e-05
G5,C1(CC(CC1(CO)O)(CCO)O)=O,4,1,0,1,2,5.9e-05
G5,C1(CC(CCO)(C(CO)(C1)O)O)=O,4,1,0,1,4,5.9e-05
G5,C1(CC(C(C(C)(CCO)O)O1)O)=O,8,1,0,1,48,5.9e-05
G5,C1(CC(C(CC(CCO)O)O1)O)=O,8,1,0,1,48,5.9e-05
G5,C1(CC(C(C(CO)C(C)O)O1)O)=O,16,1,0,1,48,5.9e-05
G5,C(C)(C1C(C(CO1)(CCO)O)O)=O,8,1,0,1,17,5.9e-05
G5,C1(COC(C(C)(CCO)O)C1O)=O,8,1,0,1,17,5.9e-05
G5,C(CC1C(C(CO1)(CCO)O)O)=O,8,1,0,1,4,5.9e-05
G5,C1(COC(CC(CCO)O)C1O)=O,8,1,0,1,9,5.9e-05
G5,C1(COC(C(CO)C(C)O)C1O)=O,16,1,0,1,9,5.9e-05
G5,C(C)(C1CC(C(O1)O)(CCO)O)=O,8,2,0,2,29,0.000106
G5,C1(C(O)OC(C(C)(CCO)O)C1)=O,8,2,0,2,22,0.000106
G5,C(CC1CC(C(O)O1)(CCO)O)=O,8,2,0,2,13,0.000106
G5,C1(C(O)OC(CC(CCO)O)C1)=O,8,2,0,2,29,0.000106
G5,C1(C(O)OC(C(CO)C(C)O)C1)=O,16,2,0,2,29,0.000106
G5,C(C)(C1C(CC(O1)O)(CCO)O)=O,8,2,0,2,9,0.000106
G5,C(CC1C(CC(O)O1)(CCO)O)=O,8,2,0,2,13,0.000106
G5,C1(C(CC(CCO)O)OC(C1)O)=O,8,2,0,2,29,0.000106
G5,C1(C(C(CO)C(C)O)OC(C1)O)=O,16,2,0,2,29,0.000106
G5,C1(CC(CC(CO)O1)(CCO)O)=O,4,1,0,1,19,5.9e-05
G5,C1(CCC(CCO)(C(CO)O1)O)=O,4,1,0,1,4,5.9e-05
G5,C1(CC(CO)OCC1(CCO)O)=O,4,1,0,1,54,5.9e-05
G5,C1(COC(CO)CC1(CCO)O)=O,4,1,0,1,54,5.9e-05
G5,C1(C(CO)OCC(CCO)(C1)O)=O,4,1,0,1,54,5.9e-05
G5,C1(COC(CO)C(CCO)(C1)O)=O,4,1,0,1,54,5.9e-05
G5,C1(CC(CC(CO1)O)(CCO)O)=O,4,1,0,1,19,5.9e-05
G5,C1(CCC(CCO)(C(CO1)O)O)=O,4,1,0,1,4,5.9e-05
G5,C1(CC(C(CCO)(CCO1)O)O)=O,4,1,0,1,19,5.9e-05
G5,C1(CC(CC(CO1)(CCO)O)O)=O,4,1,0,1,48,5.9e-05
G5,C1(CC(COCC1(CCO)O)O)=O,4,1,0,1,4,5.9e-05
G5,C1(COCC(CC1(CCO)O)O)=O,4,1,0,1,36,5.9e-05
G5,C1(C(COCC(CCO)(C1)O)O)=O,4,1,0,1,36,5.9e-05
G5,C1(COCC(C(CCO)(C1)O)O)=O,4,1,0,1,36,5.9e-05
G5,C1(C(C(COCC1)(CCO)O)O)=O,4,1,0,1,36,5.9e-05
G5,C1(COCCC(CCO)(C1O)O)=O,4,1,0,1,36,5.9e-05
G5,C1(COCC(C(C1)O)(CCO)O)=O,4,1,0,1,36,5.9e-05
G5,C1(COCC(CC1O)(CCO)O)=O,4,1,0,1,36,5.9e-05
G5,C1(CC(C(O)OCC1)(CCO)O)=O,4,2,0,2,23,0.000106
G5,C1(C(O)OCCC(CCO)(C1)O)=O,4,2,0,2,29,0.000106
G5,C1(COC(C(CC1)(CCO)O)O)=O,4,2,0,2,29,0.000106
G5,C1(C(O)OCC(CC1)(CCO)O)=O,4,2,0,2,29,0.000106
G5,C1(CCOC(CC1(CCO)O)O)=O,4,2,0,2,4,0.000106
G5,C1(CC(O)OCCC1(CCO)O)=O,4,2,0,2,29,0.000106
G5,C1(COC(CC(CCO)(C1)O)O)=O,4,2,0,2,32,0.000106
G5,C1(CC(COC(C1)O)(CCO)O)=O,4,2,0,2,26,0.000106
G5,C(C=CC(C)=O)(C(CCO)O)=O,4,3,0,3,29,0.000154
G5,C(C(C=CC(C)=O)(CCO)O)=O,4,4,0,4,29,0.00020099999999999998
G5,C(C(C)(CCO)O)=CC(C=O)=O,4,2,0,2,29,0.000106
G5,C(CC=CC(C(CCO)O)=O)=O,4,3,0,3,29,0.000154
G5,C(C(C=CCC=O)(CCO)O)=O,4,3,0,3,29,0.000154
G5,C(CC(CCO)O)=CC(C=O)=O,4,2,0,2,29,0.000106
G5,C(C(CO)C(C)O)=CC(C=O)=O,8,2,0,2,29,0.000106
G5,C(C(CCO)O)=CC(C(C)=O)=O,4,3,0,3,29,0.000154
G5,C(C)(C(C=CC=O)(CCO)O)=O,4,3,0,3,29,0.000154
G5,C(C=CC(C(C)(CCO)O)=O)=O,4,2,0,2,29,0.000106
G5,C(CC(C=CC(CCO)O)=O)=O,4,5,0,5,29,0.00024900000000000004
G5,C(C(CCO)O)(CC(C=C)=O)=O,2,3,0,3,29,0.000154
G5,C(C(CCO)(CC(C=C)=O)O)=O,2,2,0,2,29,0.000106
G5,C(C(CCO)(CC(C=O)=O)O)=C,2,3,0,3,29,0.000154
G5,C=CC(C(CC(CCO)O)=O)=O,2,3,0,3,29,0.000154
G5,C(CC=O)(C(C=C)(CCO)O)=O,2,4,0,4,29,0.00020099999999999998
G5,C(C(CCO)O)(CC=CC=O)=O,4,3,0,3,29,0.000154
G5,C(C(CCO)(CC=CC=O)O)=O,4,2,0,2,29,0.000106
G5,C(CC(C=O)=O)=CC(CCO)O,4,3,0,3,29,0.000154
G5,C1C(C(CO1)(CCO)O)O,4,1,0,1,10,5.9e-05
G5,C1CC(C(O)O1)(CCO)O,4,2,0,2,29,0.000106
G5,C1(C(CC(CCO)O)OCC1O)=O,8,1,0,1,9,5.9e-05
G5,C(CC1C(CCO)(C(CO1)O)O)=O,8,1,0,1,9,5.9e-05
G5,C1(C(C(CO)C(C)O)OCC1O)=O,16,1,0,1,9,5.9e-05
G5,C1(C(CC(CCO)O)(O)OCC1)=O,4,2,0,2,53,0.000106
G5,C(CC1(C(CCO)(CCO1)O)O)=O,4,2,0,2,29,0.000106
G5,C1(C(C(CO)C(C)O)(O)OCC1)=O,8,2,0,2,2,0.000106
G5,C1(COC(CC(CCO)O)(C1)O)=O,4,2,0,2,26,0.000106
G5,C(CC1(CC(CO1)(CCO)O)O)=O,4,2,0,2,29,0.000106
G5,C1(COC(C(CO)C(C)O)(C1)O)=O,8,2,0,2,4,0.000106
G5,C(C1CC(CO1)O)(C(CCO)O)=O,8,1,0,1,39,5.9e-05
G5,C(C(CCO)(C1CC(CO1)O)O)=O,8,1,0,1,4,5.9e-05
G5,C(C1CC(C(C(CCO)O)O1)O)=O,16,1,0,1,40,5.9e-05
G5,C(C1C(CC(C(CCO)O)O1)O)=O,16,1,0,1,40,5.9e-05
G5,C1(C(C(CCO)O)OC(C)(C1)O)=O,8,2,0,2,26,0.000106
G5,C(C1C(CC(C)(O1)O)(CCO)O)=O,8,2,0,2,27,0.000106
G5,C1(C(C)(O)OC(C(CCO)O)C1)=O,8,2,0,2,21,0.000106
G5,C(C1CC(CCO)(C(C)(O1)O)O)=O,8,2,0,2,21,0.000106
G5,C1(C(C)OC(C(CCO)O)C1O)=O,16,1,0,1,29,5.9e-05
G5,C(C1C(C(CCO)(C(C)O1)O)O)=O,16,1,0,1,29,5.9e-05
G5,C1(CC(C(CCO)O)(O)OCC1)=O,4,2,0,2,29,0.000106
G5,C(C1(CC(CCO)(CCO1)O)O)=O,4,2,0,2,29,0.000106
G5,C1(COC(CC1)(C(CCO)O)O)=O,4,2,0,2,7,0.000106
G5,C(C1(CCC(CO1)(CCO)O)O)=O,4,2,0,2,29,0.000106
G5,C1(C(C(CCO)O)OC(CC1)O)=O,8,2,0,2,37,0.000106
G5,C(C1C(CCC(O1)O)(CCO)O)=O,8,2,0,2,29,0.000106
G5,C1(CC(C(CCO)O)OC(C1)O)=O,8,2,0,2,29,0.000106
G5,C(C1CC(CCO)(CC(O1)O)O)=O,8,2,0,2,4,0.000106
G5,C1C(C(C(C=1CO)(CCO)O)O)O,8,1,0,1,2,5.9e-05
G5,C=C1C(C(C(C1(CCO)O)O)O)O,16,1,0,1,47,5.9e-05
G5,C1C(C(C(C=1C(CCO)O)O)O)O,16,1,0,1,29,5.9e-05
G5,C=CC(C(C(C(CCO)O)O)O)O,16,1,0,1,4,5.9e-05
G5,C1C(C(C(C=1)O)O)(C(CCO)O)O,16,1,0,1,29,5.9e-05
G5,C1OC(C(CO)O)C(C=1)(CCO)O,8,1,0,1,9,5.9e-05
G5,C1C(C(OC(C=1)CO)O)(CCO)O,8,1,0,1,46,5.9e-05
G5,C1OC(CO)C(C(C=1)(CCO)O)O,8,1,0,1,9,5.9e-05
G5,C1C(C(CO)OC(C=1)O)(CCO)O,8,1,0,1,2,5.9e-05
G5,C1C(C(O)OCC(C=1)O)(CCO)O,8,1,0,1,41,5.9e-05
G5,C1OCC(C(C(C=1)(CCO)O)O)O,8,1,0,1,38,5.9e-05
G5,C1C(C(C(OCC=1)O)O)(CCO)O,8,1,0,1,19,5.9e-05
G5,C1C(C(COC(C=1)O)O)(CCO)O,8,1,0,1,38,5.9e-05
G5,C1C(COC(C(C=1)O)O)(CCO)O,8,1,0,1,29,5.9e-05
G5,C1(C(CCO)O)OC(CO)C(C=1)O,8,1,0,1,29,5.9e-05
G5,C1C(CO)OC(C=1)(C(CCO)O)O,8,1,0,1,41,5.9e-05
G5,C1(C(C(CO1)O)O)=CC(CCO)O,16,1,0,1,29,5.9e-05
G5,C1(C(C(CCO)O)O)OCC(C=1)O,8,1,0,1,36,5.9e-05
G5,C1C(C(C(CCO)O)O)(OCC=1)O,8,1,0,1,39,5.9e-05
G5,C1C(C(CCO)O)OC(C=1)(CO)O,8,1,0,1,40,5.9e-05
G5,C1C(C(C(CCO)O)OC=1CO)O,8,1,0,1,40,5.9e-05
G5,C=C1C(C(C(C(CCO)O)O1)O)O,16,1,0,1,26,5.9e-05
G5,C1C(C(C(CCO)O)O)OC(C=1)O,16,1,0,1,43,5.9e-05
G5,C1OC(C(C(CCO)O)O)C(C=1)O,16,1,0,1,36,5.9e-05
G5,C1(C(CCO)O)OCC(C(C=1)O)O,8,1,0,1,30,5.9e-05
G5,C1C(COC(C=1)(C(CCO)O)O)O,8,1,0,1,30,5.9e-05
G5,C1C(C(C(CCO)O)OC(C=1)O)O,16,1,0,1,37,5.9e-05
G5,C1OC(C(C(C=1)O)O)C(CCO)O,16,1,0,1,37,5.9e-05
G5,C(COCCO)(CO)=O,1,1,0,1,27,5.9e-05
G5,C(C(O)OCCO)(C)=O,2,1,0,1,27,5.9e-05
G5,C(CO)(C(COCCO)O)=O,2,1,0,1,36,5.9e-05
G5,C(CO)=CCO,2,2,0,2,29,0.000106
G5,C(COC(CCO)O)(CO)=O,2,1,0,1,38,5.9e-05
G5,C(C)(C(CO)(CO)OC(CO)O)=O,2,3,0,3,2,0.00015800000000000002
G5,C(C)(C(C(O)OCCO)(CO)O)=O,4,3,0,3,29,0.00015800000000000002
G5,C(C)(C(COC(CO)O)(CO)O)=O,4,3,0,3,29,0.00015800000000000002
G5,C(C)(C(CO)(O)OC(CO)CO)=O,2,2,0,2,2,0.00010800000000000001
G5,C(C)(C(CO)(O)OCC(CO)O)=O,4,2,0,2,41,0.00010800000000000001
G5,C(COCC(CO)=O)(C)=O,1,3,0,3,29,0.000154
G5,C(CC(C)=O)(OCCO)=O,1,2,0,2,29,0.000106
G5,C(C(COCCO)=O)(C)=O,1,2,0,2,29,0.000106
G5,C(C(C(CO)OCCO)O)=O,4,1,0,1,26,5.9e-05
G5,C(COC(CO)C(CO)O)=O,4,1,0,1,26,5.9e-05
G5,C(CC(C=O)OCCO)=O,2,2,0,2,29,0.000106
G5,C(C(CCO)OCC=O)=O,2,2,0,2,29,0.000106
G5,C(C(C(C)OCCO)=O)=O,2,2,0,2,29,0.000106
G5,C(C(C(COCCO)O)O)=O,4,1,0,1,37,5.9e-05
G5,C(COCC(C(CO)O)O)=O,4,1,0,1,37,5.9e-05
G5,C(CO)(C(CO)OCCO)=O,2,1,0,1,2,5.9e-05
G5,C(C)(C(CO)(O)OCCO)=O,2,1,0,1,2,5.9e-05
G5,C(COC(CO)(CO)O)(C)=O,1,1,0,1,2,5.9e-05
G5,C(C(C)=O)(OC(CO)CO)=O,1,1,0,1,50,5.9e-05
G5,C(C(C)=O)(OCC(CO)O)=O,2,1,0,1,27,5.9e-05
G5,C(CC(CO)=O)(OCCO)=O,1,1,0,1,2,5.9e-05
G5,C(C(C(C)=O)O)(OCCO)=O,2,1,0,1,2,5.9e-05
G5,C=CC(CO)O,2,4,0,4,29,0.000212
G5,C(OCCO)=CC(CO)=O,2,2,0,2,29,0.000106
G5,C(CO)(OCCO)=CC=O,2,2,0,2,29,0.000106
G5,C(COC(CO)=CCO)=O,2,2,0,2,29,0.000106
G5,C(C(C(OCCO)=C)O)=O,2,2,0,2,29,0.000106
G5,C(COC(C(CO)O)=C)=O,2,2,0,2,29,0.000106
G5,C(C(O)OCCO)=CC=O,4,2,0,2,29,0.000106
G5,C(COC(C=CCO)O)=O,4,2,0,2,29,0.000106
G5,C(C(C=COCCO)O)=O,4,2,0,2,29,0.000106
G5,C(COC=CC(CO)O)=O,4,2,0,2,29,0.000106
G5,C(C(C(CO)OC(CO)O)O)=O,8,1,0,1,0,5.9e-05
G5,C(CC(CO)OC(CO)O)=O,4,1,0,1,41,5.9e-05
G5,C(C(O)OC(CO)CCO)=O,4,1,0,1,41,5.9e-05
G5,C(C(O)OC(CO)CO)(CO)=O,2,1,0,1,29,5.9e-05
G5,C(C(C(COC(CO)O)O)O)=O,8,1,0,1,15,5.9e-05
G5,C(CC(COC(CO)O)O)=O,4,1,0,1,30,5.9e-05
G5,C(C(O)OCC(CCO)O)=O,4,1,0,1,30,5.9e-05
G5,C(CC(C(O)OCCO)O)=O,4,1,0,1,37,5.9e-05
G5,C(COC(C(CCO)O)O)=O,4,1,0,1,37,5.9e-05
G5,C(COC(CO)(C)O)(CO)=O,2,1,0,1,24,5.9e-05
G5,C(CO)(C(C)OC(CO)O)=O,4,1,0,1,24,5.9e-05
G5,C(CC(C=O)O)(OCCO)=O,2,1,0,1,8,5.9e-05
G5,C(CC(CO)O)(OCC=O)=O,2,4,0,4,29,0.000212
G5,C(C(CC(CO)(CO)O)O)O,2,1,0,1,29,5.9e-05
G5,C(C)(C(CC(CO)O)O)=O,4,2,0,2,29,0.000106
G5,C(C(C)(CC(CO)O)O)=O,4,1,0,1,16,5.9e-05
G5,C(C(C(C)(CC(CO)O)O)O)=O,8,1,0,1,0,5.9e-05
G5,CC(CC(CO)O)(C(CO)O)O,8,1,0,1,52,5.9e-05
G5,C(C(CC(CO)O)O)(CCO)=O,4,1,0,1,3,5.9e-05
G5,CC(CO)(CC(CO)O)O,4,1,0,1,49,5.9e-05
G5,CC(CC(CO)O)O,4,1,0,1,11,5.9e-05
G5,C(C(CC(CO)O)O)O,3,2,0,2,27,0.000117
G5,C(C(CC(C(C(CO)O)O)O)O)O,16,3,0,3,29,0.000176
G5,C(C(CO)OCC(CO)O)=O,4,1,0,1,2,5.9e-05
G5,C(OC(CO)CC(CO)O)=O,4,1,0,1,2,5.9e-05
G5,C(OCC(CC(CO)O)O)=O,4,1,0,1,19,5.9e-05
G5,C(C(O)OCCC(CO)O)=O,4,1,0,1,30,5.9e-05
G5,C(C(CO)O)=CC(CO)O,6,3,0,3,29,0.000154
G5,C(C(CO)(CC(CO)O)O)=O,4,2,0,2,2,0.00010800000000000001
G5,C(C(C(C)O)(CC(CO)O)O)=O,8,2,0,2,4,0.00010700000000000001
G5,C(C(C=CC(CO)O)(CO)O)=O,8,4,0,4,29,0.00020299999999999997
G5,C(C(C=CC(CO)O)(C(C)O)O)=O,16,2,0,2,32,0.00010700000000000001
G5,C(CC(CC(CO)O)C(C=O)O)=O,8,2,0,2,27,0.000106
G5,C(CO)OC(CO)(CCO)O,2,2,0,2,29,0.000117
G5,C(CO)OC(C)(C(CO)O)O,4,2,0,2,29,0.000117
G5,C(CO)OC(CC(CO)O)O,4,2,0,2,29,0.000117
G5,C(C(CC(C(CO)(CO)O)O)O)O,4,3,0,3,29,0.000176
G5,C(CCCO)(C(CO)(CO)O)=O,1,5,0,5,29,0.000264
G5,C(C(C(CO)(CO)O)O)=CCO,4,3,0,3,29,0.000165
G5,C(CCCO)(C(CO)(C(C)O)O)=O,4,4,0,4,29,0.000215
G5,C(C(C(CO)(C(C)O)O)O)=CCO,16,2,0,2,29,0.000117
G5,C(CCO)(C(CO)(CCO)O)=O,2,4,0,4,29,0.00021400000000000002
G5,CC(CO)(C(CO)(CCO)O)O,4,3,0,3,29,0.000176
G5,C(CCO)(C(C(C)O)(CCO)O)=O,4,3,0,3,29,0.000166
G5,C(CCO)=CC(CO)=O,2,5,0,5,29,0.00026000000000000003
G5,C(CO)(CC=CCO)=O,2,5,0,5,29,0.00026000000000000003
G5,C(C1CC(C(CO)O1)O)O,8,2,0,2,29,0.000117
G5,C(C(CO)O)(C(CCO)CCO)=O,2,1,0,1,46,5.9e-05
G5,C(C(C(C(CCO)CCO)O)O)=O,4,1,0,1,46,5.9e-05
G5,C(C(C(CO)O)C(C(C)=O)O)(O)=O,8,4,0,4,29,0.00021400000000000002
G5,C(C(C(CO)O)C(C=O)(C)O)(O)=O,8,4,0,4,29,0.00021400000000000002
G5,C(CC(CO)(CC(CO)O)O)(O)=O,4,2,0,2,29,0.000117
G5,C(CC(C)(C(C(CO)O)O)O)(O)=O,8,2,0,2,29,0.000117
G5,C(C(C(CO)O)C(C)(CO)O)(O)=O,8,4,0,4,29,0.00021400000000000002
G5,C(C(C(CO)O)C(C)O)(O)=O,8,4,0,4,29,0.000215
G5,C(CC(CC(CO)O)O)(O)=O,4,2,0,2,29,0.000117
G5,C(C(C(CO)O)C(CO)O)(O)=O,3,4,0,4,29,0.00022400000000000002
G5,C(COC(CO)(CCO)O)(O)=O,2,2,0,2,29,0.000117
G5,C(CC(CO)(O)OCCO)(O)=O,2,2,0,2,29,0.000117
G5,C(COC(C)(C(CO)O)O)(O)=O,4,2,0,2,29,0.000117
G5,C(C(C(C)(O)OCCO)O)(O)=O,4,2,0,2,29,0.000117
G5,C(COC(CC(CO)O)O)(O)=O,4,2,0,2,29,0.000117
G5,C(C(CC(O)OCCO)O)(O)=O,4,2,0,2,29,0.000117
G5,C(C(C(CCCO)=O)(CO)O)(O)=O,2,7,0,7,55,0.00037200000000000004
G5,C(CCC(O)=O)(C(CO)(CO)O)=O,1,4,0,4,29,0.00021600000000000002
G5,C(C(CO)(C(C=CCO)O)O)(O)=O,8,7,0,7,29,0.000371
G5,C(C(C(CO)(CO)O)O)=CC(O)=O,4,2,0,2,29,0.000117
G5,C(CC(C(CO)(CCO)O)=O)(O)=O,2,3,0,3,29,0.000167
G5,C(C(CO)(CC(O)=O)O)(CCO)=O,2,3,0,3,29,0.000167
G5,C(CC(CO)(C(C)(CO)O)O)(O)=O,4,3,0,3,29,0.000176
G5,C(CC(CO)(C(C)O)O)(O)=O,4,2,0,2,29,0.000117
G5,C(CCO)=CC(C(O)=O)=O,2,3,0,3,29,0.000165
G5,C(CC=CC(CO)=O)(O)=O,2,3,0,3,29,0.000165
G5,C(CC(C=CCO)=O)(O)=O,2,5,0,5,29,0.00026000000000000003
G5,C(CC(C(O)=O)=O)=CCO,2,5,0,5,29,0.00026000000000000003
G5,C(C1C(CC(CO)O1)O)(O)=O,8,2,0,2,29,0.000117
G5,C(C1CC(C(CO)O1)O)(O)=O,8,2,0,2,29,0.000117
G5,C1(CCC(CO)(C1(CO)O)O)=O,4,6,0,6,29,0.0003
G5,C1(C(C(C(C1)O)(CO)CO)O)=O,4,2,0,2,29,0.000106
G5,C1(C(CC(C1(CO)CO)O)O)=O,4,3,0,3,2,0.000156
G5,C1(C(C(C(CO)(CO)C1)O)O)=O,4,4,0,4,29,0.00020099999999999998
G5,C1(CC(C(C1(CO)CO)O)O)=O,4,4,0,4,29,0.00020299999999999997
G5,CC1(CC(C(CO)(C1O)O)O)O,16,1,0,1,16,5.9e-05
G5,C(C1(C(C(CC1(CO)O)O)O)O)O,16,4,0,4,29,0.00023500000000000002
G5,CC1(C(C(C(C1(CO)O)O)O)O)O,32,5,0,5,29,0.000293
G5,C1(CCC(CO)(C1(C(C)O)O)O)=O,8,6,0,6,29,0.000299
G5,C1(C(C(C(C1)O)(CO)C(C)O)O)=O,16,1,0,1,4,5.9e-05
G5,C1(C(CC(C1(CO)C(C)O)O)O)=O,16,3,0,3,4,0.000155
G5,C1(CCC(CC(C1(CO)O)O)O)=O,8,3,0,3,7,0.000154
G5,C1(C(C(C(CO)(C(C)O)C1)O)O)=O,16,2,0,2,46,0.000106
G5,C1(CC(C(C1(CO)C(C)O)O)O)=O,16,3,0,3,29,0.000155
G5,C=CC1(C(C(CO)(C(C1)O)O)O)O,16,1,0,1,7,5.9e-05
G5,C1C(C(CO)(C(CC(C=1)O)O)O)O,16,1,0,1,43,5.9e-05
G5,CC1(C(C(C(CO)(C1O)O)O)O)O,32,3,0,3,29,0.000176
G5,C1C(CO)(C(CO1)(CO)O)O,3,1,0,1,36,5.9e-05
G5,C1C(CO)(C(C)(C(O)O1)O)O,8,2,0,2,11,0.000106
G5,C(C1(C(CC(CO)(C1O)O)O)O)O,16,2,0,2,29,0.000117
G5,C1(CC(CO)CC(C1(CO)O)O)=O,8,5,0,5,29,0.00026000000000000003
G5,C1(C(CO)(C(CC1CCO)O)O)=O,8,3,0,3,46,0.000154
G5,C1(CCCC(C1(C(CO)O)O)O)=O,8,4,0,4,27,0.00020099999999999998
G5,C(CC1CC(C(CO)(C1O)O)O)=O,16,2,0,2,43,0.000106
G5,C(C1(C(C(CC1O)CCO)O)O)=O,16,3,0,3,46,0.000154
G5,C(C1(C(CCC1(CO)O)=O)O)(O)=O,4,6,0,6,29,0.000298
G5,C(C1(CO)C(CC(C1O)=O)O)(O)=O,8,5,0,5,29,0.000262
G5,C(C1(C(C(CC1O)O)=O)CO)(O)=O,8,5,0,5,29,0.000263
G5,C(C1(C(CC(CO)C1O)=O)O)(O)=O,8,7,0,7,17,0.000356
G5,C(C1(CO)C(C(C(C1)=O)O)O)(O)=O,8,4,0,4,29,0.00021400000000000002
G5,C(C1(C(CC(C1O)O)=O)CO)(O)=O,8,5,0,5,17,0.000263
G5,C(C(C=O)(C(C)(CCO)O)O)(O)=O,4,5,0,5,28,0.000251
G5,C(C(C=O)(CO)C(CO)O)(O)=O,4,4,0,4,17,0.000205
G5,C(C(C(CO)O)C(CCO)O)(O)=O,8,3,0,3,29,0.000165
G5,C(C(C=O)(C(CO)O)C(C)O)(O)=O,8,4,0,4,4,0.000204
G5,CC(CC(C(CO)(C(C)O)O)O)O,16,2,0,2,29,0.000117
G5,C(C)(C(C)(C(CO)(C(C)O)O)O)=O,8,2,0,2,29,0.000117
G5,C(C(C=C)(C(CO)(C(C)O)O)O)=O,8,3,0,3,7,0.000165
G5,C=CC(CO)(C(CO)(C(C)O)O)O,8,2,0,2,29,0.000117
G5,CC(C(C(CO)(C(C)O)O)O)O,16,2,0,2,29,0.000117
G5,C(C(C(O)=O)C(CO)O)(O)=O,2,3,0,3,29,0.000166
G5,C(C(C=O)(C(C(O)=O)(CO)O)O)=O,2,8,0,8,1,0.000408
G5,C1(C(C(O)=O)C(C(CCO)O1)O)=O,8,2,0,2,17,0.00010700000000000001
G5,C(C1(C(COC1CCO)=O)O)(O)=O,4,3,0,3,29,0.000155
G5,C(C1(C(C(CCO)OC1)=O)O)(O)=O,4,3,0,3,29,0.000155
G5,C(C1(CO)C(CC(C=O)O1)O)(O)=O,8,4,0,4,29,0.00021600000000000002
G5,C(C1(C=O)C(CC(CO)O1)O)(O)=O,8,3,0,3,29,0.000155
G5,C(C1(C(CC(C)(O1)O)=O)CO)(O)=O,4,7,0,7,26,0.00036
G5,C(C1(CO)C(C(C(C)O1)=O)O)(O)=O,8,4,0,4,29,0.00021600000000000002
G5,C(C1(C(C(C)OC1CO)=O)O)(O)=O,8,3,0,3,29,0.000155
G5,C(C1(C(CCC(O1)O)=O)CO)(O)=O,4,7,0,7,37,0.00036
G5,C(C(CO)(C(C(C=C)O)O)O)(O)=O,8,6,0,6,28,0.000312
G5,C(C(C1OCC(C=1)O)(CO)O)(O)=O,4,4,0,4,29,0.00021600000000000002
G5,C(C(CO)(C1(C=CCO1)O)O)(O)=O,4,4,0,4,2,0.00021600000000000002
G5,C(C1(CO)C(C=C(CO)O1)O)(O)=O,4,4,0,4,29,0.00021600000000000002
G5,C(C1(CO)C(C(C(O1)=C)O)O)(O)=O,8,4,0,4,29,0.00021600000000000002
G5,C(C(CO)(C1C=CC(O1)O)O)(O)=O,8,4,0,4,29,0.00021600000000000002
G5,C(C(CO)(C1C(C=CO1)O)O)(O)=O,8,4,0,4,29,0.00021600000000000002
G5,C(C1(CO)C(C=CC(O1)O)O)(O)=O,8,4,0,4,29,0.00021600000000000002
G5,C(C1(CO)C(C(C=CO1)O)O)(O)=O,8,4,0,4,29,0.00021600000000000002
G5,C(C(C(CO)O)C(C(C)O)O)(O)=O,16,3,0,3,29,0.000165
G5,C1(C(C(CO1)O)C(C)(CCO)O)=O,8,2,0,2,8,0.000106
G5,C(C(CO)(C(C)(CCO)O)O)(O)=O,4,3,0,3,33,0.000154
G5,C1(COCC1(C(C)(CCO)O)O)=O,4,3,0,3,10,0.000154
G5,C1(C(C(CO1)O)C(C=CCO)O)=O,16,2,0,2,8,0.000106
G5,C1(COCC1(C(C=CCO)O)O)=O,8,3,0,3,10,0.000154
G5,C(C(CO)(C(CO)O)C(CO)O)=O,3,3,0,3,6,0.000157
G5,CC(C(CO)(C(CO)(CO)O)O)O,4,4,0,4,29,0.00023500000000000002
G5,CC(CC(C(CO)(CO)O)O)O,4,2,0,2,29,0.000117
G5,CC(C(C(C(CO)(CO)O)O)O)O,8,4,0,4,29,0.000234
G5,C(C)(C(C)(C(CO)(CO)O)O)=O,2,3,0,3,29,0.000165
G5,C1C(CC(O)O1)(C(CO)(CO)O)O,4,3,0,3,29,0.000165
G5,C(C(C=C)(C(CO)(CO)O)O)=O,2,5,0,5,29,0.00026000000000000003
G5,C=CC(CO)(C(CO)(CO)O)O,2,3,0,3,29,0.000165
G5,CC(C(C(CO)(CO)O)O)O,4,2,0,2,29,0.000117
G5,C1C(C(CO1)O)(C(CO)(CO)O)O,4,2,0,2,29,0.000117
G5,C1CC(C(O)O1)(C(CO)(CO)O)O,4,3,0,3,29,0.000165
G5,C(C(C(C)=O)(C(C)(CCO)O)O)=O,4,3,0,3,1,0.000154
G5,C(C(C(C)=O)(C(C=CCO)O)O)=O,8,4,0,4,1,0.000213
G5,C(C)(C(CO)(C(C)(CCO)O)O)=O,4,3,0,3,28,0.000154
G5,C(C)(C(CO)(C(C=CCO)O)O)=O,8,3,0,3,28,0.000154
G5,C(C(CO)(CO)C(CO)O)=O,2,3,0,3,2,0.000157
G5,C(C(CO)(C(CO)O)C(C)O)=O,8,4,0,4,4,0.000205
G5,C(COC(C(CO)(CO)O)O)(C)=O,2,1,0,1,35,5.9e-05
G5,C(COC(CO)(CO)CO)(CO)=O,1,1,0,1,2,5.9e-05
G5,C(C(O)OC(CO)(CO)CO)(C)=O,2,1,0,1,2,5.9e-05
G5,C(COCC(CO)(CO)O)(CO)=O,1,1,0,1,36,5.9e-05
G5,C(C(O)OCC(CO)(CO)O)(C)=O,2,1,0,1,41,5.9e-05
G5,C(C(CO)(C(C)(O)OCCO)O)=O,4,3,0,3,29,0.00015800000000000002
G5,C(COC(C)(C(CO)(CO)O)O)=O,2,1,0,1,1,5.9e-05
G5,C1(C(CO)C(C(CCO)O1)O)=O,8,3,0,3,29,0.000156
G5,C1(COC(CCO)C1(CO)O)=O,4,3,0,3,29,0.00015800000000000002
G5,C(C1(CO)C(C(C(CO)O1)O)O)O,8,1,0,1,26,5.9e-05
G5,C1(C(CCO)OCC1(CO)O)=O,4,4,0,4,29,0.000205
G5,C(C1CC(C(CO)(CO)O1)O)=O,4,2,0,2,29,0.000106
G5,C(C1(CO)C(CC(CO)O1)O)=O,8,3,0,3,29,0.00015800000000000002
G5,C1(CC(C)(OC1(CO)CO)O)=O,2,5,0,5,26,0.00025299999999999997
G5,C1(C(C)OC(CO)(CO)C1O)=O,4,2,0,2,29,0.000106
G5,C1(C(C)OC(CO)C1(CO)O)=O,8,4,0,4,29,0.000205
G5,C1C(C(C(C(CO)(CO)O1)O)O)O,8,1,0,1,37,5.9e-05
G5,C1(CCC(OC1(CO)CO)O)=O,2,5,0,5,37,0.00025299999999999997
G5,C1(C(CO)(C(C(CCO)O1)O)O)=O,8,3,0,3,29,0.00015800000000000002
G5,C=CC(C(C(CO)(CO)O)O)O,4,2,0,2,29,0.000106
G5,C1(C(CO)(CO)O)OCC(C=1)O,2,2,0,2,29,0.000106
G5,C1C(C(CO)(CO)O)(OCC=1)O,2,2,0,2,29,0.000106
G5,C1C(C(CO)(CO)OC=1CO)O,2,2,0,2,29,0.000106
G5,C=C1C(C(C(CO)(CO)O1)O)O,4,2,0,2,29,0.000106
G5,C1C(C(CO)(CO)O)OC(C=1)O,4,2,0,2,29,0.000106
G5,C1OC(C(CO)(CO)O)C(C=1)O,4,2,0,2,29,0.000106
G5,C1C(C(CO)(CO)OC(C=1)O)O,4,2,0,2,29,0.000106
G5,C1OC(CO)(CO)C(C(C=1)O)O,4,2,0,2,29,0.000106
G5,C1CC(C(C(CO)(CO)O)(O)O1)O,4,2,0,2,2,0.000106
G5,C1(C(CC(C(CO)(CO)O)O1)O)O,8,2,0,2,29,0.000106
G5,C1(C(CC(C(CO)(CO)O1)O)O)O,8,2,0,2,29,0.000106
G5,C1(CC(C(C(CO)(CO)O)O1)O)=O,4,2,0,2,29,0.000117
G5,C1(CC(C(C(CO)(CO)O1)O)O)=O,4,2,0,2,2,0.000117
G5,C(C(C=O)(C(C)(CCO)O)O)=O,2,3,0,3,1,0.000154
G5,C(C(C=O)(C(C=CCO)O)O)=O,4,6,0,6,29,0.000308
G5,CC(CO)(C(CO)(C(C)O)O)O,8,3,0,3,29,0.000176
G5,C(C(C(CO)O)(C(C)O)C(C)O)=O,6,3,0,3,4,0.000156
G5,CC(C(CO)(C(C)O)O)O,3,2,0,2,29,0.000117
G5,C1(C(C(C(CCO)O1)O)C(C)O)=O,16,2,0,2,48,0.00010700000000000001
G5,C1(COC(CCO)C1(C(C)O)O)=O,8,3,0,3,29,0.000156
G5,C1(C(CCO)OCC1(C(C)O)O)=O,8,3,0,3,29,0.000156
G5,C(C1CC(C(CO)(C(C)O)O1)O)=O,16,1,0,1,40,5.9e-05
G5,C(C1(C(C)O)C(CC(CO)O1)O)=O,16,3,0,3,29,0.000156
G5,C1(CC(C)(OC1(CO)C(C)O)O)=O,8,4,0,4,26,0.000204
G5,C1(C(C)OC(CO)(C(C)O)C1O)=O,16,1,0,1,29,5.9e-05
G5,C1(C(C)OC(CO)C1(C(C)O)O)=O,16,3,0,3,29,0.000156
G5,C1(CCC(OC1(CO)C(C)O)O)=O,8,4,0,4,37,0.000204
G5,C=CC(C(C(CO)(C(C)O)O)O)O,16,1,0,1,28,5.9e-05
G5,C1(C(CO)(C(C)O)O)OCC(C=1)O,8,1,0,1,36,5.9e-05
G5,C1C(C(CO)(C(C)O)O)(OCC=1)O,8,1,0,1,39,5.9e-05
G5,C1C(C(CO)(C(C)O)OC=1CO)O,8,1,0,1,40,5.9e-05
G5,C=C1C(C(C(CO)(C(C)O)O1)O)O,16,1,0,1,26,5.9e-05
G5,C1C(C(CO)(C(C)O)O)OC(C=1)O,16,1,0,1,43,5.9e-05
G5,C1OC(C(CO)(C(C)O)O)C(C=1)O,16,1,0,1,36,5.9e-05
G5,C1C(C(CO)(C(C)O)OC(C=1)O)O,16,1,0,1,37,5.9e-05
G5,C1OC(CO)(C(C(C=1)O)O)C(C)O,16,1,0,1,37,5.9e-05
G5,C(C1(CC(C(CO)(C1)O)O)O)O,8,1,0,1,21,5.9e-05
G5,C(C1(CC(CC1(CO)O)O)O)O,3,1,0,1,21,5.9e-05
G5,CC1(C(C(CC1(CO)O)O)O)O,16,1,0,1,49,5.9e-05
G5,C(C1(CC(CC1O)O)O)O,8,1,0,1,43,5.9e-05
G5,C1(CCC(CO)(C1(CCO)O)O)=O,4,2,0,2,7,0.000106
G5,C1(CC(C(C)(C1(CCO)O)O)O)=O,8,2,0,2,45,0.000106
G5,C(C)(C1(CC(CO)(CC1O)O)O)=O,8,2,0,2,22,0.000106
G5,C1(CC(CC(C1(CCO)O)O)O)=O,8,2,0,2,4,0.000106
G5,C(CCO)(C1(C(CC(C1)O)O)O)=O,8,2,0,2,13,0.000106
G5,C(C)(C1(CC(CO)(C(C1)O)O)O)=O,8,1,0,1,21,5.9e-05
G5,C1(CC(CO)(C(CC1(C)O)O)O)=O,8,1,0,1,21,5.9e-05
G5,C1(CC(CO)(C(CC(C1)O)O)O)=O,8,1,0,1,26,5.9e-05
G5,C1C(CO)(C(CC(C=1)(CO)O)O)O,8,1,0,1,32,5.9e-05
G5,C(C1(CC(CO)(C(C1O)O)O)O)O,10,1,0,1,20,5.9e-05
G5,CC1(C(COC1(CO)O)O)O,8,2,0,2,2,0.000106
G5,C1CC(CO)(C(CO)(O)O1)O,4,2,0,2,30,0.000106
G5,C(C1(C(CC(C1CO)O)=O)O)(O)=O,8,2,0,2,17,0.00010700000000000001
G5,C(C(CC(C)O)(C(CO)(C)O)O)=O,8,2,0,2,11,0.00010700000000000001
G5,C(C)(C(CCO)(C(CCO)O)O)=O,4,2,0,2,45,0.00010700000000000001
G5,C(C)(C(CCO)(C(C(O)=O)O)O)=O,4,3,0,3,45,0.000154
G5,C(C(C)(C(C)(C(CCO)O)O)O)=O,8,2,0,2,11,0.00010700000000000001
G5,C(C)(C(CC(C(CO)(C)O)O)O)=O,8,1,0,1,11,5.9e-05
G5,C(C)(C(CCO)(C(C(C)O)O)O)=O,8,2,0,2,45,0.00010700000000000001
G5,C(C(C)(CC(C(CO)(C)O)O)O)=O,8,1,0,1,11,5.9e-05
G5,C(C(C=O)(C(CO)CO)O)(O)=O,2,2,0,2,17,0.00010700000000000001
G5,C(C(CCO)(C(CCO)O)O)O,4,1,0,1,29,5.9e-05
G5,C(CC(CO)(C(CCO)O)O)(O)=O,4,1,0,1,29,5.9e-05
G5,CC(CO)(C(CCO)O)O,4,1,0,1,11,5.9e-05
G5,C(C(C(CCO)=O)(CCO)O)(O)=O,2,3,0,3,29,0.000166
G5,CC(CC(CO)(C(C)(CO)O)O)O,8,1,0,1,11,5.9e-05
G5,CC(C(C(C)O)O)(C(C)(CO)O)O,16,1,0,1,11,5.9e-05
G5,CC(CO)(CC(C(C)(CO)O)O)O,8,1,0,1,11,5.9e-05
G5,C(C(C=O)(C(CO)C(C)O)O)(O)=O,8,2,0,2,17,0.00010700000000000001
G5,C(C(C=O)(CC(CCO)O)O)(O)=O,4,2,0,2,17,0.00010700000000000001
G5,CC(CC(C(CO)(CCO)O)O)O,8,1,0,1,29,5.9e-05
G5,CC(CC(C(C)(CO)O)O)O,8,1,0,1,11,5.9e-05
G5,CC(CO)(C(C(C(C)O)O)O)O,16,1,0,1,11,5.9e-05
G5,CC(CO)(C(CC(CO)O)O)O,8,1,0,1,11,5.9e-05
G5,C(C(C)(C(C)(CCO)O)O)(O)=O,4,2,0,2,25,0.000106
G5,C(C(C)(C(C=CCO)O)O)(O)=O,8,4,0,4,29,0.00020099999999999998
G5,C(C(C(C)(C(C)(CCO)O)O)=O)=O,4,2,0,2,25,0.00010700000000000001
G5,C(CO)=CC(C(C(C=O)=O)(C)O)O,8,2,0,2,25,0.00010700000000000001
G5,C(CO)(C(C)(C(C)(CCO)O)O)=O,4,2,0,2,25,0.00010700000000000001
G5,C(CO)(C(C)(C(C=CCO)O)O)=O,8,2,0,2,25,0.00010700000000000001
G5,C(C)(C(C)(C(CO)(CCO)O)O)=O,4,1,0,1,14,5.9e-05
G5,C(CC(C)(C(CO)(CCO)O)O)=O,4,1,0,1,29,5.9e-05
G5,C(C(CCO)(C(C)(CCO)O)O)=O,4,2,0,2,29,0.000106
G5,C(C(C=C)(C(CO)(CCO)O)O)=O,4,2,0,2,28,0.00010700000000000001
G5,C=CC(CO)(C(CO)(CCO)O)O,4,1,0,1,7,5.9e-05
G5,C(C(C(CC(CO)=O)=O)(C)O)(O)=O,2,2,0,2,17,0.00010700000000000001
G5,C(C(C(C(C)=O)=O)(CCO)O)(O)=O,2,2,0,2,17,0.00010700000000000001
G5,C(C(C(C(CCO)=O)=O)(C)O)(O)=O,2,3,0,3,17,0.000154
G5,C(C(C(CO)=O)(CC(C)=O)O)(O)=O,2,2,0,2,17,0.00010700000000000001
G5,C(CCC(C(O)=O)(C(CO)=O)O)=O,2,3,0,3,17,0.000155
G5,C(C(C(C=O)=O)(CCCO)O)(O)=O,2,2,0,2,17,0.00010700000000000001
G5,C(C(C(CO)=O)(C=CCO)O)(O)=O,4,3,0,3,29,0.000166
G5,C(C(C(C(CO)O)=O)(C=C)O)(O)=O,4,2,0,2,17,0.00010700000000000001
G5,C(C(C=O)(C=CC(CO)O)O)(O)=O,8,2,0,2,17,0.00010700000000000001
G5,C(C1(C(CC(CCO)O1)=O)O)(O)=O,4,2,0,2,17,0.00010700000000000001
G5,C(C1(C(CC(O1)O)=O)CCO)(O)=O,4,3,0,3,17,0.000154
G5,C(C1(C(C(CO1)O)=O)CCO)(O)=O,4,2,0,2,17,0.00010700000000000001
G5,C(C1(C(CO)=O)CC(CO1)O)(O)=O,4,2,0,2,17,0.00010700000000000001
G5,C(C1(C=O)CC(C(CO)O1)O)(O)=O,8,2,0,2,40,0.00010700000000000001
G5,C(C1(CO)CC(C(C=O)O1)O)(O)=O,8,3,0,3,29,0.000167
G5,C(C1(CO)CC(C(C)(O1)O)=O)(O)=O,4,4,0,4,14,0.00021400000000000002
G5,C(C1(C(C(C(CO)O1)O)=O)C)(O)=O,8,2,0,2,29,0.00010700000000000001
G5,C(C1(CO)CC(CC(O1)O)=O)(O)=O,4,4,0,4,37,0.00021400000000000002
G5,C(C1(C=CC(CO)(O1)O)CO)(O)=O,4,3,0,3,29,0.000167
G5,C(CC(C(C(C)(CO)O)O)O)(O)=O,8,2,0,2,29,0.000117
G5,C(CC(CO)(C(C(C)O)O)O)(O)=O,8,2,0,2,29,0.000117
G5,C(C(C)(C(C)(CC(CO)=O)O)O)=O,4,2,0,2,11,0.00010700000000000001
G5,C(C(CC(C)(C(C)(CO)O)O)=O)=O,4,1,0,1,11,5.9e-05
G5,C(C(C)(C(C(C)=O)(CCO)O)O)=O,4,3,0,3,45,0.000155
G5,C(CC(C(C)(C(CO)(C)O)O)=O)=O,4,2,0,2,45,0.00010700000000000001
G5,C(C)(C(C)(C(CO)(C)O)O)=O,4,1,0,1,11,5.9e-05
G5,C(C(C)(C(C)(CCO)O)O)=O,4,2,0,2,11,0.00010700000000000001
G5,C(CC(C)(C(C)(CO)O)O)=O,4,1,0,1,11,5.9e-05
G5,C1(C(C(C)(CCO)O)(O)OCC1)=O,4,2,0,2,34,0.00010700000000000001
G5,C1C(CC(O)O1)(C(C)(CO)O)O,8,2,0,2,11,0.000106
G5,C(C(C(CO)(C)O)O)=CC(CO)=O,8,1,0,1,11,5.9e-05
G5,C(C(C)(C(C=CCO)(CO)O)O)=O,8,2,0,2,11,0.00010700000000000001
G5,C(C(CO)(C(CO)(C)O)O)=CC=O,8,1,0,1,11,5.9e-05
G5,C(C(C=C)(C(CO)(C)O)O)=O,4,4,0,4,29,0.000202
G5,C=CC(CO)(C(CO)(C)O)O,4,1,0,1,7,5.9e-05
G5,C(C(C)(C(C=CCO)O)O)=O,8,4,0,4,29,0.000202
G5,C(C(C(CO)(C)O)O)=CC=O,8,2,0,2,29,0.000106
G5,C1(C(C(C=CCO)O)(O)OCC1)=O,8,2,0,2,34,0.00010700000000000001
G5,CC(CO)(C(C(C)O)O)O,8,1,0,1,11,5.9e-05
G5,C(C(CC(C(CO)(C)O)O)O)(O)=O,8,1,0,1,11,5.9e-05
G5,CC(CO)(C(C(CO)(CO)O)O)O,4,1,0,1,11,5.9e-05
G5,C(C(CO)(C(C(CO)(C)O)O)O)=O,8,5,0,5,11,0.00025299999999999997
G5,C1C(C(CO1)O)(C(C)(CO)O)O,8,1,0,1,10,5.9e-05
G5,CC(CO)(C1(C(O)OCC1)O)O,8,2,0,2,29,0.000106
G5,C(C)(C(C(CO)O)(CCO)O)=O,4,2,0,2,0,0.00010700000000000001
G5,CC(C(CO)O)(C(C)(CO)O)O,8,1,0,1,11,5.9e-05
G5,C(C)(C(CO)OC(CO)(CO)O)=O,2,1,0,1,2,5.9e-05
G5,C(C)(C(COC(CO)(CO)O)O)=O,2,1,0,1,2,5.9e-05
G5,C(CO)(CCOC(CO)(CO)O)=O,1,1,0,1,30,5.9e-05
G5,C(C(CO)(CC(O)OCCO)O)=O,4,2,0,2,29,0.00010800000000000001
G5,C(COC(CC(CO)(CO)O)O)=O,2,1,0,1,37,5.9e-05
G5,CC(CO)(CO)O,1,1,0,1,11,5.9e-05
G5,C(C(CO)(C)O)(CC(CO)=O)=O,2,4,0,4,29,0.00020299999999999997
G5,C(CCC(C(CO)=O)(CO)O)=O,2,4,0,4,29,0.00020299999999999997
G5,C(C(C(CO)(CCCO)O)=O)=O,2,2,0,2,29,0.00010800000000000001
G5,C(CO)(C(C=CCO)(CO)O)=O,4,5,0,5,29,0.000262
G5,C1(C(CO)(O)OC(CCO)C1)=O,4,3,0,3,2,0.000156
G5,C1(CC(OC1(CO)CCO)O)=O,4,3,0,3,2,0.000156
G5,C1(C(COC1(CO)CCO)O)=O,4,2,0,2,9,0.00010800000000000001
G5,C(CO)(C1(CO)CC(CO1)O)=O,4,2,0,2,39,0.00010800000000000001
G5,C(C1(CO)CC(C(CO)O1)O)=O,8,2,0,2,29,0.00010800000000000001
G5,C(C1C(CC(CO)(CO)O1)O)=O,4,1,0,1,40,5.9e-05
G5,C1(C(C)(O)OC(CO)(CO)C1)=O,2,3,0,3,29,0.000154
G5,C1(C(C(CO)OC1(CO)C)O)=O,8,2,0,2,29,0.00010800000000000001
G5,C1(CC(CO)(CO)OC(C1)O)=O,2,3,0,3,29,0.000154
G5,C1C(CO)(CO)OC(C=1)(CO)O,2,2,0,2,29,0.000106
G5,C(C1(C(CC(CO)(CO)O1)O)O)O,4,2,0,2,40,0.000106
G5,C1(C(C(CC(CO)(CO)O1)O)O)O,8,2,0,2,5,0.000106
G5,C(C)(C(CCO)(C(CO)(C)O)O)=O,4,2,0,2,45,0.00010700000000000001
G5,CC(CO)(C(C)(CO)O)O,3,1,0,1,11,5.9e-05
G5,C(CC(CO)(C(C(C)=O)(C)O)O)=O,4,1,0,1,14,5.9e-05
G5,C(C(C(C)(CCO)O)(CC=O)O)=O,4,2,0,2,6,0.00010700000000000001
G5,C(C(C=C)(C(CO)(CC=O)O)O)=O,4,2,0,2,28,0.00010700000000000001
G5,C(C(CC(C(CO)(C)O)O)O)=O,8,1,0,1,11,5.9e-05
G5,C(C)(C(C(C)O)(CCO)O)=O,4,2,0,2,4,0.00010700000000000001
G5,C(CO)(C(C(C)O)(CCO)O)=O,4,2,0,2,4,0.00010800000000000001
G5,CC(CO)(C(C)O)O,4,1,0,1,18,5.9e-05
G5,C(C(CCC(CO)(C(C)O)O)=O)=O,4,3,0,3,29,0.000165
G5,C(C(C)(C(C)O)O)(CC(CO)=O)=O,4,2,0,2,4,0.00010700000000000001
G5,C(C(C)=O)(C(C(C)O)(CCO)O)=O,4,2,0,2,25,0.00010700000000000001
G5,C(C(CCO)=O)(C(C)(C(C)O)O)=O,4,2,0,2,4,0.00010700000000000001
G5,C(CCC(C(CO)=O)(C(C)O)O)=O,4,3,0,3,27,0.000155
G5,C(C(C(C(C)O)(CCCO)O)=O)=O,4,2,0,2,27,0.00010700000000000001
G5,C(CO)(C(C=CCO)(C(C)O)O)=O,8,3,0,3,29,0.000166
G5,C(C(CO)O)(C(C=C)(C(C)O)O)=O,8,2,0,2,4,0.00010700000000000001
G5,C1(C(C(C)O)(O)OC(CCO)C1)=O,8,2,0,2,4,0.00010700000000000001
G5,C1(CC(OC1(C(C)O)CCO)O)=O,8,3,0,3,4,0.000155
G5,C1(C(COC1(C(C)O)CCO)O)=O,8,2,0,2,9,0.00010700000000000001
G5,C(CO)(C1(C(C)O)CC(CO1)O)=O,8,2,0,2,4,0.00010700000000000001
G5,C(C1(C(C)O)CC(C(CO)O1)O)=O,16,2,0,2,40,0.00010700000000000001
G5,C(C1C(CC(CO)(C(C)O)O1)O)=O,16,1,0,1,40,5.9e-05
G5,C1(C(C)(O)OC(CO)(C(C)O)C1)=O,8,2,0,2,14,0.000106
G5,C1(C(C(CO)OC1(C)C(C)O)O)=O,16,2,0,2,29,0.00010700000000000001
G5,C1(CC(CO)(C(C)O)OC(C1)O)=O,8,2,0,2,29,0.000106
G5,C1C(CO)(C(C)O)OC(C=1)(CO)O,8,1,0,1,40,5.9e-05
G5,C(CCO)(OC(CO)C(CO)O)=O,4,2,0,2,29,0.000117
G5,C(CCO)(OCC(C(CO)O)O)=O,4,1,0,1,48,5.9e-05
G5,C(C(CCO)OC(CO)=O)=O,2,2,0,2,29,0.000106
G5,C(CO)(OCC(CCO)=O)=O,1,3,0,3,29,0.000154
G5,C(CO)(OC(CO)(CCO)O)=O,2,2,0,2,29,0.000117
G5,C(CO)(OC(C)(C(CO)O)O)=O,4,1,0,1,14,5.9e-05
G5,C(CO)(OC(CC(CO)O)O)=O,4,1,0,1,43,5.9e-05
G5,C1(C(CCC1CO)=O)=O,2,3,0,3,29,0.000154
G5,C1(C(CO)CC(C1)=O)=O,2,4,0,4,29,0.00020099999999999998
G5,C1(C(CC(CO)C1)=O)=O,1,3,0,3,55,0.000154
G5,C1(CCC(C1CO)=O)=O,1,3,0,3,29,0.000154
G5,C(C(C(CO)=O)C(CO)CO)=O,2,3,0,3,55,0.000165
G5,C(C(C(CO)C(CO)CO)=O)=O,2,4,0,4,29,0.000212
G5,C(CO)(C(C(CO)CCO)O)=O,4,3,0,3,29,0.000176
G5,C(CO)(C(CO)C(CO)CO)=O,2,3,0,3,29,0.000165
G5,C(CO)(C(C(CO)C)O)=O,4,2,0,2,49,0.000117
G5,C(C(CO)=O)(CCC(CO)O)=O,2,3,0,3,6,0.000154
G5,C(C(C(CO)CO)C(C=O)O)=O,4,4,0,4,29,0.000212
G5,C(CC(CO)CO)=O,1,3,0,3,55,0.000165
G5,C(C(CO)CCO)=O,2,3,0,3,29,0.000154
G5,C(C(CC(C)CO)=O)=O,2,2,0,2,28,0.00010700000000000001
G5,C(CCC(C=O)=O)(CCO)=O,1,3,0,3,29,0.000154
G5,C(C(C(CO)=O)C(CO)C)=O,4,2,0,2,49,0.00010700000000000001
G5,C(CC(C(C(CO)C)O)=O)=O,4,1,0,1,49,5.9e-05
G5,C(CC(CO)C(C(C)=O)O)=O,4,4,0,4,43,0.000202
G5,C(C(C(CC(CO)C)=O)O)=O,4,2,0,2,49,0.00010700000000000001
G5,C(C(C(C)CCO)=O)=O,2,2,0,2,29,0.000106
G5,C(C(CO)O)(CC(CO)C)=O,4,2,0,2,28,0.00010700000000000001
G5,C(CO)(C(C)CCO)=O,2,2,0,2,29,0.000106
G5,C(CCC(CCO)=O)(CO)=O,1,3,0,3,29,0.000154
G5,C(CCCO)(CC(CO)=O)=O,1,5,0,5,29,0.00026000000000000003
G5,C(C(CC(CO)O)CC=O)=O,4,4,0,4,21,0.000202
G5,C(CC(CO)CC(C=O)O)=O,4,3,0,3,21,0.000154
G5,C(CC(C=CC(CO)O)=O)=O,4,3,0,3,29,0.000154
G5,C(C(CO)O)=CC(C(C)=O)=O,4,3,0,3,29,0.000154
G5,C(C(C(CO)C(C)CO)=O)=O,4,2,0,2,29,0.00010700000000000001
G5,C(C(C(CO)C)O)(CCO)=O,4,1,0,1,3,5.9e-05
G5,C(CO)(C(CO)C(CO)C)=O,4,2,0,2,55,0.00010700000000000001
G5,C(C)(C(C(CO)CCO)O)=O,4,1,0,1,3,5.9e-05
G5,C(CC(CO)CCO)=O,2,2,0,2,46,0.000106
G5,C(C(CCO)CCO)=O,1,2,0,2,29,0.000106
G5,C(CCCO)(C(C(C)=O)O)=O,2,4,0,4,29,0.00020099999999999998
G5,C(C(C(C(C)CCO)=O)O)=O,4,2,0,2,29,0.000106
G5,C(CO)(CC(CO)C)=O,2,2,0,2,28,0.00010700000000000001
G5,C(C)(C(C(CO)C)O)=O,4,1,0,1,27,5.9e-05
G5,C(C(C)=O)(CCC(CO)O)=O,2,2,0,2,29,0.000106
G5,C(C(C(CO)C)C(C=O)O)=O,8,2,0,2,28,0.00010700000000000001
G5,C(CC(C)CO)=O,2,2,0,2,28,0.00010700000000000001
G5,C(C(C)CCO)=O,2,2,0,2,29,0.000106
G5,C(C(C(CO)C)O)(C(CO)O)=O,8,2,0,2,49,0.000117
G5,C(C(CCO)C(CO)O)=O,4,4,0,4,29,0.000223
G5,C(CC(CO)C(CO)O)=O,4,6,0,6,29,0.000319
G5,C(C(CCC(C=O)=O)CCO)=O,2,2,0,2,29,0.000106
G5,C(CO)(CCC(C=O)CC=O)=O,2,5,0,5,29,0.00025
G5,C(CC(CCC(C=O)=O)CO)=O,2,2,0,2,28,0.000106
G5,C(C)(CC(CCC(CO)=O)=O)=O,1,3,0,3,29,0.000154
G5,C(CCC(C(CC)=O)=O)(CO)=O,1,2,0,2,29,0.000106
G5,C(C(C)CCO)(CC(C=O)=O)=O,2,2,0,2,29,0.000106
G5,C(CO)(CC(C(C)CC=O)=O)=O,2,2,0,2,29,0.000106
G5,C(CC(C=O)CC=O)(CCO)=O,2,4,0,4,29,0.00020299999999999997
G5,C(CC(CC(CO)CC=O)=O)=O,2,4,0,4,43,0.00020299999999999997
G5,C(CCO)(CC(CC(C)=O)=O)=O,1,4,0,4,29,0.00020099999999999998
G5,C(CCO)(CC(C(CC)=O)=O)=O,1,2,0,2,29,0.000106
G5,C(CC(C(C(C)CCO)=O)=O)=O,2,2,0,2,29,0.000106
G5,C(CC(C(C(CCO)=O)=O)C)=O,2,2,0,2,29,0.000106
G5,C(CC(C(CCO)=O)CC=O)=O,1,4,0,4,4,0.000202
G5,C(C)(CC(C(CCCO)=O)=O)=O,1,2,0,2,29,0.000106
G5,C(CC(C(CO)=O)CC(C)=O)=O,2,4,0,4,27,0.00020299999999999997
G5,C(CCO)(CC(CCC=O)=O)=O,1,3,0,3,29,0.000154
G5,C(CC(CC(CCCO)=O)=O)=O,1,3,0,3,29,0.000154
G5,C(CCC(C(CCCO)=O)=O)=O,1,3,0,3,29,0.000154
G5,C(CCC(C(C=O)=O)CCO)=O,2,3,0,3,29,0.000154
G5,C(CO)(C(CCC=O)CC=O)=O,2,3,0,3,29,0.000154
G5,C(CC(C(C=O)=O)CCCO)=O,2,2,0,2,29,0.000106
G5,C(CCC(C(C)=O)=O)(CCO)=O,1,2,0,2,29,0.000106
G5,C(CCCO)(CC(C(C)=O)=O)=O,1,2,0,2,29,0.000106
G5,C(CC(CCC(CCO)=O)=O)=O,1,3,0,3,29,0.000154
G5,C(CCO)(CC(C=CCO)=O)=O,2,4,0,4,29,0.000212
G5,C(CO)=CC(C(CCCO)=O)=O,2,2,0,2,29,0.000106
G5,C(C(C(C=O)=O)CCO)=CCO,4,2,0,2,29,0.000106
G5,C(CC(C(CO)=O)C=CCO)=O,4,3,0,3,29,0.000165
G5,C(CO)(C(C=CC=O)CCO)=O,4,2,0,2,29,0.000106
G5,C(CCCO)(C(C(C=C)=O)O)=O,2,2,0,2,29,0.000106
G5,C(C(C=O)O)(C(C=C)CCO)=O,4,3,0,3,29,0.000154
G5,C(C(CO)O)(C(C=C)CC=O)=O,4,4,0,4,29,0.00020099999999999998
G5,C(CCO)(CC=CC(CO)=O)=O,2,2,0,2,29,0.000106
G5,C(C=CC(CO)=O)(CCCO)=O,2,2,0,2,29,0.000106
G5,C(C(C=CC(C=O)O)CCO)=O,8,2,0,2,29,0.000106
G5,C(C(C=CC(CO)O)CC=O)=O,8,2,0,2,29,0.000106
G5,C(C(C=CC(CO)CC=O)O)=O,8,1,0,1,29,5.9e-05
G5,C(C)(CC(C=CC(CO)O)=O)=O,4,2,0,2,29,0.000106
G5,C(C(CO)O)=CC(C(CC)=O)=O,4,2,0,2,29,0.000106
G5,C(CCCO)(C(C=CC=O)O)=O,4,3,0,3,29,0.000154
G5,C(CCC(C(C=CCO)O)=O)=O,4,3,0,3,29,0.000154
G5,C(CO)(C(C)C(CO)O)=O,4,4,0,4,29,0.000223
G5,C(C(CC(CO)O)C(C=O)O)=O,8,3,0,3,29,0.000154
G5,C(C(C(CO)CCO)O)=O,4,2,0,2,46,0.000117
G5,C(CO)(C(CO)C)=O,2,2,0,2,29,0.000106
G5,C(C(C)C(CO)O)=O,4,4,0,4,29,0.000212
G5,C(C(C(CO)C)O)=O,4,2,0,2,49,0.000117
G5,C(C(CO)CC(CO)O)(O)=O,4,1,0,1,29,5.9e-05
G5,C(CCC(C(CO)O)O)=O,4,4,0,4,29,0.000212
G5,C(C(C(CCCO)O)O)=O,4,2,0,2,46,0.000117
G5,C(C)(C(C=CCO)O)=O,4,3,0,3,29,0.000154
G5,C1C(CC(CCO)(O)O1)O,4,2,0,2,44,0.000106
G5,C(CC1C(CC(O)O1)O)O,8,2,0,2,43,0.000106
G5,C1C(C(CC(CO)O1)O)O,8,1,0,1,29,5.9e-05
G5,C1(CC(C(C(C1CO)O)O)O)=O,16,1,0,1,0,5.9e-05
G5,C(C(C(C)=O)(C(CO)CO)O)=O,2,2,0,2,29,0.000117
G5,C(C(C=O)(C(CO)CO)O)=O,1,2,0,2,29,0.000117
G5,C(C(CO)(C(CO)CC=O)O)=O,4,2,0,2,28,0.00010700000000000001
G5,C(CO)(C(C)C(CO)(CO)O)=O,2,2,0,2,29,0.000106
G5,C(C(CCO)C(CO)(CO)O)=O,2,3,0,3,29,0.000165
G5,C(C(CO)(C(CO)CCO)O)=O,4,1,0,1,3,5.9e-05
G5,C(C(C)C(CO)(CO)O)=O,2,2,0,2,29,0.000106
G5,C(C(CO)(C(CO)C)O)=O,4,1,0,1,49,5.9e-05
G5,C(C(C=O)(C(CO)CC=O)O)=O,2,2,0,2,1,0.00010700000000000001
G5,C(C(C(C)=O)(C(CO)C)O)=O,4,1,0,1,29,5.9e-05
G5,C(C)(C(CO)(C(CO)C)O)=O,4,1,0,1,29,5.9e-05
G5,C(C(C=O)C(CCCO)=O)=O,1,3,0,3,29,0.000154
G5,C1(COC(C(CO)O)C1CO)=O,8,1,0,1,29,5.9e-05
G5,C1(COC(CO)C(C1CO)O)=O,8,1,0,1,29,5.9e-05
G5,C1(COCC(C(C1CO)O)O)=O,8,1,0,1,29,5.9e-05
G5,C(C(C(C=C)=O)C(CO)O)=O,4,3,0,3,29,0.000154
G5,C(C(C=O)(C(CO)CCO)O)=O,2,1,0,1,29,5.9e-05
G5,C(C(C=O)(C(CO)C)O)=O,2,1,0,1,49,5.9e-05
G5,C(C(C=O)(C(CCCO)=O)O)=O,1,2,0,2,29,0.000106
G5,C(CO)(C(CO)(C(CO)C)O)=O,4,2,0,2,49,0.000117
G5,C(CCO)(C(C(C)=O)C(C)=O)=O,1,2,0,2,29,0.000106
G5,C(CC(C)=O)(C(C(C)=O)CO)=O,2,3,0,3,29,0.000154
G5,C(C)(C(C(CCC=O)=O)CO)=O,2,2,0,2,29,0.000106
G5,C(CCCO)(C(C=O)C(C)=O)=O,2,3,0,3,29,0.000154
G5,C(C)(C(C(C=CCO)=O)CO)=O,4,3,0,3,29,0.000165
G5,C(C)(C(C(C=C)=O)C(CO)O)=O,4,2,0,2,29,0.000106
G5,C(C)(C(C(C)=O)(C(CO)O)O)=O,2,4,0,4,49,0.00020299999999999997
G5,C(C(C)C(CO)(C(CO)O)O)=O,8,4,0,4,29,0.000223
G5,C(C(C(CO)O)(C(CO)C)O)=O,8,1,0,1,49,5.9e-05
G5,C(C(C(CCO)=O)(CCO)O)=O,2,2,0,2,29,0.000106
G5,C(C)(C(CO)CC(CO)=O)=O,2,5,0,5,29,0.00026000000000000003
G5,C(C(C=O)CCO)=O,1,3,0,3,29,0.000154
G5,C(C(C(CO)=O)CC(CO)O)=O,4,4,0,4,29,0.000213
G5,C(C(C=O)CC(C(CO)O)O)=O,4,3,0,3,29,0.000165
G5,C(C(C(CC=O)=O)CCO)=O,2,3,0,3,29,0.000154
G5,C(C(C=O)CC(CCO)=O)=O,1,3,0,3,29,0.000154
G5,C1(C(CO)OC(C(CO)O)C1)=O,8,1,0,1,29,5.9e-05
G5,C1(C(CO)OC(C(C1)O)CO)=O,8,1,0,1,29,5.9e-05
G5,C1(C(CO)OCC(C(C1)O)O)=O,8,1,0,1,29,5.9e-05
G5,C(C(C(CC=O)=O)(CCO)O)=O,2,3,0,3,29,0.000154
G5,C(C(C)C(CO)(CC=O)O)=O,4,2,0,2,29,0.000106
G5,C(C(C)C(C=O)(CCO)O)=O,4,2,0,2,29,0.000106
G5,C(C)(C(CO)CC=O)=O,2,3,0,3,29,0.000154
G5,C(C(C(C)=O)CCO)=O,2,2,0,2,29,0.000106
G5,C(C)(C(C(C)=O)CC(CO)=O)=O,1,2,0,2,29,0.000106
G5,C(C)(C(C(CCO)=O)CC=O)=O,2,3,0,3,29,0.000154
G5,C(CC=O)(C(C(C)=O)CCO)=O,2,2,0,2,29,0.000106
G5,C(C)(C(CO)CC(C(C)=O)=O)=O,2,2,0,2,29,0.000106
G5,C(C)(C(CO)CC(CC=O)=O)=O,2,2,0,2,29,0.000106
G5,C(C)(C(C=O)CC(CCO)=O)=O,2,3,0,3,29,0.000154
G5,C(C)(C(C=CC(CO)=O)CO)=O,4,2,0,2,29,0.000106
G5,C1(C(CO)OC(CO)C1)=O,4,4,0,4,29,0.000212
G5,C1(C(CO)OCC(C1)O)=O,4,3,0,3,29,0.000154
G5,C1(C(COC(CO)C1)O)=O,4,2,0,2,29,0.000106
G5,C1(C(C(CO)OCC1)O)=O,4,2,0,2,29,0.000106
G5,C1(COC(CO)C(C1)O)=O,4,3,0,3,29,0.000154
G5,C1(C(CC(CCO)O1)=O)=O,2,3,0,3,29,0.000154
G5,C1(CO)C(CC(C=1)=O)O,2,4,0,4,29,0.00020099999999999998
G5,C1(C(C(CO)=CC1)O)=O,2,4,0,4,29,0.00020099999999999998
G5,C1(C(C=C(CO)C1)O)=O,2,4,0,4,29,0.00020099999999999998
G5,C1C(CC(C=1CO)=O)O,2,3,0,3,29,0.000154
G5,C(C(CCO)O)=CC(O)=O,4,2,0,2,29,0.000106
G5,C=CC(CC(CO)O)=O,2,3,0,3,29,0.000154
G5,C1(C(C=CC1CO)O)=O,4,3,0,3,29,0.000154
G5,C1(CC=CC1(CO)O)=O,2,3,0,3,29,0.000154
G5,C1C(CCO)OC(C=1)=O,2,2,0,2,29,0.000106
G5,C1OC(C(C=1)=O)CCO,2,2,0,2,29,0.000106
G5,C(CO)=C1C(CCO1)=O,2,3,0,3,29,0.000154
G5,C1(COC(C1)=CCO)=O,2,3,0,3,29,0.000154
G5,C(CO)(C1C=CCO1)=O,2,3,0,3,29,0.000154
G5,C(C1C=CC(CO)O1)=O,4,4,0,4,29,0.00020099999999999998
G5,C1(C(CO)OC(C1)=C)=O,2,3,0,3,29,0.000154
G5,C=C1C(CC(CO)O1)=O,2,3,0,3,29,0.000154
G5,C1(CO)OCCC(C=1)=O,1,3,0,3,29,0.000154
G5,C1(COC(CO)=CC1)=O,1,3,0,3,29,0.000154
G5,C1(C(CO)OC=CC1)=O,2,3,0,3,29,0.000154
G5,C1OC(CO)CC(C=1)=O,2,3,0,3,29,0.000154
G5,C(CO)(C1C(CCO1)O)=O,4,2,0,2,29,0.000106
G5,C1(C(C(CO)O)OCC1)=O,4,2,0,2,29,0.000106
G5,C1(COC(C(CO)O)C1)=O,4,2,0,2,29,0.000106
G5,C1(CCC(C(CO)O)O1)=O,4,2,0,2,29,0.000106
G5,C1C(C(C(O)O1)(CCO)O)O,8,2,0,2,29,0.000106
G5,C1(COC(CO)CC1O)=O,4,2,0,2,29,0.000106
G5,C1(CCC(C(CO)O1)O)=O,4,2,0,2,29,0.000106
G5,C1(CC(CC(CO)O1)O)=O,4,2,0,2,29,0.000106
G5,C1(C(O)OC(CO)CC1)=O,4,3,0,3,29,0.000154
G5,C(CC(C(C)=O)CC(CO)=O)=O,2,4,0,4,46,0.00020299999999999997
G5,C(CC(CC=O)CC(CO)=O)=O,1,6,0,6,4,0.000299
G5,C(CC(CO)CC(C(C)=O)=O)=O,2,4,0,4,14,0.00020299999999999997
G5,C(CCCC(CC(CO)=O)=O)=O,1,4,0,4,27,0.00020299999999999997
G5,C(CCCC(C(CCO)=O)=O)=O,1,4,0,4,27,0.00020299999999999997
G5,C1(CO)CC(C(C=1)=O)O,2,2,0,2,29,0.000106
G5,C1CC(C(C=1CO)=O)O,2,2,0,2,29,0.000106
G5,C(CO)(CO)=C(C=O)C(CO)O,2,2,0,2,29,0.000106
G5,C(CO)=C(C=O)C(CO)(CO)O,2,4,0,4,29,0.000212
G5,C(CO)(C(CO)(CO)O)=CC=O,2,4,0,4,29,0.000212
G5,C(CO)=C(CO)CO,1,3,0,3,29,0.000154
G5,C(C(CO)O)=C(C=O)C(CO)O,8,2,0,2,29,0.000106
G5,C(CO)=C(C=O)C(C(CO)O)O,8,6,0,6,29,0.00031800000000000003
G5,C(CO)(C(C(CO)O)O)=CC=O,8,5,0,5,29,0.000271
G5,C(C(CCO)O)=CC(C=O)=O,4,2,0,2,29,0.000106
G5,C(CC(CO)O)=CC(C=O)=O,4,2,0,2,29,0.000106
G5,C(CC(C=O)=O)=CC(CO)O,4,3,0,3,29,0.000154
G5,C(C(C(CO)O)=CC(C)=O)=O,4,2,0,2,29,0.000106
G5,C(C(C(CO)O)=C(C=O)C)=O,4,3,0,3,29,0.000154
G5,C(C(C(C=O)=CCO)(C)O)=O,4,3,0,3,29,0.000154
G5,C(C(C(CO)=CC=O)(C)O)=O,4,3,0,3,29,0.000154
G5,C(CO)=CC(C)=O,2,4,0,4,29,0.00020099999999999998
G5,C=C(C=O)CCO,1,2,0,2,29,0.000106
G5,C(CO)=C(C=O)C,2,2,0,2,29,0.000106
G5,C(C(C(CCO)=C)O)=O,2,2,0,2,29,0.000106
G5,C(C(C(C)=CCO)O)=O,4,2,0,2,29,0.000106
G5,C=C(C(CO)O)CCO,2,2,0,2,29,0.000106
G5,C(C)(C(CO)O)=CCO,4,2,0,2,29,0.000106
G5,C(CO)=C(C(CO)=O)C(C)O,4,2,0,2,29,0.000106
G5,C(C)=C(C(CO)=O)C(CO)O,4,2,0,2,29,0.000106
G5,C(CC(CO)=CC(CO)O)=O,4,3,0,3,29,0.000154
G5,C(CO)(CC(CO)O)=CC=O,4,2,0,2,29,0.000106
G5,C=C(C=O)C(CO)O,2,6,0,6,29,0.000307
G5,C(CO)=C(C=O)CO,2,4,0,4,29,0.00020099999999999998
G5,C=CCO,1,5,0,5,17,0.00024900000000000004
G5,C=C(CO)C(C(C(CO)O)O)O,8,5,0,5,29,0.000271
G5,C(C(C(CO)O)O)=C(CO)CO,4,2,0,2,29,0.000106
G5,C=C(C(CCO)=O)C(CO)=O,1,4,0,4,29,0.000212
G5,C(CO)(CC(C(CO)=C)=O)=O,1,4,0,4,29,0.000212
G5,C=C(C(C=O)=O)C(CCO)O,2,3,0,3,29,0.000154
G5,C(CC=C(C(CO)=O)CO)=O,2,3,0,3,29,0.000154
G5,C(CCO)=C(C(C=O)=O)CO,2,2,0,2,29,0.000106
G5,C(CO)(CC(C(C=O)=C)O)=O,2,4,0,4,29,0.00020099999999999998
G5,C=C(CO)C(CC(C=O)=O)O,2,2,0,2,29,0.000106
G5,C(CO)(CC=C(C=O)CO)=O,2,4,0,4,29,0.00020099999999999998
G5,C(CC(C=O)=O)=C(CO)CO,1,3,0,3,29,0.000154
G5,C=C(C(C(CCO)=O)=O)CO,1,4,0,4,29,0.000212
G5,C(C)(C(C(C(CO)=C)=O)O)=O,2,3,0,3,29,0.000154
G5,C(C=C(C=O)CO)(CCO)=O,2,4,0,4,29,0.00020099999999999998
G5,C(CC(C=C(CO)CO)=O)=O,1,4,0,4,29,0.00020099999999999998
G5,C=C(C(C(CO)O)=O)C(C)=O,2,3,0,3,29,0.000154
G5,C(CC(C(C(CO)O)=O)=C)=O,2,4,0,4,29,0.00020099999999999998
G5,C(C(C(C(CCO)=C)=O)O)=O,2,2,0,2,29,0.000106
G5,C=C(C(C(C)=O)=O)C(CO)O,2,3,0,3,29,0.000154
G5,C(CO)=C(C(C(C)=O)=O)CO,2,3,0,3,29,0.000154
G5,C=CC(C(CC(CO)O)=O)=O,2,3,0,3,29,0.000154
G5,C(CC(C(C(CO)O)=C)=O)=O,2,3,0,3,29,0.000154
G5,C(C(C(C(CCO)=O)=C)O)=O,2,2,0,2,29,0.000106
G5,C(CC(C(CO)=CCO)=O)=O,2,4,0,4,29,0.00020099999999999998
G5,C(C(CO)=CC=O)(CCO)=O,2,3,0,3,29,0.000154
G5,C=C(C=O)C(CC(CO)O)=O,2,3,0,3,29,0.000154
G5,C(C(CC(C(CO)=C)=O)O)=O,2,2,0,2,29,0.000106
G5,C=C(CO)C1C(C(C(O1)O)O)O,16,2,0,2,29,0.000106
G5,C=C(CO)C1(C(C(CO1)O)O)O,8,3,0,3,29,0.000154
G5,C1(C(C(CO1)O)O)=C(CO)CO,4,2,0,2,29,0.000106
G5,C(CO)=C(C=O)CCO,2,3,0,3,29,0.000165
G5,C(CO)(CCO)=CCO,2,3,0,3,29,0.000165
G5,C(CC(C(C(CO)O)O)=C)=O,4,3,0,3,29,0.000154
G5,C(C(C(C(CCO)=C)O)O)=O,4,2,0,2,29,0.000106
G5,C(C)(C(C(CO)O)O)=CC=O,8,2,0,2,29,0.000106
G5,C(C(C(C(C)=CCO)O)O)=O,8,2,0,2,29,0.000106
G5,C(CC(CO)O)=CC(CO)=O,4,2,0,2,29,0.000106
G5,C(CO)(CC=CC(CO)O)=O,4,3,0,3,29,0.000154
G5,C(C)(C(C=CC(CO)O)O)=O,8,2,0,2,29,0.000106
G5,C(CO)(C)=C(C=O)C(CO)O,4,2,0,2,29,0.000106
G5,C(CO)=C(C=O)C(CO)(C)O,4,3,0,3,29,0.000154
G5,C(CO)(C(CO)(C)O)=CC=O,4,3,0,3,29,0.000154
G5,C=C(CO)CCO,1,2,0,2,29,0.000106
G5,C(CO)=C(C)CO,2,2,0,2,29,0.000106
G5,C(CO)=C(C=O)C(C)O,4,3,0,3,29,0.000154
G5,C(CO)(C(C)O)=CC=O,4,3,0,3,29,0.000154
G5,C(C)=C(C=O)C(CO)O,4,2,0,2,29,0.000106
G5,C(CC=CC(CO)O)=O,4,2,0,2,29,0.000106
G5,C(C(C=CCCO)O)=O,4,2,0,2,29,0.000106
G5,C(CC(CO)O)=CC=O,4,2,0,2,29,0.000106
G5,C(C(CC=CCO)O)=O,4,2,0,2,29,0.000106
G5,C(C)=CCO,2,2,0,2,29,0.000106
G5,C=CCCO,1,2,0,2,29,0.000106
G5,C(CO)(C(CO)O)=CCO,4,4,0,4,29,0.000223
G5,C(CCO)(CC(C=O)=CCO)=O,2,2,0,2,29,0.000106
G5,C(CCO)(CC(CO)=CC=O)=O,2,3,0,3,29,0.000165
G5,C(C(CCO)=CC(CCO)=O)=O,2,2,0,2,29,0.000106
G5,C(CC(CO)=CC(CCO)=O)=O,2,3,0,3,29,0.000165
G5,C(CCO)(CC(C=O)=O)=CCO,2,4,0,4,29,0.000212
G5,C(CO)(CC(CCO)=CC=O)=O,2,4,0,4,29,0.000212
G5,C(CCO)(CCO)=CC(C=O)=O,1,2,0,2,29,0.000106
G5,C(CC(CCO)=CC(CO)=O)=O,2,4,0,4,29,0.000212
G5,C(CC(CC(CO)=O)=CCO)=O,2,4,0,4,29,0.000212
G5,C(CCO)(C(C(CO)=O)C=C)=O,2,3,0,3,29,0.000165
G5,C(C)=C(C(CCO)=O)C(CO)=O,2,3,0,3,29,0.000165
G5,C(CC(CO)=O)(C(C=C)CO)=O,2,3,0,3,29,0.000165
G5,C(CO)(CC(C(CO)=CC)=O)=O,2,3,0,3,29,0.000165
G5,C(CO)(CC(C(C(C)O)=C)=O)=O,2,2,0,2,29,0.000106
G5,C(CO)(CCC(C=CCO)=O)=O,2,2,0,2,29,0.000106
G5,C(CO)(CCC(C=O)=CCO)=O,2,3,0,3,29,0.000154
G5,C(CO)(CCC(CO)=CC=O)=O,2,4,0,4,29,0.000212
G5,C(CO)(CC=C(C=O)CCO)=O,2,2,0,2,29,0.000106
G5,C(CC(CO)=CCC(CO)=O)=O,2,3,0,3,29,0.000165
G5,C(CO)=C(CO)CCC(C=O)=O,2,2,0,2,29,0.000106
G5,C(CC(C=O)=O)=C(CO)CCO,2,2,0,2,29,0.000106
G5,C(CO)(C(C=C)CC(CO)=O)=O,2,4,0,4,29,0.000212
G5,C(CO)(CC(C(CO)=O)=CC)=O,2,3,0,3,29,0.000165
G5,C(C)(C(CC(C=CCO)=O)O)=O,4,2,0,2,29,0.000106
G5,C(C)(C(CC(C=O)=CCO)O)=O,4,2,0,2,29,0.000106
G5,C(C)(C(CC(CO)=CC=O)O)=O,4,2,0,2,29,0.000106
G5,C(C)(C(C=C(C=O)CCO)O)=O,4,2,0,2,29,0.000106
G5,C(CC(CO)=CC(C(C)=O)O)=O,4,2,0,2,29,0.000106
G5,C(CO)=C(C)C(CC(C=O)=O)O,4,2,0,2,29,0.000106
G5,C=C(C(CC(C=O)=O)O)CCO,2,2,0,2,29,0.000106
G5,C(C)(C(C(C(CO)=O)=CC)O)=O,4,2,0,2,29,0.000106
G5,C(C=C(C(CO)=O)C(C)O)(C)=O,4,2,0,2,29,0.000106
G5,C(C=C(C=O)CC(CCO)O)=O,4,2,0,2,29,0.000106
G5,C(CC(C=O)=CC(CCO)O)=O,4,2,0,2,29,0.000106
G5,C(CC(CC(C=O)=O)O)=CCO,4,2,0,2,29,0.000106
G5,C(CCO)=CC(CC(C=O)=O)O,4,2,0,2,29,0.000106
G5,C(C)=C(C(C=O)=O)C(CCO)O,4,2,0,2,29,0.000106
G5,C(CC=C(C(CO)=O)C(C)O)=O,4,2,0,2,29,0.000106
G5,C(CCO)=C(C(C=O)=O)C(C)O,4,2,0,2,29,0.000106
G5,C(C(CO)C(CC(C=O)=O)O)=C,4,2,0,2,29,0.000106
G5,C(CO)(CC(C(C=O)=CC)O)=O,4,2,0,2,29,0.000106
G5,C(C)=C(CO)C(CC(C=O)=O)O,4,2,0,2,29,0.000106
G5,C(CO)(CC=C(C=O)C(C)O)=O,4,3,0,3,29,0.000154
G5,C(CC(C=O)=O)=C(CO)C(C)O,4,2,0,2,29,0.000106
G5,C(CC(C(CCO)=O)=O)=CCO,2,2,0,2,29,0.000106
G5,C(CCO)=CC(C(CCO)=O)=O,2,2,0,2,29,0.000106
G5,C(CC(C(CCO)=O)=CCO)=O,2,3,0,3,29,0.000165
G5,C(C=C(C(CCO)=O)CCO)=O,2,3,0,3,29,0.000165
G5,C(CC(C(CCO)=CCO)=O)=O,2,3,0,3,29,0.000165
G5,C=CC(C(C(CCO)=O)=O)CO,2,4,0,4,29,0.000212
G5,C(C)=C(C(C(CCO)=O)=O)CO,2,3,0,3,29,0.000165
G5,C=C(C(C(CCO)=O)=O)C(C)O,2,2,0,2,29,0.000106
G5,C(CC(CO)=O)(CC=CCO)=O,2,2,0,2,29,0.000106
G5,C(CO)(CC(C=CCCO)=O)=O,2,2,0,2,29,0.000106
G5,C(CC=O)(CC(CO)=CCO)=O,2,2,0,2,29,0.000106
G5,C(CC(C=C(CO)CCO)=O)=O,2,2,0,2,29,0.000106
G5,C(C(C=C)O)(CC(CCO)=O)=O,2,3,0,3,29,0.000154
G5,C(C(C(C)=O)O)(CC=CCO)=O,4,2,0,2,29,0.000106
G5,C(C)(C(C(C=CCCO)=O)O)=O,4,2,0,2,29,0.000106
G5,C(CC(C(C(C)=O)O)=CCO)=O,4,2,0,2,29,0.000106
G5,C(C)(C(C(CCO)=CC=O)O)=O,4,2,0,2,29,0.000106
G5,C(CC(C(C(C)=CCO)O)=O)=O,4,2,0,2,29,0.000106
G5,C(CCO)(C(C(C)=CC=O)O)=O,4,2,0,2,29,0.000106
G5,C(CC(C(C(CCO)=C)O)=O)=O,2,2,0,2,29,0.000106
G5,C(CC(C(C(CCO)=O)O)=C)=O,2,2,0,2,29,0.000106
G5,C(C(C(C)=O)O)(C(C=C)CO)=O,4,2,0,2,29,0.000106
G5,C(C)(C(C(C(CO)=CC)=O)O)=O,4,2,0,2,29,0.000106
G5,C(C(C(CCO)=O)O)(CC=C)=O,2,2,0,2,29,0.000106
G5,C(CCO)(C(C(C=CC)=O)O)=O,4,2,0,2,29,0.000106
G5,C(CC(C(CCO)O)=CC=O)=O,4,2,0,2,29,0.000106
G5,C(CC(C(CC=CCO)O)=O)=O,4,2,0,2,29,0.000106
G5,C(C(CC=CC=O)O)(CCO)=O,4,2,0,2,29,0.000106
G5,C(CC(C(C=CCCO)O)=O)=O,4,2,0,2,29,0.000106
G5,C(CC=CC(C(CCO)=O)O)=O,4,2,0,2,29,0.000106
G5,C(C(C(C(CCO)O)=O)C=C)=O,4,2,0,2,29,0.000106
G5,C(C)=C(C(C(CCO)O)=O)C=O,4,2,0,2,29,0.000106
G5,C(CC(C(C(C=C)CO)O)=O)=O,4,2,0,2,29,0.000106
G5,C(CCO)(C(C(C=O)=CC)O)=O,4,2,0,2,29,0.000106
G5,C(CC(C(C(CO)=CC)O)=O)=O,4,2,0,2,29,0.000106
G5,C(C=C(C=O)C(C)O)(CCO)=O,4,3,0,3,29,0.000154
G5,C(CC(C=C(CO)C(C)O)=O)=O,4,3,0,3,29,0.000154
G5,C(C(C=CCO)O)(CC(C)=O)=O,4,2,0,2,29,0.000106
G5,C(C(C(CC(C)=O)=CCO)O)=O,4,2,0,2,29,0.000106
G5,C(C)(CC(C(CO)O)=CC=O)=O,4,2,0,2,29,0.000106
G5,C(C(C(CCO)=CC(C)=O)O)=O,4,2,0,2,29,0.000106
G5,C(CC(C(CO)O)=CC(C)=O)=O,4,2,0,2,29,0.000106
G5,C(C(C=O)O)(CC(C)=CCO)=O,4,2,0,2,29,0.000106
G5,C(C(CO)O)(CC(C)=CC=O)=O,4,2,0,2,29,0.000106
G5,C(C(C(C=C(C)CCO)=O)O)=O,4,2,0,2,29,0.000106
G5,C(CC(C)=CC(C(CO)O)=O)=O,4,2,0,2,29,0.000106
G5,C(C(C=O)O)(CC(CCO)=C)=O,2,3,0,3,29,0.000154
G5,C(CC(CC(C(CO)O)=O)=C)=O,2,3,0,3,29,0.000154
G5,C(C(CO)O)(C(C(C)=O)C=C)=O,4,2,0,2,29,0.000106
G5,C(C)=C(C(C(CO)O)=O)C(C)=O,4,2,0,2,29,0.000106
G5,C(CC(C(CO)O)=O)(CC=C)=O,2,2,0,2,29,0.000106
G5,C(C(CO)O)(CC(C=CC)=O)=O,4,2,0,2,29,0.000106
G5,C(C(C(CCC=O)=CCO)O)=O,4,2,0,2,29,0.000106
G5,C(CCC(C(CO)O)=CC=O)=O,4,2,0,2,29,0.000106
G5,C(C(C(CCCO)=CC=O)O)=O,4,2,0,2,29,0.000106
G5,C(CC=C(CCO)C(C=O)O)=O,4,2,0,2,29,0.000106
G5,C(CC=C(C(CO)O)CC=O)=O,4,2,0,2,29,0.000106
G5,C(CC(C(C=O)O)=CCCO)=O,4,2,0,2,29,0.000106
G5,C(C(C(CCC=CCO)=O)O)=O,4,2,0,2,29,0.000106
G5,C(CCC=CC=O)(C(CO)O)=O,4,2,0,2,29,0.000106
G5,C(C(C=O)O)(CC=CCCO)=O,4,2,0,2,29,0.000106
G5,C(CC=CCC(C(CO)O)=O)=O,4,2,0,2,29,0.000106
G5,C(CC(C(C(CO)O)=O)=CC)=O,4,2,0,2,29,0.000106
G5,C(C(C(C(CCO)=CC)=O)O)=O,4,2,0,2,29,0.000106
G5,C(C(C=C)CC(C(CO)O)=O)=O,4,4,0,4,29,0.00020099999999999998
G5,C(C(C(CC(C=C)CO)=O)O)=O,4,3,0,3,29,0.000154
G5,C(C(CO)O)(CC(C=O)=CC)=O,4,2,0,2,29,0.000106
G5,C(C(C=O)O)(CC(CO)=CC)=O,4,2,0,2,29,0.000106
G5,C(C(CC(C(C)=O)=CCO)O)=O,4,2,0,2,29,0.000106
G5,C(C=C(C(C)=O)CC(CO)O)=O,4,2,0,2,29,0.000106
G5,C(C(C=C(C(C)=O)CCO)O)=O,4,2,0,2,29,0.000106
G5,C(CC(C(C)=O)=CC(CO)O)=O,4,2,0,2,29,0.000106
G5,C(C(CC(C(C)=CCO)=O)O)=O,4,2,0,2,29,0.000106
G5,C(C(C)=CC=O)(CC(CO)O)=O,4,2,0,2,29,0.000106
G5,C(C(CC(C(CCO)=C)=O)O)=O,2,2,0,2,29,0.000106
G5,C(CC(C(CC(CO)O)=O)=C)=O,2,2,0,2,29,0.000106
G5,C=CC(C(C(C)=O)=O)C(CO)O,4,2,0,2,29,0.000106
G5,C(C)=C(C(C(C)=O)=O)C(CO)O,4,2,0,2,29,0.000106
G5,C(CO)=C(C(C(C)=O)=O)C(C)O,4,2,0,2,29,0.000106
G5,C=CCC(C(CC(CO)O)=O)=O,2,2,0,2,29,0.000106
G5,C(C)=CC(C(CC(CO)O)=O)=O,4,2,0,2,29,0.000106
G5,C(CC(CC(C=O)O)=CCO)=O,4,2,0,2,29,0.000106
G5,C(CC(CC(CO)O)=CC=O)=O,4,2,0,2,29,0.000106
G5,C(C(CC(CCO)=CC=O)O)=O,4,2,0,2,29,0.000106
G5,C(CC(CCO)=CC(C=O)O)=O,4,3,0,3,29,0.000154
G5,C(CC(CC=O)=CC(CO)O)=O,2,3,0,3,29,0.000154
G5,C(C(CC(CC=CCO)=O)O)=O,4,2,0,2,29,0.000106
G5,C(CC(CO)O)(CC=CC=O)=O,4,2,0,2,29,0.000106
G5,C(C(CC(C=CCCO)=O)O)=O,4,2,0,2,29,0.000106
G5,C(CC=CC(CC(CO)O)=O)=O,4,2,0,2,29,0.000106
G5,C(CC=O)(C(C=C)C(CO)O)=O,4,2,0,2,29,0.000106
G5,C(CCO)(C(C=C)C(C=O)O)=O,4,2,0,2,29,0.000106
G5,C(CC(C(C(CO)O)=CC)=O)=O,4,2,0,2,29,0.000106
G5,C(C(C(C(CCO)=O)=CC)O)=O,4,2,0,2,29,0.000106
G5,C(CC(C(C(C)O)=CCO)=O)=O,4,3,0,3,29,0.000154
G5,C(C(C(C)O)=CC=O)(CCO)=O,4,3,0,3,29,0.000154
G5,C(C(C(CC(CO)O)=O)C=C)=O,4,2,0,2,29,0.000106
G5,C(CC(C=O)O)(C(C=C)CO)=O,4,2,0,2,29,0.000106
G5,C(C)=C(C(CC(CO)O)=O)C=O,4,2,0,2,29,0.000106
G5,C(C(CC(C(CO)=CC)=O)O)=O,4,2,0,2,29,0.000106
G5,C(C(CO)O)=CC(C=CCO)=O,8,2,0,2,29,0.000106
G5,C(CO)=C(C=O)C=CC(CO)O,8,2,0,2,29,0.000106
G5,C(C(CO)O)=CC(CO)=CC=O,8,3,0,3,29,0.000165
G5,C(C(C(C=CCO)=O)O)=CCO,8,2,0,2,29,0.000106
G5,C(C(C(C=CCO)=CCO)O)=O,8,2,0,2,29,0.000106
G5,C(CO)=CC(C(CO)O)=CC=O,8,3,0,3,29,0.000165
G5,C(CO)=CC=CC(C(CO)O)=O,8,2,0,2,29,0.000106
G5,C(CO)=C(C=CC=O)C(CO)O,8,2,0,2,29,0.000106
G5,C(C(C(C(C=C)=CCO)O)O)=O,8,2,0,2,29,0.000106
G5,C=CC(C(C(CO)O)O)=CC=O,8,2,0,2,29,0.000106
G5,C(C(C=CC(CO)=O)O)=CCO,8,2,0,2,29,0.000106
G5,C(C(C=CC(CO)=CCO)O)=O,8,2,0,2,29,0.000106
G5,C=CC(C(C=CC(CO)O)=O)O,8,3,0,3,29,0.000154
G5,C(C(C(C=CC=O)O)O)=CCO,16,3,0,3,29,0.000154
G5,C(C(C(C=CC=CCO)O)O)=O,16,2,0,2,29,0.000106
G5,C(C(C(CO)O)O)=CC=CC=O,16,2,0,2,29,0.000106
G5,C=C(C(CO)O)C(CO)O,3,3,0,3,29,0.000165
G5,C(CO)=C(C(CO)=O)C(CO)O,4,3,0,3,29,0.000165
G5,C(CO)=C(C=O)C(CO)O,4,5,0,5,29,0.000271
G5,C=C(CO)C(CO)O,2,4,0,4,29,0.000212
G5,C(CO)=C(C(O)=O)CCO,2,3,0,3,29,0.000165
G5,C(C(CO)O)=C(C(O)=O)C,4,2,0,2,29,0.000106
G5,C=C(C(O)=O)CC(CO)O,2,2,0,2,29,0.000106
G5,C=C(C=O)C(CO)(CO)O,1,3,0,3,29,0.000154
G5,C=C(C(CO)O)C(CO)(CO)O,2,2,0,2,29,0.000106
G5,C(CO)(C(CO)(CO)O)=CCO,2,2,0,2,29,0.000106
G5,C=C(CO)C(CO)(CO)O,1,2,0,2,29,0.000106
G5,C=CC(CO)(CO)O,1,3,0,3,29,0.000154
G5,C(C)(C(C=C)(C(CO)O)O)=O,4,3,0,3,4,0.000155
G5,C(C(C=O)(C=CC(CO)O)O)=O,4,2,0,2,29,0.000106
G5,C(CCO)(C(C(C)=O)(C=C)O)=O,2,2,0,2,29,0.000106
G5,C(CC(C)=O)(C(C=C)(CO)O)=O,2,2,0,2,29,0.000106
G5,C(CCC(C(C=C)(CO)O)=O)=O,2,2,0,2,29,0.000106
G5,C(C(C(CCCO)=O)(C=C)O)=O,2,2,0,2,29,0.000106
G5,C=CC(C(C=CCO)=O)(CO)O,4,3,0,3,29,0.000165
G5,C=CC(C(C=C)=O)(C(CO)O)O,4,2,0,2,29,0.000106
G5,C(C(CO)(C(C=CC=O)O)O)=C,8,2,0,2,29,0.000106
G5,C(C(C=C)(C(C=CCO)O)O)=O,8,3,0,3,43,0.000154
G5,C=C(C=O)C(CO)(C(CO)O)O,4,5,0,5,29,0.000271
G5,C=C(CO)C(CO)(C(CO)O)O,4,4,0,4,29,0.000223
G5,C(C(C(C=O)=C)(CCO)O)=O,2,3,0,3,29,0.000154
G5,C(CO)(C(C)O)=CC(CO)=O,4,2,0,2,29,0.000106
G5,C(C(CO)=CC(CO)=O)(C)=O,2,3,0,3,29,0.000154
G5,C(CO)(CO)=CC(C(C)=O)=O,1,3,0,3,29,0.000154
G5,C(C(C(CO)=C)(CCO)O)=O,2,2,0,2,29,0.000106
G5,C(C)(C(C=C)(CC(CO)=O)O)=O,2,2,0,2,29,0.000106
G5,C(C(C(C)O)=CC(CO)=O)(C)=O,4,2,0,2,29,0.000106
G5,C(CO)(C(C)O)=CC(C(C)=O)=O,4,2,0,2,29,0.000106
G5,C=CC(C=CC(CO)=O)(CO)O,4,2,0,2,29,0.000106
G5,C1(CCO)OCC(C=1)=O,1,2,0,2,29,0.000106
G5,C1(C)OC(C(C=1)=O)CO,2,2,0,2,29,0.000106
G5,C1C(C(CO)(OCC=1)O)O,4,3,0,3,29,0.000154
G5,C1C(C(OC(C=1)CO)O)O,8,3,0,3,29,0.000154
G5,CC(C(C(CO)O)(C(CO)O)O)O,6,3,0,3,29,0.000176
G5,CC(C(C(C(C(CO)O)O)O)O)O,32,7,0,7,29,0.00041
G5,C(C(CO)O)OC(C(CO)O)O,8,4,0,4,29,0.00023500000000000002
G5,C(C(CO)O)(O)OC(CO)CO,4,2,0,2,29,0.000117
G5,C(CO)(O)OC(CO)C(CO)O,8,2,0,2,29,0.000117
G5,C(CO)OC(C(C(CO)O)O)O,8,3,0,3,29,0.000176
G5,C(C(C(CO)O)O)OC(CO)O,8,3,0,3,29,0.000176
G5,C(CO)OC(CO)(C(CO)O)O,4,2,0,2,29,0.000117
G5,C1C(C(C(C(CO)O)O1)O)O,16,4,0,4,29,0.000234
G5,C(C1(C(C(C(CCO)O1)O)O)O)O,16,2,0,2,51,0.000106
G5,C1C(CO)(C(C(O)O1)C(CO)O)O,16,2,0,2,5,0.000106
G5,C(C1C(C(O)OC1(CO)CO)O)O,8,2,0,2,29,0.000106
G5,C(C(C1C(O)OC(CO)C1O)O)O,32,2,0,2,41,0.000106
G5,C1(C(C(CO)C(C(CO)O)O1)O)O,32,2,0,2,41,0.000106
G5,C1(C(O)OC(C(CCO)O)C1)=O,8,2,0,2,29,0.000106
G5,C(C1(CC(C(CCO)O1)O)O)=O,8,2,0,2,20,0.000106
G5,C1(C(O)OC(CC(CO)O)C1)=O,8,2,0,2,20,0.000106
G5,C(C1C(CO)OC(C)(C1O)O)=O,16,3,0,3,29,0.000154
G5,C(C1C(CO)C(C(C)(O1)O)O)=O,16,2,0,2,45,0.000106
G5,C(C)(C1C(CO)C(C(O1)O)O)=O,16,2,0,2,45,0.000106
G5,C(C1C(CO)OC(C1(C)O)O)=O,16,2,0,2,45,0.000106
G5,C(C1C(CO)C(C)(C(O1)O)O)=O,16,2,0,2,29,0.000106
G5,C(C1(C)C(CO)C(C(O1)O)O)=O,16,2,0,2,29,0.000106
G5,C(C1C(CO)C(C(O1)O)O)=O,16,2,0,2,29,0.000106
G5,C(C1(CC(C(CCO)O1)O)O)O,8,2,0,2,21,0.000106
G5,C1C(CC(O)O1)(CC(CO)O)O,8,2,0,2,21,0.000106
G5,C1(C(CC(CO)(CCO)O1)O)O,8,2,0,2,21,0.000106
G5,C1C(CO)C(C(O)O1)O,8,2,0,2,2,0.000106
G5,C1C(CO)C(C(C(CO)O)(O)O1)O,16,2,0,2,2,0.000106
G5,C(C(C1(C(CC(CO)O1)O)O)O)O,16,2,0,2,32,0.000106
G5,C(CO)(C1COC(CO)(C1)O)=O,4,4,0,4,12,0.000212
G5,C(C1COC(C1O)(CCO)O)=O,8,3,0,3,23,0.000154
G5,C(CC1(C(C(CO1)CO)O)O)=O,8,2,0,2,29,0.000106
G5,C(C(CO)O)(C1COC(C1)O)=O,8,2,0,2,43,0.000106
G5,C(C1COC(C1)(C(CO)O)O)=O,8,3,0,3,5,0.000154
G5,C(C(C1(CC(CO1)CO)O)O)=O,8,2,0,2,55,0.000106
G5,C1(C(C)(O)OCC1C(CO)O)=O,8,3,0,3,0,0.000154
G5,C1(C(CCO)(O)OC(CO)C1)=O,4,3,0,3,14,0.000154
G5,C1(C(CC(CO)O)(O)OCC1)=O,4,2,0,2,14,0.000106
G5,C(CCO)(C1COC(C1O)O)=O,8,2,0,2,30,0.000106
G5,CC1(C(C(C(CCO)O1)O)O)O,16,2,0,2,49,0.000106
G5,CC1(CC(O)OC1C(CO)O)O,16,2,0,2,16,0.000106
G5,CC1(CCO)C(C(C(O)O1)O)O,16,2,0,2,29,0.000106
G5,C(C1C(C(C(O1)O)C(CO)O)O)=O,32,2,0,2,43,0.000106
G5,C(C(C1C(CO)C(C(O)O1)O)O)=O,32,2,0,2,43,0.000106
G5,C1C(C)(C(C(O)O1)C(CO)O)O,16,2,0,2,49,0.000106
G5,CC1(CO)C(CO)C(C(O)O1)O,16,2,0,2,49,0.000106
G5,CC1C(CO)C(C(O)O1)O,16,2,0,2,4,0.000106
G5,C(CC1CC(C(O)O1)O)O,8,2,0,2,29,0.000106
G5,C1(C(CCO)OC(CCO)(C1)O)=O,4,2,0,2,30,0.000106
G5,C1(C(O)OC(CCO)(CCO)C1)=O,2,2,0,2,29,0.000106
G5,C(C1(CCO)CCC(CO)(O1)O)=O,4,2,0,2,29,0.000106
G5,C(CC1(CO)CCC(CO)(O)O1)=O,4,3,0,3,29,0.000165
G5,C(C1(CCC(CO)(CCO)O1)O)=O,4,2,0,2,29,0.000106
G5,C(CO)(CCC1(COC(C1)O)O)=O,4,3,0,3,29,0.000154
G5,C(CO)(C1C(C)OC(CO)(C1)O)=O,8,3,0,3,29,0.000165
G5,C(C1(CCO)CC(C(C)(O1)O)O)=O,8,2,0,2,22,0.000106
G5,C(CC1(CO)CC(C(C)(O)O1)O)=O,8,2,0,2,22,0.000106
G5,C(C1(CC(C(C)(CCO)O1)O)O)=O,8,2,0,2,29,0.000106
G5,C(CC1(C)C(CC(CO)(O)O1)O)=O,8,2,0,2,22,0.000106
G5,C(CO)(CC1C(C)(CC(O)O1)O)=O,8,2,0,2,22,0.000106
G5,C(CO)(C1C(C)OC(C)(C1O)O)=O,16,2,0,2,45,0.000106
G5,C1(C(CCO)(O)OC(CCO)C1)=O,4,2,0,2,53,0.000106
G5,C1(CC(OC1(CCO)CCO)O)=O,2,2,0,2,29,0.000106
G5,C1(C(CCO)(O)OC(C)C1CO)=O,8,3,0,3,4,0.000165
G5,C(C1C(C)(CC(O1)O)O)(CCO)=O,8,2,0,2,6,0.000106
G5,C(CC1(CCO)C(CC(O)O1)O)=O,8,2,0,2,13,0.000106
G5,C(CC1(C(CC(CCO)O1)O)O)=O,8,2,0,2,29,0.000106
G5,C(CC1CC(C(CCO)(O)O1)O)=O,8,2,0,2,13,0.000106
G5,C(C1C(C)OC(C1O)(CCO)O)=O,16,2,0,2,4,0.000106
G5,C(CC1(C(C(CO)C(C)O1)O)O)=O,16,2,0,2,29,0.000106
G5,C1(C(CO)OC(CC(C)O)(C1)O)=O,8,2,0,2,4,0.000106
G5,C(C1C(CC(O1)O)O)(CCCO)=O,8,2,0,2,45,0.000106
G5,C(C(C1(CCC(O)O1)CCO)O)=O,8,2,0,2,29,0.000106
G5,C(CC1(CCC(O)O1)C(CO)O)=O,8,2,0,2,29,0.000106
G5,C(CCC1(CC(O)OC1CO)O)=O,8,3,0,3,27,0.000154
G5,C(C1C(CCCO)(CC(O1)O)O)=O,8,2,0,2,44,0.000106
G5,C(C(C1(CCC(CCO)O1)O)O)=O,8,2,0,2,29,0.000106
G5,C(CC1CCC(C(CO)O)(O)O1)=O,8,2,0,2,44,0.000106
G5,C(C(CO)O)(C1C(C)OC(C1)O)=O,16,2,0,2,46,0.000106
G5,C(C1C(C)OC(C1)(C(CO)O)O)=O,16,2,0,2,46,0.000106
G5,C(C(C1(CC(CO)C(C)O1)O)O)=O,16,2,0,2,46,0.000106
G5,C(C)(C1(CC(C(CCO)O1)O)O)=O,8,2,0,2,29,0.000106
G5,C(C)(C1(CCO)CC(C(O1)O)O)=O,8,2,0,2,29,0.000106
G5,C1(C(C)(O)OC(C)C1C(CO)O)=O,16,2,0,2,14,0.000106
G5,C1(C(CC(C)O)(O)OC(CO)C1)=O,8,2,0,2,14,0.000106
G5,C1(C(CC(CO)O)(O)OC(C)C1)=O,8,2,0,2,14,0.000106
G5,C(CC1(CC(C(CCO)O1)O)O)=O,8,2,0,2,29,0.000106
G5,C(CC1C(CC(CCO)(O)O1)O)=O,8,2,0,2,6,0.000106
G5,C(CC1C(CC(O)O1)O)(CCO)=O,8,2,0,2,6,0.000106
G5,C(CC1(CC(C(O)O1)O)CCO)=O,8,2,0,2,4,0.000106
G5,C(CCO)(C1C(C)OC(C1O)O)=O,16,2,0,2,37,0.000106
G5,C(C1(C(CO)OC(C1)O)O)=CCO,16,3,0,3,21,0.000165
G5,C=CC1(C(C(C(CCO)O1)O)O)O,16,2,0,2,7,0.000106
G5,C=CC1(CCO)C(C(C(O1)O)O)O,16,2,0,2,7,0.000106
G5,C=CC1(CC(O)OC1C(CO)O)O,16,2,0,2,7,0.000106
G5,C(C1(COC(C1)O)O)=CC(CO)O,16,2,0,2,29,0.000106
G5,C(C(C1C(CC(O)O1)O)O)=CCO,32,2,0,2,43,0.000106
G5,C1(C(CC(CO)(C(CO)O)O1)O)O,16,3,0,3,20,0.000165
G5,C1C(CC(CO)O)(C(C(O)O1)O)O,16,2,0,2,12,0.000106
G5,C1C(C(C(CO)O)C(CO)(O)O1)O,16,2,0,2,0,0.000106
G5,C1C(C(C(CC(CO)O)(O)O1)O)O,16,2,0,2,0,0.000106
G5,CC1(C(CO)O)C(C(C(O)O1)O)O,32,4,0,4,16,0.000223
G5,CC1(C(C(CO)O)OC(C1O)O)O,32,3,0,3,5,0.000165
G5,C1C(CC(C(C(CO)O)O)(O)O1)O,16,2,0,2,0,0.000106
G5,C1C(C(C(O)O1)C(CO)O)O,16,2,0,2,38,0.000106
G5,C1(C(C(CO)C(CO)O1)O)O,16,2,0,2,41,0.000106
G5,C1C(CC(O)O1)(O)OCCO,4,2,0,2,40,0.000106
G5,C(CO)OC1CC(C(O)O1)O,8,2,0,2,29,0.000106
G5,C(C1CC(C(O)O1)O)O,8,2,0,2,27,0.000106
G5,C(C1CCC(CO)(O1)O)=O,4,2,0,2,12,0.000106
G5,C(C1(CCC(CO)O1)O)=O,4,2,0,2,12,0.000106
G5,C1(C(C)OC(CO)(C1)O)=O,4,2,0,2,24,0.000106
G5,C(CO)(C1CCC(O1)O)=O,4,2,0,2,27,0.000106
G5,C1CC(C(CCO)(O)O1)O,4,2,0,2,4,0.000106
G5,C1CCC(C(CO)O)(O)O1,4,2,0,2,29,0.000106
G5,C1(CC(C(CCO)(O)O1)O)=O,4,2,0,2,29,0.000106
G5,C1(CCC(C(CO)O)(O)O1)=O,4,2,0,2,29,0.000106
G5,C(C1(CC(O)OC1(CO)CO)O)O,4,3,0,3,43,0.000165
G5,CC1(C(C(O)OC1(CO)CO)O)O,8,2,0,2,0,0.000106
G5,C1C(CO)(C(C(O)O1)(CCO)O)O,8,3,0,3,41,0.000165
G5,C(C1(CO)C(C(C(O)O1)O)O)O,8,3,0,3,5,0.000165
G5,C(C)(C1C(CO)(C(C(O1)O)O)O)=O,16,4,0,4,2,0.000223
G5,C(C1C(CO)(C(C(C)(O1)O)O)O)=O,16,4,0,4,14,0.000223
G5,C(C1(C)C(CO)(C(C(O1)O)O)O)=O,16,4,0,4,4,0.000223
G5,C(C1C(CO)(C(C)(C(O1)O)O)O)=O,16,3,0,3,45,0.000165
G5,C(C1C(CO)(C(C(O1)O)O)O)=O,16,4,0,4,0,0.000223
G5,C1C(CO)(C(C(C(C)O)(O)O1)O)O,16,2,0,2,25,0.000106
G5,C=CC1(C(C(CO)(CO1)O)O)O,8,3,0,3,29,0.000154
G5,CC1(C(C(CO)(C(C)O1)O)O)O,16,2,0,2,25,0.000106
G5,C(C1(C(O)OC(C1O)CCO)O)=O,16,2,0,2,43,0.000106
G5,CC1(CO)C(CO)(C(C(O)O1)O)O,16,4,0,4,49,0.000223
G5,CC1C(CO)(C(C(O)O1)O)O,16,4,0,4,4,0.000223
G5,C=CC1(C(C(CO)(C(C)O1)O)O)O,16,2,0,2,7,0.000106
G5,C1C(C(C(CO)O)(C(C)(O)O1)O)O,16,2,0,2,0,0.000106
G5,CC1(C(O)OC(CO)C1(CO)O)O,16,2,0,2,45,0.000106
G5,C1(C(CCO)(C(C(CO)O1)O)O)O,16,2,0,2,41,0.000106
G5,C(C(C1C(CO)(CC(O)O1)O)O)O,16,3,0,3,41,0.000165
G5,C(C1(C)C(CO)(CC(O1)O)O)=O,8,2,0,2,49,0.000106
G5,C(C1C(CO)(CC(CO)(O1)O)O)=O,8,2,0,2,51,0.000106
G5,CC1C(CO)(CC(CO)(O)O1)O,8,2,0,2,41,0.000106
G5,C(C1(C(CO)(CC(CO)O1)O)O)O,8,3,0,3,32,0.000165
G5,C1CC(CO)(C(C(CO)O)(O)O1)O,8,2,0,2,2,0.000106
G5,C(C(C1CC(C(O)O1)(CO)O)O)O,16,2,0,2,43,0.000106
G5,C(C)(C1(COC(CO)(C1)O)O)=O,4,3,0,3,45,0.000154
G5,C(CCO)(C1(COC(C1)O)O)=O,4,2,0,2,2,0.000106
G5,C(C)(C1(CC(CO)(CO1)O)O)=O,4,3,0,3,14,0.000154
G5,C(CC1(CC(CO1)(CO)O)O)=O,4,3,0,3,14,0.000154
G5,C(C1(COC(C1)(CCO)O)O)=O,4,2,0,2,14,0.000106
G5,C(C1C(C(C(O1)O)(CCO)O)O)=O,16,2,0,2,1,0.000106
G5,C(CC1(CO)C(C(C(O)O1)O)O)=O,16,4,0,4,1,0.000223
G5,C(C1(CCO)C(C(C(O1)O)O)O)=O,16,3,0,3,29,0.000165
G5,C1C(C)(C(C(O)O1)(CCO)O)O,8,2,0,2,49,0.000106
G5,CC1(CO)C(CO)(CC(O)O1)O,8,2,0,2,29,0.000106
G5,CC1C(CO)(CC(O)O1)O,8,2,0,2,4,0.000106
G5,C(C)(C1(C(C)OC(CO)(C1)O)O)=O,8,2,0,2,45,0.000106
G5,C(CCO)(C1(C(C)OC(C1)O)O)=O,8,2,0,2,4,0.000106
G5,C(C)(C1(CC(CO)(C(C)O1)O)O)=O,8,2,0,2,14,0.000106
G5,C(CC1(CC(CO)(C(C)O1)O)O)=O,8,2,0,2,25,0.000106
G5,C(C1(C(C)OC(C1)(CCO)O)O)=O,8,2,0,2,25,0.000106
G5,C1C2CC(C(CO)(O)O2)O1,8,2,0,2,39,0.000106
G5,C1(C2CC(C(CO)O2)O1)O,16,2,0,2,29,0.000106
G5,C(CO)(CC1C(CO)OC(C1)O)=O,8,3,0,3,46,0.000165
G5,C(C1(CC(CCO)C(CO)O1)O)=O,8,2,0,2,46,0.000106
G5,C(CC1CC(CO)(O)OC1CO)=O,8,3,0,3,32,0.000165
G5,C(C(CO)O)(CC1COC(C1)O)=O,8,2,0,2,55,0.000106
G5,C(C(C1(CC(CO1)CCO)O)O)=O,8,2,0,2,55,0.000106
G5,C(CC1COC(C1)(C(CO)O)O)=O,8,2,0,2,55,0.000106
G5,C(C1C(CC(CO)(O1)O)CCO)=O,8,2,0,2,32,0.000106
G5,C(CC1C(C(CO)O)OC(C1)O)=O,16,2,0,2,4,0.000106
G5,C(C(C1C(CC(O)O1)CCO)O)=O,16,2,0,2,43,0.000106
G5,C(C1(C(C(CC(CO)O1)O)O)O)O,16,2,0,2,51,0.000106
G5,C1C(CO)(C(CO)C(C(O)O1)O)O,16,2,0,2,29,0.000106
G5,C1(C(C(CO)C(C(CO)O1)O)O)O,32,2,0,2,37,0.000106
G5,C1C(C(C(C(O)O1)C(CO)O)O)O,32,2,0,2,41,0.000106
G5,C1(C(O)OC(C(C1)O)CCO)=O,8,2,0,2,29,0.000106
G5,C(C1(CC(CC(CO)O1)O)O)=O,8,2,0,2,20,0.000106
G5,C(C1(CC(O)OC(CO)C1)O)O,8,2,0,2,21,0.000106
G5,C1C(CO)C(C(C(CO)(O)O1)O)O,16,2,0,2,18,0.000106
G5,C1(COC(CO)(C(CO)C1)O)=O,4,4,0,4,41,0.00020099999999999998
G5,C(CO)(C1COC(CC1O)O)=O,8,2,0,2,33,0.000106
G5,C(C1COC(CO)(CC1O)O)=O,8,2,0,2,23,0.000106
G5,C(C1(CC(C(CO)CO1)O)O)=O,8,2,0,2,29,0.000106
G5,C1(C(COC(CCO)(C1)O)O)=O,4,3,0,3,3,0.000154
G5,C1(C(C(CCO)(O)OCC1)O)=O,4,3,0,3,29,0.000154
G5,C1(CC(C(CO)O)(O)OCC1)=O,4,3,0,3,41,0.000154
G5,C1(C(C(O)OCC1CCO)O)=O,8,2,0,2,29,0.000106
G5,C1(CC(O)OCC1C(CO)O)=O,8,2,0,2,2,0.000106
G5,CC1(CC(O)OC(CO)C1O)O,16,2,0,2,16,0.000106
G5,C(C1C(C(CO)C(C(O1)O)O)O)=O,32,2,0,2,43,0.000106
G5,C(C1C(CO)OC(C(C1O)O)O)=O,32,3,0,3,9,0.000165
G5,C(C1C(CO)C(C(C(O1)O)O)O)=O,32,3,0,3,2,0.000165
G5,C(C1(CC(CC(CO)O1)O)O)O,8,2,0,2,21,0.000106
G5,CC1(C(C(CC(CO)O1)O)O)O,16,2,0,2,49,0.000106
G5,C1C(C)(C(CO)C(C(O)O1)O)O,16,2,0,2,29,0.000106
G5,C(C1CC(CC(O)O1)O)O,8,2,0,2,43,0.000106
G5,C(CO)(CC1(CC(O)OCC1)O)=O,4,2,0,2,30,0.000106
G5,C1(CC(CO)(O)OC(C)C1CO)=O,8,3,0,3,4,0.000165
G5,C1(C(CCO)OC(CO)(CC1)O)=O,4,2,0,2,7,0.000106
G5,C1(C(O)OC(CO)(CC1)CCO)=O,4,2,0,2,29,0.000106
G5,C1(COC(CO)(C(C(C)O)C1)O)=O,8,3,0,3,12,0.000154
G5,C1(C(CCO)OC(C(C1)O)(C)O)=O,8,2,0,2,45,0.000106
G5,C(C)(C1CC(CO)(CC(O1)O)O)=O,8,2,0,2,29,0.000106
G5,C1(C(O)OC(C)(C(C1)O)CCO)=O,8,2,0,2,22,0.000106
G5,C(C1(CCO)CC(CC(O1)O)O)=O,8,2,0,2,13,0.000106
G5,C(CC1(CO)CC(CC(O)O1)O)=O,8,2,0,2,13,0.000106
G5,C(CC1CC(CO)(CC(O)O1)O)=O,8,2,0,2,13,0.000106
G5,C(C1(CC(O)OC(C1)CCO)O)=O,8,2,0,2,13,0.000106
G5,C(C1(CC(CC(CCO)O1)O)O)=O,8,2,0,2,29,0.000106
G5,C(CC1CC(CC(CO)(O)O1)O)=O,8,2,0,2,13,0.000106
G5,C(CO)(CC1CC(CC(O)O1)O)=O,8,2,0,2,13,0.000106
G5,C(CO)(C1C(C)OC(CC1O)O)=O,16,2,0,2,4,0.000106
G5,C(C1C(C)OC(CO)(CC1O)O)=O,16,2,0,2,23,0.000106
G5,C(C1(CC(C(CO)C(C)O1)O)O)=O,16,2,0,2,29,0.000106
G5,C(CCO)(C1(CC(O)OCC1)O)=O,4,2,0,2,53,0.000106
G5,C1(CC(CO)(O)OC(CCO)C1)=O,4,2,0,2,26,0.000106
G5,C1(CC(CO)(CCO)OC(C1)O)=O,4,2,0,2,26,0.000106
G5,C1(C(C(C)OC(CCO)(C1)O)O)=O,8,2,0,2,4,0.000106
G5,C1(C(C(C)(O)OC(CCO)C1)O)=O,8,2,0,2,9,0.000106
G5,C1(C(C(C)(CCO)OC(C1)O)O)=O,8,2,0,2,6,0.000106
G5,C1(C(C(C)(O)OC(C)C1CO)O)=O,16,2,0,2,9,0.000106
G5,C1(C(C(CCO)(O)OC(C)C1)O)=O,8,2,0,2,9,0.000106
G5,C(C1CC(CC(O1)O)O)(CCO)=O,8,2,0,2,13,0.000106
G5,C1(C(C(CCO)OC(C)(C1)O)O)=O,8,2,0,2,26,0.000106
G5,C1(C(C(O)OC(C)(CCO)C1)O)=O,8,2,0,2,6,0.000106
G5,C1(CC(C(CO)O)(O)OC(C)C1)=O,8,2,0,2,4,0.000106
G5,C1(C(C(O)OC(C)C1CCO)O)=O,16,2,0,2,4,0.000106
G5,C1(C(C)(O)OC(C(C1)O)CCO)=O,8,2,0,2,21,0.000106
G5,C(C)(C1(CC(O)OC(CO)C1)O)=O,8,2,0,2,21,0.000106
G5,C1(CC(C(OC1(C)CCO)O)O)=O,8,2,0,2,21,0.000106
G5,C1(CC(O)OC(C)C1C(CO)O)=O,16,2,0,2,4,0.000106
G5,C(C1(C(COC(C1)O)O)O)=CCO,16,2,0,2,21,0.000106
G5,C=CC1(CC(O)OC(CO)C1O)O,16,2,0,2,29,0.000106
G5,C(C1C(C(CC(O1)O)O)O)=CCO,32,2,0,2,29,0.000106
G5,C1(C(CC(CO)(C(CO)O1)O)O)O,16,2,0,2,20,0.000106
G5,C1(C(C(CO)(CC(CO)O1)O)O)O,16,2,0,2,0,0.000106
G5,CC1(C(CO)OC(C(C1O)O)O)O,32,3,0,3,29,0.000165
G5,CC1(C(C(O)OC(CO)C1O)O)O,32,2,0,2,0,0.000106
G5,C1C(C(CO)C(C(O)O1)O)O,16,2,0,2,30,0.000106
G5,C1CC(CC(CO)(O)O1)O,4,2,0,2,4,0.000106
G5,C1(CC(CC(CO)(O)O1)O)=O,4,2,0,2,28,0.000106
G5,C1C(CO)(C(CC(CO)(O)O1)O)O,8,2,0,2,29,0.000106
G5,C1C(CO)(C(CO)(CC(O)O1)O)O,8,3,0,3,43,0.000165
G5,C1C(CO)(C(C(C(C)(O)O1)O)O)O,16,2,0,2,26,0.000106
G5,CC1(C(C(O)OCC1(CO)O)O)O,16,2,0,2,1,0.000106
G5,C1C(CO)(C(C(C(O)O1)O)O)O,16,3,0,3,5,0.000165
G5,C1(C(CO)(C(CC(CO)O1)O)O)O,16,2,0,2,43,0.000106
G5,C1(CC(C)(O)OCC1(CO)O)=O,4,4,0,4,26,0.000205
G5,C(C1(C(O)OC(CO)CC1O)O)=O,16,3,0,3,29,0.000165
G5,C1C(C)(C(CO)(C(C(O)O1)O)O)O,16,4,0,4,49,0.000223
G5,C1(CC(C)(O)OC(C)C1(CO)O)=O,8,2,0,2,2,0.000106
G5,CC1(C(O)OCC(C1(CO)O)O)O,16,3,0,3,16,0.000165
G5,C(C1(CC(O)OC(CO)C1O)O)O,16,2,0,2,37,0.000106
G5,C1C(C(C(C(O)O1)(CCO)O)O)O,16,3,0,3,41,0.000165
G5,C1C(CC(CO)(C(CO)(O)O1)O)O,8,2,0,2,20,0.000106
G5,C1C(CO)(CC(C(CO)(O)O1)O)O,8,2,0,2,43,0.000106
G5,C1(C(CO)(CC(C(CO)O1)O)O)O,16,2,0,2,43,0.000106
G5,C1(CC(O)OCC1(CCO)O)=O,4,2,0,2,12,0.000106
G5,C1(C(C)(O)OCC(CO)(C1)O)=O,4,2,0,2,14,0.000106
G5,C1C(C)(C(CO)(CC(O)O1)O)O,8,2,0,2,43,0.000106
G5,C1(CC(O)OC(C)C1(CCO)O)=O,8,2,0,2,4,0.000106
G5,C1(C(C)(O)OC(C)C(CO)(C1)O)=O,8,2,0,2,14,0.000106
G5,C(CO)(CC1C(COC(C1)O)O)=O,8,2,0,2,46,0.000106
G5,C(C1(CC(C(CO1)O)CCO)O)=O,8,2,0,2,46,0.000106
G5,C(CC1CC(CO)(O)OCC1O)=O,8,2,0,2,46,0.000106
G5,C1(C(CO)OC(CC1CCO)O)=O,8,2,0,2,46,0.000106
G5,C(CC1CC(O)OC(CO)C1O)=O,16,2,0,2,43,0.000106
G5,C(C1C(C(CCO)CC(O1)O)O)=O,16,2,0,2,43,0.000106
G5,C1C(C(C(CO)C(C(O)O1)O)O)O,32,3,0,3,55,0.000165
G5,C1(C(O)OC(CO)CC(C1)O)=O,8,2,0,2,20,0.000106
G5,C1(C(COC(CC1)(CO)O)O)=O,4,3,0,3,20,0.000154
G5,C1(C(O)OCC(CO)C(C1)O)=O,8,2,0,2,29,0.000106
G5,C1(C(C(COC(C1)O)CO)O)=O,8,2,0,2,23,0.000106
G5,C1(C(C(C)OC(CC1)(CO)O)O)=O,8,2,0,2,12,0.000106
G5,C1(C(CC(CO)(O)OC(C)C1)O)=O,8,2,0,2,22,0.000106
G5,C1(C(CCO)OC(CC(C1)O)O)=O,8,2,0,2,13,0.000106
G5,C1(C(CC(O)OC(CCO)C1)O)=O,8,2,0,2,13,0.000106
G5,C1(C(O)OC(CCO)CC(C1)O)=O,8,2,0,2,13,0.000106
G5,C1(C(O)OC(C)C(CO)C(C1)O)=O,16,2,0,2,23,0.000106
G5,C1(C(CC(CCO)OC(C1)O)O)=O,8,2,0,2,13,0.000106
G5,C1(C(CC(O)OC(C)C1CO)O)=O,16,2,0,2,4,0.000106
G5,C1(C(C(CO)C(C)OC(C1)O)O)=O,16,2,0,2,4,0.000106
G5,C1(C(CO)OC(CC(C)(C1)O)O)=O,8,2,0,2,6,0.000106
G5,C1(C(C(CCO)OC(CC1)O)O)=O,8,2,0,2,45,0.000106
G5,C1(C(C(O)OC(CC1)CCO)O)=O,8,2,0,2,44,0.000106
G5,C1(C(C(O)OC(C)C(CO)C1)O)=O,16,2,0,2,46,0.000106
G5,C1(CC(CO)OC(CC1(C)O)O)=O,8,2,0,2,21,0.000106
G5,C1(CC(C(CCO)OC(C1)O)O)=O,8,2,0,2,6,0.000106
G5,C1(CC(C(O)OC(CCO)C1)O)=O,8,2,0,2,26,0.000106
G5,C1(CC(C(O)OC(C)C1CO)O)=O,16,2,0,2,37,0.000106
G5,C1C(CO)C(C(C(C(O)O1)O)O)O,32,3,0,3,29,0.000165
G5,C1C(CO)(C(C(CC(O)O1)O)O)O,16,2,0,2,38,0.000106
G5,C1C(CO)(C(CC(C(O)O1)O)O)O,16,2,0,2,43,0.000106
G5,C1(CCC(O)OCC1(CO)O)=O,4,4,0,4,7,0.000205
G5,C1(CCC(O)OC(C)C1(CO)O)=O,8,2,0,2,4,0.000106
G5,C1C(C(C(CO)(CC(O)O1)O)O)O,16,3,0,3,41,0.000165
G5,C1(COC(C(C(CO)(C1)O)O)O)=O,8,3,0,3,12,0.000165
G5,C1C(CO)(CC(C(C(O)O1)O)O)O,16,2,0,2,43,0.000106
G5,C1(CC(COC(C1)O)(CO)O)=O,4,2,0,2,38,0.000106
G5,C1(CC(CO)(C(C)OC(C1)O)O)=O,8,2,0,2,25,0.000106
G5,C1(C(CO)OC(CC(CO)C1)O)=O,8,3,0,3,29,0.000165
G5,C1(C(COC(CC1CCO)O)O)=O,8,2,0,2,46,0.000106
G5,C1(C(C(CO)O)OC(CCC1)O)=O,8,2,0,2,27,0.000106
G5,C1(COC(CC(C(CO)O)C1)O)=O,8,2,0,2,32,0.000106
G5,C1(C(CCO)(CCO1)O)=O,2,2,0,2,29,0.000106
G5,C1(C(C)(CC(CO)O1)O)=O,4,2,0,2,29,0.000106
G5,C1(C(C(C)(C(C(CO)O)C1)O)O)=O,16,2,0,2,29,0.000106
G5,C1(CCC(C1(C(CO)O)O)O)=O,8,2,0,2,7,0.000106
G5,C1(CC(CO)C(C)(C1(CO)O)O)=O,8,3,0,3,29,0.000165
G5,C1(CCC(C)(C1(C(CO)O)O)O)=O,8,2,0,2,7,0.000106
G5,C(C(C(CO)CO)CC(CO)=O)=O,2,3,0,3,3,0.000154
G5,C(C(CO)C(CO)CC(CO)=O)=O,4,2,0,2,18,0.00010700000000000001
G5,C(CO)(C(C(CO)CO)CC=O)=O,2,2,0,2,46,0.000106
G5,C(C(CCC(CCO)O)=O)=O,2,2,0,2,7,0.00010700000000000001
G5,C(C(CCC(CO)CO)=O)=O,1,2,0,2,7,0.00010700000000000001
G5,C(CO)(CCC(CCO)O)=O,2,2,0,2,7,0.00010700000000000001
G5,C(CO)(CCC(CO)CO)=O,1,2,0,2,7,0.00010700000000000001
G5,C(C(C(CC=O)O)CCO)=O,4,1,0,1,18,5.9e-05
G5,C(C(C(CO)CO)CC=O)=O,2,4,0,4,29,0.000202
G5,C(C(CO)C(CO)CC=O)=O,4,2,0,2,18,0.00010700000000000001
G5,C(C(CCC(CO)C(C)O)=O)=O,4,2,0,2,7,0.00010700000000000001
G5,C(C(CCCC(CCO)O)=O)=O,2,2,0,2,7,0.00010700000000000001
G5,C(C(CCC(C)(CCO)O)=O)=O,2,2,0,2,7,0.00010700000000000001
G5,C(CO)(CCC(CO)C(C)O)=O,4,2,0,2,7,0.00010700000000000001
G5,C(CO)(CCCC(CCO)O)=O,2,2,0,2,7,0.00010700000000000001
G5,C(CO)(CCC(C)(CCO)O)=O,2,2,0,2,7,0.00010700000000000001
G5,C(C(C(CO)C(C)O)CC=O)=O,8,4,0,4,4,0.000202
G5,C(C(C(CO)CC=O)C(C)O)=O,8,2,0,2,28,0.00010700000000000001
G5,C(C(CC(CCO)O)CC=O)=O,4,3,0,3,43,0.000154
G5,C(CC(CO)CC(CC=O)O)=O,4,2,0,2,43,0.00010700000000000001
G5,C(CC(C)(C(CO)CC=O)O)=O,4,2,0,2,28,0.00010700000000000001
G5,C(C(CCO)C(C)(CC=O)O)=O,4,1,0,1,28,5.9e-05
G5,C(C(CCCC(C(CO)O)O)=O)=O,4,3,0,3,7,0.000165
G5,C(C(CCC(C)(C(CO)O)O)=O)=O,4,3,0,3,29,0.000165
G5,C(CO)(CCC(CO)(C(C)O)O)=O,4,3,0,3,29,0.000165
G5,C(CO)(CCCC(C(CO)O)O)=O,4,3,0,3,29,0.000165
G5,C(CO)(CCC(C)(C(CO)O)O)=O,4,3,0,3,29,0.000165
G5,C(C(C(C)O)(C(CO)CC=O)O)=O,8,2,0,2,43,0.00010700000000000001
G5,C(C(CCO)C(C=O)(C(C)O)O)=O,8,2,0,2,3,0.00010700000000000001
G5,C(C(CC(C(CO)O)O)CC=O)=O,8,4,0,4,43,0.000213
G5,C(CC(CO)CC(C(C=O)O)O)=O,8,2,0,2,43,0.00010700000000000001
G5,C(CC(CO)C(C)(C(C=O)O)O)=O,8,2,0,2,45,0.00010700000000000001
G5,C(C(CCO)C(C)(C(C=O)O)O)=O,8,1,0,1,45,5.9e-05
G5,C(C(CCC(CO)C(CO)O)=O)=O,4,3,0,3,29,0.000165
G5,C(CO)(CCC(C(CCO)O)O)=O,4,2,0,2,7,0.00010700000000000001
G5,C(CO)(CCC(CO)C(CO)O)=O,4,3,0,3,29,0.000165
G5,C(C(CCO)C(CO)(CC=O)O)=O,4,1,0,1,29,5.9e-05
G5,C(CC(C(C(CO)CC=O)O)O)=O,8,2,0,2,43,0.000106
G5,C(C(C(CO)C(CO)O)CC=O)=O,8,4,0,4,29,0.000213
G5,C(C(C(CO)CC=O)C(CO)O)=O,8,2,0,2,46,0.000106
G5,C(CC(CO)C(C(C(C)=O)=O)O)=O,4,2,0,2,25,0.00010700000000000001
G5,C(C(CCO)C(C(C(C)=O)=O)O)=O,4,1,0,1,25,5.9e-05
G5,C(C(CCO)CC(C(CO)=O)=O)=O,2,1,0,1,43,5.9e-05
G5,C(CC(CO)C(C(C=O)=O)(C)O)=O,4,2,0,2,25,0.00010700000000000001
G5,C(C(CCO)C(C(C=O)=O)(C)O)=O,4,1,0,1,25,5.9e-05
G5,C(C(CC(C(C=O)=O)O)CCO)=O,4,1,0,1,43,5.9e-05
G5,C(CC(CO)C(C(C(C)O)=O)O)=O,8,2,0,2,25,0.00010700000000000001
G5,C(C(CCO)C(C(C(C)O)=O)O)=O,8,1,0,1,25,5.9e-05
G5,C(CC(CO)C(C(CO)=O)(C)O)=O,4,2,0,2,25,0.00010700000000000001
G5,C(C(CCO)C(C(CO)=O)(C)O)=O,4,1,0,1,25,5.9e-05
G5,C(C(C=O)C(C(CO)=O)CCO)=O,2,1,0,1,45,5.9e-05
G5,C(C(C=O)C(CO)CC=O)=O,2,2,0,2,29,0.00010700000000000001
G5,C(C(C=O)C(C=O)CCO)=O,2,3,0,3,29,0.000154
G5,C(C(CCC(CC(CO)O)O)=O)=O,4,2,0,2,7,0.00010700000000000001
G5,C(CO)(CCC(CC(CO)O)O)=O,4,2,0,2,7,0.00010700000000000001
G5,C(C(CCO)(C(CO)CC=O)O)=O,4,2,0,2,29,0.000106
G5,C(C(CCO)C(C=O)(CCO)O)=O,4,1,0,1,29,5.9e-05
G5,C(CC(CO)C(CO)C(C=O)O)=O,8,2,0,2,29,0.000106
G5,C(C(CCO)C(CO)C(C=O)O)=O,8,1,0,1,29,5.9e-05
G5,C(CC(CO)C(CC(C=O)O)O)=O,8,2,0,2,43,0.000106
G5,C(C(C(CC(C=O)O)O)CCO)=O,8,1,0,1,43,5.9e-05
G5,C(CC(CO)CC(C(O)=O)=O)=O,2,7,0,7,55,0.000356
G5,C(C(CCO)CC(C(O)=O)=O)=O,2,3,0,3,29,0.000165
G5,C(C(C=O)(C(CO)CC=O)O)(O)=O,4,2,0,2,17,0.00010700000000000001
G5,C(C(C=O)(C(C=O)CCO)O)(O)=O,4,3,0,3,29,0.000166
G5,C(C(C(C=O)=O)C(CO)CC=O)=O,4,2,0,2,29,0.00010700000000000001
G5,C(C(C(C=O)=O)C(C=O)CCO)=O,4,1,0,1,29,5.9e-05
G5,C(CCCC(C=O)=O)(CCO)=O,1,2,0,2,7,0.00010700000000000001
G5,C(C)(C(CCC(C=O)=O)CO)=O,2,2,0,2,7,0.00010700000000000001
G5,C(CCO)(CCCC(CO)=O)=O,1,2,0,2,7,0.00010700000000000001
G5,C(C)(C(CO)CCC(CO)=O)=O,2,2,0,2,7,0.00010700000000000001
G5,C(C)(C(CO)C(C=O)CC=O)=O,4,2,0,2,29,0.00010700000000000001
G5,C(CC(CO)C(C=O)C(C)=O)=O,4,2,0,2,29,0.00010700000000000001
G5,C(C(CCO)C(C=O)C(C)=O)=O,4,2,0,2,29,0.000106
G5,C(CC(CO)C1(CC(CO1)=O)O)=O,4,2,0,2,35,0.00010700000000000001
G5,C(C(C1(CC(CO1)=O)O)CCO)=O,4,1,0,1,35,5.9e-05
G5,C(CC(CO)C1C(COC1O)=O)=O,8,2,0,2,35,0.00010700000000000001
G5,C(C(CCO)C1C(COC1O)=O)=O,8,1,0,1,35,5.9e-05
G5,C(CC(CO)C1C(CC(O1)O)=O)=O,8,2,0,2,43,0.00010700000000000001
G5,C(C(CCO)C1C(CC(O1)O)=O)=O,8,1,0,1,43,5.9e-05
G5,C(C(CC(CO)CC(CO)=O)O)=O,4,3,0,3,11,0.000154
G5,C(C(CC(CO)O)CC(CO)=O)=O,4,3,0,3,11,0.000154
G5,C(CO)(C(CC(CO)O)CC=O)=O,4,2,0,2,11,0.000106
G5,C(C(C)(C(CO)CC(CO)=O)O)=O,4,2,0,2,11,0.00010700000000000001
G5,C(CO)(C(CCO)CCO)=O,1,1,0,1,46,5.9e-05
G5,C(CC(CO)CC(CO)=O)(O)=O,2,5,0,5,18,0.00025
G5,C(CO)(C(CCO)CC(O)=O)=O,2,3,0,3,29,0.000165
G5,C(C(CCCC(CO)O)=O)=O,2,2,0,2,7,0.00010700000000000001
G5,C(C(CCC(C)(CO)O)=O)=O,2,3,0,3,29,0.000154
G5,C(CC(CO)C(C(C=C)=O)O)=O,4,2,0,2,7,0.00010700000000000001
G5,C(C(CCO)C(C(C=C)=O)O)=O,4,2,0,2,29,0.000106
G5,C(CO)(CCCC(CO)O)=O,2,2,0,2,11,0.00010700000000000001
G5,C(CO)(CCC(CO)(C)O)=O,2,2,0,2,11,0.00010700000000000001
G5,C1(C(C(CO)CC=O)C(CO1)O)=O,8,2,0,2,8,0.000106
G5,C1(C(C(CO1)O)C(C=O)CCO)=O,8,1,0,1,8,5.9e-05
G5,C1(CC(CO1)(C(CO)CC=O)O)=O,4,2,0,2,8,0.000106
G5,C(C(CCO)C1(COC(C1)=O)O)=O,4,1,0,1,8,5.9e-05
G5,C1(CC(C(C(CO)CC=O)O1)O)=O,8,2,0,2,8,0.000106
G5,C(C(CCO)C1C(CC(O1)=O)O)=O,8,1,0,1,8,5.9e-05
G5,C(C(C)(C(CO)CC=O)O)=O,4,2,0,2,29,0.00010700000000000001
G5,C(C(CCO)C(C=O)(C)O)=O,4,2,0,2,29,0.000106
G5,C(C(CCO)C(C(CO)O)O)=O,8,4,0,4,29,0.000223
G5,C(CC(CO)C(CO)(CO)O)=O,2,2,0,2,29,0.000106
G5,C(CC(CO)C(C)O)=O,4,2,0,2,27,0.000106
G5,C(C(CCO)C(C)O)=O,4,1,0,1,27,5.9e-05
G5,C(C(C(C(C(O)=O)O)O)CCO)=O,8,1,0,1,43,5.9e-05
G5,C(CC(CO)CC=O)(O)=O,2,3,0,3,18,0.000155
G5,C(C(CCO)CC(O)=O)=O,2,4,0,4,29,0.000213
G5,C(CC(CO)C1C(C(CO1)O)=O)=O,8,2,0,2,10,0.00010700000000000001
G5,C(C(CCO)C1C(C(CO1)O)=O)=O,8,1,0,1,10,5.9e-05
G5,C(CC(CO)C1(C(COC1)=O)O)=O,4,2,0,2,10,0.00010700000000000001
G5,C(C(CCO)C1(C(COC1)=O)O)=O,4,1,0,1,10,5.9e-05
G5,C(CC(CO)C1C(C(CO1)=O)O)=O,8,2,0,2,10,0.00010700000000000001
G5,C(C(C1C(C(CO1)=O)O)CCO)=O,8,1,0,1,10,5.9e-05
G5,C(CC(CO)C1(C(CCO1)=O)O)=O,4,2,0,2,34,0.00010700000000000001
G5,C(C(CCO)C1(C(CCO1)=O)O)=O,4,1,0,1,34,5.9e-05
G5,C(CC(CO)C1C(C(O)OC1)=O)=O,8,2,0,2,34,0.00010700000000000001
G5,C(C(CCO)C1C(C(O)OC1)=O)=O,8,1,0,1,34,5.9e-05
G5,C(CC(CO)C1CC(C(O)O1)=O)=O,8,2,0,2,34,0.00010700000000000001
G5,C(C(C1CC(C(O)O1)=O)CCO)=O,8,1,0,1,34,5.9e-05
G5,C(CO)(C(C(CCO)CCO)O)=O,2,1,0,1,46,5.9e-05
G5,C(CO)(C(C(C(C)O)CCO)O)=O,8,1,0,1,46,5.9e-05
G5,C(C(C(C(CO)CCO)O)O)O,8,1,0,1,29,5.9e-05
G5,C(C(C(C(CO)CCO)O)O)(O)=O,8,1,0,1,29,5.9e-05
G5,C(CO)(C(CO)CC(C)=O)=O,2,3,0,3,29,0.000154
G5,C(C(C)=O)(CC(CO)CO)=O,1,3,0,3,29,0.000154
G5,C(CC(CC(CO)CO)=O)=O,1,3,0,3,29,0.000154
G5,C(C(CO)CC(CCO)=O)=O,2,3,0,3,29,0.000154
G5,C(CC(C(CO)CCO)=O)=O,2,1,0,1,29,5.9e-05
G5,C(C(CO)CC=O)(CCO)=O,2,3,0,3,29,0.000154
G5,C(C(CCO)=O)(CCCO)=O,1,4,0,4,29,0.00020099999999999998
G5,C(C1C(C(C(C1CO)O)O)O)O,10,1,0,1,55,5.9e-05
G5,C(CC(CCO)C(C(CO)O)O)O,4,1,0,1,46,5.9e-05
G5,CC(C(CCO)C(C(CO)O)O)O,16,1,0,1,46,5.9e-05
G5,C(CO)(C(CCO)CC(C)=O)=O,2,2,0,2,46,0.000106
G5,C(CO)(C(C(C)O)CC(C)=O)=O,4,3,0,3,29,0.000154
G5,C(C)(C(CCO)CC(CO)=O)=O,2,3,0,3,29,0.000154
G5,C(C)(C(C(C)O)CC(CO)=O)=O,4,3,0,3,29,0.000154
G5,C(CC(CCO)CC(CO)=O)=O,2,5,0,5,46,0.00024900000000000004
G5,C(C(CC(CCO)CCO)=O)=O,1,2,0,2,46,0.000106
G5,C(CC(C(C)O)CC(CO)=O)=O,4,5,0,5,46,0.00024900000000000004
G5,C(C(CC(CCO)C(C)O)=O)=O,4,2,0,2,46,0.000106
G5,C(C(C)=O)(CC(CO)CCO)=O,2,3,0,3,29,0.000154
G5,C(C(C)=O)(CC(CO)C(C)O)=O,4,3,0,3,29,0.000154
G5,C(C(C)=O)(C(CCO)CCO)=O,1,1,0,1,46,5.9e-05
G5,C(C(C)=O)(C(CCO)C(C)O)=O,4,1,0,1,46,5.9e-05
G5,C(CC(CC(CO)CCO)=O)=O,2,3,0,3,29,0.000154
G5,C(C(CCO)CC(CCO)=O)=O,2,2,0,2,29,0.000106
G5,C(CC(CC(CO)C(C)O)=O)=O,4,3,0,3,29,0.000154
G5,C(C(C(C)O)CC(CCO)=O)=O,4,3,0,3,29,0.000154
G5,C(CC(C(CCO)CCO)=O)=O,1,1,0,1,29,5.9e-05
G5,C(C(CCO)CC=O)(CCO)=O,2,3,0,3,29,0.000154
G5,C(CC(C(CCO)C(C)O)=O)=O,4,1,0,1,46,5.9e-05
G5,C(C(C(C)O)CC=O)(CCO)=O,4,3,0,3,29,0.000154
G5,C(CCCCO)(CC(CO)=O)=O,1,3,0,3,29,0.000154
G5,C(CCC(C)O)(CC(CO)=O)=O,2,3,0,3,29,0.000154
G5,C(C(CCO)=O)(CCCCO)=O,1,3,0,3,29,0.000154
G5,C(C(CCO)=O)(CCC(C)O)=O,2,4,0,4,29,0.00020099999999999998
G5,C(C1C(C(C(C1CCO)O)O)O)O,32,1,0,1,46,5.9e-05
G5,CC(C1C(C(C(C1CO)O)O)O)O,64,1,0,1,46,5.9e-05
G5,C(CC(C(CO)=O)CC(C)=O)(O)=O,2,3,0,3,18,0.000154
G5,C(CC(C(C)=O)CC(CO)=O)(O)=O,2,2,0,2,18,0.000106
G5,C(CC(CC=O)CC(CO)=O)(O)=O,2,4,0,4,18,0.00020299999999999997
G5,C(CC(CCO)CC(C=O)=O)(O)=O,2,5,0,5,46,0.000261
G5,C(CC(CO)CC(C(C)=O)=O)(O)=O,2,3,0,3,18,0.000154
G5,C(CC(C(C(C)=O)=O)CCO)(O)=O,2,3,0,3,29,0.000165
G5,C(CC(CC(CO)CC(O)=O)=O)=O,2,3,0,3,18,0.000154
G5,C(CC(C=O)CC(O)=O)(CCO)=O,2,3,0,3,18,0.000154
G5,C(C(CCO)CC(O)=O)(CC=O)=O,2,3,0,3,29,0.000165
G5,C(CC(C(CCO)=O)CC=O)(O)=O,2,3,0,3,18,0.000155
G5,C(CCCC(CC(CO)=O)=O)(O)=O,1,3,0,3,18,0.000154
G5,C(CCCC(C(CCO)=O)=O)(O)=O,1,3,0,3,18,0.000154
G5,C(C(C(C(CO)=O)CC(C)=O)O)=O,4,2,0,2,0,0.00010700000000000001
G5,C(C(C(CCO)CC(C=O)=O)O)=O,4,4,0,4,29,0.000213
G5,C(C(C(CO)CC(C(C)=O)=O)O)=O,4,3,0,3,0,0.000155
G5,C(C(C(C(C(C)=O)=O)CCO)O)=O,4,3,0,3,46,0.000165
G5,C(CC(CO)C(C=O)O)(CC=O)=O,4,4,0,4,29,0.000213
G5,C(CC(C=O)C(C=O)O)(CCO)=O,4,3,0,3,23,0.000166
G5,C(C(CCO)C(C=O)O)(CC=O)=O,4,4,0,4,29,0.00022400000000000002
G5,C(C(C(C(CCO)=O)CC=O)O)=O,4,3,0,3,0,0.000166
G5,C(C(CCC(CC(CO)=O)=O)O)=O,2,3,0,3,0,0.000166
G5,C(CO)(CC(CO)CC(C=O)=O)=O,2,5,0,5,55,0.00025
G5,C(CO)(C(CCO)CC(C=O)=O)=O,2,4,0,4,12,0.000213
G5,C(CC(CO)C(C=O)C(CO)=O)=O,4,3,0,3,55,0.000155
G5,C(C(CCO)C(C=O)C(CO)=O)=O,4,3,0,3,55,0.000154
G5,C(CC(CO)C(C(CC=O)=O)O)=O,4,4,0,4,26,0.00022400000000000002
G5,C(C(CCO)C(C(CC=O)=O)O)=O,4,3,0,3,29,0.000165
G5,C(CC(CO)C(C=O)(C(C)=O)O)=O,4,2,0,2,1,0.00010700000000000001
G5,C(C(CCO)C(C=O)(C(C)=O)O)=O,4,2,0,2,1,0.00010700000000000001
G5,C(C(CCO)CC(C(C=O)O)=O)=O,4,4,0,4,29,0.000213
G5,C(CC(CO)C(C(C)=O)(CO)O)=O,4,2,0,2,43,0.00010700000000000001
G5,C(C(CCO)C(C(C)=O)(CO)O)=O,4,3,0,3,25,0.000156
G5,C(C(C(C(C(C)=O)O)O)CCO)=O,8,2,0,2,29,0.000117
G5,C(C(C(CC(C=O)=O)O)CCO)=O,4,3,0,3,43,0.000165
G5,C(CC(CO)C(C(CCO)=O)O)=O,4,2,0,2,3,0.00010700000000000001
G5,C(CC(CO)C(C(CO)=O)CO)=O,4,3,0,3,43,0.000155
G5,C(C(C(CC(CO)=O)O)CCO)=O,4,1,0,1,43,5.9e-05
G5,C(CO)(CC(CO)CC(CO)=O)=O,1,3,0,3,49,0.000155
G5,C(C)(C(C(CO)CC(CO)=O)O)=O,4,3,0,3,49,0.000155
G5,C(CC(CO)C(C=O)C(C=O)O)=O,8,3,0,3,43,0.000155
G5,C(CO)(C(C(CO)O)CC(C)=O)=O,4,2,0,2,46,0.000106
G5,C(C)(C(C(CO)O)CC(CO)=O)=O,4,2,0,2,46,0.000106
G5,C(C(C)=O)(CC(CO)C(CO)O)=O,4,2,0,2,46,0.000106
G5,C(C(C)=O)(C(CCO)C(CO)O)=O,4,2,0,2,46,0.000117
G5,C(CC(CC(CO)C(CO)O)=O)=O,4,2,0,2,46,0.000106
G5,C(C(C(CO)O)CC(CCO)=O)=O,4,2,0,2,46,0.000106
G5,C(CC(C(CCO)C(CO)O)=O)=O,4,2,0,2,29,0.000117
G5,C(C(C(CO)O)CC=O)(CCO)=O,4,2,0,2,46,0.000106
G5,C(CCC(CO)O)(CC(CO)=O)=O,2,2,0,2,46,0.000106
G5,C(C(CCO)=O)(CCC(CO)O)=O,2,2,0,2,46,0.000106
G5,C(C(C(C(CO)CCO)O)O)=O,8,1,0,1,55,5.9e-05
G5,C(C(C(C(C(C)O)CCO)O)O)=O,16,1,0,1,46,5.9e-05
G5,C=CC(C(CO)(CO)O)=O,1,7,0,7,7,0.00034700000000000003
G5,C=CC(COC(CO)O)=O,2,2,0,2,4,0.000106
G5,C=CC(C(CO)OCO)=O,2,2,0,2,37,0.000106
G5,C(C(C=O)O)(CC=CCO)=O,4,2,0,2,29,0.000106
G5,C(C(C(C=CCCO)=O)O)=O,4,3,0,3,46,0.000154
G5,C(CC=CCO)=O,2,4,0,4,29,0.00020099999999999998
G5,C(CCO)=CC=O,2,6,0,6,46,0.000296
G5,C(C1C(C(CC1(C=O)O)O)O)(O)=O,16,2,0,2,29,0.000106
G5,C(C1C(C(CC1(CO)O)O)O)(O)=O,16,3,0,3,29,0.000154
G5,C(C1C(C(C(C1(C)O)O)O)O)(O)=O,32,3,0,3,29,0.000154
G5,C(C1C(C(CC1O)O)O)(O)=O,16,3,0,3,29,0.000154
G5,C(C1C(CO)(O)OCC1O)(O)=O,8,3,0,3,29,0.000154
G5,C(C1C(C(C(C1)=O)(CO)O)O)(O)=O,8,6,0,6,29,0.0003
G5,C(C1C(CC(C1(CO)O)=O)O)(O)=O,8,3,0,3,29,0.000156
G5,C(C1C=CC(C1O)=O)(O)=O,4,2,0,2,29,0.000106
G5,C(C(C(O)=O)C(CO)(CO)O)(O)=O,1,2,0,2,29,0.00010700000000000001
G5,C(C(C(O)=O)C(C(CO)O)O)(O)=O,4,2,0,2,17,0.00010700000000000001
G5,C(C(C(O)=O)C(C(C)=O)O)(O)=O,2,2,0,2,17,0.00010700000000000001
G5,C(C(C(O)=O)C(C=O)(C)O)(O)=O,2,2,0,2,17,0.00010700000000000001
G5,C(C(CO)C(CCO)O)(O)=O,4,2,0,2,18,0.00010700000000000001
G5,C(C(CO)C(CC(C)O)O)(O)=O,8,2,0,2,28,0.00010700000000000001
G5,C(C(C(C)O)C(CCO)O)(O)=O,8,2,0,2,18,0.00010700000000000001
G5,C(C(CO)C(C(C(C)O)O)O)(O)=O,16,2,0,2,28,0.000106
G5,C(C(CO)C(CC(CO)O)O)(O)=O,8,2,0,2,6,0.000106
G5,C(C(CO)C(C(C)=O)(CO)O)(O)=O,4,2,0,2,25,0.00010700000000000001
G5,C(C(CO)C(C(CO)=O)(C)O)(O)=O,4,2,0,2,25,0.00010700000000000001
G5,C(C(CO)C(CO)(C(C)O)O)(O)=O,8,2,0,2,25,0.00010700000000000001
G5,C(C(CO)C(C(CCO)O)O)(O)=O,8,2,0,2,29,0.000106
G5,C(C(CO)C(C(O)=O)(C)O)(O)=O,4,2,0,2,28,0.00010700000000000001
G5,C(C(C(O)=O)CO)(O)=O,1,2,0,2,18,0.00010700000000000001
G5,C(C(CO)C(C(C(O)=O)O)O)(O)=O,8,3,0,3,18,0.000154
G5,C(C(CO)C(C(C)=O)(C)O)(O)=O,4,2,0,2,14,0.00010700000000000001
G5,C(C(CO)C(C)(CC=O)O)(O)=O,4,2,0,2,6,0.00010700000000000001
G5,C(C(CO)C1(COC(C1)O)O)(O)=O,8,2,0,2,35,0.00010700000000000001
G5,C(C(CO)C(C(C=C)=O)O)(O)=O,4,2,0,2,7,0.00010700000000000001
G5,C(C(C=C)(C(C(O)=O)CO)O)=O,4,2,0,2,7,0.00010700000000000001
G5,C(C(CO)C(C=C)(CO)O)(O)=O,4,2,0,2,7,0.00010700000000000001
G5,C(C(CO)C(C=CC=O)O)(O)=O,8,2,0,2,43,0.00010700000000000001
G5,C(C(CO)C(C(C)O)O)(O)=O,8,2,0,2,11,0.00010700000000000001
G5,C(C(CO)C1(COCC1O)O)(O)=O,8,2,0,2,10,0.00010700000000000001
G5,C(C(CO)C1(C(O)OCC1)O)(O)=O,8,2,0,2,34,0.00010700000000000001
G5,C(C(C(O)=O)C(C(C=O)O)O)(O)=O,4,2,0,2,0,0.00010700000000000001
G5,C(C(C(O)=O)C(C)(CO)O)(O)=O,2,2,0,2,29,0.00010700000000000001
G5,C(C(C(C)O)C(CC(C)O)O)(O)=O,16,2,0,2,28,0.00010700000000000001
G5,C(C(C(C)O)C(C=O)(CO)O)(O)=O,8,4,0,4,29,0.000205
G5,C(C(C(C)O)C(C(O)=O)(C)O)(O)=O,8,2,0,2,28,0.00010700000000000001
G5,C(C(C(O)=O)C(C)O)(O)=O,2,2,0,2,4,0.00010700000000000001
G5,C(C(C(C)O)C(C(C)=O)(C)O)(O)=O,8,2,0,2,14,0.00010700000000000001
G5,C(C(C(C)O)C(C)(CC=O)O)(O)=O,8,2,0,2,6,0.00010700000000000001
G5,C(C(C(C)O)C(C(C=C)=O)O)(O)=O,8,2,0,2,7,0.00010700000000000001
G5,C(C(C=C)(C(C(O)=O)C(C)O)O)=O,8,2,0,2,7,0.00010700000000000001
G5,C(C(C(C)O)C(C=C)(CO)O)(O)=O,8,2,0,2,7,0.00010700000000000001
G5,C(C(C(C)O)C(C=CC=O)O)(O)=O,16,2,0,2,43,0.00010700000000000001
G5,C(C(C(C)O)C(C(C)O)O)(O)=O,16,2,0,2,11,0.00010700000000000001
G5,C(C(C(O)=O)C(C(CO)=O)O)(O)=O,2,2,0,2,28,0.00010700000000000001
G5,C(C(C(O)=O)C(C(O)=O)O)(O)=O,2,3,0,3,33,0.000166
G5,C(C(C(O)=O)C(C=O)(CO)O)(O)=O,2,3,0,3,17,0.000156
G5,C(C(C(O)=O)C=CC(C=O)=O)(O)=O,2,1,0,1,17,5.9e-05
G5,C(C(C(C)O)C(CO)(CO)O)(O)=O,4,3,0,3,29,0.000155
G5,C(C(C(C)O)C(C(CO)O)O)(O)=O,16,3,0,3,29,0.000155
G5,C(C(C(C)O)C(C(C)=O)O)(O)=O,8,3,0,3,45,0.000156
G5,C(C(C(C)O)C(C=O)(C)O)(O)=O,8,3,0,3,29,0.000156
G5,C(C(C(C)O)C(C)(CO)O)(O)=O,8,3,0,3,29,0.000155
G5,C(CC1(CC(C(C1O)O)O)O)(O)=O,16,1,0,1,4,5.9e-05
G5,C(CC(CC(CO)(CO)O)O)(O)=O,2,1,0,1,4,5.9e-05
G5,C(CC(CC(C(CO)O)O)O)(O)=O,8,1,0,1,29,5.9e-05
G5,C(C(CC(C=O)(CC(O)=O)O)O)=O,4,1,0,1,20,5.9e-05
G5,C(C(CC(C)O)(CC(O)=O)O)=O,4,1,0,1,4,5.9e-05
G5,C(CC(CC(C(C)=O)O)O)(O)=O,4,1,0,1,45,5.9e-05
G5,C(C(C)(CC(CC(O)=O)O)O)=O,4,1,0,1,18,5.9e-05
G5,C(CC(CCO)(C(C=O)O)O)(O)=O,4,1,0,1,0,5.9e-05
G5,C(CC(CCO)(C(CO)O)O)(O)=O,4,1,0,1,29,5.9e-05
G5,C(C(C(CO)CO)(CC(O)=O)O)=O,2,1,0,1,29,5.9e-05
G5,C(CC(C(CO)C(C=O)O)O)(O)=O,8,1,0,1,43,5.9e-05
G5,C(CC(CCO)O)(O)=O,2,2,0,2,29,0.000106
G5,C(CC(CC(C(C=O)O)O)O)(O)=O,8,1,0,1,45,5.9e-05
G5,C(CC(CO)(CC(C)O)O)(O)=O,4,1,0,1,11,5.9e-05
G5,C(CC(C)(C(C(C)O)O)O)(O)=O,8,1,0,1,4,5.9e-05
G5,C(CC(CC(C)(CO)O)O)(O)=O,4,1,0,1,18,5.9e-05
G5,C(CC(CC(C)O)O)(O)=O,4,1,0,1,28,5.9e-05
G5,C(C(C(C)O)C(C)O)(O)=O,3,2,0,2,4,0.00010700000000000001
G5,C(C(CC(CO)O)(CC(O)=O)O)=O,4,1,0,1,4,5.9e-05
G5,C(CC(C(C(C)O)O)O)(O)=O,8,1,0,1,28,5.9e-05
G5,C(CC(CC(C(CO)=O)O)O)(O)=O,4,1,0,1,41,5.9e-05
G5,C(C)(C(CO)(CC(O)=O)O)=O,2,3,0,3,29,0.000156
G5,C(CC(O)=O)(O)=O,1,2,0,2,17,0.000106
G5,C(CC(CO)(CC(O)=O)O)(O)=O,1,1,0,1,29,5.9e-05
G5,C(CC(C)(C(C(O)=O)O)O)(O)=O,4,3,0,3,33,0.000165
G5,C(CC(C(C(O)=O)O)O)(O)=O,4,3,0,3,33,0.000165
G5,C(CC(C(CC(O)=O)O)O)(O)=O,3,1,0,1,29,5.9e-05
G5,C(CC(C(CC(C)=O)=O)O)(O)=O,2,2,0,2,29,0.000106
G5,C(C(C)(CC(O)=O)O)(CC=O)=O,2,2,0,2,29,0.000106
G5,C(C)(C(C)(CC(O)=O)O)=O,2,2,0,2,29,0.000106
G5,C(CC1(COC(C1)O)O)(O)=O,4,2,0,2,29,0.000106
G5,C(CC1(COC(C(C1)O)O)O)(O)=O,8,2,0,2,29,0.000106
G5,C(CC(C=CC(CO)=O)O)(O)=O,4,2,0,2,29,0.000106
G5,C(CC(C=CC=O)(CO)O)(O)=O,4,2,0,2,29,0.000106
G5,C(CC(C(C=C)=O)O)(O)=O,2,2,0,2,29,0.000106
G5,C(C(C=C)(CC(O)=O)O)=O,2,3,0,3,29,0.000154
G5,C(CC(C=C)(CO)O)(O)=O,2,2,0,2,29,0.000106
G5,C(CC(C=CC=O)O)(O)=O,4,3,0,3,29,0.000154
G5,C(CC(C(C)O)(C(C=O)O)O)(O)=O,8,1,0,1,45,5.9e-05
G5,C(CC(C(C)O)O)(O)=O,4,2,0,2,11,0.000106
G5,C(CC(C(CO)(CO)O)O)(O)=O,2,1,0,1,18,5.9e-05
G5,C(CC(C(CO)(C(C)O)O)O)(O)=O,8,1,0,1,4,5.9e-05
G5,C(CC(C(C(C)=O)(CO)O)O)(O)=O,4,5,0,5,28,0.00025299999999999997
G5,C(C(CO)(C(C)(CC(O)=O)O)O)=O,4,5,0,5,6,0.00025299999999999997
G5,C(CC(C)(C(CO)(CO)O)O)(O)=O,2,1,0,1,29,5.9e-05
G5,C(C(CO)(C(CC(O)=O)O)O)=O,4,5,0,5,28,0.00025299999999999997
G5,C(C(C(CC(O)=O)O)(C(C)O)O)=O,8,5,0,5,28,0.000252
G5,C(C(CO)(CC(CC(O)=O)O)O)=O,4,2,0,2,29,0.00010800000000000001
G5,C(CC(C(C=CC(C)=O)=O)O)(O)=O,4,1,0,1,29,5.9e-05
G5,C(C(C=CC(C)=O)(CC(O)=O)O)=O,4,1,0,1,29,5.9e-05
G5,C(CC(C=CC(C=O)=O)(C)O)(O)=O,4,1,0,1,29,5.9e-05
G5,C(CC=CC(C(CC(O)=O)O)=O)=O,4,1,0,1,13,5.9e-05
G5,C(C(C=CCC=O)(CC(O)=O)O)=O,4,1,0,1,29,5.9e-05
G5,C(CC(CC=CC(C=O)=O)O)(O)=O,4,1,0,1,29,5.9e-05
G5,C(C(C=CC(C=O)=O)C(C)O)(O)=O,8,1,0,1,46,5.9e-05
G5,C(CC(C=CC(C(C)=O)=O)O)(O)=O,4,1,0,1,21,5.9e-05
G5,C(CC(C(C)=O)(C=CC=O)O)(O)=O,4,1,0,1,21,5.9e-05
G5,C(CC(C(C=CC=O)=O)(C)O)(O)=O,4,1,0,1,29,5.9e-05
G5,C(CC(C=CC(CC(O)=O)O)=O)=O,4,1,0,1,29,5.9e-05
G5,C(CC(C(CC(C=C)=O)=O)O)(O)=O,2,1,0,1,7,5.9e-05
G5,C(CC(C=O)(CC(C=C)=O)O)(O)=O,2,1,0,1,29,5.9e-05
G5,C(CC(C=C)(CC(C=O)=O)O)(O)=O,2,1,0,1,29,5.9e-05
G5,C(CC(CC(C(C=C)=O)=O)O)(O)=O,2,1,0,1,29,5.9e-05
G5,C(CC=O)(C(C=C)(CC(O)=O)O)=O,2,1,0,1,29,5.9e-05
G5,C(CC(C(CC=CC=O)=O)O)(O)=O,4,1,0,1,29,5.9e-05
G5,C(CC(C=O)(CC=CC=O)O)(O)=O,4,1,0,1,29,5.9e-05
G5,C(CC(C=CCC(C=O)=O)O)(O)=O,4,1,0,1,29,5.9e-05
G5,C(CC1(COCC1O)O)(O)=O,4,1,0,1,10,5.9e-05
G5,C(CC1(C(O)OCC1)O)(O)=O,4,2,0,2,29,0.000106
G5,C(C)(CC(C(C(O)=O)=O)=O)=O,1,3,0,3,29,0.000154
G5,C(CCC(C(C(O)=O)=O)=O)=O,1,3,0,3,29,0.000154
G5,C(CC(CC(C(O)=O)=O)=O)=O,1,5,0,5,29,0.00024900000000000004
G5,C(CO)=CC(C(C(O)=O)=O)=O,2,2,0,2,29,0.000106
G5,C=CC(C(C(C(O)=O)=O)O)=O,2,2,0,2,29,0.000106
G5,C(C(C=CC(CO)=O)=O)(O)=O,2,5,0,5,29,0.00024900000000000004
G5,C(C(C1(CC(CO1)O)O)=O)(O)=O,4,2,0,2,29,0.000106
G5,C(C(C1C(CC(O1)O)O)=O)(O)=O,8,2,0,2,33,0.000106
G5,C(C(C(CO)(CO)O)=O)(O)=O,1,3,0,3,0,0.00015800000000000002
G5,C(CC(C(C(O)=O)=O)(CO)O)=O,2,1,0,1,29,5.9e-05
G5,C(C(C(C(C(O)=O)=O)(C)O)O)=O,4,2,0,2,0,0.00010700000000000001
G5,C(C(C(C)(C(CO)O)O)=O)(O)=O,4,2,0,2,0,0.00010700000000000001
G5,C(C(C(C(O)=O)=O)(CCO)O)=O,2,1,0,1,29,5.9e-05
G5,C(C(C(CO)(CCO)O)=O)(O)=O,2,2,0,2,29,0.000117
G5,C(C(C(CO)(C(CO)O)O)=O)(O)=O,4,3,0,3,0,0.000156
G5,C(CC(CCC=O)=O)(O)=O,1,4,0,4,29,0.00020099999999999998
G5,C(CC(CCC(O)=O)=O)=O,1,3,0,3,29,0.000154
G5,C(COCC(CO)=O)(O)=O,1,2,0,2,29,0.000106
G5,C(COC(C(C)=O)O)(O)=O,2,2,0,2,29,0.000106
G5,C(CO)(C(COCC(O)=O)O)=O,2,1,0,1,36,5.9e-05
G5,C(CC(OCC(CO)=O)O)(O)=O,2,1,0,1,38,5.9e-05
G5,C(C=CC(O)=O)(O)=O,2,2,0,2,29,0.000106
G5,C(C)(COCC(C(O)=O)=O)=O,1,2,0,2,29,0.000106
G5,C(CC(C)=O)(OCC(O)=O)=O,1,2,0,2,29,0.000106
G5,C(COCC(C(C)=O)=O)(O)=O,1,2,0,2,29,0.000106
G5,C(C(C(CO)OCC(O)=O)O)=O,4,2,0,2,29,0.000106
G5,C(C(C(CO)OCC=O)O)(O)=O,4,1,0,1,26,5.9e-05
G5,C(COC(C=O)CC=O)(O)=O,2,3,0,3,29,0.000154
G5,C(CC(C=O)OCC=O)(O)=O,2,2,0,2,29,0.000106
G5,C(COC(C(C=O)=O)C)(O)=O,2,3,0,3,29,0.000154
G5,C(COC(C(C(O)=O)=O)C)=O,2,2,0,2,29,0.000106
G5,C(C(C(COCC(O)=O)O)O)=O,4,2,0,2,29,0.000106
G5,C(C(C(COCC=O)O)O)(O)=O,4,1,0,1,37,5.9e-05
G5,C(COC(C(CO)=O)CO)(O)=O,2,1,0,1,2,5.9e-05
G5,C(C)(C(CO)(OCC(O)=O)O)=O,2,1,0,1,2,5.9e-05
G5,C(C(CO)(OCC(C)=O)O)(O)=O,2,1,0,1,2,5.9e-05
G5,C(C(C(O)=O)O)(OCC(C)=O)=O,2,1,0,1,2,5.9e-05
G5,C(C(CO)OC(C(C)=O)=O)(O)=O,2,1,0,1,50,5.9e-05
G5,C(C)(C(CO)OC(C(O)=O)=O)=O,2,1,0,1,2,5.9e-05
G5,C(C(COC(C(C)=O)=O)O)(O)=O,2,1,0,1,27,5.9e-05
G5,C(CC(CO)=O)(OCC(O)=O)=O,1,1,0,1,2,5.9e-05
G5,C(C(C(C)=O)O)(OCC(O)=O)=O,2,1,0,1,2,5.9e-05
G5,C(C)(C(COC(C(O)=O)=O)O)=O,2,1,0,1,2,5.9e-05
G5,C(CO)(CCOC(C(O)=O)=O)=O,1,1,0,1,2,5.9e-05
G5,C(C=C(C(CO)=O)CO)(O)=O,2,2,0,2,29,0.000106
G5,C(COC=CC(CO)=O)(O)=O,2,2,0,2,29,0.000106
G5,C(COC(CO)=CC=O)(O)=O,2,3,0,3,29,0.000154
G5,C(COC(CO)=CC(O)=O)=O,2,2,0,2,29,0.000106
G5,C(C(C(OCC(O)=O)=C)O)=O,2,3,0,3,29,0.000154
G5,C(C(C(OCC=O)=C)O)(O)=O,2,2,0,2,29,0.000106
G5,C(COC(C=CC=O)O)(O)=O,4,3,0,3,29,0.000154
G5,C(COC(C=CC(O)=O)O)=O,4,2,0,2,29,0.000106
G5,C(C(C=COCC(O)=O)O)=O,4,3,0,3,29,0.000154
G5,C(C(C=COCC=O)O)(O)=O,4,2,0,2,29,0.000106
G5,C(C(C(CO)OC(C(O)=O)O)O)=O,8,2,0,2,29,0.000106
G5,C(C(C(CO)OC(C=O)O)O)(O)=O,8,3,0,3,0,0.000154
G5,C(CC(CO)OC(C(O)=O)O)=O,4,2,0,2,29,0.000106
G5,C(CC(CO)OC(C=O)O)(O)=O,4,1,0,1,41,5.9e-05
G5,C(C(CO)OC(C(CO)=O)O)(O)=O,4,1,0,1,29,5.9e-05
G5,C(C(C(COC(C(O)=O)O)O)O)=O,8,2,0,2,29,0.000106
G5,C(C(C(COC(C=O)O)O)O)(O)=O,8,3,0,3,15,0.000154
G5,C(CC(COC(C(O)=O)O)O)=O,4,2,0,2,29,0.000106
G5,C(CC(COC(C=O)O)O)(O)=O,4,1,0,1,30,5.9e-05
G5,C(CC(C(OCC(O)=O)O)O)=O,4,2,0,2,29,0.000106
G5,C(CC(C(OCC=O)O)O)(O)=O,4,1,0,1,37,5.9e-05
G5,C(C(C)(OCC(CO)=O)O)(O)=O,2,1,0,1,24,5.9e-05
G5,C(CO)(C(C)OC(C(O)=O)O)=O,4,1,0,1,24,5.9e-05
G5,C(C(COC(C(CO)=O)O)O)(O)=O,4,1,0,1,2,5.9e-05
G5,C(CC(C=O)O)(OCC(O)=O)=O,2,2,0,2,29,0.000106
G5,C(CC(C(O)=O)O)(OCC=O)=O,2,2,0,2,29,0.000106
G5,C(C(CC=O)CC(CO)=O)(O)=O,2,3,0,3,43,0.000155
G5,C(CCCC(C(O)=O)=O)=O,1,5,0,5,29,0.00025
G5,C(CC(C(O)=O)CC=O)=O,1,2,0,2,43,0.00010800000000000001
G5,C(C(COC(C=O)CO)O)(O)=O,4,1,0,1,2,5.9e-05
G5,C(OC(CO)CC(C(O)=O)O)=O,4,1,0,1,2,5.9e-05
G5,C(OCC(CC(C(O)=O)O)O)=O,4,1,0,1,19,5.9e-05
G5,C(C(CCOC(C=O)O)O)(O)=O,4,1,0,1,30,5.9e-05
G5,C(C(CCC(C(O)=O)=O)O)(O)=O,2,4,0,4,33,0.000213
G5,C(C(C=CC(C(O)=O)O)O)(O)=O,6,2,0,2,29,0.000106
G5,C(C(C=CC(C(O)=O)O)(CO)O)=O,8,2,0,2,29,0.00010800000000000001
G5,C(CC(CO)(OCC(O)=O)O)(O)=O,2,2,0,2,29,0.000117
G5,C(C(C(C)(OCC(O)=O)O)O)(O)=O,4,2,0,2,29,0.000117
G5,C(C(CC(OCC(O)=O)O)O)(O)=O,4,2,0,2,29,0.000117
G5,C(C(C(CO)O)(CC(O)=O)O)(O)=O,4,3,0,3,33,0.000166
G5,C(CC=CC(C(O)=O)=O)(O)=O,2,3,0,3,33,0.000165
G5,C(CC(C=CC(O)=O)=O)(O)=O,2,5,0,5,29,0.00026000000000000003
G5,C(CC(C(O)=O)=O)=CC(O)=O,2,4,0,4,29,0.000212
G5,C(C1C(CC(C(O)=O)O1)O)(O)=O,8,2,0,2,29,0.000117
G5,C1(C(CO)(C(C(O)=O)(CC1)O)O)=O,4,6,0,6,29,0.0003
G5,C(C1(C(C(C)(CC1O)O)O)O)(O)=O,16,5,0,5,16,0.00024900000000000004
G5,C(C1(C(O)OCC1(C)O)O)(O)=O,8,4,0,4,29,0.00020099999999999998
G5,C(C1(COCC1(CO)O)O)(O)=O,4,3,0,3,29,0.000154
G5,C(C1(COC(C1(C)O)O)O)(O)=O,8,4,0,4,29,0.00020099999999999998
G5,C(C1(C(C)(O)OCC1O)O)(O)=O,8,4,0,4,29,0.00020099999999999998
G5,C(C(C(O)=O)(C(CO)=O)CO)(O)=O,1,3,0,3,2,0.000156
G5,C(C(C(C(O)=O)=O)(CO)CO)(O)=O,1,3,0,3,17,0.000156
G5,C(C(C=O)(CO)C(C(O)=O)O)(O)=O,4,4,0,4,17,0.000204
G5,C(C(C(O)=O)(CO)C(C=O)O)(O)=O,2,3,0,3,17,0.000156
G5,C(C(C(O)=O)(C(CCO)O)O)(O)=O,2,5,0,5,17,0.000251
G5,C(C(C=O)(C(CC(O)=O)O)O)(O)=O,4,5,0,5,28,0.000251
G5,C(C(C(C(O)=O)=O)(CO)O)(O)=O,2,3,0,3,0,0.000155
G5,C1(C(C(CC(O)=O)O)C(CO1)O)=O,8,2,0,2,8,0.000106
G5,C(C(CO)(C(CC(O)=O)O)O)(O)=O,4,3,0,3,33,0.000154
G5,C(CC(C1(C(COC1)=O)O)O)(O)=O,4,3,0,3,10,0.000154
G5,C(C(C(O)=O)(C(O)=O)O)(O)=O,1,3,0,3,17,0.000155
G5,C(C(C(O)=O)(C(C(O)=O)O)O)(O)=O,2,6,0,6,33,0.000309
G5,C(C(C(O)=O)(C(C(C)O)O)O)(O)=O,4,5,0,5,11,0.000251
G5,C(C(C=C)(C(C=O)(CO)O)O)(O)=O,4,4,0,4,7,0.000202
G5,C(CC(C(C=O)(C(C)=O)O)O)(O)=O,4,3,0,3,1,0.000154
G5,C(C(C(C(C(O)=O)=O)(CO)O)O)=O,4,3,0,3,0,0.000155
G5,C(C(C(CO)(CO)CO)=O)(O)=O,1,2,0,2,2,0.00010800000000000001
G5,C(C(CO)(CO)C(C(O)=O)O)=O,2,3,0,3,2,0.000156
G5,C(C(C(CO)(CO)C(C)O)=O)(O)=O,2,3,0,3,4,0.000157
G5,C(C(CO)(C(C)O)C(C(O)=O)O)=O,8,4,0,4,33,0.000205
G5,C1(C(CO)C(C(CC(O)=O)O1)O)=O,8,2,0,2,29,0.00010800000000000001
G5,C(CC1C(C(CO1)=O)(CO)O)(O)=O,4,3,0,3,29,0.00015800000000000002
G5,C(CC1C(C(CO)(CO1)O)=O)(O)=O,4,3,0,3,29,0.00015800000000000002
G5,C(C1(CO)C(CC(C(O)=O)O1)O)=O,8,3,0,3,29,0.00015800000000000002
G5,C1(C(CO)(C(C(O)=O)OC1C)O)=O,8,3,0,3,29,0.00015800000000000002
G5,C(C(C=O)(C(CC(O)=O)O)O)=O,2,3,0,3,28,0.000154
G5,C(C(C=O)(C(C)(CC(O)=O)O)O)=O,2,3,0,3,1,0.000154
G5,C(C(C=C)(C(C=O)(C=O)O)O)(O)=O,2,4,0,4,7,0.000202
G5,C(C(C=O)(C(C=CC(O)=O)O)O)=O,4,3,0,3,18,0.000154
G5,C(C(C(CO)(C(C)O)O)=O)(O)=O,4,3,0,3,0,0.000156
G5,C(C1(CC(CC1(C=O)O)O)O)(O)=O,8,3,0,3,20,0.000154
G5,C(C1(CC(CO)(CC1O)O)O)(O)=O,8,2,0,2,21,0.000106
G5,C(C1(CC(CC1(CO)O)O)O)(O)=O,8,2,0,2,21,0.000106
G5,C(C1(CC(C(C1(C)O)O)O)O)(O)=O,16,2,0,2,49,0.000106
G5,C(C1(C(C)(C(CO1)O)O)O)(O)=O,8,2,0,2,29,0.000106
G5,C(C1(C(CO)(CCO1)O)O)(O)=O,4,2,0,2,29,0.000106
G5,C(C1(C(COC(C1)O)O)O)(O)=O,8,3,0,3,29,0.000154
G5,C(C(C=O)(CC(C(O)=O)=O)O)(O)=O,2,2,0,2,29,0.00010700000000000001
G5,C(C(C(O)=O)(CC(C=O)=O)O)(O)=O,1,2,0,2,29,0.00010700000000000001
G5,C(C(C(C)=O)(CC(O)=O)O)(O)=O,2,2,0,2,29,0.00010700000000000001
G5,C(C(C=O)(C(C(O)=O)CO)O)(O)=O,4,3,0,3,29,0.000156
G5,C(C(C(C)(C(CCO)O)O)=O)(O)=O,4,2,0,2,18,0.00010700000000000001
G5,C(C(C)(C(C)(CC(O)=O)O)O)(O)=O,4,2,0,2,25,0.000106
G5,C(C(C=C)(C(C(O)=O)(C)O)O)(O)=O,4,3,0,3,28,0.000154
G5,C(C(C)(C(C=CC(O)=O)O)O)(O)=O,8,2,0,2,29,0.000106
G5,C(C(C(CO)=O)(CC(O)=O)O)(O)=O,2,2,0,2,17,0.00010700000000000001
G5,C(CC(C(C(C(O)=O)=O)(C)O)O)=O,4,2,0,2,25,0.00010700000000000001
G5,C(CC(C(C(C=O)=O)(C)O)O)(O)=O,4,2,0,2,25,0.00010700000000000001
G5,C(C(C(C(O)=O)=O)(C)O)(O)=O,2,2,0,2,28,0.00010700000000000001
G5,C(C(C(C(C(O)=O)=O)(C)O)O)(O)=O,4,2,0,2,33,0.00010700000000000001
G5,C(C(C(C)(C(C(C)O)O)O)=O)(O)=O,8,2,0,2,11,0.00010700000000000001
G5,C(CC(C(C(CO)=O)(C)O)O)(O)=O,4,2,0,2,25,0.00010700000000000001
G5,C(C(C(CC(O)=O)O)(CCO)O)=O,4,2,0,2,29,0.00010700000000000001
G5,C(C(C)(C(CC(O)=O)O)O)=O,4,2,0,2,11,0.00010700000000000001
G5,C(CC(C1(C(CCO1)=O)O)O)(O)=O,4,2,0,2,34,0.00010700000000000001
G5,C(C(C(O)=O)(CC(O)=O)O)(O)=O,1,3,0,3,33,0.000166
G5,C(C(C)(C(CC(C(O)=O)=O)O)O)=O,4,2,0,2,11,0.00010700000000000001
G5,C(C(C)(C(C)(CC(O)=O)O)O)=O,4,2,0,2,11,0.00010700000000000001
G5,C(C(C=C)(C(C=O)(C)O)O)(O)=O,4,5,0,5,29,0.00025
G5,C(C(C)(C(C=CC(O)=O)O)O)=O,8,4,0,4,29,0.000202
G5,C(C)(C(C(CO)O)(CC(O)=O)O)=O,4,2,0,2,0,0.00010700000000000001
G5,C(C(C(C(C(O)=O)=O)(C)O)O)(C)=O,4,2,0,2,49,0.00010700000000000001
G5,C(C(C)(C(C(C(O)=O)=O)(C)O)O)=O,4,2,0,2,11,0.00010700000000000001
G5,C(C(CO)(CCC(C(O)=O)=O)O)=O,2,3,0,3,29,0.000156
G5,C(C(CO)(C)O)(CC(C(O)=O)=O)=O,2,2,0,2,24,0.00010800000000000001
G5,C(CC(C(C(C)=O)=O)(CO)O)(O)=O,2,2,0,2,29,0.00010800000000000001
G5,C(CC(C(C(CO)(C)O)=O)=O)(O)=O,2,2,0,2,4,0.00010800000000000001
G5,C(CC(C(C(O)=O)=O)(CO)O)(C)=O,2,2,0,2,29,0.00010800000000000001
G5,C(CCC(C(C(O)=O)=O)(CO)O)=O,2,3,0,3,29,0.000156
G5,C(CCC(C(C=O)=O)(CO)O)(O)=O,2,3,0,3,29,0.000156
G5,C(C(C(C(O)=O)=O)(CO)O)=CCO,4,2,0,2,29,0.00010800000000000001
G5,C(CO)(C(C=CC(O)=O)(CO)O)=O,4,2,0,2,2,0.00010800000000000001
G5,C(CC1CC(C(CO)(O)O1)=O)(O)=O,4,2,0,2,2,0.00010800000000000001
G5,C1(C(CO)(CC(O)=O)OC(C1)O)=O,4,3,0,3,29,0.000156
G5,C1(C(CO)(CC(O)=O)OCC1O)=O,4,2,0,2,29,0.00010800000000000001
G5,C(C(C1(CO)CC(CO1)O)=O)(O)=O,4,2,0,2,29,0.00010800000000000001
G5,C(C1(CO)CC(C(C(O)=O)O1)O)=O,8,2,0,2,29,0.00010800000000000001
G5,C(C1C(C(C(CO)(C)O1)=O)O)(O)=O,8,2,0,2,29,0.00010800000000000001
G5,C(C(C(C)(C(CO)(C)O)O)=O)(O)=O,4,2,0,2,49,0.00010700000000000001
G5,C(CC(C(C=O)(CC=O)O)O)(O)=O,4,2,0,2,43,0.00010700000000000001
G5,C(C)(C(C(C)O)(CC(O)=O)O)=O,4,2,0,2,4,0.00010700000000000001
G5,C(CO)(C(C(C)O)(CC(O)=O)O)=O,4,2,0,2,4,0.00010700000000000001
G5,C(C(C(C)(C(C)O)O)=O)(O)=O,4,2,0,2,4,0.00010700000000000001
G5,C(C(C=C)(C(C(O)=O)O)O)(O)=O,4,5,0,5,29,0.00024900000000000004
G5,C(C(C(C)=O)OC(CO)=O)(O)=O,2,2,0,2,29,0.000106
G5,C(CO)(OC(C(O)=O)CC=O)=O,2,2,0,2,29,0.000106
G5,C(CO)(OC(C=O)CC(O)=O)=O,2,2,0,2,29,0.000106
G5,C(CO)(OCCC(C(O)=O)=O)=O,1,2,0,2,29,0.000106
G5,C(CC(COC(CO)=O)=O)(O)=O,1,2,0,2,29,0.000106
G5,C(C(CCO)(O)OC(CO)=O)(O)=O,2,1,0,1,2,5.9e-05
G5,C(CC(CO)(O)OC(CO)=O)(O)=O,2,1,0,1,17,5.9e-05
G5,C(C(C(C)(O)OC(CO)=O)O)(O)=O,4,1,0,1,14,5.9e-05
G5,C(C(CC(O)OC(CO)=O)O)(O)=O,4,1,0,1,43,5.9e-05
G5,C(C1C(C(CC1)=O)=O)(O)=O,2,3,0,3,29,0.000154
G5,C1(CC(CC1C(O)=O)=O)=O,2,4,0,4,29,0.00020099999999999998
G5,C(C1CC(C(C1)=O)=O)(O)=O,1,3,0,3,29,0.000154
G5,C(C1C(CCC1=O)=O)(O)=O,1,3,0,3,29,0.000154
G5,C(C(CO)CC(C=O)=O)(O)=O,2,1,0,1,55,5.9e-05
G5,C(C(CO)CC(C(O)=O)=O)=O,2,3,0,3,29,0.000154
G5,C(CC(C=O)C(C(CO)=O)O)(O)=O,4,2,0,2,5,0.00010700000000000001
G5,C(C(CO)C(C=O)C(CO)=O)(O)=O,4,1,0,1,55,5.9e-05
G5,C(C(CO)C(C(C=O)=O)CO)(O)=O,4,1,0,1,55,5.9e-05
G5,C(C(CCO)C(C(CO)=O)O)(O)=O,4,1,0,1,55,5.9e-05
G5,C(C(CO)C(C(CO)=O)CO)(O)=O,4,1,0,1,55,5.9e-05
G5,C(C(C)C(C(CO)=O)O)(O)=O,4,1,0,1,49,5.9e-05
G5,C(CCC(C(C(CO)=O)O)=O)(O)=O,2,1,0,1,51,5.9e-05
G5,C(C(CCC(C(CO)=O)=O)O)(O)=O,2,2,0,2,12,0.00010700000000000001
G5,C(C(CO)C(C=O)C(C=O)O)(O)=O,8,1,0,1,29,5.9e-05
G5,C(C(C(C(O)=O)C(C=O)CO)O)=O,8,1,0,1,29,5.9e-05
G5,C(C(CO)CC=O)(O)=O,2,2,0,2,55,0.00010700000000000001
G5,C(C(CC(O)=O)CC(C=O)=O)=O,2,4,0,4,29,0.000202
G5,C(CC(C(O)=O)CC(C=O)=O)=O,2,2,0,2,43,0.00010700000000000001
G5,C(CC(C)=O)(CC(C(O)=O)=O)=O,1,3,0,3,29,0.000154
G5,C(C(CCC(C(C)=O)=O)=O)(O)=O,1,4,0,4,29,0.00020099999999999998
G5,C(C=O)(C(C)CC(C(O)=O)=O)=O,2,2,0,2,29,0.000106
G5,C(C(O)=O)(C(C)CC(C=O)=O)=O,2,2,0,2,29,0.000106
G5,C(CO)(C(C)CC(C(O)=O)=O)=O,2,2,0,2,29,0.000106
G5,C(C(CCO)CC(C=O)=O)(O)=O,2,1,0,1,29,5.9e-05
G5,C(C(CCC(C(O)=O)=O)=O)=O,1,3,0,3,29,0.000154
G5,C(C(C)CC(C(O)=O)=O)=O,2,2,0,2,29,0.000106
G5,C(C(C)CC(C=O)=O)(O)=O,2,1,0,1,28,5.9e-05
G5,C(CCC(CC(C(O)=O)=O)=O)=O,1,2,0,2,29,0.000106
G5,C(CCC(O)=O)(CC(C=O)=O)=O,1,2,0,2,29,0.000106
G5,C(CC(CCC(C(O)=O)=O)=O)=O,1,4,0,4,29,0.00020099999999999998
G5,C(CC(CCC(C=O)=O)=O)(O)=O,1,3,0,3,29,0.000154
G5,C(C(C(CCC(C(O)=O)=O)=O)O)=O,2,1,0,1,29,5.9e-05
G5,C(C(C(CO)O)CC(C(O)=O)=O)=O,4,2,0,2,29,0.000117
G5,C(C(C(CO)O)CC(C=O)=O)(O)=O,4,1,0,1,0,5.9e-05
G5,C(C(C(CO)=O)CC(C(O)=O)=O)=O,2,1,0,1,29,5.9e-05
G5,C(C(C)C(C=O)C(CO)=O)(O)=O,4,1,0,1,49,5.9e-05
G5,C(C(C)C(C(CC=O)=O)O)(O)=O,4,1,0,1,49,5.9e-05
G5,C(CC(C=O)C(C(C)=O)O)(O)=O,4,3,0,3,29,0.000154
G5,C(C(CC=O)C(C(C)=O)O)(O)=O,4,2,0,2,43,0.00010700000000000001
G5,C(CC(C(C(C)=O)=O)CO)(O)=O,2,4,0,4,29,0.00020099999999999998
G5,C(C(C)CC(C(C=O)O)=O)(O)=O,4,1,0,1,49,5.9e-05
G5,C(CC(C(C(O)=O)=O)C)(CO)=O,2,2,0,2,29,0.000106
G5,C(CCC(C(C)=O)=O)(O)=O,1,3,0,3,29,0.000154
G5,C(CC(C(C(O)=O)=O)C)=O,2,3,0,3,29,0.000154
G5,C(CC(C(C=O)=O)C)(O)=O,2,2,0,2,29,0.000106
G5,C(C(C)CC(C(CO)O)=O)(O)=O,4,1,0,1,28,5.9e-05
G5,C(CO)(C(C)CC(O)=O)=O,2,2,0,2,29,0.000106
G5,C(CC(CCC(CO)=O)=O)(O)=O,1,3,0,3,29,0.000154
G5,C(CCC(CC(CO)=O)=O)(O)=O,1,2,0,2,29,0.000106
G5,C(C(CC(C=O)O)CC=O)(O)=O,4,2,0,2,21,0.00010700000000000001
G5,C(C(CC(C(C(C)=O)=O)O)O)(O)=O,4,1,0,1,32,5.9e-05
G5,C(CC(C=CC(C=O)O)=O)(O)=O,4,1,0,1,29,5.9e-05
G5,C(C(C=CC(CC=O)=O)O)(O)=O,4,3,0,3,29,0.000154
G5,C(C(C=CC(C(C)=O)=O)O)(O)=O,4,3,0,3,29,0.000154
G5,C(CC=O)(C(C(C(O)=O)=O)CO)=O,2,1,0,1,2,5.9e-05
G5,C(C(O)=O)(C(CO)CC(C=O)=O)=O,2,1,0,1,29,5.9e-05
G5,C(C=O)(C(CO)CC(C(O)=O)=O)=O,2,1,0,1,29,5.9e-05
G5,C(C(C)C(C(C(O)=O)=O)CO)=O,4,2,0,2,29,0.000106
G5,C(C(C)C(C(C=O)=O)CO)(O)=O,4,1,0,1,29,5.9e-05
G5,C(C(C(C(C)=O)=O)CCO)(O)=O,2,2,0,2,29,0.000106
G5,C(C(C)C(C(CCO)=O)O)(O)=O,4,1,0,1,3,5.9e-05
G5,C(C(C)C(C(CO)=O)CO)(O)=O,4,1,0,1,55,5.9e-05
G5,C(C(CCO)CC(CO)=O)(O)=O,2,2,0,2,46,0.000106
G5,C(C(CCO)C(C(C)=O)O)(O)=O,4,1,0,1,3,5.9e-05
G5,C(C(CCO)CC=O)(O)=O,2,2,0,2,46,0.000106
G5,C(CCC(C(C(C)=O)O)=O)(O)=O,2,2,0,2,29,0.000106
G5,C(C(C)CC(O)=O)(C(C=O)O)=O,4,2,0,2,29,0.000106
G5,C(C(C(C=O)CC(C(O)=O)=O)O)=O,4,1,0,1,29,5.9e-05
G5,C(C(C)CC(CO)=O)(O)=O,2,1,0,1,28,5.9e-05
G5,C(C(C)C(C(C)=O)O)(O)=O,4,1,0,1,27,5.9e-05
G5,C(C(C)C(C=O)C(C=O)O)(O)=O,8,1,0,1,28,5.9e-05
G5,C(C(C(C(O)=O)C(C=O)C)O)=O,8,2,0,2,29,0.000106
G5,C(CC(C(O)=O)C)=O,2,1,0,1,28,5.9e-05
G5,C(C(C)CC(O)=O)=O,2,2,0,2,29,0.000106
G5,C(C(C(CO)O)CC(CO)=O)(O)=O,4,2,0,2,46,0.000106
G5,C(C(C)C(C(C(CO)O)=O)O)(O)=O,8,1,0,1,49,5.9e-05
G5,C(C(C(CO)O)CC(O)=O)=O,4,4,0,4,29,0.000212
G5,C(C(C(CO)O)CC=O)(O)=O,4,3,0,3,7,0.000165
G5,C(C(CCC(C=O)=O)CC(O)=O)=O,2,2,0,2,28,0.000106
G5,C(C(CCC(C(O)=O)=O)CC=O)=O,2,4,0,4,28,0.000202
G5,C(CC(C(O)=O)CCC(C=O)=O)=O,2,2,0,2,28,0.000106
G5,C(CCC(C(O)=O)=O)(CC(C)=O)=O,1,1,0,1,12,5.9e-05
G5,C(C(CCC(C(O)=O)=O)=O)(CC)=O,1,1,0,1,29,5.9e-05
G5,C(C(C)CC(O)=O)(CC(C=O)=O)=O,2,1,0,1,29,5.9e-05
G5,C(C(C)CC=O)(CC(C(O)=O)=O)=O,2,1,0,1,29,5.9e-05
G5,C(CC(CC(C=O)CC=O)=O)(O)=O,2,3,0,3,43,0.000155
G5,C(CC(CC(C(O)=O)CC=O)=O)=O,2,3,0,3,43,0.000155
G5,C(CC(CC(C)=O)=O)(CC(O)=O)=O,1,1,0,1,26,5.9e-05
G5,C(CC(O)=O)(CC(C(CC)=O)=O)=O,1,1,0,1,4,5.9e-05
G5,C(CC(C(C(C)CC(O)=O)=O)=O)=O,2,1,0,1,29,5.9e-05
G5,C(CC(C(C(CC(O)=O)=O)=O)C)=O,2,1,0,1,29,5.9e-05
G5,C(CC(C(CC=O)CC=O)=O)(O)=O,1,2,0,2,46,0.00010700000000000001
G5,C(C)(CC(C(CCC(O)=O)=O)=O)=O,1,1,0,1,26,5.9e-05
G5,C(CC(C(C(O)=O)=O)CC(C)=O)=O,2,2,0,2,27,0.00010700000000000001
G5,C(CC(CCC=O)=O)(CC(O)=O)=O,1,1,0,1,29,5.9e-05
G5,C(CC(CC(CCC(O)=O)=O)=O)=O,1,1,0,1,29,5.9e-05
G5,C(CCC(C(CCC(O)=O)=O)=O)=O,1,1,0,1,29,5.9e-05
G5,C(CCC(C(C=O)=O)CC(O)=O)=O,2,1,0,1,44,5.9e-05
G5,C(CCC(C(C(O)=O)=O)CC=O)=O,2,1,0,1,44,5.9e-05
G5,C(CC(C(C=O)=O)CCC(O)=O)=O,2,2,0,2,44,0.000106
G5,C(CC(CCC(C(C)=O)=O)=O)(O)=O,1,1,0,1,21,5.9e-05
G5,C(CCC(O)=O)(CC(C(C)=O)=O)=O,1,1,0,1,21,5.9e-05
G5,C(CC(CCC(CC(O)=O)=O)=O)=O,1,1,0,1,6,5.9e-05
G5,C(CC(O)=O)(CC(C=CCO)=O)=O,2,1,0,1,29,5.9e-05
G5,C(CCC(C(C=CCO)=O)=O)(O)=O,2,1,0,1,29,5.9e-05
G5,C(CC(C=CCO)C(C=O)=O)(O)=O,4,1,0,1,29,5.9e-05
G5,C(CC(C=CCO)C(C(O)=O)=O)=O,4,1,0,1,29,5.9e-05
G5,C(CC(C(CO)=O)C=CC=O)(O)=O,4,1,0,1,29,5.9e-05
G5,C(CC(C(CO)=O)C=CC(O)=O)=O,4,1,0,1,29,5.9e-05
G5,C(CCC(C(C(C=C)=O)O)=O)(O)=O,2,1,0,1,7,5.9e-05
G5,C(C(C=O)O)(C(C=C)CC(O)=O)=O,4,1,0,1,29,5.9e-05
G5,C(C(C(O)=O)O)(C(C=C)CC=O)=O,4,1,0,1,29,5.9e-05
G5,C(CC(O)=O)(CC=CC(CO)=O)=O,2,1,0,1,32,5.9e-05
G5,C(CCC(C=CC(CO)=O)=O)(O)=O,2,1,0,1,32,5.9e-05
G5,C(C(C=CC(C=O)O)CC(O)=O)=O,8,1,0,1,29,5.9e-05
G5,C(C(C=CC(C(O)=O)O)CC=O)=O,8,1,0,1,29,5.9e-05
G5,C(C(C=CC(C=O)O)CC=O)(O)=O,8,1,0,1,29,5.9e-05
G5,C(C(C=CC(CC(C)=O)=O)O)(O)=O,4,1,0,1,29,5.9e-05
G5,C(C(C=CC(C(CC)=O)=O)O)(O)=O,4,1,0,1,32,5.9e-05
G5,C(CCC(C(C=CC=O)O)=O)(O)=O,4,1,0,1,29,5.9e-05
G5,C(CCC(C(C=CC(O)=O)O)=O)=O,4,1,0,1,29,5.9e-05
G5,C(CC(C(C=O)=O)CO)(O)=O,2,2,0,2,29,0.000106
G5,C(CC(C=O)C(C=O)O)(O)=O,4,3,0,3,0,0.000155
G5,C(C(CC=O)C(C=O)O)(O)=O,4,3,0,3,29,0.000155
G5,C(C(C(CO)=O)CC(O)=O)=O,2,2,0,2,29,0.000106
G5,C(C(CC(C=O)O)C(C=O)O)(O)=O,8,1,0,1,29,5.9e-05
G5,C(CC(C(CO)=O)C(C=O)O)(O)=O,4,2,0,2,0,0.00010700000000000001
G5,C(C(CCO)C(C=O)O)(O)=O,4,2,0,2,46,0.000117
G5,C(C(C)C(C(O)=O)O)(C(C=O)O)=O,8,1,0,1,42,5.9e-05
G5,C(CCC(C(C(C=O)O)O)=O)(O)=O,4,1,0,1,20,5.9e-05
G5,C(C(C)C(C=O)O)(O)=O,4,1,0,1,49,5.9e-05
G5,C(C(C(O)=O)CC(CO)O)(O)=O,2,1,0,1,29,5.9e-05
G5,C(C(C(CCCO)=O)=O)(O)=O,1,2,0,2,29,0.000106
G5,C(CCC(C(C=O)O)O)(O)=O,4,3,0,3,18,0.000165
G5,C(CC1(CC(CO1)O)O)(O)=O,4,2,0,2,29,0.000106
G5,C(CC1C(CC(O)O1)O)(O)=O,8,2,0,2,29,0.000106
G5,C(C1CC(C(CO1)O)O)(O)=O,8,1,0,1,29,5.9e-05
G5,C(C1C(CC(C(C1O)O)O)=O)(O)=O,16,1,0,1,0,5.9e-05
G5,C(C(CO)C(C=O)(C(C)=O)O)(O)=O,4,2,0,2,25,0.000106
G5,C(C(C=O)(C(C(O)=O)CO)O)=O,2,2,0,2,1,0.000106
G5,C(CC(C=O)C(C=O)(CO)O)(O)=O,4,2,0,2,18,0.00010700000000000001
G5,C(CC(C(O)=O)C(C=O)(CO)O)=O,4,2,0,2,18,0.00010700000000000001
G5,C(C(CO)(C(C(CO)=O)C)O)(O)=O,4,2,0,2,28,0.00010800000000000001
G5,C(C(CCO)C(C=O)(CO)O)(O)=O,4,1,0,1,3,5.9e-05
G5,C(C(C)C(C=O)(CO)O)(O)=O,4,1,0,1,49,5.9e-05
G5,C(C(C=O)(C(C=O)CC(O)=O)O)=O,2,2,0,2,1,0.00010700000000000001
G5,C(C(C=O)(C(C(O)=O)CC=O)O)=O,2,2,0,2,1,0.00010700000000000001
G5,C(C(C(C)=O)C(C(O)=O)=O)=O,2,2,0,2,29,0.000106
G5,C(C(C=O)(C(C(C=O)=O)C)O)(O)=O,4,2,0,2,28,0.00010700000000000001
G5,C(C(C)C(C(O)=O)(C(C)=O)O)=O,4,3,0,3,29,0.000154
G5,C(C(C)C(C=O)(C(C)=O)O)(O)=O,4,1,0,1,29,5.9e-05
G5,C(C(C=O)C(C(O)=O)=O)=O,1,2,0,2,29,0.000106
G5,C(C(C=O)(C(C(CO)=O)C)O)(O)=O,4,2,0,2,28,0.00010700000000000001
G5,C(C(C)C(C(C)=O)(CO)O)(O)=O,4,1,0,1,29,5.9e-05
G5,C(C(C=O)C(CCC(O)=O)=O)=O,1,3,0,3,29,0.000154
G5,C(C1C(COC1C(CO)O)=O)(O)=O,8,1,0,1,29,5.9e-05
G5,C(C1C(COC(CO)C1O)=O)(O)=O,8,1,0,1,29,5.9e-05
G5,C(C1C(COCC(C1O)O)=O)(O)=O,8,1,0,1,29,5.9e-05
G5,C(C(C(C=C)=O)C(C(O)=O)O)=O,4,2,0,2,29,0.000106
G5,C(C(C=O)(C(C(O)=O)CCO)O)=O,2,1,0,1,29,5.9e-05
G5,C(C(C=O)(C(CC=O)=O)O)(O)=O,2,4,0,4,1,0.00020299999999999997
G5,C(C(C=O)(C(C=O)C)O)(O)=O,4,3,0,3,49,0.000154
G5,C(C(C=O)(C(C(O)=O)C)O)=O,2,1,0,1,49,5.9e-05
G5,C(C(C=O)C(C(CC(O)=O)O)=O)=O,2,1,0,1,23,5.9e-05
G5,C(C(C=O)(C(CCC(O)=O)=O)O)=O,1,1,0,1,29,5.9e-05
G5,C(C(C)C(C=O)(C(C=O)O)O)(O)=O,8,1,0,1,49,5.9e-05
G5,C(C(C(C=O)(C(C=O)C)O)O)(O)=O,8,3,0,3,49,0.000154
G5,C(C(C)C(C(CO)=O)(CO)O)(O)=O,4,1,0,1,49,5.9e-05
G5,C(CC(O)=O)(C(C(C)=O)C(C)=O)=O,1,1,0,1,29,5.9e-05
G5,C(CC(C)=O)(C(C(O)=O)C(C)=O)=O,2,1,0,1,29,5.9e-05
G5,C(C(C(CCC=O)=O)C(C)=O)(O)=O,2,1,0,1,29,5.9e-05
G5,C(C(C(CCC(O)=O)=O)C(C)=O)=O,2,1,0,1,29,5.9e-05
G5,C(C(C(C)=O)C(C=CCO)=O)(O)=O,4,1,0,1,29,5.9e-05
G5,C(C)(C(C(C=CC(O)=O)=O)CO)=O,4,1,0,1,29,5.9e-05
G5,C(C(C(C(C)=O)C(C=C)=O)O)(O)=O,4,1,0,1,0,5.9e-05
G5,C(C(C(C)=O)(CC(O)=O)O)=O,2,2,0,2,29,0.000106
G5,C(C(C(C(C)=O)(C(C)=O)O)O)(O)=O,2,3,0,3,49,0.000154
G5,C(C(C)C(C=O)(C(CO)O)O)(O)=O,8,1,0,1,49,5.9e-05
G5,C(C1C(C(C(C1)O)O)=O)(O)=O,8,2,0,2,29,0.000106
G5,C(CCO)(C(C=O)(CC(O)=O)O)=O,2,1,0,1,29,5.9e-05
G5,C(C(CO)O)(C(C=O)CC(O)=O)=O,4,1,0,1,41,5.9e-05
G5,C(C(C(C(C)=O)=O)CC(O)=O)=O,2,2,0,2,29,0.000106
G5,C(CC(C=O)C(C(O)=O)O)(O)=O,4,3,0,3,29,0.000154
G5,C(C(C(C(O)=O)CC=O)O)(O)=O,4,2,0,2,33,0.00010700000000000001
G5,C(CC(C(C(O)=O)=O)CO)(O)=O,2,2,0,2,29,0.000106
G5,C(C(C(C(O)=O)=O)CC(CO)=O)=O,2,1,0,1,51,5.9e-05
G5,C(C(C(C(O)=O)=O)CC=O)=O,2,2,0,2,29,0.000106
G5,C(C(C(C=O)=O)CC(O)=O)=O,2,2,0,2,29,0.000106
G5,C(C(C(C)=O)CC(CO)=O)(O)=O,2,2,0,2,29,0.000106
G5,C(C(C=O)CC(O)=O)=O,1,2,0,2,29,0.000106
G5,C(C(C(C(O)=O)=O)CC(CO)O)=O,4,1,0,1,29,5.9e-05
G5,C(C(C(C(C(O)=O)O)=O)CCO)=O,4,1,0,1,29,5.9e-05
G5,C(C(C=O)CC(C(C(O)=O)O)O)=O,4,2,0,2,43,0.00010700000000000001
G5,C(C(C(C(C(C=O)O)O)=O)C)(O)=O,8,1,0,1,49,5.9e-05
G5,C(C(C(C(C(C(O)=O)O)O)=O)C)=O,8,2,0,2,49,0.00010700000000000001
G5,C(C(C(C)=O)CC(C=O)=O)(O)=O,2,1,0,1,29,5.9e-05
G5,C(C(C(C)=O)CC(C(O)=O)=O)=O,2,4,0,4,29,0.00020099999999999998
G5,C(C(C(CC=O)=O)CC(O)=O)=O,2,3,0,3,29,0.000154
G5,C(C(C=O)CC(CC(O)=O)=O)=O,1,3,0,3,29,0.000154
G5,C(C1C(CC(C(CO)O)O1)=O)(O)=O,8,1,0,1,29,5.9e-05
G5,C(C1C(CC(C(CO)O1)O)=O)(O)=O,8,1,0,1,29,5.9e-05
G5,C(C1C(CC(C(CO1)O)O)=O)(O)=O,8,1,0,1,29,5.9e-05
G5,C(C(C(C(O)=O)=O)CCO)(O)=O,2,2,0,2,29,0.000106
G5,C(C(CCO)C(C(O)=O)O)(O)=O,4,1,0,1,29,5.9e-05
G5,C(C(C(CC=O)=O)(CC(O)=O)O)=O,2,1,0,1,29,5.9e-05
G5,C(C(C(C(C=O)O)=O)CC(O)=O)=O,4,1,0,1,1,5.9e-05
G5,C(C(C)C(C=O)(CC=O)O)(O)=O,4,1,0,1,49,5.9e-05
G5,C(CC(C=O)(C(C=O)C)O)(O)=O,4,2,0,2,29,0.000106
G5,C(C(C)C(C(O)=O)O)(O)=O,4,1,0,1,49,5.9e-05
G5,C(C(C(C)=O)CC=O)(O)=O,2,3,0,3,29,0.000154
G5,C(C(C(C)=O)CC(O)=O)=O,2,2,0,2,29,0.000106
G5,C(C)(C(C(C)=O)CC(C(O)=O)=O)=O,1,1,0,1,29,5.9e-05
G5,C(CC(O)=O)(C(C(C)=O)CC=O)=O,2,1,0,1,29,5.9e-05
G5,C(CC=O)(C(C(C)=O)CC(O)=O)=O,2,1,0,1,29,5.9e-05
G5,C(C(C(C)=O)CC(C(C)=O)=O)(O)=O,2,1,0,1,29,5.9e-05
G5,C(CC(CC(C(O)=O)C(C)=O)=O)=O,2,1,0,1,29,5.9e-05
G5,C(C(C(C)=O)CC(CC(O)=O)=O)=O,2,1,0,1,29,5.9e-05
G5,C(C(C(C)=O)C=CC(CO)=O)(O)=O,4,1,0,1,32,5.9e-05
G5,C(C1C(CC(CO)O1)=O)(O)=O,4,3,0,3,29,0.000154
G5,C1(CC(C(O)=O)OC1CO)=O,4,3,0,3,29,0.000154
G5,C(C1C(CC(CO1)O)=O)(O)=O,4,3,0,3,29,0.000154
G5,C1(CC(C(O)=O)OCC1O)=O,4,2,0,2,29,0.000106
G5,C1(C(C(C(O)=O)OCC1)O)=O,4,2,0,2,29,0.000106
G5,C(C1C(CC(CO1)=O)O)(O)=O,4,3,0,3,29,0.000154
G5,C(CC1CC(C(O1)=O)=O)(O)=O,2,3,0,3,29,0.000154
G5,C1(CC(C(CC(O)=O)O1)=O)=O,2,3,0,3,29,0.000154
G5,C(C1C(CC(C=1)=O)O)(O)=O,2,4,0,4,29,0.00020099999999999998
G5,C1(CC=C(C(O)=O)C1O)=O,2,4,0,4,29,0.00020099999999999998
G5,C1(CC(C(O)=O)=CC1O)=O,2,4,0,4,29,0.00020099999999999998
G5,C1C(CC(C=1C(O)=O)=O)O,2,3,0,3,29,0.000154
G5,C(CC(C=CC(O)=O)O)(O)=O,4,2,0,2,29,0.000106
G5,C(C1C(C(C=C1)O)=O)(O)=O,4,3,0,3,29,0.000154
G5,C(C1(C(CC=C1)=O)O)(O)=O,2,3,0,3,29,0.000154
G5,C(CC1C=CC(O1)=O)(O)=O,2,2,0,2,29,0.000106
G5,C(CC1C(C=CO1)=O)(O)=O,2,2,0,2,29,0.000106
G5,C1(C(OCC1)=CC(O)=O)=O,2,3,0,3,29,0.000154
G5,C1(COC(C1)=CC(O)=O)=O,2,3,0,3,29,0.000154
G5,C1C(C(C(O)=O)=O)OCC=1,2,3,0,3,29,0.000154
G5,C(C1C=CC(C=O)O1)(O)=O,4,4,0,4,29,0.00020099999999999998
G5,C(C1C(CC(O1)=C)=O)(O)=O,2,3,0,3,29,0.000154
G5,C(C1CC(C(O1)=C)=O)(O)=O,2,3,0,3,29,0.000154
G5,C1(C=C(C(O)=O)OCC1)=O,1,3,0,3,29,0.000154
G5,C1(COC(C(O)=O)=CC1)=O,1,3,0,3,29,0.000154
G5,C(C1C(CC=CO1)=O)(O)=O,2,3,0,3,29,0.000154
G5,C(C1CC(C=CO1)=O)(O)=O,2,3,0,3,29,0.000154
G5,C(CC1C(C(C(O)O1)=O)O)(O)=O,8,2,0,2,5,0.000106
G5,C(C1(C(CC(CO)O1)=O)O)(O)=O,4,4,0,4,29,0.000202
G5,C1(CC(C(O)=O)(OC1CO)O)=O,4,3,0,3,29,0.000154
G5,C(C(C1C(CCO1)O)=O)(O)=O,4,2,0,2,29,0.000106
G5,C(C(C1C(CCO1)=O)O)(O)=O,4,2,0,2,29,0.000106
G5,C(C(C1CC(CO1)=O)O)(O)=O,4,2,0,2,29,0.000106
G5,C1(CCC(C(C(O)=O)O)O1)=O,4,2,0,2,29,0.000106
G5,C(CC1(CC(C(O1)=O)O)O)(O)=O,4,2,0,2,2,0.000106
G5,C(CC1(C(O)OCC1O)O)(O)=O,8,2,0,2,29,0.000106
G5,C(C1(C(CC(CO1)O)=O)O)(O)=O,4,4,0,4,15,0.000202
G5,C1(CC(C(O)=O)(O)OCC1O)=O,4,3,0,3,29,0.000154
G5,C1(C(C(C(O)=O)(O)OCC1)O)=O,4,3,0,3,29,0.000154
G5,C(C1(C(CC(CO1)=O)O)O)(O)=O,4,3,0,3,29,0.000154
G5,C(C1CC(C(CO1)=O)O)(O)=O,4,2,0,2,29,0.000106
G5,C1(CCC(C(C(O)=O)O1)O)=O,4,2,0,2,29,0.000106
G5,C1(CC(CC(C(O)=O)O1)O)=O,4,3,0,3,29,0.000154
G5,C(C1CCC(C(O1)O)=O)(O)=O,4,3,0,3,29,0.000154
G5,C1(C(C(CC(C(O)=O)O1)O)O)=O,8,2,0,2,29,0.000106
G5,C1(CC(CC(C(O)=O)O1)=O)=O,2,3,0,3,29,0.000154
G5,C(CC(C(C)=O)CC(C(O)=O)=O)=O,2,3,0,3,46,0.000155
G5,C(CC(CC=O)CC(C(O)=O)=O)=O,1,4,0,4,4,0.000204
G5,C(CC(C(O)=O)CC(C(C)=O)=O)=O,2,3,0,3,14,0.000155
G5,C(CCCC(CC(C(O)=O)=O)=O)=O,1,3,0,3,27,0.000155
G5,C(CCCC(C(CC(O)=O)=O)=O)=O,1,3,0,3,27,0.000155
G5,C(C1CC(C(C=1)=O)O)(O)=O,2,2,0,2,29,0.000106
G5,C1CC(C(C=1C(O)=O)=O)O,2,2,0,2,29,0.000106
G5,C(CO)(C(C(C(O)=O)=C)O)=O,2,2,0,2,29,0.000106
G5,C(CO)(CO)=CC(C(O)=O)=O,1,2,0,2,29,0.000106
G5,C(CO)(C(C(CO)=CC(O)=O)O)=O,4,1,0,1,5,5.9e-05
G5,C(CO)(CO)=C(C(O)=O)C(CO)=O,1,1,0,1,29,5.9e-05
G5,C(C(C(C(C(CO)=O)O)=C)O)(O)=O,4,1,0,1,5,5.9e-05
G5,C(CO)(C(C(C(O)=O)=CCO)O)=O,4,1,0,1,5,5.9e-05
G5,C(CO)(CO)=C(C(C(O)=O)=O)CO,1,1,0,1,29,5.9e-05
G5,C=C(C(C(O)=O)=O)C(CO)(CO)O,1,1,0,1,29,5.9e-05
G5,C(C(C(C=O)=C(CO)CO)O)(O)=O,2,1,0,1,29,5.9e-05
G5,C(C(C(C(O)=O)=C(CO)CO)O)=O,2,1,0,1,29,5.9e-05
G5,C(C=C(C=O)C(CO)(CO)O)(O)=O,2,1,0,1,29,5.9e-05
G5,C(C(C(CO)(CO)O)=CC=O)(O)=O,2,1,0,1,29,5.9e-05
G5,C(CO)(CO)=CC(O)=O,1,3,0,3,29,0.000154
G5,C(C(CO)O)=C(C(O)=O)C(CO)=O,4,1,0,1,29,5.9e-05
G5,C(C(CO)O)=C(C(C(O)=O)=O)CO,4,1,0,1,29,5.9e-05
G5,C=C(C(C(O)=O)=O)C(C(CO)O)O,4,1,0,1,41,5.9e-05
G5,C(C(C(C=O)=CC(CO)O)O)(O)=O,8,1,0,1,29,5.9e-05
G5,C(C(C(C(O)=O)=CC(CO)O)O)=O,8,1,0,1,29,5.9e-05
G5,C(C=C(C=O)C(C(CO)O)O)(O)=O,8,1,0,1,29,5.9e-05
G5,C(C(C(C(CO)O)O)=CC=O)(O)=O,8,1,0,1,29,5.9e-05
G5,C(C(CO)O)=CC(O)=O,4,3,0,3,29,0.000154
G5,C(C(C)=CC(C(O)=O)=O)=O,2,2,0,2,29,0.000106
G5,C(C(C=C(C(O)=O)C)=O)=O,2,2,0,2,29,0.000106
G5,C=C(C=O)CC(C(O)=O)=O,1,2,0,2,29,0.000106
G5,C=C(C(O)=O)CC(C=O)=O,1,2,0,2,29,0.000106
G5,C(CO)(CC=CC(C(O)=O)=O)=O,2,2,0,2,29,0.000106
G5,C(CC(C(O)=O)=O)=CC(CO)=O,2,3,0,3,29,0.000154
G5,C(CC(CO)=CC(C(O)=O)=O)=O,2,2,0,2,29,0.000106
G5,C(CC(CO)=CC(C=O)=O)(O)=O,2,2,0,2,29,0.000106
G5,C(CO)(CC(C(O)=O)=O)=CC=O,2,2,0,2,29,0.000106
G5,C(CO)(CC(C=O)=O)=CC(O)=O,2,2,0,2,29,0.000106
G5,C(C(C(CO)=O)=CC(C)=O)(O)=O,2,2,0,2,29,0.000106
G5,C(C(C(CO)=O)C(C(O)=O)=C)=O,2,2,0,2,29,0.000106
G5,C(C(C(CO)=O)=C(C(O)=O)C)=O,2,2,0,2,29,0.000106
G5,C(C(C(CO)=O)=C(C=O)C)(O)=O,2,2,0,2,29,0.000106
G5,C(CC(C(C(C(O)=O)=C)O)=O)=O,2,3,0,3,29,0.000154
G5,C(C)(C(C=CC(C(O)=O)=O)O)=O,4,2,0,2,29,0.000106
G5,C(C(C(C)=CC(C(O)=O)=O)O)=O,4,2,0,2,29,0.000106
G5,C(C(C(C)=CC(C=O)=O)O)(O)=O,4,2,0,2,29,0.000106
G5,C(C(C(CC(C(O)=O)=O)=C)O)=O,2,2,0,2,29,0.000106
G5,C(C(C(CC(C=O)=O)=C)O)(O)=O,2,2,0,2,29,0.000106
G5,C(C(C(CC(C(O)=O)=C)=O)O)=O,2,3,0,3,29,0.000154
G5,C(C(C(C=C(C(O)=O)C)=O)O)=O,4,2,0,2,29,0.000106
G5,C(C=CC(C(O)=O)=O)=O,2,4,0,4,29,0.00020099999999999998
G5,C(C(C=CC(O)=O)=O)=O,2,3,0,3,18,0.000154
G5,C(C)(C(CO)O)=CC(C(O)=O)=O,4,2,0,2,29,0.000106
G5,C=C(C(CO)O)CC(C(O)=O)=O,2,3,0,3,29,0.000154
G5,C(C(CO)O)(CC(C(O)=O)=C)=O,2,3,0,3,29,0.000154
G5,C(C=C(C(O)=O)C)(C(CO)O)=O,4,2,0,2,29,0.000106
G5,C(C(C=C(C=O)CCO)=O)(O)=O,2,2,0,2,29,0.000106
G5,C(C(C=C(C(O)=O)CCO)=O)=O,2,2,0,2,29,0.000106
G5,C(CO)=C(C=O)CC(C(O)=O)=O,2,2,0,2,29,0.000106
G5,C(CO)=C(C(O)=O)CC(C=O)=O,2,2,0,2,29,0.000106
G5,C(C(C(CO)=CC(C)=O)=O)(O)=O,2,2,0,2,29,0.000106
G5,C(C)(C(C(C(C(O)=O)=O)=C)O)=O,2,2,0,2,29,0.000106
G5,C=C(C(O)=O)C(C(C=O)=O)CO,2,2,0,2,29,0.000106
G5,C=C(C=O)C(C(C(O)=O)=O)CO,2,2,0,2,29,0.000106
G5,C(C(C(CO)=C(C(O)=O)C)=O)=O,2,2,0,2,29,0.000106
G5,C(C(C(CO)=C(C=O)C)=O)(O)=O,2,2,0,2,29,0.000106
G5,C(C(C(C(C=O)=O)=C)(C)O)(O)=O,2,3,0,3,29,0.000154
G5,C(C(C(C(C(O)=O)=O)=C)(C)O)=O,2,2,0,2,29,0.000106
G5,C(CO)(CCO)=CC(C(O)=O)=O,2,2,0,2,29,0.000106
G5,C(CO)=C(CO)CC(C(O)=O)=O,2,3,0,3,29,0.000154
G5,C(CCO)(C(C(C(O)=O)=C)O)=O,2,2,0,2,29,0.000106
G5,C(CO)(C(C(C(O)=O)=C)CO)=O,2,2,0,2,29,0.000106
G5,C(C(C)=C(C(CO)=O)CO)(O)=O,2,2,0,2,29,0.000106
G5,C(C(C(C(CO)=O)=C)(C)O)(O)=O,2,3,0,3,29,0.000154
G5,C(C(C=CC(C(O)=O)=O)O)=O,4,2,0,2,29,0.000106
G5,C(C(C=CC(C=O)=O)O)(O)=O,4,2,0,2,29,0.000106
G5,C(C)(CO)=CC(C(O)=O)=O,2,2,0,2,29,0.000106
G5,C=C(CO)CC(C(O)=O)=O,1,2,0,2,29,0.000106
G5,C(C)(C(C(C(O)=O)=C)O)=O,2,2,0,2,29,0.000106
G5,C(CC(C=CC(C(O)=O)=O)O)=O,4,2,0,2,29,0.000106
G5,C(CC(C=CC(C=O)=O)O)(O)=O,4,2,0,2,29,0.000106
G5,C(C(CC=CC(C(O)=O)=O)O)=O,4,2,0,2,29,0.000106
G5,C(C(CC=CC(C=O)=O)O)(O)=O,4,2,0,2,29,0.000106
G5,C(C(C=CCC(C(O)=O)=O)O)=O,4,2,0,2,29,0.000106
G5,C(C(C=CCC(C=O)=O)O)(O)=O,4,3,0,3,29,0.000154
G5,C(C(C(C=O)=CC(C)=O)O)(O)=O,4,3,0,3,29,0.000154
G5,C(C(C(C(O)=O)=CC(C)=O)O)=O,4,2,0,2,29,0.000106
G5,C(C)(C(C(C=O)=CC(O)=O)O)=O,4,3,0,3,29,0.000154
G5,C(C)(C(C(C(O)=O)=CC=O)O)=O,4,3,0,3,29,0.000154
G5,C(C(C(C(O)=O)=C)C(C=O)O)=O,4,2,0,2,29,0.000106
G5,C(C(C(C=O)=C)C(C=O)O)(O)=O,4,2,0,2,29,0.000106
G5,C(C(C(C=O)=C(C(O)=O)C)O)=O,4,2,0,2,29,0.000106
G5,C(C(C(C=O)=C(C=O)C)O)(O)=O,4,2,0,2,29,0.000106
G5,C(C(C(C(O)=O)=C(C=O)C)O)=O,4,2,0,2,29,0.000106
G5,C(C(C(C=O)=CC=O)(C)O)(O)=O,4,3,0,3,29,0.000154
G5,C(C(C(C=O)=CC(O)=O)(C)O)=O,4,3,0,3,29,0.000154
G5,C(C(C(C(O)=O)=CC=O)(C)O)=O,4,3,0,3,29,0.000154
G5,C(C(C(C=CC(C(O)=O)=O)O)O)=O,8,1,0,1,20,5.9e-05
G5,C(C(C(C=CC(C=O)=O)O)O)(O)=O,8,3,0,3,17,0.000165
G5,C(C)=CC(C(O)=O)=O,2,2,0,2,29,0.000106
G5,C=CCC(C(O)=O)=O,1,2,0,2,29,0.000106
G5,C(CC(C(O)=O)=C)=O,1,2,0,2,29,0.000106
G5,C(CC(C=O)=C)(O)=O,1,2,0,2,29,0.000106
G5,C(C=C(C(O)=O)C)=O,2,2,0,2,29,0.000106
G5,C(C(C)=CC(O)=O)=O,2,3,0,3,29,0.000154
G5,C(CO)(C(CO)O)=CC(C(O)=O)=O,4,1,0,1,29,5.9e-05
G5,C(C(CO)O)(C(C(C(O)=O)=C)O)=O,4,1,0,1,2,5.9e-05
G5,C(C(C(CO)=O)=CC=O)(O)=O,2,3,0,3,29,0.000154
G5,C(C(C(CO)=O)=CC(O)=O)=O,2,2,0,2,29,0.000106
G5,C=C(C(O)=O)C(CO)=O,1,3,0,3,29,0.000154
G5,C(C(C=C(C(O)=O)C(CO)=O)O)=O,4,1,0,1,29,5.9e-05
G5,C(C(C=C(C=O)C(CO)=O)O)(O)=O,4,1,0,1,29,5.9e-05
G5,C(C)(CO)=C(C(O)=O)C(CO)=O,2,2,0,2,29,0.000106
G5,C(CO)(CC(CO)=CC(O)=O)=O,2,3,0,3,29,0.000154
G5,C(CC(CO)=CC(CO)=O)(O)=O,2,2,0,2,29,0.000106
G5,C(C)(C(C(CO)=CC(O)=O)O)=O,4,3,0,3,29,0.000154
G5,C(C)=C(C(O)=O)C(CO)=O,2,2,0,2,29,0.000106
G5,C(CC(CO)=CC(O)=O)=O,2,2,0,2,29,0.000106
G5,C(CC(CO)=CC=O)(O)=O,2,2,0,2,29,0.000106
G5,C(C(C(C=CC(O)=O)=O)O)=O,4,4,0,4,55,0.00020099999999999998
G5,C(C(C=CC(C(C=O)O)=O)O)(O)=O,8,1,0,1,29,5.9e-05
G5,C(C(C(C)=CC(CO)=O)O)(O)=O,4,2,0,2,29,0.000106
G5,C(C(C(CC=O)=C)O)(O)=O,2,3,0,3,29,0.000154
G5,C(CC(C(C=O)O)=C)(O)=O,2,2,0,2,29,0.000106
G5,C(C(C(C)=CC=O)O)(O)=O,4,2,0,2,29,0.000106
G5,C(C(C(C)=CC(O)=O)O)=O,4,2,0,2,29,0.000106
G5,C(C(C(C(CO)=O)=CC(O)=O)O)=O,4,1,0,1,0,5.9e-05
G5,C(C(C(C(CO)=O)=CC=O)O)(O)=O,4,1,0,1,0,5.9e-05
G5,C(C(C(CO)=CC(O)=O)=O)=O,2,2,0,2,29,0.000106
G5,C(C(C(CO)=CC=O)=O)(O)=O,2,2,0,2,29,0.000106
G5,C(C(C(C(C=O)=O)=C)O)(O)=O,2,3,0,3,29,0.000154
G5,C(C(C(C(C(O)=O)=O)=C)O)=O,2,2,0,2,29,0.000106
G5,C(C(C(C=O)=CC(O)=O)O)=O,4,3,0,3,29,0.000154
G5,C(C(C(C=O)=CC=O)O)(O)=O,4,3,0,3,29,0.000154
G5,C(C(C(C(O)=O)=CC=O)O)=O,4,3,0,3,29,0.000154
G5,C(CC(C(CO)O)=C)(O)=O,2,2,0,2,29,0.000106
G5,C(C)(C(CO)O)=CC(O)=O,4,2,0,2,29,0.000106
G5,C(C=C(C(CO)=O)C(C)O)(O)=O,4,2,0,2,29,0.000106
G5,C(C(C(C(CO)=O)=CC)O)(O)=O,4,2,0,2,29,0.000106
G5,C(CC(CO)=CC(C=O)O)(O)=O,4,3,0,3,29,0.000154
G5,C(C(CC(CO)=CC(O)=O)O)=O,4,2,0,2,29,0.000106
G5,C=C(C(C(O)=O)=O)CO,1,3,0,3,7,0.000154
G5,C(C(C(C(O)=O)=C)O)=O,2,3,0,3,29,0.000154
G5,C(C(CO)=CC(O)=O)=O,2,3,0,3,29,0.000154
G5,C(C(CO)=CC=O)(O)=O,2,3,0,3,29,0.000154
G5,C(C=C(C(O)=O)CO)(C(CO)O)=O,4,1,0,1,2,5.9e-05
G5,C(CO)(C(C(C(C(O)=O)=C)O)O)=O,4,1,0,1,5,5.9e-05
G5,C(CO)(C(C=C(C(O)=O)CO)O)=O,4,1,0,1,43,5.9e-05
G5,C=C(C(O)=O)C(C(C(CO)O)O)O,8,1,0,1,29,5.9e-05
G5,C(C(C(CO)O)O)=C(C(O)=O)CO,8,1,0,1,29,5.9e-05
G5,C=C(C(CCO)=O)C(C(O)=O)=O,1,2,0,2,29,0.000106
G5,C=C(C(CC(C(O)=O)=O)=O)CO,1,2,0,2,29,0.000106
G5,C(CO)(CC(C(C(O)=O)=O)=C)=O,1,2,0,2,29,0.000106
G5,C=C(C(CO)=O)CC(C(O)=O)=O,1,3,0,3,29,0.000154
G5,C(CC(C(C(C(O)=O)=O)=C)O)=O,2,2,0,2,29,0.000106
G5,C(CC(C(C(C=O)=O)=C)O)(O)=O,2,2,0,2,29,0.000106
G5,C(CC=C(C(C(O)=O)=O)CO)=O,2,2,0,2,29,0.000106
G5,C(CC=C(C(C=O)=O)CO)(O)=O,2,2,0,2,29,0.000106
G5,C=C(C=O)C(CC(C(O)=O)=O)O,2,2,0,2,29,0.000106
G5,C=C(C(O)=O)C(CC(C=O)=O)O,2,3,0,3,29,0.000154
G5,C(CC(C(O)=O)=O)=C(C=O)CO,2,2,0,2,29,0.000106
G5,C(CC(C=O)=O)=C(C(O)=O)CO,2,3,0,3,29,0.000154
G5,C=C(C(O)=O)C(C(CCO)=O)=O,1,2,0,2,29,0.000106
G5,C(CC(C(C(CO)=C)=O)=O)(O)=O,1,2,0,2,29,0.000106
G5,C(CO)(CC(C(C(O)=O)=C)=O)=O,1,2,0,2,29,0.000106
G5,C(CC(C(C(CO)=O)=C)=O)(O)=O,1,2,0,2,29,0.000106
G5,C(C)(C(C(C(C(O)=O)=C)=O)O)=O,2,2,0,2,29,0.000106
G5,C(CC(C(C(C(O)=O)=C)=O)O)=O,2,2,0,2,29,0.000106
G5,C(CC(C(C(C=O)=C)=O)O)(O)=O,2,2,0,2,29,0.000106
G5,C(CC(C=C(C=O)CO)=O)(O)=O,2,3,0,3,29,0.000154
G5,C(CC(C=C(C(O)=O)CO)=O)=O,2,3,0,3,29,0.000154
G5,C(C(C(C(C(C)=O)=C)=O)O)(O)=O,2,2,0,2,29,0.000106
G5,C(C(C(C(CC=O)=C)=O)O)(O)=O,2,2,0,2,29,0.000106
G5,C(CC(C(C(C=O)O)=O)=C)(O)=O,2,2,0,2,29,0.000106
G5,C(C(C(C(C(C)=O)=O)=C)O)(O)=O,2,2,0,2,29,0.000106
G5,C(C=C(C(C(C)=O)=O)CO)(O)=O,2,2,0,2,29,0.000106
G5,C(C(CC(C(C=C)=O)=O)O)(O)=O,2,3,0,3,29,0.000154
G5,C(C(C(C(CC=O)=O)=C)O)(O)=O,2,3,0,3,29,0.000154
G5,C(CC(C(C(C=O)O)=C)=O)(O)=O,2,2,0,2,29,0.000106
G5,C(CC(C(CO)=CC(O)=O)=O)=O,2,3,0,3,29,0.000154
G5,C(CC(C(CO)=CC=O)=O)(O)=O,2,3,0,3,29,0.000154
G5,C(C(CC(C(C=O)=C)=O)O)(O)=O,2,2,0,2,29,0.000106
G5,C(C(CC(C(C(O)=O)=C)=O)O)=O,2,2,0,2,29,0.000106
G5,C=C(C(O)=O)C1C(C(C(O1)O)O)O,16,1,0,1,29,5.9e-05
G5,C=C(C(O)=O)C1(C(C(CO1)O)O)O,8,1,0,1,29,5.9e-05
G5,C1(C(C(CO1)O)O)=C(C(O)=O)CO,8,1,0,1,29,5.9e-05
G5,C(C(C(C(C(C(O)=O)=O)=C)O)O)=O,4,1,0,1,29,5.9e-05
G5,C(C(C(C(C(C=O)=O)=C)O)O)(O)=O,4,1,0,1,29,5.9e-05
G5,C(C(C=C(C(C(O)=O)=O)CO)O)=O,4,1,0,1,29,5.9e-05
G5,C(C(C=C(C(C=O)=O)CO)O)(O)=O,4,1,0,1,29,5.9e-05
G5,C=C(C(C(O)=O)=O)C(CO)(C)O,2,2,0,2,29,0.000106
G5,C(C)(CO)=C(C(C(O)=O)=O)CO,2,2,0,2,29,0.000106
G5,C=C(CO)C(C(C(O)=O)=O)CO,2,2,0,2,29,0.000106
G5,C(CO)(CC(C(O)=O)=CCO)=O,2,2,0,2,29,0.000106
G5,C(C(CCO)=CC(CO)=O)(O)=O,2,2,0,2,29,0.000106
G5,C(C)(C(C(C(O)=O)=CCO)O)=O,4,2,0,2,29,0.000106
G5,C=C(C(C(O)=O)=O)C(C)O,2,2,0,2,29,0.000106
G5,C(C)=C(C(C(O)=O)=O)CO,2,2,0,2,29,0.000106
G5,C=CC(C(C(O)=O)=O)CO,2,4,0,4,29,0.00020099999999999998
G5,C(CC(C=O)=CCO)(O)=O,2,2,0,2,29,0.000106
G5,C(C=C(C=O)CCO)(O)=O,2,3,0,3,29,0.000154
G5,C(C(C(C(C(CO)=O)=C)O)O)(O)=O,4,2,0,2,9,0.00010700000000000001
G5,C(C(C=C(C(CO)=O)CO)O)(O)=O,4,1,0,1,29,5.9e-05
G5,C(CC(CO)=CCO)(O)=O,2,2,0,2,29,0.000106
G5,C(CO)(CCO)=CC(O)=O,2,2,0,2,29,0.000106
G5,C(CC(C(C(C(O)=O)O)O)=C)=O,4,4,0,4,29,0.00020099999999999998
G5,C(CC(C(C(C=O)O)O)=C)(O)=O,4,3,0,3,29,0.000154
G5,C(C(C(C(C)=CC=O)O)O)(O)=O,8,3,0,3,29,0.000154
G5,C(C(C(C(C)=CC(O)=O)O)O)=O,8,2,0,2,29,0.000106
G5,C(C(C=C(C=O)C(C=O)O)O)(O)=O,8,1,0,1,29,5.9e-05
G5,C(C(C(C=O)=CC(C=O)O)O)(O)=O,8,1,0,1,29,5.9e-05
G5,C(C(C(C(O)=O)=CC(C=O)O)O)=O,8,1,0,1,29,5.9e-05
G5,C(C(C(C(C=O)=CC=O)O)O)(O)=O,8,1,0,1,29,5.9e-05
G5,C(C(C(C(C=O)=CC(O)=O)O)O)=O,8,1,0,1,29,5.9e-05
G5,C(C(C(C(C(O)=O)=CC=O)O)O)=O,8,1,0,1,29,5.9e-05
G5,C(C(C(CO)=C)C(C=O)O)(O)=O,4,2,0,2,29,0.000106
G5,C(C(C(C=O)=C(CO)C)O)(O)=O,4,2,0,2,29,0.000106
G5,C(C(C(C(O)=O)=C(CO)C)O)=O,4,2,0,2,29,0.000106
G5,C(C=C(C=O)C(CO)(C)O)(O)=O,4,3,0,3,29,0.000154
G5,C(C(C(CO)(C)O)=CC=O)(O)=O,4,3,0,3,29,0.000154
G5,C(CC(CO)=C)(O)=O,1,2,0,2,29,0.000106
G5,C(C)(CO)=CC(O)=O,2,2,0,2,29,0.000106
G5,C(C=C(C=O)C(C)O)(O)=O,4,3,0,3,29,0.000154
G5,C(C(C(C)O)=CC=O)(O)=O,4,3,0,3,29,0.000154
G5,C(C(C(C=O)=CC)O)(O)=O,4,2,0,2,29,0.000106
G5,C(C(C(C(O)=O)=CC)O)=O,4,2,0,2,29,0.000106
G5,C(C(C=C)C(C=O)O)(O)=O,4,2,0,2,29,0.000106
G5,C(CC=CC(C=O)O)(O)=O,4,2,0,2,29,0.000106
G5,C(C)=CC(O)=O,2,2,0,2,29,0.000106
G5,C(CC=C)(O)=O,1,2,0,2,29,0.000106
G5,C(CO)(C(CO)O)=CC(O)=O,4,3,0,3,29,0.000154
G5,C(CCO)(CC(C=CC(O)=O)=O)=O,2,1,0,1,30,5.9e-05
G5,C(CCO)(CC(C=O)=CC(O)=O)=O,2,1,0,1,23,5.9e-05
G5,C(CCO)(CC(C(O)=O)=CC=O)=O,2,1,0,1,23,5.9e-05
G5,C(CC(C=O)=CC(CCO)=O)(O)=O,2,1,0,1,23,5.9e-05
G5,C(CC(C(O)=O)=CC(CCO)=O)=O,2,1,0,1,23,5.9e-05
G5,C(CCO)(CC(C=O)=O)=CC(O)=O,2,1,0,1,29,5.9e-05
G5,C(CCO)(CC(C(O)=O)=O)=CC=O,2,1,0,1,29,5.9e-05
G5,C(CC(CCO)=CC(C=O)=O)(O)=O,2,1,0,1,29,5.9e-05
G5,C(CC(CCO)=CC(C(O)=O)=O)=O,2,1,0,1,29,5.9e-05
G5,C(CC(CC(C=O)=O)=CCO)(O)=O,2,1,0,1,29,5.9e-05
G5,C(CC(CC(C(O)=O)=O)=CCO)=O,2,1,0,1,29,5.9e-05
G5,C(CCO)(C(C=C)C(C(O)=O)=O)=O,2,1,0,1,29,5.9e-05
G5,C(C)=C(C(CCO)=O)C(C(O)=O)=O,2,1,0,1,29,5.9e-05
G5,C(CC(C(O)=O)=O)(C(C=C)CO)=O,2,1,0,1,29,5.9e-05
G5,C(C)=C(C(CC(C(O)=O)=O)=O)CO,2,1,0,1,29,5.9e-05
G5,C=C(C(CC(C(O)=O)=O)=O)C(C)O,2,1,0,1,29,5.9e-05
G5,C(CO)(CCC(C=CC(O)=O)=O)=O,2,1,0,1,7,5.9e-05
G5,C(CO)(CCC(C=O)=CC(O)=O)=O,2,1,0,1,29,5.9e-05
G5,C(CO)(CCC(C(O)=O)=CC=O)=O,2,1,0,1,29,5.9e-05
G5,C(CC(C=O)=CCC(CO)=O)(O)=O,2,1,0,1,29,5.9e-05
G5,C(CC(C(O)=O)=CCC(CO)=O)=O,2,1,0,1,29,5.9e-05
G5,C(CO)(CCC(C=O)=O)=CC(O)=O,2,1,0,1,29,5.9e-05
G5,C(CO)(CCC(C(O)=O)=O)=CC=O,2,1,0,1,29,5.9e-05
G5,C(CC(CO)=CCC(C=O)=O)(O)=O,2,1,0,1,29,5.9e-05
G5,C(CC(CO)=CCC(C(O)=O)=O)=O,2,1,0,1,29,5.9e-05
G5,C(CC(C=C)C(C(O)=O)=O)(CO)=O,2,1,0,1,12,5.9e-05
G5,C(CO)(CC(C(C(O)=O)=O)=CC)=O,2,1,0,1,12,5.9e-05
G5,C(CO)(C(C=C)CC(C(O)=O)=O)=O,2,1,0,1,12,5.9e-05
G5,C(C)=C(C(CO)=O)CC(C(O)=O)=O,2,1,0,1,12,5.9e-05
G5,C(CCC(C(O)=O)=O)(C(C=C)O)=O,2,1,0,1,12,5.9e-05
G5,C(C)(C(CC(C=CC(O)=O)=O)O)=O,4,1,0,1,45,5.9e-05
G5,C(C)(C(CC(C=O)=CC(O)=O)O)=O,4,1,0,1,29,5.9e-05
G5,C(C)(C(CC(C(O)=O)=CC=O)O)=O,4,1,0,1,29,5.9e-05
G5,C(CC(C=O)=CC(C(C)=O)O)(O)=O,4,1,0,1,29,5.9e-05
G5,C(CC(C(O)=O)=CC(C(C)=O)O)=O,4,1,0,1,29,5.9e-05
G5,C(C)(C(CC(C=O)=O)O)=CC(O)=O,4,1,0,1,22,5.9e-05
G5,C(CC(C(CC(C=O)=O)O)=C)(O)=O,2,1,0,1,22,5.9e-05
G5,C(C)(C(C(C=C)C(C(O)=O)=O)O)=O,4,1,0,1,45,5.9e-05
G5,C(C)(C(C(C(C(O)=O)=O)=CC)O)=O,4,1,0,1,45,5.9e-05
G5,C(C(C(C(C)O)=CC(C)=O)=O)(O)=O,4,1,0,1,29,5.9e-05
G5,C(CC(CC(C=O)=CC(O)=O)O)=O,4,1,0,1,29,5.9e-05
G5,C(CC(CC(C(O)=O)=CC=O)O)=O,4,1,0,1,29,5.9e-05
G5,C(CC(CC(C=O)=CC=O)O)(O)=O,4,1,0,1,29,5.9e-05
G5,C(CC(C=O)=CC(CC=O)O)(O)=O,4,1,0,1,29,5.9e-05
G5,C(CC(C(O)=O)=CC(CC=O)O)=O,4,1,0,1,29,5.9e-05
G5,C(CC(C=O)=CC(CC(O)=O)O)=O,4,1,0,1,29,5.9e-05
G5,C(CC(CC(C=O)=O)O)=CC(O)=O,4,1,0,1,13,5.9e-05
G5,C(CC=CC(CC(C=O)=O)O)(O)=O,4,1,0,1,13,5.9e-05
G5,C(CC(C(C=C)C(C(O)=O)=O)O)=O,4,1,0,1,29,5.9e-05
G5,C(CC(C(C(C(O)=O)=O)=CC)O)=O,4,1,0,1,29,5.9e-05
G5,C(CC(C(C(C=O)=O)=CC)O)(O)=O,4,1,0,1,29,5.9e-05
G5,C(CC=C(C(C(O)=O)=O)C(C)O)=O,4,1,0,1,29,5.9e-05
G5,C(CC=C(C(C=O)=O)C(C)O)(O)=O,4,1,0,1,29,5.9e-05
G5,C(C(C=C)C(CC(C=O)=O)O)(O)=O,4,1,0,1,29,5.9e-05
G5,C(C)=C(C=O)C(CC(C(O)=O)=O)O,4,1,0,1,29,5.9e-05
G5,C(C)=C(C(O)=O)C(CC(C=O)=O)O,4,1,0,1,29,5.9e-05
G5,C(CC(C(O)=O)=O)=C(C=O)C(C)O,4,1,0,1,29,5.9e-05
G5,C(CC(C=O)=O)=C(C(O)=O)C(C)O,4,1,0,1,29,5.9e-05
G5,C(CC(C(CCO)=O)=O)=CC(O)=O,2,1,0,1,53,5.9e-05
G5,C(CC=CC(C(CCO)=O)=O)(O)=O,2,1,0,1,53,5.9e-05
G5,C(CC(C(CCO)=O)=CC(O)=O)=O,2,1,0,1,29,5.9e-05
G5,C(CC(C(CCO)=O)=CC=O)(O)=O,2,1,0,1,29,5.9e-05
G5,C(CC(C(CCO)=CC(O)=O)=O)=O,2,1,0,1,29,5.9e-05
G5,C(CC(C(CCO)=CC=O)=O)(O)=O,2,1,0,1,29,5.9e-05
G5,C(CC(C(CC(O)=O)=CCO)=O)=O,2,1,0,1,29,5.9e-05
G5,C(CC(C(CC=O)=CCO)=O)(O)=O,2,1,0,1,29,5.9e-05
G5,C(C(C=C)C(C(CCO)=O)=O)(O)=O,2,1,0,1,29,5.9e-05
G5,C(C)=C(C(O)=O)C(C(CCO)=O)=O,2,1,0,1,4,5.9e-05
G5,C(CC(C(C(C=C)CO)=O)=O)(O)=O,2,1,0,1,29,5.9e-05
G5,C(CC(C(C(CO)=CC)=O)=O)(O)=O,2,1,0,1,4,5.9e-05
G5,C(CC(C(C(C(C)O)=C)=O)=O)(O)=O,2,1,0,1,29,5.9e-05
G5,C(CC(CO)=O)(CC=CC(O)=O)=O,2,1,0,1,26,5.9e-05
G5,C(CC=CC(CC(CO)=O)=O)(O)=O,2,1,0,1,26,5.9e-05
G5,C(CC(CC(CO)=O)=CC(O)=O)=O,2,1,0,1,32,5.9e-05
G5,C(CC(CC(CO)=O)=CC=O)(O)=O,2,1,0,1,32,5.9e-05
G5,C(CC(CC=O)=CC(CO)=O)(O)=O,2,1,0,1,46,5.9e-05
G5,C(CC=O)(CC(CO)=CC(O)=O)=O,2,1,0,1,29,5.9e-05
G5,C(CC(O)=O)(CC(CO)=CC=O)=O,2,1,0,1,29,5.9e-05
G5,C(CC(CO)=CC(CC=O)=O)(O)=O,2,1,0,1,26,5.9e-05
G5,C(CC(CO)=CC(CC(O)=O)=O)=O,2,1,0,1,26,5.9e-05
G5,C(C(C(CC(CO)=O)=O)C=C)(O)=O,2,1,0,1,4,5.9e-05
G5,C(CO)(CC(C(C(O)=O)=CC)=O)=O,2,1,0,1,4,5.9e-05
G5,C(CC(C(C(CO)=O)C=C)=O)(O)=O,2,1,0,1,4,5.9e-05
G5,C(CC(C(C(CO)=O)=CC)=O)(O)=O,2,1,0,1,4,5.9e-05
G5,C(CC(CC(C(C=C)O)=O)=O)(O)=O,2,1,0,1,7,5.9e-05
G5,C(C(C(C)=O)O)(CC=CC(O)=O)=O,4,1,0,1,9,5.9e-05
G5,C(CC=CC(C(C(C)=O)O)=O)(O)=O,4,1,0,1,9,5.9e-05
G5,C(CC(C(C(C)=O)O)=CC(O)=O)=O,4,1,0,1,29,5.9e-05
G5,C(CC(C(C(C)=O)O)=CC=O)(O)=O,4,1,0,1,29,5.9e-05
G5,C(CC(C(C(C)=CC(O)=O)O)=O)=O,4,1,0,1,29,5.9e-05
G5,C(CC(C(C(C)=CC=O)O)=O)(O)=O,4,1,0,1,29,5.9e-05
G5,C(CC(C(C(CC=O)=O)O)=C)(O)=O,2,1,0,1,29,5.9e-05
G5,C(CC(C(C(CC=O)=C)O)=O)(O)=O,2,1,0,1,29,5.9e-05
G5,C(C(C(C(C(C)=O)O)=O)C=C)(O)=O,4,1,0,1,29,5.9e-05
G5,C(C)(C(C(C(C(O)=O)=CC)=O)O)=O,4,1,0,1,9,5.9e-05
G5,C(CC(C(C(CC=C)=O)O)=O)(O)=O,2,1,0,1,9,5.9e-05
G5,C(CC(C(C(C=CC)=O)O)=O)(O)=O,4,1,0,1,9,5.9e-05
G5,C(CC(C(CC=O)O)=CC(O)=O)=O,4,1,0,1,29,5.9e-05
G5,C(CC(C(CC=O)O)=CC=O)(O)=O,4,1,0,1,29,5.9e-05
G5,C(CC(C(CC(O)=O)O)=CC=O)=O,4,1,0,1,29,5.9e-05
G5,C(CC(C(CC=CC(O)=O)O)=O)=O,4,1,0,1,29,5.9e-05
G5,C(CC(C(CC=CC=O)O)=O)(O)=O,4,1,0,1,29,5.9e-05
G5,C(CC=CC(C(CC=O)=O)O)(O)=O,4,1,0,1,13,5.9e-05
G5,C(CC(C(C=CCC=O)O)=O)(O)=O,4,1,0,1,13,5.9e-05
G5,C(C(C(C(CC=O)O)=O)C=C)(O)=O,4,1,0,1,29,5.9e-05
G5,C(C(C(C(CC(O)=O)O)=O)C=C)=O,4,1,0,1,29,5.9e-05
G5,C(CC(C(C(C(O)=O)=CC)=O)O)=O,4,1,0,1,29,5.9e-05
G5,C(CC(C(C(C=O)=CC)=O)O)(O)=O,4,1,0,1,29,5.9e-05
G5,C(C(C=C)C(C(CC=O)=O)O)(O)=O,4,1,0,1,29,5.9e-05
G5,C(CC(C(C(C=O)=CC)O)=O)(O)=O,4,1,0,1,29,5.9e-05
G5,C(CC(C(C(C(O)=O)=CC)O)=O)=O,4,1,0,1,29,5.9e-05
G5,C(CC(C=C(C=O)C(C)O)=O)(O)=O,4,1,0,1,29,5.9e-05
G5,C(CC(C=C(C(O)=O)C(C)O)=O)=O,4,1,0,1,29,5.9e-05
G5,C(C(C=CC(O)=O)O)(CC(C)=O)=O,4,1,0,1,29,5.9e-05
G5,C(C(C(CC(C)=O)=CC(O)=O)O)=O,4,1,0,1,29,5.9e-05
G5,C(C(C(CC(C)=O)=CC=O)O)(O)=O,4,1,0,1,29,5.9e-05
G5,C(CC(C(C=O)O)=CC(C)=O)(O)=O,4,1,0,1,29,5.9e-05
G5,C(CC(C(C(O)=O)O)=CC(C)=O)=O,4,1,0,1,29,5.9e-05
G5,C(C(C=O)O)(CC(C)=CC(O)=O)=O,4,1,0,1,29,5.9e-05
G5,C(C(C(O)=O)O)(CC(C)=CC=O)=O,4,1,0,1,29,5.9e-05
G5,C(CC(C)=CC(C(C=O)O)=O)(O)=O,4,1,0,1,6,5.9e-05
G5,C(CC(C)=CC(C(C(O)=O)O)=O)=O,4,1,0,1,6,5.9e-05
G5,C(CC(CC(C(C=O)O)=O)=C)(O)=O,2,1,0,1,29,5.9e-05
G5,C(C(C(CC(CC=O)=C)=O)O)(O)=O,2,1,0,1,29,5.9e-05
G5,C(C(C(C(C(C)=O)C=C)=O)O)(O)=O,4,1,0,1,29,5.9e-05
G5,C(C(C(C(C(C)=O)=CC)=O)O)(O)=O,4,1,0,1,29,5.9e-05
G5,C(C(C(CC(CC=C)=O)=O)O)(O)=O,2,1,0,1,4,5.9e-05
G5,C(C(C(O)=O)O)(CC(C=CC)=O)=O,4,1,0,1,29,5.9e-05
G5,C(C(C(CCC=O)=CC(O)=O)O)=O,4,1,0,1,29,5.9e-05
G5,C(C(C(CCC=O)=CC=O)O)(O)=O,4,1,0,1,29,5.9e-05
G5,C(C(C(CCC(O)=O)=CC=O)O)=O,4,1,0,1,29,5.9e-05
G5,C(CC(C(C=O)O)=CCC=O)(O)=O,4,1,0,1,29,5.9e-05
G5,C(C(C(CC=O)=CCC=O)O)(O)=O,4,1,0,1,29,5.9e-05
G5,C(CC=C(CC=O)C(C=O)O)(O)=O,4,1,0,1,29,5.9e-05
G5,C(C(C(CCC=CC(O)=O)=O)O)=O,4,1,0,1,44,5.9e-05
G5,C(C(C(CCC=CC=O)=O)O)(O)=O,4,1,0,1,44,5.9e-05
G5,C(CC=CCC(C(C=O)O)=O)(O)=O,4,1,0,1,44,5.9e-05
G5,C(C(C(CC=CCC=O)=O)O)(O)=O,4,1,0,1,44,5.9e-05
G5,C(CC(C(C(C(O)=O)O)=O)=CC)=O,4,1,0,1,4,5.9e-05
G5,C(CC(C(C(C=O)O)=O)=CC)(O)=O,4,1,0,1,4,5.9e-05
G5,C(C(C=C)CC(C(C(O)=O)O)=O)=O,4,1,0,1,29,5.9e-05
G5,C(C(C=C)CC(C(C=O)O)=O)(O)=O,4,1,0,1,29,5.9e-05
G5,C(C(C(O)=O)O)(CC(C=O)=CC)=O,4,1,0,1,46,5.9e-05
G5,C(C(C=O)O)(CC(C(O)=O)=CC)=O,4,1,0,1,46,5.9e-05
G5,C(C(CC(C(C)=O)=CC(O)=O)O)=O,4,1,0,1,29,5.9e-05
G5,C(C(CC(C(C)=O)=CC=O)O)(O)=O,4,1,0,1,29,5.9e-05
G5,C(CC(C(C)=O)=CC(C=O)O)(O)=O,4,1,0,1,29,5.9e-05
G5,C(CC(C(C)=O)=CC(C(O)=O)O)=O,4,1,0,1,29,5.9e-05
G5,C(C(CC(C(C)=CC(O)=O)=O)O)=O,4,1,0,1,29,5.9e-05
G5,C(C(CC(C(C)=CC=O)=O)O)(O)=O,4,1,0,1,29,5.9e-05
G5,C(CC(C(CC(C=O)O)=O)=C)(O)=O,2,1,0,1,21,5.9e-05
G5,C(CC(C(CC(C(O)=O)O)=O)=C)=O,2,1,0,1,21,5.9e-05
G5,C(C(C(C=C)C(C(C)=O)=O)O)(O)=O,4,1,0,1,29,5.9e-05
G5,C(C(C(C(C(C)=O)=O)=CC)O)(O)=O,4,1,0,1,14,5.9e-05
G5,C(C(C(C(C)O)=CC(O)=O)=O)(C)=O,4,1,0,1,14,5.9e-05
G5,C(C(CC(C(CC=C)=O)=O)O)(O)=O,2,1,0,1,29,5.9e-05
G5,C(C(CC(C(C=CC)=O)=O)O)(O)=O,4,1,0,1,29,5.9e-05
G5,C(CC(CC(C=O)O)=CC(O)=O)=O,4,1,0,1,29,5.9e-05
G5,C(CC(CC(C(O)=O)O)=CC=O)=O,4,1,0,1,29,5.9e-05
G5,C(CC(CC(C=O)O)=CC=O)(O)=O,4,1,0,1,29,5.9e-05
G5,C(CC(CC=O)=CC(C=O)O)(O)=O,4,1,0,1,29,5.9e-05
G5,C(C(C=C(CC=O)CC=O)O)(O)=O,2,1,0,1,29,5.9e-05
G5,C(C(CC(CC=CC(O)=O)=O)O)=O,4,1,0,1,26,5.9e-05
G5,C(C(CC(CC=CC=O)=O)O)(O)=O,4,1,0,1,26,5.9e-05
G5,C(CC=CC(CC(C=O)O)=O)(O)=O,4,1,0,1,29,5.9e-05
G5,C(CC=CC(CC(C(O)=O)O)=O)=O,4,1,0,1,29,5.9e-05
G5,C(CC=O)(C(C=C)C(C(O)=O)O)=O,4,1,0,1,29,5.9e-05
G5,C(CC(O)=O)(C(C=C)C(C=O)O)=O,4,1,0,1,29,5.9e-05
G5,C(CC(C(C(C(O)=O)O)=CC)=O)=O,4,1,0,1,29,5.9e-05
G5,C(CC(C(C(C=O)O)=CC)=O)(O)=O,4,1,0,1,29,5.9e-05
G5,C(CC(C(C(C)O)=CC(O)=O)=O)=O,4,1,0,1,29,5.9e-05
G5,C(CC(C(C(C)O)=CC=O)=O)(O)=O,4,1,0,1,29,5.9e-05
G5,C(C(C(CC(C(O)=O)O)=O)C=C)=O,4,1,0,1,29,5.9e-05
G5,C(C(C(CC(C=O)O)=O)C=C)(O)=O,4,1,0,1,29,5.9e-05
G5,C(C(CC(C(C=O)=CC)=O)O)(O)=O,4,1,0,1,29,5.9e-05
G5,C(C(CC(C(C(O)=O)=CC)=O)O)=O,4,1,0,1,29,5.9e-05
G5,C(C(CO)O)=CC(C=CC(O)=O)=O,8,1,0,1,29,5.9e-05
G5,C(C(CO)O)=CC(C=O)=CC(O)=O,8,1,0,1,29,5.9e-05
G5,C(C(CO)O)=CC(C(O)=O)=CC=O,8,1,0,1,29,5.9e-05
G5,C(C(C(C=CCO)=O)O)=CC(O)=O,8,1,0,1,29,5.9e-05
G5,C(C(C(C=CCO)=CC(O)=O)O)=O,8,1,0,1,29,5.9e-05
G5,C(C(C(C=CCO)=CC=O)O)(O)=O,8,1,0,1,29,5.9e-05
G5,C(C=CC=CC(C(CO)O)=O)(O)=O,8,1,0,1,21,5.9e-05
G5,C(C=CC(C(CO)O)=CC(O)=O)=O,8,1,0,1,29,5.9e-05
G5,C(C=C(C=CC(O)=O)C(CO)O)=O,8,1,0,1,29,5.9e-05
G5,C(C(C(C(C=C)=CC(O)=O)O)O)=O,8,1,0,1,29,5.9e-05
G5,C(C(C(C(C=C)=CC=O)O)O)(O)=O,8,1,0,1,29,5.9e-05
G5,C(C(C=CC(CO)=O)O)=CC(O)=O,8,1,0,1,32,5.9e-05
G5,C(C(C=CC(CO)=CC(O)=O)O)=O,8,1,0,1,29,5.9e-05
G5,C(C(C=CC(CO)=CC=O)O)(O)=O,8,1,0,1,29,5.9e-05
G5,C(C(C=CC(C(C=C)O)=O)O)(O)=O,8,1,0,1,29,5.9e-05
G5,C(C(C(C=CC(O)=O)O)O)=CC=O,16,1,0,1,29,5.9e-05
G5,C(C(C(C=CC=CC(O)=O)O)O)=O,16,1,0,1,29,5.9e-05
G5,C(C(C(C=CC=CC=O)O)O)(O)=O,16,1,0,1,29,5.9e-05
G5,C(C(C(CO)=CC(O)=O)O)=O,4,3,0,3,29,0.000154
G5,C(CO)=C(C(O)=O)C(CO)=O,2,2,0,2,29,0.000106
G5,C(C(C=C(CO)C(C=O)O)O)(O)=O,8,1,0,1,29,5.9e-05
G5,C(C(C(C(CO)=O)=CCO)O)(O)=O,4,1,0,1,0,5.9e-05
G5,C(C=C(C(CO)=O)C(CO)O)(O)=O,4,1,0,1,0,5.9e-05
G5,C(C(C(C(O)=O)=CCO)O)=O,4,3,0,3,29,0.000154
G5,C(CO)=C(C(C(O)=O)=O)CO,2,2,0,2,29,0.000106
G5,C=C(C(C(O)=O)=O)C(CO)O,2,2,0,2,29,0.000106
G5,C(C(C(C(C(C(O)=O)O)O)=C)O)=O,8,2,0,2,16,0.00010700000000000001
G5,C(C=C(C=O)C(CO)O)(O)=O,4,3,0,3,29,0.000154
G5,C(C(C(CO)O)=CC=O)(O)=O,4,3,0,3,29,0.000154
G5,C(C(C(CO)O)O)=CC(C(O)=O)=O,8,1,0,1,20,5.9e-05
G5,C=C(C(O)=O)C(C(C(CO)O)O)=O,4,1,0,1,9,5.9e-05
G5,C(C(CO)=CC(O)=O)(C(CO)O)=O,4,1,0,1,2,5.9e-05
G5,C(C(C(C(C(CO)O)=O)=C)O)(O)=O,4,1,0,1,47,5.9e-05
G5,C(C(C(C=C(C=O)CO)O)O)(O)=O,8,2,0,2,18,0.00010700000000000001
G5,C(C(C(C=C(C(O)=O)CO)O)O)=O,8,1,0,1,18,5.9e-05
G5,C(C(C(C(C(C=O)=C)O)O)O)(O)=O,8,2,0,2,16,0.00010700000000000001
G5,C(C(C(C(C(C(O)=O)=C)O)O)O)=O,8,1,0,1,16,5.9e-05
G5,C(C=C(C(O)=O)CCO)(O)=O,2,2,0,2,29,0.000106
G5,C(CC(C(O)=O)=CCO)(O)=O,2,2,0,2,29,0.000106
G5,C(C(C=C(C(O)=O)C)O)(O)=O,4,2,0,2,29,0.000106
G5,C(C(CC(C(O)=O)=C)O)(O)=O,2,2,0,2,29,0.000106
G5,C(C(C(C=O)=C)(CO)O)(O)=O,2,3,0,3,16,0.000156
G5,C(C(C(C(O)=O)=C)(CO)O)=O,2,2,0,2,29,0.000106
G5,C(C(C(CO)=CC=O)(CO)O)(O)=O,4,2,0,2,29,0.00010800000000000001
G5,C(C(C(CO)=CC(O)=O)(CO)O)=O,4,1,0,1,29,5.9e-05
G5,C(C(C(C(C=O)O)=C)(CO)O)(O)=O,4,2,0,2,29,0.00010800000000000001
G5,C(C(C(C(C(O)=O)O)=C)(CO)O)=O,4,2,0,2,29,0.00010800000000000001
G5,C(C(C(C=O)=CCO)(CO)O)(O)=O,4,2,0,2,29,0.00010800000000000001
G5,C(C(C(C(O)=O)=CCO)(CO)O)=O,4,1,0,1,43,5.9e-05
G5,C(C(C(CO)=C)(CO)O)(O)=O,2,3,0,3,49,0.000156
G5,C(C(C(C)=O)(C(C(O)=O)=C)O)=O,2,2,0,2,29,0.000106
G5,C(C(C(C)=O)(C(C=O)=C)O)(O)=O,2,3,0,3,25,0.000154
G5,C(C)(C(C(C(O)=O)=C)(CO)O)=O,2,2,0,2,29,0.000106
G5,C(C(C=O)(C(C(O)=O)=C)O)=O,1,2,0,2,29,0.000106
G5,C(C(C=O)(C(C=O)=C)O)(O)=O,2,4,0,4,29,0.000202
G5,C(C(C(C(O)=O)=C)(C(C=O)O)O)=O,4,1,0,1,29,5.9e-05
G5,C(C(C(C=O)=C)(C(C=O)O)O)(O)=O,4,2,0,2,29,0.00010700000000000001
G5,C(C(C(C=O)=C)(C(C(O)=O)O)O)=O,4,2,0,2,29,0.00010700000000000001
G5,C(CO)(C(C(C(O)=O)=C)(CO)O)=O,2,1,0,1,2,5.9e-05
G5,C(C(C=O)(C(CO)=CC(O)=O)O)=O,2,1,0,1,29,5.9e-05
G5,C(C(C=O)(C(CO)=CC=O)O)(O)=O,4,2,0,2,29,0.00010700000000000001
G5,C(C(C=O)(C(C(C(O)=O)O)=C)O)=O,2,1,0,1,29,5.9e-05
G5,C(C(C=O)(C(C(C=O)O)=C)O)(O)=O,4,2,0,2,29,0.00010700000000000001
G5,C(C(C(C)=O)(C(CO)=C)O)(O)=O,2,3,0,3,29,0.000154
G5,C(C(C(C)=O)(C=C)O)(O)=O,2,4,0,4,29,0.000202
G5,C(C(C=O)(C(C(CO)O)=C)O)(O)=O,4,2,0,2,29,0.00010700000000000001
G5,C(C(C=O)(C(C(O)=O)=CCO)O)=O,2,1,0,1,29,5.9e-05
G5,C(C(C=O)(C(C=O)=CCO)O)(O)=O,4,2,0,2,29,0.00010700000000000001
G5,C(C(C=O)(C(CO)=CCO)O)(O)=O,4,2,0,2,29,0.00010700000000000001
G5,C(C(C(C(C)=O)(C=C)O)O)(O)=O,4,3,0,3,33,0.000154
G5,C(C(C=O)(C(CO)=C)O)(O)=O,2,3,0,3,29,0.000154
G5,C(C(C=O)(C=CC(C(O)=O)O)O)=O,4,1,0,1,29,5.9e-05
G5,C(C(C=O)(C=C)O)(O)=O,2,4,0,4,29,0.000202
G5,C(C(C(CO)=C)(C(C=O)O)O)(O)=O,4,2,0,2,49,0.00010700000000000001
G5,C(C(C(CO)=C)(C(C(O)=O)O)O)=O,4,3,0,3,49,0.000154
G5,C(CC(C(C(C)=O)(C=C)O)=O)(O)=O,2,1,0,1,29,5.9e-05
G5,C(C(C(CC(C)=O)=O)(C=C)O)(O)=O,2,1,0,1,29,5.9e-05
G5,C(C(C(CCC=O)=O)(C=C)O)(O)=O,2,1,0,1,29,5.9e-05
G5,C(C(C(CCC(O)=O)=O)(C=C)O)=O,2,1,0,1,29,5.9e-05
G5,C(C(C=C)(C(C=CCO)=O)O)(O)=O,4,1,0,1,29,5.9e-05
G5,C=CC(C(C=CC(O)=O)=O)(CO)O,4,1,0,1,29,5.9e-05
G5,C(C(C(C=C)(C(C=C)=O)O)O)(O)=O,4,1,0,1,7,5.9e-05
G5,C(C(C=C)(C(C=CC=O)O)O)(O)=O,8,2,0,2,43,0.00010700000000000001
G5,C(C(C=C)(C(C=CC(O)=O)O)O)=O,8,2,0,2,43,0.000106
G5,C(C(C(C=O)=C)(C(CO)O)O)(O)=O,4,2,0,2,0,0.00010700000000000001
G5,C(C(C(C(O)=O)=C)(C(CO)O)O)=O,4,1,0,1,0,5.9e-05
G5,C(C(C(CO)=C)(C(CO)O)O)(O)=O,4,2,0,2,29,0.00010700000000000001
G5,C(C(C(C(O)=O)=C)(CC=O)O)=O,2,2,0,2,29,0.000106
G5,C(C(C(C=O)=C)(CC=O)O)(O)=O,2,2,0,2,29,0.000106
G5,C(C(C(C=O)=C)(CC(O)=O)O)=O,2,2,0,2,29,0.000106
G5,C(C(C(C(O)=O)=C)O)(O)=O,2,2,0,2,29,0.000106
G5,C(C(C(CO)=CC(O)=O)O)(O)=O,4,2,0,2,29,0.000106
G5,C(C(C(C(C(O)=O)O)=C)O)(O)=O,3,2,0,2,29,0.000106
G5,C(C(C(C=O)=CC(CO)=O)O)(O)=O,4,1,0,1,29,5.9e-05
G5,C(C(C(C(O)=O)=CC(CO)=O)O)=O,4,1,0,1,29,5.9e-05
G5,C(C(CO)=CC(CO)=O)(O)=O,2,2,0,2,29,0.000106
G5,C(C(C(C)O)=CC(CO)=O)(O)=O,4,2,0,2,29,0.000106
G5,C(C(C=C(C(C)=O)CO)=O)(O)=O,2,2,0,2,29,0.000106
G5,C(C(CO)=CC(C(C)=O)=O)(O)=O,2,2,0,2,29,0.000106
G5,C(C(C(C(O)=O)=CCO)O)(O)=O,4,2,0,2,29,0.000106
G5,C(C(C(CO)=C)(CC(O)=O)O)=O,2,2,0,2,29,0.000106
G5,C(C)(C(C=C)(CC(C(O)=O)=O)O)=O,2,1,0,1,29,5.9e-05
G5,C(C(C=C(C(C)=O)C(C)O)=O)(O)=O,4,1,0,1,29,5.9e-05
G5,C(C(C=C(C(O)=O)C(C)O)=O)(C)=O,4,1,0,1,29,5.9e-05
G5,C(C(C=C)(C=CC(CO)=O)O)(O)=O,4,1,0,1,32,5.9e-05
G5,C(C(C(CO)O)=CC(CO)=O)(O)=O,4,1,0,1,29,5.9e-05
G5,C(CC1OCC(C=1)=O)(O)=O,1,2,0,2,29,0.000106
G5,C(C1C(C=C(C)O1)=O)(O)=O,2,2,0,2,29,0.000106
G5,C(C1(C(C=CCO1)O)O)(O)=O,4,2,0,2,29,0.000106
G5,C(C1C=CC(C(O1)O)O)(O)=O,8,3,0,3,29,0.000154
G5,C(C(C1C=CC(O1)=O)O)(O)=O,4,2,0,2,29,0.000106
G5,C(C1C(C=CC(O1)=O)O)(O)=O,4,2,0,2,29,0.000106
G5,C(C(C(O)OCC(CO)O)O)(O)=O,8,2,0,2,29,0.000117
G5,C(C(CO)OC(C(CO)O)O)(O)=O,8,2,0,2,29,0.000117
G5,C(C(O)OC(CO)C(CO)O)(O)=O,8,2,0,2,29,0.000117
G5,C(C(COC(C(CO)O)O)O)(O)=O,8,2,0,2,29,0.000117
G5,C(COC(C(C(CO)O)O)O)(O)=O,8,3,0,3,29,0.000176
G5,C(C(O)OCC(C(CO)O)O)(O)=O,8,3,0,3,29,0.000176
G5,C(COC(CO)(C(CO)O)O)(O)=O,4,2,0,2,29,0.000117
G5,C(C1(C(C(CCO1)O)O)O)(O)=O,8,3,0,3,30,0.000165
G5,C(C(C1C(C(CO1)O)O)O)(O)=O,16,4,0,4,29,0.000234
G5,C(C(C(C=C)O)O)(O)=O,4,5,0,5,29,0.00024900000000000004
G5,C(C1(CC(CO)(CO1)O)O)(O)=O,4,2,0,2,5,0.000106
G5,C(C1C(C(C(CO)(O1)O)O)O)(O)=O,16,2,0,2,5,0.000106
G5,C(C1(C)CC(C(O1)O)=O)(O)=O,4,2,0,2,29,0.000106
G5,C(CC1(CO)CC(C(O)O1)=O)(O)=O,4,2,0,2,51,0.000106
G5,C(CC1(COC(C(O)=O)(C1)O)O)=O,4,2,0,2,29,0.000106
G5,C(CC1(COC(C=O)(C1)O)O)(O)=O,4,2,0,2,51,0.000106
G5,C(C1(CC(C(C(C)=O)O1)O)O)(O)=O,8,2,0,2,20,0.000106
G5,C(C(C1(C)CC(C(O)O1)=O)O)(O)=O,8,2,0,2,26,0.000106
G5,C(C1C(C)(CC(C(O)=O)(O1)O)O)=O,8,2,0,2,0,0.000106
G5,C(C1C(C)(CC(C=O)(O1)O)O)(O)=O,8,2,0,2,26,0.000106
G5,C(C1CC(C(O)O1)=O)(O)=O,4,3,0,3,17,0.000154
G5,C(C1(CC(C)(C(CO)O1)O)O)(O)=O,8,2,0,2,29,0.000106
G5,C(C1(CCO)CC(C(O1)O)=O)(O)=O,4,2,0,2,29,0.000106
G5,C(C(C1COC(C)(C1O)O)=O)(O)=O,8,2,0,2,45,0.000106
G5,C(C1(C)C(C(C(O1)O)=O)CO)(O)=O,8,2,0,2,4,0.000106
G5,C(C(C1COC(C1(C)O)O)=O)(O)=O,8,2,0,2,42,0.000106
G5,C(C1(CC(CO1)(CCO)O)O)(O)=O,4,2,0,2,29,0.000106
G5,C(C(C1CC(C(O)O1)=O)O)(O)=O,8,3,0,3,29,0.000154
G5,C(C1C(CC(C(O)=O)(O1)O)O)=O,8,2,0,2,5,0.000106
G5,C(C1C(CC(C=O)(O1)O)O)(O)=O,8,2,0,2,15,0.000106
G5,C(C1(CC(CO1)(C)O)O)(O)=O,4,2,0,2,49,0.000106
G5,C(CC(C1CC(C(O)O1)=O)O)(O)=O,8,2,0,2,20,0.000106
G5,C(C(CC1C(CC(O)O1)O)=O)(O)=O,8,2,0,2,20,0.000106
G5,C(CC1C(CC(C(O)=O)(O)O1)O)=O,8,2,0,2,29,0.000106
G5,C(CC1C(CC(C=O)(O)O1)O)(O)=O,8,2,0,2,29,0.000106
G5,C(C(CC1CC(C(O)O1)=O)O)(O)=O,8,2,0,2,29,0.000106
G5,C(C(CC1CC(C(O)O1)O)=O)(O)=O,8,2,0,2,29,0.000106
G5,C(C1C(C(C)(OC1C(O)=O)O)O)=O,16,2,0,2,45,0.000106
G5,C(C1C(C(C)(OC1C=O)O)O)(O)=O,16,2,0,2,45,0.000106
G5,C(C1C(C(OC1C(C)=O)O)O)(O)=O,16,2,0,2,45,0.000106
G5,C(C1C(C)(C(OC1C(O)=O)O)O)=O,16,2,0,2,45,0.000106
G5,C(C1C(C)(C(OC1C=O)O)O)(O)=O,16,2,0,2,29,0.000106
G5,C(C1C(C(OC1(C(O)=O)C)O)O)=O,16,2,0,2,45,0.000106
G5,C(C1C(C(OC1(C=O)C)O)O)(O)=O,16,2,0,2,45,0.000106
G5,C(C1C(CO)(O)OCC1(C)O)(O)=O,8,2,0,2,49,0.000106
G5,C(CC1(C(C(CO1)(C)O)O)O)(O)=O,8,2,0,2,49,0.000106
G5,C(CC1(COC(CO)(C1)O)O)(O)=O,4,2,0,2,29,0.000106
G5,C(CC1(COC(C)(C1O)O)O)(O)=O,8,2,0,2,0,0.000106
G5,C(C(C1(CC(CO1)(C)O)O)O)(O)=O,8,2,0,2,49,0.000106
G5,C(C1C(C)(CC(CO)(O1)O)O)(O)=O,8,2,0,2,55,0.000106
G5,C(C1C(C)(C(C(C)(O1)O)O)O)(O)=O,16,2,0,2,49,0.000106
G5,C(C1C(C)(CC(O1)O)O)(O)=O,8,2,0,2,33,0.000106
G5,C1(C(OC(C(O)=O)C1CO)O)=O,8,2,0,2,0,0.000106
G5,C(C(C1COC(C1O)O)=O)(O)=O,8,2,0,2,29,0.000106
G5,C(C1C(C(OC1C(O)=O)O)O)=O,16,2,0,2,43,0.000106
G5,C(C1C(C(OC1C=O)O)O)(O)=O,16,2,0,2,29,0.000106
G5,C(CC1C(CC(CO)(O)O1)O)(O)=O,8,2,0,2,29,0.000106
G5,C(CC1(CO)CC(C(O)O1)O)(O)=O,8,2,0,2,21,0.000106
G5,C(C1COC(C1O)O)(O)=O,8,2,0,2,29,0.000106
G5,C(C(C1COC(C1)(CO)O)=O)(O)=O,4,2,0,2,29,0.000106
G5,C(C1(CC(C(CO)=O)CO1)O)(O)=O,4,2,0,2,12,0.000106
G5,C(C1COC(C1O)(CC(O)=O)O)=O,8,2,0,2,23,0.000106
G5,C(C1COC(C1O)(CC=O)O)(O)=O,8,2,0,2,29,0.000106
G5,C(C(C(C1COC(C1)O)=O)O)(O)=O,8,2,0,2,43,0.000106
G5,C(C1COC(C1)(C(C(O)=O)O)O)=O,8,2,0,2,55,0.000106
G5,C(C1COC(C1)(C(C=O)O)O)(O)=O,8,2,0,2,29,0.000106
G5,C1(C(C)(O)OCC1C(C(O)=O)O)=O,8,2,0,2,14,0.000106
G5,C1(CC(C(O)=O)OC1(CCO)O)=O,4,2,0,2,14,0.000106
G5,C(C(CC1(C(CCO1)=O)O)O)(O)=O,4,2,0,2,14,0.000106
G5,C(CC(C1COC(C1O)O)=O)(O)=O,8,2,0,2,17,0.000106
G5,C(C1(C(CO)C(CO1)(C)O)O)(O)=O,8,2,0,2,49,0.000106
G5,C(CC1C(C(C(C)(O)O1)O)O)(O)=O,16,2,0,2,29,0.000106
G5,C(C(C1C(C)(CC(O)O1)O)O)(O)=O,16,2,0,2,16,0.000106
G5,C(CC1(C)C(C(C(O)O1)O)O)(O)=O,16,2,0,2,29,0.000106
G5,C(C1C(CC(O1)O)O)(O)=O,8,2,0,2,0,0.000106
G5,C(C(C1C(O)OCC1(C)O)O)(O)=O,16,2,0,2,49,0.000106
G5,C(C1C(C(O)OC1(C)CO)O)(O)=O,16,2,0,2,49,0.000106
G5,C(C1C(C)OC(C1O)O)(O)=O,16,2,0,2,29,0.000106
G5,C(CC1CC(C(O)O1)O)(O)=O,8,2,0,2,29,0.000106
G5,C(C1(CC(CO1)O)O)(O)=O,4,2,0,2,0,0.000106
G5,C(CC1(COC(C1O)O)O)(O)=O,8,2,0,2,0,0.000106
G5,C(C1(C(CO)C(CO1)O)O)(O)=O,8,2,0,2,0,0.000106
G5,C(C(C1C(O)OCC1O)O)(O)=O,16,2,0,2,38,0.000106
G5,C(C1C(CO)OC(C1O)O)(O)=O,16,2,0,2,41,0.000106
G5,C(COC1(COC(C1)O)O)(O)=O,4,2,0,2,29,0.000106
G5,C(COC1CC(C(O)O1)O)(O)=O,8,2,0,2,29,0.000106
G5,C(C(C1(C(C(CO1)O)O)O)O)(O)=O,16,3,0,3,34,0.000165
G5,C(C1CC(C(O1)O)O)(O)=O,8,2,0,2,29,0.000106
G5,C(C1CCC(C(O)=O)(O1)O)=O,4,2,0,2,29,0.000106
G5,C(C1CCC(C=O)(O1)O)(O)=O,4,2,0,2,29,0.000106
G5,C1(CC(C(O)=O)(OC1C)O)=O,4,2,0,2,29,0.000106
G5,C(C(C1CCC(O1)O)=O)(O)=O,4,2,0,2,27,0.000106
G5,C(CC1(C(CCO1)O)O)(O)=O,4,2,0,2,29,0.000106
G5,C(C(C1(CCCO1)O)O)(O)=O,4,2,0,2,29,0.000106
G5,C1(CC(C(CC(O)=O)(O)O1)O)=O,4,2,0,2,29,0.000106
G5,C1(CCC(C(C(O)=O)O)(O)O1)=O,4,2,0,2,29,0.000106
G5,C(C1(C(O)OCC1(CO)O)O)(O)=O,8,2,0,2,5,0.000106
G5,C(C1(COC(C)(C1O)O)O)(O)=O,8,2,0,2,24,0.000106
G5,C(C1(COC(C1O)O)O)(O)=O,8,3,0,3,34,0.000165
G5,C(C1(C(O)OC(CO)C1O)O)(O)=O,16,2,0,2,1,0.000106
G5,C(C1(CO)C(C(C(O1)O)O)O)(O)=O,16,4,0,4,17,0.000205
G5,C(C1C(C(CO)(C(O1)O)O)O)(O)=O,16,2,0,2,1,0.000106
G5,C(C1(C(C)(O)OCC1(C)O)O)(O)=O,8,2,0,2,49,0.000106
G5,C(C1(C(C(OC1C(O)=O)O)O)O)=O,16,2,0,2,0,0.000106
G5,C(C1(C(C(OC1C=O)O)O)O)(O)=O,16,2,0,2,0,0.000106
G5,C(C1(COC(C=C)(C1O)O)O)(O)=O,8,2,0,2,7,0.000106
G5,C(C1(C(C)OC(C)(C1O)O)O)(O)=O,16,2,0,2,4,0.000106
G5,C(C1(C(OC(C(O)=O)C1O)O)O)=O,16,2,0,2,1,0.000106
G5,C(C1(C(OC(C=O)C1O)O)O)(O)=O,16,2,0,2,1,0.000106
G5,C(C1(C=O)C(C(C(O1)O)O)O)(O)=O,16,4,0,4,1,0.00020299999999999997
G5,C(C1(C(C)OC(C1O)O)O)(O)=O,16,2,0,2,25,0.000106
G5,C(C1(C(O)OCC1O)O)(O)=O,8,3,0,3,17,0.000165
G5,C(C(C1(C(O)OCC1O)O)O)(O)=O,16,4,0,4,0,0.000212
G5,C(C1(CC(OC1C(C)=O)O)O)(O)=O,8,2,0,2,49,0.000106
G5,C(C1(CC(OC1(C(O)=O)C)O)O)=O,8,2,0,2,49,0.000106
G5,C(C1(CC(OC1(C=O)C)O)O)(O)=O,8,2,0,2,49,0.000106
G5,C(C1(CC(OC1C(O)=O)O)O)=O,8,2,0,2,2,0.000106
G5,C(C1(CC(OC1C=O)O)O)(O)=O,8,2,0,2,2,0.000106
G5,C(C1(COC(CO)(C1)O)O)(O)=O,4,2,0,2,2,0.000106
G5,C(C1(C(C)OC(CO)(C1)O)O)(O)=O,8,2,0,2,41,0.000106
G5,C(C1(COC(C1)O)O)(O)=O,4,2,0,2,27,0.000106
G5,C(C1(CC(C(C)=O)(CO1)O)O)(O)=O,4,2,0,2,29,0.000106
G5,C(CC(C1(COC(C1)O)O)=O)(O)=O,4,2,0,2,2,0.000106
G5,C(C1(COC(C(C)=O)(C1)O)O)(O)=O,4,2,0,2,14,0.000106
G5,C(C1(COC(C1)(CC=O)O)O)(O)=O,4,2,0,2,2,0.000106
G5,C(C1(COC(C1)(CC(O)=O)O)O)=O,4,2,0,2,14,0.000106
G5,C(CC1(C(O)OCC1(C)O)O)(O)=O,8,2,0,2,29,0.000106
G5,C(C1(CC(O)OC1(CO)C)O)(O)=O,8,2,0,2,29,0.000106
G5,C(C1(C(CO)OC(C1)O)O)(O)=O,8,2,0,2,0,0.000106
G5,C(C1(C2CC(CO2)O1)O)(O)=O,8,2,0,2,29,0.000106
G5,C(C1C2CC(C(O)O2)O1)(O)=O,16,2,0,2,40,0.000106
G5,C(CC1(COC(C(C1)=O)O)O)(O)=O,4,2,0,2,51,0.000106
G5,C(C1(C)C(C(CC(O1)O)=O)O)(O)=O,8,2,0,2,49,0.000106
G5,C(C1C(C)(CC(C(O1)O)=O)O)(O)=O,8,2,0,2,26,0.000106
G5,C(C1(C)CC(C(C(O1)O)O)=O)(O)=O,8,2,0,2,25,0.000106
G5,C(C1(CC(C)(C(CO1)O)O)O)(O)=O,8,2,0,2,29,0.000106
G5,C(C1(CC(C(O)=O)(O)OCC1)O)=O,4,2,0,2,29,0.000106
G5,C(C1(CC(C=O)(O)OCC1)O)(O)=O,4,2,0,2,29,0.000106
G5,C(C1(CC(CO)(CCO1)O)O)(O)=O,4,2,0,2,29,0.000106
G5,C(C1C(CC(C(O1)O)=O)O)(O)=O,8,3,0,3,29,0.000154
G5,C(CC1C(CC(C(O)O1)=O)O)(O)=O,8,2,0,2,29,0.000106
G5,C(C1CC(CC(C(O)=O)(O1)O)O)=O,8,2,0,2,29,0.000106
G5,C(C1CC(CC(C=O)(O1)O)O)(O)=O,8,2,0,2,20,0.000106
G5,C1(C(C(C(O)=O)OC(C1)O)O)=O,8,3,0,3,29,0.000154
G5,C1(CC(C(O)=O)OC(C1O)O)=O,8,3,0,3,29,0.000154
G5,C(C1CC(CO)(CC(O1)O)O)(O)=O,8,2,0,2,21,0.000106
G5,C(C1(C(CO)CC(CO1)=O)O)(O)=O,4,2,0,2,12,0.000106
G5,C(C(C1COC(CC1O)O)=O)(O)=O,8,2,0,2,45,0.000106
G5,C(C1COC(C(O)=O)(CC1O)O)=O,8,2,0,2,18,0.000106
G5,C(C1COC(C=O)(CC1O)O)(O)=O,8,2,0,2,29,0.000106
G5,C(CC1(CC(C(CO1)O)=O)O)(O)=O,4,2,0,2,17,0.000106
G5,C(CC1(C(C(CCO1)=O)O)O)(O)=O,4,2,0,2,29,0.000106
G5,C1(CCOC(C(C(O)=O)O)(C1)O)=O,4,2,0,2,30,0.000106
G5,C1(C(COC(C1O)O)CC(O)=O)=O,8,2,0,2,43,0.000106
G5,C(C1C(CC(CO)C(O1)O)=O)(O)=O,8,2,0,2,55,0.000106
G5,C1(C(COC(C1)O)C(C(O)=O)O)=O,8,2,0,2,2,0.000106
G5,C(C1(CCOC(CO)(C1)O)O)(O)=O,4,2,0,2,29,0.000106
G5,C(C1(CCOC(C)(C1O)O)O)(O)=O,8,2,0,2,3,0.000106
G5,C(C1C(C(C)(CC(O1)O)O)O)(O)=O,16,2,0,2,16,0.000106
G5,C(C1CC(CC(CO)(O1)O)O)(O)=O,8,2,0,2,29,0.000106
G5,C(C1CC(C(C(C)(O1)O)O)O)(O)=O,16,2,0,2,49,0.000106
G5,C(C1C(C(O)OCC1(C)O)O)(O)=O,16,2,0,2,29,0.000106
G5,C(C1(C(C(O)OCC1)O)O)(O)=O,8,2,0,2,30,0.000106
G5,C(C1C(C(O)OCC1O)O)(O)=O,16,2,0,2,30,0.000106
G5,C(C1(CC(CCO1)O)O)(O)=O,4,2,0,2,4,0.000106
G5,C1(CC(CC(C(O)=O)(O)O1)O)=O,4,2,0,2,29,0.000106
G5,C(C1(C(O)OCC(C1O)O)O)(O)=O,16,2,0,2,1,0.000106
G5,C(C1(COC(C(C1O)O)O)O)(O)=O,16,2,0,2,1,0.000106
G5,C(C1(C(CC(C)(O)OC1)=O)O)(O)=O,4,4,0,4,26,0.00020299999999999997
G5,C1(C(COC(C1)O)(CC(O)=O)O)=O,4,2,0,2,12,0.000106
G5,C(C1(COC(C(C1)=O)(C)O)O)(O)=O,4,2,0,2,14,0.000106
G5,C(C1(CC(O)OCC1(C)O)O)(O)=O,8,2,0,2,43,0.000106
G5,C(C1(CC(CC(CO1)=O)O)O)(O)=O,4,2,0,2,20,0.000106
G5,C1(C(CC(C(O)=O)(O)OCC1)O)=O,4,2,0,2,20,0.000106
G5,C(C1(CCOC(C(C1)=O)O)O)(O)=O,4,2,0,2,29,0.000106
G5,C(C1CC(CC(C(O1)O)=O)O)(O)=O,8,2,0,2,20,0.000106
G5,C1(C(COC(C(O)=O)(CC1)O)O)=O,4,2,0,2,12,0.000106
G5,C(C1COC(C(CC1O)=O)O)(O)=O,8,2,0,2,23,0.000106
G5,C(C1COC(CC(C1O)=O)O)(O)=O,8,2,0,2,23,0.000106
G5,C(C1COC(C(C(C1)=O)O)O)(O)=O,8,2,0,2,29,0.000106
G5,C(C1(C(CCC(O)OC1)=O)O)(O)=O,4,4,0,4,7,0.00020299999999999997
G5,C(C1(COC(CC(C1)=O)O)O)(O)=O,4,2,0,2,38,0.000106
G5,C1(C(CCO1)(CC(O)=O)O)=O,2,2,0,2,29,0.000106
G5,C1(C(C)(CC(C(O)=O)O1)O)=O,4,2,0,2,14,0.000106
G5,C1(C(CC(C(C(O)=O)O)O1)O)=O,8,2,0,2,29,0.000106
G5,C(CC1(COC(C1O)=O)O)(O)=O,4,2,0,2,29,0.000106
G5,C1(C(C(C)(C(C(O)=O)O1)O)O)=O,8,2,0,2,29,0.000106
G5,C1(C(C(C(C(O)=O)O1)O)O)=O,8,2,0,2,29,0.000106
G5,C1(C(C(C(C(C(O)=O)O)O1)O)O)=O,16,1,0,1,29,5.9e-05
G5,C1(C(CC(C(C(O)=O)O1)O)O)=O,8,2,0,2,29,0.000106
G5,C(C1(CCOC(C1O)=O)O)(O)=O,4,2,0,2,29,0.000106
G5,C1(C(C(C(C(C(O)=O)O1)O)O)O)=O,16,1,0,1,29,5.9e-05
G5,C(C1(C(CCC(C1O)=O)O)O)(O)=O,8,4,0,4,20,0.00020099999999999998
G5,C1(C(C(CC1)O)(C(C(O)=O)O)O)=O,8,2,0,2,33,0.000106
G5,C(CC(CCC(C=O)=O)O)(O)=O,2,2,0,2,7,0.00010700000000000001
G5,C(CC(CCC(C(O)=O)=O)O)=O,2,2,0,2,7,0.00010700000000000001
G5,C(C(CCC(C=O)=O)CO)(O)=O,2,2,0,2,7,0.00010700000000000001
G5,C(C(CCC(C(O)=O)=O)CO)=O,2,2,0,2,7,0.00010700000000000001
G5,C(CC(CCC(CO)=O)O)(O)=O,2,2,0,2,7,0.00010700000000000001
G5,C(C(CO)CCC(CO)=O)(O)=O,2,2,0,2,7,0.00010700000000000001
G5,C(C(C(CC=O)O)CC=O)(O)=O,4,2,0,2,18,0.00010700000000000001
G5,C(CC(C(C=O)CC(O)=O)O)=O,4,2,0,2,18,0.00010700000000000001
G5,C(C(CO)C(C=O)CC=O)(O)=O,4,2,0,2,18,0.00010700000000000001
G5,C(CC(C(O)=O)C(C=O)CO)=O,4,2,0,2,18,0.00010700000000000001
G5,C(C(CCC(C=O)=O)C(C)O)(O)=O,4,2,0,2,7,0.00010700000000000001
G5,C(C(CCC(C(O)=O)=O)C(C)O)=O,4,2,0,2,7,0.00010700000000000001
G5,C(CC(CCCC(C=O)=O)O)(O)=O,2,2,0,2,7,0.00010700000000000001
G5,C(CC(CCCC(C(O)=O)=O)O)=O,2,2,0,2,7,0.00010700000000000001
G5,C(CC(C)(CCC(C=O)=O)O)(O)=O,2,2,0,2,7,0.00010700000000000001
G5,C(CC(C)(CCC(C(O)=O)=O)O)=O,2,2,0,2,7,0.00010700000000000001
G5,C(C(CCC(CO)=O)C(C)O)(O)=O,4,2,0,2,7,0.00010700000000000001
G5,C(CC(CCCC(CO)=O)O)(O)=O,2,2,0,2,7,0.00010700000000000001
G5,C(CC(C)(CCC(CO)=O)O)(O)=O,2,2,0,2,7,0.00010700000000000001
G5,C(C(C(C)O)C(C=O)CC=O)(O)=O,8,2,0,2,28,0.00010700000000000001
G5,C(CC(C(O)=O)C(C=O)C(C)O)=O,8,2,0,2,28,0.00010700000000000001
G5,C(CC(CC(C=O)CC=O)O)(O)=O,4,3,0,3,43,0.000154
G5,C(C(CC(CC=O)O)CC=O)(O)=O,4,2,0,2,43,0.00010700000000000001
G5,C(C(C(C)(CC=O)O)CC=O)(O)=O,4,2,0,2,28,0.00010700000000000001
G5,C(CC(C)(C(C=O)CC(O)=O)O)=O,4,2,0,2,28,0.00010700000000000001
G5,C(C(C)(CCC(C(O)=O)=O)O)(O)=O,2,2,0,2,25,0.000106
G5,C(C(C)(C(C(O)=O)CC=O)O)(O)=O,4,2,0,2,29,0.000106
G5,C(CC(C=O)C(C(O)=O)(C)O)(O)=O,4,2,0,2,29,0.000106
G5,C(C(CC(C(O)=O)CC=O)O)(O)=O,4,2,0,2,25,0.000106
G5,C(C(CC(C=O)CC(O)=O)O)(O)=O,4,2,0,2,25,0.000106
G5,C(C(O)=O)(CCC(C(C=O)=O)O)=O,2,2,0,2,20,0.00010700000000000001
G5,C(CC(C=O)C(C(C(O)=O)=O)O)=O,4,2,0,2,33,0.00010700000000000001
G5,C(CC(C=O)C(C(C=O)=O)O)(O)=O,4,2,0,2,43,0.00010700000000000001
G5,C(C(C=O)CCC(C(O)=O)=O)=O,1,2,0,2,45,0.00010700000000000001
G5,C(C(C=O)C(C(O)=O)CC=O)=O,2,2,0,2,29,0.00010700000000000001
G5,C(C(C=O)C(C=O)CC(O)=O)=O,2,3,0,3,45,0.000154
G5,C(C(O)=O)(CCCC(C(O)=O)=O)=O,1,2,0,2,7,0.00010700000000000001
G5,C(CC(C(O)=O)CC(C(O)=O)=O)=O,2,2,0,2,29,0.00010700000000000001
G5,C(C(CC(O)=O)CC(C(O)=O)=O)=O,2,2,0,2,29,0.00010700000000000001
G5,C(C(C)=O)(CCCC(C(O)=O)=O)=O,1,2,0,2,14,0.00010700000000000001
G5,C(CCCC(C=O)=O)(CC(O)=O)=O,1,2,0,2,7,0.00010700000000000001
G5,C(CC(CCCC(C(O)=O)=O)=O)=O,1,2,0,2,7,0.00010700000000000001
G5,C(C)(C(C(O)=O)CCC(C=O)=O)=O,2,2,0,2,7,0.00010700000000000001
G5,C(C(C(C)=O)CCC(C(O)=O)=O)=O,2,2,0,2,7,0.00010700000000000001
G5,C(CCCC(CO)=O)(CC(O)=O)=O,1,2,0,2,7,0.00010700000000000001
G5,C(C)(C(C(O)=O)CCC(CO)=O)=O,2,2,0,2,7,0.00010700000000000001
G5,C(C(C(C)=O)C(C=O)CC=O)(O)=O,4,2,0,2,29,0.00010700000000000001
G5,C(C(C(C)=O)C(C(O)=O)CC=O)=O,4,2,0,2,29,0.00010700000000000001
G5,C(C(C(C)=O)C(C=O)CC(O)=O)=O,4,2,0,2,29,0.00010700000000000001
G5,C(C(C(C)O)CC(CO)=O)(O)=O,4,2,0,2,46,0.000106
G5,C(CO)(C(C(C)O)CC(O)=O)=O,4,2,0,2,46,0.000106
G5,C(CC(C(O)=O)CC(CO)=O)(O)=O,2,2,0,2,18,0.000106
G5,C(CC(C(CO)=O)CC(O)=O)(O)=O,1,2,0,2,18,0.000106
G5,C=CC(C(CCC(C(O)=O)=O)O)=O,2,2,0,2,7,0.00010700000000000001
G5,C(C(C)(CCC(C(O)=O)=O)O)=O,2,3,0,3,29,0.000154
G5,C(C(CCC(C(CO)O)O)=O)(O)=O,4,3,0,3,29,0.000165
G5,C(C(CCC(CO)(CO)O)=O)(O)=O,1,2,0,2,7,0.000106
G5,C(C(CCCCO)=O)(O)=O,1,2,0,2,46,0.000106
G5,C(C(CCC(C)O)=O)(O)=O,2,3,0,3,33,0.000154
G5,C(CCCC(C(O)=O)=O)(O)=O,1,3,0,3,18,0.000154
G5,C(C(CC=O)C(C(C=C)=O)O)(O)=O,4,2,0,2,7,0.00010700000000000001
G5,C(CC(C=O)C(C(C=C)=O)O)(O)=O,4,2,0,2,7,0.00010700000000000001
G5,C(CC(C(O)=O)C(C=O)(C)O)=O,4,2,0,2,29,0.00010700000000000001
G5,C(CC(C=O)C(C=O)(C)O)(O)=O,4,3,0,3,29,0.000154
G5,C(C(C(C(CO)O)O)CC=O)(O)=O,8,2,0,2,29,0.000106
G5,C(C(C(C(CO)O)O)CC(O)=O)=O,8,3,0,3,29,0.000165
G5,C(C(C(CO)(CO)O)CC=O)(O)=O,2,2,0,2,29,0.000106
G5,C(C(C(CO)(CO)O)CC(O)=O)=O,2,2,0,2,29,0.000106
G5,C(C(C(C)O)CC=O)(O)=O,4,2,0,2,27,0.000106
G5,C(C(C(C)O)CC(O)=O)=O,4,2,0,2,27,0.000106
G5,C(CC(C(O)=O)CC(O)=O)=O,2,2,0,2,18,0.000106
G5,C(C(CC(O)=O)CC(O)=O)=O,1,2,0,2,18,0.000106
G5,C(CC(C(C(O)=O)=O)CO)(C)=O,2,3,0,3,11,0.000154
G5,C(C)(C(CO)CC(C(O)=O)=O)=O,2,4,0,4,29,0.00020099999999999998
G5,C(CC(CO)CC(C=O)=O)(O)=O,2,6,0,6,55,0.000297
G5,C(C(CO)CC(C(C)=O)=O)(O)=O,2,3,0,3,29,0.000154
G5,C(C(CO)CC(CC=O)=O)(O)=O,2,3,0,3,29,0.000154
G5,C(C(CO)CC(CC(O)=O)=O)=O,2,3,0,3,29,0.000154
G5,C(C(CO)CC(O)=O)(CC=O)=O,2,4,0,4,29,0.00020099999999999998
G5,C(C(CO)CC=O)(CC(O)=O)=O,2,3,0,3,29,0.000154
G5,C(CCCO)(CC(C(O)=O)=O)=O,1,4,0,4,29,0.00020099999999999998
G5,C(CC(C(CCCO)=O)=O)(O)=O,1,4,0,4,29,0.00020099999999999998
G5,C(C1C(C(C(C1CO)O)O)O)(O)=O,32,2,0,2,29,0.00010700000000000001
G5,C(CC(C(C(O)=O)=O)CCO)(C)=O,2,2,0,2,46,0.000106
G5,C(CC(C(C(O)=O)=O)C(C)O)(C)=O,4,2,0,2,29,0.000106
G5,C(C)(C(CCO)CC(C(O)=O)=O)=O,2,2,0,2,29,0.000106
G5,C(C)(C(C(C)O)CC(C(O)=O)=O)=O,4,2,0,2,46,0.000106
G5,C(CC(CCO)CC(C(O)=O)=O)=O,2,3,0,3,46,0.000154
G5,C(CC(C(C)O)CC(C(O)=O)=O)=O,4,3,0,3,46,0.000154
G5,C(CC(C(C)O)CC(C=O)=O)(O)=O,4,3,0,3,46,0.000154
G5,C(C(CCO)CC(C(C)=O)=O)(O)=O,2,2,0,2,29,0.000106
G5,C(C(C(C)O)CC(C(C)=O)=O)(O)=O,4,2,0,2,46,0.000106
G5,C(CC(C(C(C)=O)=O)C(C)O)(O)=O,4,2,0,2,29,0.000106
G5,C(C(CCO)CC(CC=O)=O)(O)=O,2,2,0,2,29,0.000106
G5,C(C(CCO)CC(CC(O)=O)=O)=O,2,2,0,2,29,0.000106
G5,C(C(C(C)O)CC(CC=O)=O)(O)=O,4,2,0,2,46,0.000106
G5,C(C(C(C)O)CC(CC(O)=O)=O)=O,4,2,0,2,46,0.000106
G5,C(C(CCO)CC=O)(CC(O)=O)=O,2,2,0,2,29,0.000106
G5,C(C(C(C)O)CC(O)=O)(CC=O)=O,4,2,0,2,46,0.000106
G5,C(C(C(C)O)CC=O)(CC(O)=O)=O,4,2,0,2,46,0.000106
G5,C(CCCCO)(CC(C(O)=O)=O)=O,1,2,0,2,46,0.000106
G5,C(CCC(C)O)(CC(C(O)=O)=O)=O,2,2,0,2,46,0.000106
G5,C(CC(C(CCCCO)=O)=O)(O)=O,1,2,0,2,46,0.000106
G5,C(CC(C(CCC(C)O)=O)=O)(O)=O,2,2,0,2,46,0.000106
G5,C(C(C(CCC(C(O)=O)=O)O)O)=O,4,3,0,3,20,0.000165
G5,C(C(C(C(C=O)O)O)CC=O)(O)=O,8,2,0,2,43,0.00010700000000000001
G5,C(C(C(C(C=O)CC(O)=O)O)O)=O,8,2,0,2,43,0.00010700000000000001
G5,C(C(C=O)(CCC(C(O)=O)=O)O)=O,1,2,0,2,29,0.00010700000000000001
G5,C(C)(C(CCC(C(O)=O)=O)O)=O,2,3,0,3,45,0.000154
G5,C(CO)(C(C(CO)O)CC(O)=O)=O,4,3,0,3,18,0.000165
G5,C(C(C(C=C)=O)(CO)O)(O)=O,2,7,0,7,17,0.000349
G5,C(C(O)OCC(C=C)=O)(O)=O,2,2,0,2,29,0.000106
G5,C(C(C(C=C)=O)OCO)(O)=O,2,2,0,2,37,0.000106
G5,C(C(C(CC=CC(O)=O)=O)O)=O,4,1,0,1,55,5.9e-05
G5,C(CC=CC(C(C=O)O)=O)(O)=O,4,1,0,1,55,5.9e-05
G5,C(CC=CC(O)=O)=O,2,2,0,2,18,0.000106
G5,C(CC=CC=O)(O)=O,2,2,0,2,18,0.000106
G5,C1(CC2(C(C1(CO)C(C2)O)O)O)=O,16,2,0,2,23,9.499999999999999e-05
G5,C1(CCC2(C(CC(C12O)O)O)O)=O,16,5,0,5,7,0.00023700000000000001
G5,C1(CCC2(C(C1(C(C2)O)O)O)O)=O,16,5,0,5,29,0.00023700000000000001
G5,C(C12C(C(CC1O)(CC2O)O)O)=O,6,2,0,2,13,9.499999999999999e-05
G5,C1(C2(CC(C1(CO)C(C2)O)O)O)=O,3,1,0,1,4,4.7e-05
G5,C1(CC2(CC(C1(C(C2)O)O)O)O)=O,3,2,0,2,32,9.499999999999999e-05
G5,C1(CC2C(C1(C(CC2O)O)O)O)=O,32,5,0,5,18,0.00023700000000000001
G5,C(C1(C(C2C(CC1(C2)O)O)O)O)=O,32,2,0,2,44,9.499999999999999e-05
G5,C(C12CC(CC1O)(C(C2O)O)O)=O,32,2,0,2,44,9.499999999999999e-05
G5,C1(CC2(C(C1(C(C2O)O)O)O)O)=O,32,4,0,4,51,0.00018999999999999998
G5,C1(CCC2C(C1(C(C2O)O)O)O)=O,32,3,0,3,7,0.00014199999999999998
G5,C1(CC2C(C(C1(C(C2)O)O)O)O)=O,32,5,0,5,32,0.00023700000000000001
G5,C(C1(CO)C(CC(C1(C)O)O)O)=O,16,2,0,2,45,9.499999999999999e-05
G5,C(C1(C=O)C(CC(C1(C)O)O)O)=O,8,2,0,2,45,9.499999999999999e-05
G5,C(C1(CO)C(C(C)(CC1O)O)O)=O,16,2,0,2,18,9.499999999999999e-05
G5,C(C1(C=O)C(C(C)(CC1O)O)O)=O,8,2,0,2,45,9.499999999999999e-05
G5,C(C1C(C(CO)C(C1O)O)O)(O)=O,32,1,0,1,29,4.7e-05
G5,C(C1(CO)C(C)(CC(C1O)=O)O)=O,8,2,0,2,6,9.499999999999999e-05
G5,C(C1(C(CC(C1(C)O)=O)O)CO)=O,8,2,0,2,14,9.499999999999999e-05
G5,C(C1(CO)C(C=CC1(CO)O)O)=O,8,2,0,2,11,9.499999999999999e-05
G5,C1C(C(C(C=1)=O)(C(CCO)O)O)O,8,4,0,4,18,0.00019099999999999998
G5,C(C1(CO)C(C=CC1O)O)=O,3,1,0,1,43,4.7e-05
G5,C(C1(C=O)C(C(CC1O)O)O)(O)=O,16,3,0,3,43,0.000143
G5,C(C1(C(C)O)C(C=CC1O)O)=O,6,1,0,1,43,4.7e-05
G5,C(C1(C(CO)O)C(C=CC1O)O)=O,6,1,0,1,43,4.7e-05
G5,C1(C(C(C(C=O)=O)(C(C1)O)O)O)=O,8,4,0,4,23,0.00018999999999999998
G5,C1C(C(C(C=O)=O)(C(C=1)O)O)O,3,2,0,2,43,9.499999999999999e-05
G5,C(C1(C(C(CC1O)O)=O)O)(O)=O,8,4,0,4,2,0.00019099999999999998
G5,C1C(C(C(C(C)=O)=O)(C(C=1)O)O)O,3,2,0,2,25,9.499999999999999e-05
G5,C(C1(C(C=CC1O)O)O)(C(C)O)=O,6,2,0,2,25,9.499999999999999e-05
G5,C(C1(C=O)C(C)(CC(C1O)=O)O)=O,4,2,0,2,26,9.499999999999999e-05
G5,C(C1(C=O)C(CC(C1O)=O)O)=O,4,2,0,2,23,9.499999999999999e-05
G5,C(C1(C=O)C(CC(C1(C)O)=O)O)=O,4,2,0,2,14,9.499999999999999e-05
G5,C(C1(C=O)C(C=CC1(CO)O)O)=O,4,2,0,2,11,9.499999999999999e-05
G5,C(CC(C1(C(C=CC1O)=O)O)O)=O,8,4,0,4,45,0.00019099999999999998
G5,C(C1(C=O)C(C=CC1O)O)=O,3,1,0,1,43,4.7e-05
G5,C(C1(C=O)C(C(C=CC1(C)O)=O)O)=O,4,2,0,2,45,9.499999999999999e-05
G5,C(C1(C=CC(C)(C1(C=O)C=O)O)O)=O,4,2,0,2,45,9.499999999999999e-05
G5,C(C1(C=O)C(CC=CC(C1O)=O)O)=O,4,2,0,2,45,9.499999999999999e-05
G5,C(C1(C=O)C(CC=CC1(C=O)O)O)=O,4,2,0,2,45,9.499999999999999e-05
G5,C(CC(C1(C=O)C=CC(C1O)=O)O)=O,8,2,0,2,45,9.499999999999999e-05
G5,C(C1(C=O)C(C=CC1(C(C)=O)O)O)=O,4,2,0,2,45,9.499999999999999e-05
G5,C(C1(C=O)C(C=CC(C1(C)O)=O)O)=O,4,2,0,2,45,9.499999999999999e-05
G5,C(C1(C=O)C(C=CC1(CC=O)O)O)=O,4,2,0,2,45,9.499999999999999e-05
G5,C(C1(C=O)C(CC(C=CC1O)=O)O)=O,4,2,0,2,45,9.499999999999999e-05
G5,C(CC(C1(C=O)C(C=CC1O)=O)O)=O,8,2,0,2,45,9.499999999999999e-05
G5,C(C1(C=O)C(C(CC1(C=C)O)=O)O)=O,4,2,0,2,45,9.499999999999999e-05
G5,C(C1(C=O)C(CC(C1(C=C)O)=O)O)=O,4,2,0,2,45,9.499999999999999e-05
G5,C(C1(C=O)C(C=CCC(C1O)=O)O)=O,4,2,0,2,27,9.499999999999999e-05
G5,C(C1(C=O)C(C=CCC1(C=O)O)O)=O,4,2,0,2,27,9.499999999999999e-05
G5,C(C1(C(C(CC1(C)O)=O)=O)O)(O)=O,4,4,0,4,26,0.00019099999999999998
G5,C(C1(C(C(CCC1O)=O)=O)O)(O)=O,4,4,0,4,17,0.00019099999999999998
G5,C1(C(C(O)=O)(C(C(C1)=O)(C)O)O)=O,4,4,0,4,24,0.00019099999999999998
G5,C(C1(C(C(C=CC1O)O)=O)O)(O)=O,8,4,0,4,32,0.00019099999999999998
G5,C(C1(C(C=CC1(CO)O)=O)O)(O)=O,4,4,0,4,32,0.00019099999999999998
G5,C1(C2C(C(C(O)=O)C(C2O)O1)O)=O,32,1,0,1,48,4.7e-05
G5,C(C12C(C(C(CC1O)O2)O)=O)(O)=O,16,4,0,4,9,0.00019099999999999998
G5,C(C12C(C(CC1O)OC2O)=O)(O)=O,16,4,0,4,17,0.00019099999999999998
G5,C(C1(C=O)C=CC(C1O)=O)(O)=O,4,3,0,3,17,0.000143
G5,C(C1(C=O)C(C=CC1O)=O)(O)=O,4,4,0,4,17,0.00019099999999999998
G5,C(C1C(C2(C(C1OC2)=O)O)O)(O)=O,16,2,0,2,9,9.499999999999999e-05
G5,C(C12C(C(CC1O)(O)OC2)=O)(O)=O,8,4,0,4,17,0.00019099999999999998
G5,C(C12C(CC(CC1O)(O2)O)=O)(O)=O,8,5,0,5,48,0.000239
G5,C(C12C(CC(C1O)(O)OC2)=O)(O)=O,8,4,0,4,30,0.00019099999999999998
G5,C(C12C(CC(C1O)OC2O)=O)(O)=O,16,4,0,4,17,0.00019099999999999998
G5,C(C1(C(C(C=CC1O)=O)O)O)(O)=O,8,2,0,2,33,9.499999999999999e-05
G5,C(C(C1(C(C=CC1O)=O)O)O)(O)=O,8,4,0,4,33,0.00018999999999999998
G5,C(C)(C1(C(C=O)=O)C(C=CC1O)O)=O,3,1,0,1,43,4.7e-05
G5,C(C)(C1(C=O)C(CC(C1O)=O)O)=O,8,2,0,2,23,9.499999999999999e-05
G5,C1(C(C(C(C=C)=O)(C(C1)O)O)O)=O,8,4,0,4,23,0.00018999999999999998
G5,C(C1(C(C=O)=O)C(C=CC1O)O)=O,3,1,0,1,23,4.7e-05
G5,C(C1(C(C(C)=O)=O)C(C=CC1O)O)=O,3,1,0,1,14,4.7e-05
G5,C(C1(C(C)=O)C(C=CC1O)O)=O,3,1,0,1,43,4.7e-05
G5,C1(COC(C21C(C=CC2O)O)O)=O,6,1,0,1,43,4.7e-05
G5,C1(C2(C(C=CC2O)O)OC(C1)O)=O,6,2,0,2,35,9.499999999999999e-05
G5,C=CC(C(C1(C(C=CC1O)=O)O)O)=O,8,4,0,4,7,0.00019099999999999998
G5,C=CC(C1(C(C=CC(C1O)=O)O)O)=O,8,2,0,2,7,9.499999999999999e-05
G5,C(C(C=C)(C1(C(C=CC1O)=O)O)O)=O,8,4,0,4,7,0.00019099999999999998
G5,C(C(C1(C(C=CC1O)=O)O)O)=CC=O,16,4,0,4,43,0.00018999999999999998
G5,C1C(C(C(C=CC=O)=O)(C(C=1)O)O)O,6,2,0,2,43,9.499999999999999e-05
G5,C1C(C(C(C=1)=O)(C(C(C)O)O)O)O,16,4,0,4,11,0.00019099999999999998
G5,C=CC(C1(C(C=CC1O)O)O)=O,3,3,0,3,43,0.00014199999999999998
G5,C1(C2(C(C=CC2O)O)OCC1O)=O,6,2,0,2,10,9.499999999999999e-05
G5,C1(C(O)OCC21C(C=CC2O)O)=O,6,1,0,1,34,4.7e-05
G5,C(C1(C(CC(C1(C)O)O)O)O)=O,16,4,0,4,0,0.00018999999999999998
G5,C(C1(C(C(C(CC1O)O)O)O)O)=O,32,6,0,6,0,0.000307
G5,C(C1(C(CC(C1(CO)O)O)O)O)=O,16,5,0,5,0,0.000248
G5,C(C1(C(C=CC1(CO)O)O)O)=O,8,5,0,5,11,0.00023700000000000001
G5,C1C(C(C(C=1)=O)(C(CO)O)O)O,8,5,0,5,0,0.000239
G5,C(C1(C(C(CC(C1O)O)O)O)O)=O,10,2,0,2,0,9.499999999999999e-05
G5,C(C1(C(C(C=CC1(C)O)=O)O)O)=O,8,4,0,4,45,0.00018999999999999998
G5,C(C(C1(C(C=CC1(C)O)=O)O)O)=O,8,2,0,2,45,9.499999999999999e-05
G5,C(C1(C=CC(C)(C1(C=O)O)O)O)=O,8,4,0,4,45,0.00018999999999999998
G5,C(C1(C(CC=CC(C1O)=O)O)O)=O,8,4,0,4,45,0.00018999999999999998
G5,C(C(C1(C(C=CCC1O)=O)O)O)=O,8,2,0,2,29,9.499999999999999e-05
G5,C(C1(C=CCC(C1(C=O)O)O)O)=O,8,4,0,4,45,0.00018999999999999998
G5,C(C1(C=CC(C1O)=O)C(CO)O)=O,8,2,0,2,45,9.6e-05
G5,C(C1(C(C=CC1(C(C)=O)O)O)O)=O,8,4,0,4,45,0.00018999999999999998
G5,C(C1(C(C=CC(C1(C)O)=O)O)O)=O,8,4,0,4,45,0.00018999999999999998
G5,C(CC1(C=CC(C1(C=O)O)O)O)=O,8,4,0,4,45,0.00018999999999999998
G5,C(C1(C(CC(C=CC1O)=O)O)O)=O,8,4,0,4,45,0.00018999999999999998
G5,C(C1(C(C=CC1O)=O)C(CO)O)=O,8,2,0,2,0,9.6e-05
G5,C(C1(C(C(CC1(C=C)O)=O)O)O)=O,8,4,0,4,45,0.00018999999999999998
G5,C1(CC(C(C=O)(C1(C=C)O)O)O)=O,8,4,0,4,0,0.00018999999999999998
G5,C(C1(C(C(CC=CC1O)=O)O)O)=O,8,4,0,4,27,0.00018999999999999998
G5,C(C(C1(C(CC=CC1O)=O)O)O)=O,8,2,0,2,27,9.499999999999999e-05
G5,C(C1(CC=CC(C1(C=O)O)O)O)=O,8,4,0,4,27,0.00018999999999999998
G5,C(CO)(C1(C(C=CC1O)O)O)=O,3,3,0,3,51,0.00014199999999999998
G5,C1(C(CO)(C(C=O)(CC1O)O)O)=O,8,2,0,2,5,9.499999999999999e-05
G5,C(C)(C1(C(C(C=CC1O)=O)O)O)=O,8,2,0,2,45,9.499999999999999e-05
G5,C(C)(C(C1(C(C=CC1O)=O)O)O)=O,8,4,0,4,45,0.00019099999999999998
G5,C(C(C)(C1(C(C=CC1O)=O)O)O)=O,8,4,0,4,45,0.00019099999999999998
G5,C(C1(C=CC(C1O)=O)C(C(C)=O)O)=O,8,2,0,2,45,9.499999999999999e-05
G5,C(C(C)(C1(C=O)C=CC(C1O)=O)O)=O,8,2,0,2,45,9.499999999999999e-05
G5,C(C1(C(C=CC1O)=O)C(C(C)=O)O)=O,8,2,0,2,45,9.499999999999999e-05
G5,C(C(C)(C1(C=O)C(C=CC1O)=O)O)=O,8,2,0,2,45,9.499999999999999e-05
G5,C(C1(C(CO)=O)C(C=CC1O)O)=O,3,1,0,1,43,4.7e-05
G5,C(CC(C1(C(C=CC1O)O)O)=O)=O,3,2,0,2,43,9.499999999999999e-05
G5,C(C1(C(C(C=CC1O)=O)O)O)=O,8,5,0,5,0,0.00023700000000000001
G5,C(C(C1(C(C=CC1O)=O)O)O)=O,8,5,0,5,0,0.000239
G5,C(C1(C=CC(C1O)=O)C(C=O)O)=O,8,2,0,2,45,9.6e-05
G5,C(C1(C(C=CC1O)=O)C(C=O)O)=O,8,2,0,2,45,9.6e-05
G5,C(C1(CO)C(C(CC1O)O)O)=O,16,3,0,3,43,0.000144
G5,C1(C(CO)(CO)C(C(C1O)=O)O)=O,4,2,0,2,2,9.7e-05
G5,C(C1(CO)C(C(C(C1O)=O)O)O)=O,16,2,0,2,5,9.7e-05
G5,C(CO)(C1(CO)C(C(CO1)O)O)=O,8,4,0,4,36,0.000194
G5,C(C1(COC(CO)C1(CO)O)O)=O,8,2,0,2,36,9.499999999999999e-05
G5,C(C1(COCC1(C(CO)O)O)O)=O,8,2,0,2,36,9.499999999999999e-05
G5,C(CO)(C1(C(O)OCC1O)CO)=O,8,3,0,3,38,0.000144
G5,C(CO)(C1(COC(C1O)O)CO)=O,8,3,0,3,30,0.000144
G5,C(C1(CO)C(CO)(O)OCC1O)=O,8,3,0,3,40,0.000144
G5,C1(C(CC(C)(C1(CO)O)O)=O)=O,4,5,0,5,26,0.000241
G5,C1(C(CCC(C1(CO)O)O)=O)=O,4,5,0,5,17,0.000241
G5,C1(C(CO)(C(C(C1)=O)(C)O)O)=O,4,5,0,5,2,0.000241
G5,C1(C(CO)(C(C=CC1O)O)O)=O,8,6,0,6,32,0.00028900000000000003
G5,C1C(CO)(C(C(C=1)=O)(CO)O)O,4,6,0,6,32,0.00028900000000000003
G5,C1(C2C(C(CO)C(C2O)O1)O)=O,32,1,0,1,48,4.7e-05
G5,C1(C(C2CC(C1(CO)O2)O)O)=O,16,4,0,4,2,0.000194
G5,C1(C2CC(C1(CO)C(O2)O)O)=O,16,4,0,4,2,0.000192
G5,C(C1(C=CC(C1O)=O)CO)=O,4,3,0,3,2,0.000144
G5,C(C1(C(C=CC1O)=O)CO)=O,4,4,0,4,2,0.000192
G5,C1(C2C(CO)C(C1(CO2)O)O)=O,16,2,0,2,9,9.499999999999999e-05
G5,C1(C2(CC(C1(CO)CO2)O)O)=O,8,4,0,4,2,0.000192
G5,C1(CC2(CC(C1(CO)O2)O)O)=O,8,5,0,5,2,0.000241
G5,C1(CC2(C(C1(CO2)CO)O)O)=O,8,4,0,4,30,0.000192
G5,C1(CC2C(C1(C(O)O2)CO)O)=O,16,5,0,5,2,0.000239
G5,C1(C2(C(C(CO)C(C2O)O1)O)O)=O,32,2,0,2,27,9.499999999999999e-05
G5,C1C(C(C(C=O)=O)(CO)C(C=1)O)O,3,1,0,1,20,4.7e-05
G5,C(C1(C(C=CC1O)O)O)(CCO)=O,3,2,0,2,43,9.499999999999999e-05
G5,C(CO)(C1(CO)C(C=CC1O)O)=O,3,1,0,1,43,4.7e-05
G5,C(C)(C1(C(CC(C1(C)O)O)O)O)=O,16,4,0,4,45,0.00018999999999999998
G5,C(C)(C1(C(C(C)(CC1O)O)O)O)=O,16,4,0,4,45,0.00018999999999999998
G5,C(C)(C1(C(C)(CC(C1O)=O)O)O)=O,8,4,0,4,49,0.00018999999999999998
G5,C(C1(C(C=CC1(CO)O)O)O)(C)=O,8,4,0,4,49,0.00018999999999999998
G5,C1C(C(C(C=1)=O)(C(CO)(C)O)O)O,8,4,0,4,49,0.00019099999999999998
G5,C(C)(C1(C(C=CC1O)O)O)=O,3,3,0,3,43,0.00014199999999999998
G5,C(C1(C(C(CC1O)O)O)C(C)O)=O,32,3,0,3,43,0.000144
G5,C(C(C1(C(C(CC1O)O)O)O)=O)=O,16,4,0,4,5,0.00018999999999999998
G5,C(C1(C=O)C(C(CC1O)O)O)=O,8,2,0,2,43,9.499999999999999e-05
G5,C(C1(C(C)=O)C(C(CC1O)O)O)=O,16,2,0,2,6,9.499999999999999e-05
G5,C(C(C1(C=O)C(C=CC1O)O)O)=O,6,1,0,1,43,4.7e-05
G5,C(C1(C=O)C(C(C(C1O)O)O)O)=O,10,1,0,1,0,4.7e-05
G5,C(C)(C1(C(CC(CC1O)O)O)O)=O,3,2,0,2,4,9.499999999999999e-05
G5,C(C1(C(CC(CC1(C)O)O)O)O)=O,16,2,0,2,4,9.499999999999999e-05
G5,C(C1(C(CC(CC1O)O)O)O)=O,3,2,0,2,45,9.499999999999999e-05
G5,C1(C(CC(C)(C1(C(C)O)O)O)=O)=O,8,4,0,4,26,0.000192
G5,C1(C(CCC(C1(C(C)O)O)O)=O)=O,8,4,0,4,17,0.000192
G5,C1(C(C(C)O)(C(C(C1)=O)(C)O)O)=O,8,4,0,4,24,0.000192
G5,C1(C(C(C)O)(C(C=CC1O)O)O)=O,16,4,0,4,32,0.000192
G5,C1C(CO)(C(C(C=1)=O)(C(C)O)O)O,8,4,0,4,32,0.000192
G5,C(C1(C(CC(C1(C=O)O)O)O)O)=O,10,4,0,4,0,0.00018999999999999998
G5,C(C1(C(CC(C1(C)O)O)O)O)(O)=O,16,4,0,4,45,0.00018999999999999998
G5,C1(C(C2(CC1(CO)C(C2)O)O)O)=O,16,1,0,1,47,4.7e-05
G5,C1(C2C(C(C(C)(CC2O)O)O1)O)=O,32,1,0,1,48,4.7e-05
G5,C1(C2C(CC(CC(C2O)O1)O)O)=O,32,1,0,1,48,4.7e-05
G5,C1(C2C(C(C(C2O)O1)C(C)O)O)=O,64,1,0,1,48,4.7e-05
G5,C(C)(C12C(C(CO1)(CC2O)O)O)=O,16,2,0,2,17,9.499999999999999e-05
G5,C1(COC2C(C)(CC(C12O)O)O)=O,16,2,0,2,17,9.499999999999999e-05
G5,C1(COC2CC(CC(C12O)O)O)=O,16,2,0,2,9,9.499999999999999e-05
G5,C1(C(C2CC(C1(C(C)O)O2)O)O)=O,32,4,0,4,9,0.000192
G5,C1(C2CC(C1(C(O2)O)C(C)O)O)=O,32,4,0,4,4,0.00019099999999999998
G5,C1(CC2(COC1(CO)C(C2)O)O)=O,8,2,0,2,54,9.499999999999999e-05
G5,C1(C2C(C(CC2O)(CCO1)O)O)=O,16,1,0,1,19,4.7e-05
G5,C1(C2C(CC(CO1)(CC2O)O)O)=O,3,1,0,1,48,4.7e-05
G5,C1(CC2(COCC1(C(C2)O)O)O)=O,8,2,0,2,36,9.499999999999999e-05
G5,C(C1(C=CC(C1O)=O)C(C)O)=O,8,3,0,3,4,0.000144
G5,C(C1(C(C=CC1O)=O)C(C)O)=O,8,4,0,4,4,0.00019099999999999998
G5,C1(C2CC(CC(C1(CO2)O)O)O)=O,16,2,0,2,9,9.499999999999999e-05
G5,C1(C2C(C(C1(CO2)O)O)C(C)O)=O,32,2,0,2,9,9.499999999999999e-05
G5,C1(C2(CC(C1(CO2)C(C)O)O)O)=O,16,4,0,4,4,0.00019099999999999998
G5,C1(CC2(CC(C1(C(C)O)O2)O)O)=O,16,5,0,5,48,0.00023999999999999998
G5,C(C12C(CC(C(CC1O)O2)O)O)=O,32,2,0,2,40,9.499999999999999e-05
G5,C1(C(C)OC2C(CC(C12O)O)O)=O,32,2,0,2,29,9.499999999999999e-05
G5,C(C12C(C(CC1O)(C(C)O2)O)O)=O,32,2,0,2,29,9.499999999999999e-05
G5,C1(CC2(C(C1(CO2)C(C)O)O)O)=O,16,4,0,4,4,0.00019099999999999998
G5,C1(CC2C(C1(C(O)O2)C(C)O)O)=O,32,4,0,4,4,0.00019099999999999998
G5,C(C1C(C(C=O)(C(C1)=O)O)O)(O)=O,8,2,0,2,17,9.499999999999999e-05
G5,C(C1(C(CCC1O)O)O)(O)=O,3,2,0,2,33,9.499999999999999e-05
G5,C1(C(C(C(C1(CO)O)O)O)=O)=O,8,2,0,2,0,9.499999999999999e-05
G5,C(C1(COC(CO)(C1(C)O)O)O)=O,8,3,0,3,41,0.00014199999999999998
G5,C(C1(C(CO)OCC1O)O)=O,8,2,0,2,26,9.499999999999999e-05
G5,C(C1(C(COCC1O)O)O)=O,3,2,0,2,37,9.499999999999999e-05
G5,C1(C(C=O)(C(C)(CO1)O)O)=O,4,3,0,3,2,0.00014199999999999998
G5,C1(C(C)(C(C=O)(CO1)O)O)=O,4,3,0,3,27,0.00014199999999999998
G5,C1(C(C(C)=O)(C(CO1)O)O)=O,4,4,0,4,2,0.00018999999999999998
G5,C(C)(C1(COC(C1O)=O)O)=O,4,4,0,4,2,0.00018999999999999998
G5,C(C1(C(OCC1O)=C)O)=O,4,3,0,3,26,0.00014199999999999998
G5,C1(C(CO)(C(C)(CO1)O)O)=O,4,5,0,5,27,0.000241
G5,C1(C(CO)C(CO1)(CO)O)=O,4,2,0,2,5,9.499999999999999e-05
G5,C(C1(COC(C1(CO)O)O)O)=O,8,3,0,3,2,0.00014199999999999998
G5,C(C1(C(C(CC1(C)O)O)O)O)=O,16,2,0,2,0,9.499999999999999e-05
G5,C(C1(COC(CO)C1O)O)=O,8,2,0,2,2,9.499999999999999e-05
G5,C(C1(CO)C(C(CO1)O)O)=O,8,2,0,2,2,9.499999999999999e-05
G5,C(C1(COCC(C1O)O)O)=O,8,2,0,2,36,9.499999999999999e-05
G5,C1(C2(C(O)=O)C(CC(C2O)O1)O)=O,16,2,0,2,17,9.6e-05
G5,C1(C2(C(CO1)O)C(C=CC2O)O)=O,6,1,0,1,8,4.7e-05
G5,C1(C2(CO)C(C(CC2O)O1)O)=O,16,2,0,2,48,9.7e-05
G5,C1(C2C(C(CO)(C(C2O)O1)O)O)=O,32,1,0,1,8,4.7e-05
G5,C1(C2(CO)C(C(C(C2O)O1)O)O)=O,32,3,0,3,8,0.000144
G5,C1(C2C(C(CO)(C(C2O)O)O1)O)=O,32,1,0,1,8,4.7e-05
G5,C1(C2(C(C(CC2O)O1)O)C(C)O)=O,32,2,0,2,48,9.6e-05
G5,C(C1C(CC(C1(C=O)O)O)O)(O)=O,16,2,0,2,43,9.499999999999999e-05
G5,C(C12C(C(CO1)(C(C2)O)O)=O)(O)=O,8,3,0,3,17,0.000143
G5,C(C1C(C(C)(C(C1O)O)O)O)(O)=O,32,1,0,1,29,4.7e-05
G5,C(C1(CC(C(C1(C=O)O)O)=O)O)=O,8,2,0,2,0,9.499999999999999e-05
G5,C(C1(C(C(C)(C(C1O)O)O)=O)O)=O,16,3,0,3,25,0.00014199999999999998
G5,C1(C2(CO)CC(C1(CO2)O)O)=O,8,3,0,3,9,0.000144
G5,C1(C2(C(C)O)CC(C1(CO2)O)O)=O,16,3,0,3,9,0.000144
G5,C(C1(C(C=CC1(CO)O)O)O)(O)=O,8,4,0,4,11,0.00018999999999999998
G5,C(C1(C(CCC1(CO)O)=O)O)=O,4,3,0,3,20,0.00014199999999999998
G5,C(C1(C(C(CC1O)=O)=O)C)=O,4,1,0,1,42,4.7e-05
G5,C(C1(C(CCC(C1O)=O)=O)O)=O,4,4,0,4,29,0.00018999999999999998
G5,C1(CCC(C=O)(C1(C=O)O)O)=O,4,3,0,3,29,0.00014199999999999998
G5,C1(C(C(C(C1C)O)(CO)O)=O)=O,8,5,0,5,42,0.000241
G5,C1(C(CC(C1(C)CO)O)=O)=O,4,1,0,1,42,4.7e-05
G5,C(C1(C)C(CC(C1O)=O)O)=O,8,1,0,1,49,4.7e-05
G5,C(C1(C(CC(C)C1O)=O)O)=O,8,2,0,2,49,9.499999999999999e-05
G5,C1(C(CC(C1(CO)O)O)=O)=O,4,3,0,3,2,0.00014199999999999998
G5,C1(CC(C)C(C1(CO)O)O)=O,8,2,0,2,28,9.499999999999999e-05
G5,C1(CCC(C1(C(C)=O)O)O)=O,4,3,0,3,49,0.00014199999999999998
G5,C(C1(C(C(C)CC1O)=O)O)=O,8,3,0,3,16,0.00014199999999999998
G5,C1(C(C(C)C(C1(CO)O)O)O)=O,16,2,0,2,49,9.499999999999999e-05
G5,C1(CCC(C1(C(C=C)=O)O)O)=O,4,3,0,3,7,0.00014199999999999998
G5,C1(C(C=O)(C(CC1C=C)O)O)=O,8,4,0,4,29,0.00018999999999999998
G5,C(C1(C(C(C(C1O)=O)C)O)O)=O,16,5,0,5,49,0.00023700000000000001
G5,C(C1(C(C(C)C(C1O)O)=O)O)=O,16,3,0,3,42,0.00014199999999999998
G5,C(C1(C(CCC1O)O)O)=O,3,2,0,2,27,9.499999999999999e-05
G5,C(C1(C=O)C(CCC1O)=O)=O,2,1,0,1,29,4.7e-05
G5,C(C1(C=O)C(C(CC1O)O)=O)=O,4,1,0,1,23,4.7e-05
G5,C(C1(C=O)C(CC(C1O)O)=O)=O,4,1,0,1,29,4.7e-05
G5,C1(CCC(C1(C=O)C(C)=O)O)=O,4,1,0,1,29,4.7e-05
G5,C(C)(C1(C(C=CC1O)=O)CO)=O,4,1,0,1,29,4.7e-05
G5,C(C1C(C(CO)(C(C1)O)O)=O)=O,8,6,0,6,41,0.00028900000000000003
G5,C(C1C(C(C=O)(C(C1)O)O)O)=O,16,5,0,5,43,0.00023700000000000001
G5,C(C1(C=O)CC(C(C1O)O)O)=O,8,1,0,1,43,4.7e-05
G5,C(C1(C(C(C(C1O)O)O)=O)C)=O,16,1,0,1,49,4.7e-05
G5,C(C1(C=O)C(CC(C1)=O)O)=O,2,1,0,1,2,4.7e-05
G5,C(C1C(C(C=O)(C(C1)O)O)=O)=O,8,3,0,3,1,0.00014199999999999998
G5,C(C)(C1(C=O)C(CC(C1)=O)O)=O,4,1,0,1,29,4.7e-05
G5,C1(CC2C(C1(CO2)O)O)=O,8,2,0,2,37,9.499999999999999e-05
G5,C1(CC2(C(C1(CO2)O)O)O)=O,8,4,0,4,2,0.00018999999999999998
G5,C(C1(C(C=CC1(C)O)=O)O)=O,4,4,0,4,29,0.00018999999999999998
G5,C(C1(C(CC(C1O)=C)=O)O)=O,4,4,0,4,16,0.00018999999999999998
G5,C(C1(C(C=C(C)C1O)=O)O)=O,4,3,0,3,16,0.00014199999999999998
G5,C1C(C)(C(C(C=1)=O)(CO)O)O,4,3,0,3,45,0.00014199999999999998
G5,C1(C(CO)(C(C(C1)=C)O)O)=O,4,4,0,4,16,0.00018999999999999998
G5,C1(C(C(C(C=1)=O)(CO)O)O)C,4,3,0,3,16,0.00014199999999999998
G5,C(C1(C=CC(C1(C=O)O)O)O)=O,8,3,0,3,20,0.00014199999999999998
G5,C1(C(CO)(C(C(C1O)=C)O)O)=O,8,6,0,6,2,0.00028900000000000003
G5,C(C1(C(C=CC1O)=O)O)=O,4,5,0,5,46,0.00023700000000000001
G5,C(C1(C(C=CC(C1O)O)=O)O)=O,8,3,0,3,29,0.00014199999999999998
G5,C1(C(C(C(C=1)=O)(CO)O)O)CO,4,6,0,6,2,0.00028900000000000003
G5,C(C1(C(C(CC1O)=C)=O)O)=O,4,3,0,3,29,0.00014199999999999998
G5,C(C1(C(C(C(C1O)=O)=C)O)O)=O,8,3,0,3,29,0.00014199999999999998
G5,C(C1(C(CC(C1O)=C)O)O)=O,8,3,0,3,28,0.00014199999999999998
G5,C(C1(C(C=C(C)C1O)O)O)=O,8,3,0,3,28,0.00014199999999999998
G5,C(C1(C(C(C=O)=CC1O)O)O)=O,8,4,0,4,29,0.00018999999999999998
G5,C1(CC(C(C1(C=C)CO)O)=O)=O,4,2,0,2,4,9.499999999999999e-05
G5,C(C1(C=C)C(CC(C1O)=O)O)=O,8,3,0,3,29,0.00014199999999999998
G5,C=CC1(C(C(CC1O)=O)=O)CO,4,2,0,2,29,9.499999999999999e-05
G5,C1(CC=CC(C1(C(C)=O)O)O)=O,4,3,0,3,9,0.00014199999999999998
G5,C(C)(C1(C(C=CCC1O)=O)O)=O,4,3,0,3,9,0.00014199999999999998
G5,C(C1(C(C(CC1O)O)=O)C=C)=O,8,2,0,2,4,9.499999999999999e-05
G5,C(C1(C(CC(C)=CC1O)=O)O)=O,4,3,0,3,29,0.00014199999999999998
G5,C(C1(C(C=C(C)CC1O)=O)O)=O,4,3,0,3,6,0.00014199999999999998
G5,C(C1(C(CC(CC1O)=C)=O)O)=O,4,4,0,4,29,0.00018999999999999998
G5,C(C1(C(CCC=CC1O)=O)O)=O,4,3,0,3,44,0.00014199999999999998
G5,C(C1(C(CC=CCC1O)=O)O)=O,4,3,0,3,44,0.00014199999999999998
G5,C(C1(C(C(CC1O)=CC)=O)O)=O,8,3,0,3,4,0.00014199999999999998
G5,C(C1(C(CC(C=C)C1O)=O)O)=O,8,3,0,3,29,0.00014199999999999998
G5,C(C1(C(CC(C1O)=CC)=O)O)=O,8,3,0,3,46,0.00014199999999999998
G5,C(C1(C(CC(C1O)O)=O)C=C)=O,8,2,0,2,29,9.499999999999999e-05
G5,C1C(C(C(C=CC=1)=O)(CO)O)O,4,3,0,3,21,0.00014199999999999998
G5,C(C1(C(C(C=C)=CC1O)O)O)=O,8,3,0,3,29,0.00014199999999999998
G5,C(C1(C(C=CC=CC1O)O)O)=O,3,3,0,3,29,0.00014199999999999998
G5,C(C1(C(C(C(C1O)=C)O)O)O)=O,16,6,0,6,16,0.000285
G5,C(C1(C(C=C(CO)C1O)O)O)=O,8,4,0,4,18,0.00018999999999999998
G5,C(C1(C(C2CC1(C(O)O2)O)O)O)=O,32,4,0,4,0,0.00018999999999999998
G5,C(C1(C(C2(CC(C1O2)O)O)O)O)=O,32,3,0,3,0,0.00014199999999999998
G5,C(C12C(C(C(CC1O)(O2)O)O)O)=O,32,5,0,5,1,0.00023700000000000001
G5,C(C1(C(C2C(CC1(O)O2)O)O)O)=O,32,3,0,3,1,0.00014199999999999998
G5,C(C12COC(C1O)(CC2O)O)=O,16,4,0,4,23,0.00018999999999999998
G5,C(C1(C(C2COC1(C2)O)O)O)=O,16,4,0,4,55,0.00018999999999999998
G5,C(C12COC(C1)(C(C2O)O)O)=O,16,3,0,3,2,0.00014199999999999998
G5,C(C12C(C(C(O1)O)C(C2O)O)O)=O,64,4,0,4,43,0.00018999999999999998
G5,C1(C2(CC(C1(CO)C(C)O2)O)O)=O,16,3,0,3,4,0.00014199999999999998
G5,C(C12C(C)OC(C1O)(CC2O)O)=O,32,4,0,4,4,0.00018999999999999998
G5,C1(CCC(C21C(CC(O2)O)O)O)=O,16,3,0,3,45,0.00014199999999999998
G5,C(C12C(CCC1(CC(O2)O)O)O)=O,16,3,0,3,44,0.00014199999999999998
G5,C(C1(C(CC2CCC1(O)O2)O)O)=O,16,4,0,4,44,0.00018999999999999998
G5,C(C1(C(C2CC1(O)OC2C)O)O)=O,32,4,0,4,46,0.00018999999999999998
G5,C(C12C(C)OC(C1)(C(C2O)O)O)=O,32,3,0,3,46,0.00014199999999999998
G5,C1(C2C(C(CC2O)(O)O1)O)=O,16,4,0,4,29,0.00018999999999999998
G5,C(C12C(C(C(O1)O)(CC2O)O)O)=O,32,4,0,4,1,0.00018999999999999998
G5,C(C1(C2(CC(CO2)CC1O)O)O)=O,16,4,0,4,55,0.00018999999999999998
G5,C(C1(C2C(CC1O)CC(O)O2)O)=O,32,3,0,3,43,0.00014199999999999998
G5,C1(CC2C(C)(C1(C(O)O2)O)O)=O,16,4,0,4,29,0.00018999999999999998
G5,C1(CC2(C)C(C1(C(O)O2)O)O)=O,16,4,0,4,16,0.00018999999999999998
G5,C(C1(C2C(CC1(C(O)O2)O)O)O)=O,32,4,0,4,0,0.00018999999999999998
G5,C1(CC2C(C1(C(O)O2)O)O)=O,16,4,0,4,15,0.00018999999999999998
G5,C1(CC2C(C(C1(C(O)O2)O)O)O)=O,32,3,0,3,1,0.00014199999999999998
G5,C1(CC2(CC(C1(CO2)O)O)O)=O,8,3,0,3,3,0.00014199999999999998
G5,C1(C2(C(O)OCC1CC2O)O)=O,16,4,0,4,43,0.00018999999999999998
G5,C1(CC2(C(C1(CO)C(C)O2)O)O)=O,16,3,0,3,4,0.00014199999999999998
G5,C1(CC2(CC(C1(C(C)O2)O)O)O)=O,16,3,0,3,4,0.00014199999999999998
G5,C1(CC2CC(C1(C(C)(O)O2)O)O)=O,16,3,0,3,9,0.00014199999999999998
G5,C1(CC2(C)CC(C1(C(O)O2)O)O)=O,16,3,0,3,6,0.00014199999999999998
G5,C1(C2(C(O)OC(C)C1CC2O)O)=O,32,4,0,4,4,0.00018999999999999998
G5,C1(CC2C(OC1(CO)C(C2)O)O)=O,16,4,0,4,43,0.00018999999999999998
G5,C1(C2(CO)C(CC1CC(O2)O)O)=O,16,4,0,4,46,0.00018999999999999998
G5,C(C12C(C(CC1O)CC(O2)O)O)=O,32,4,0,4,43,0.00018999999999999998
G5,C1(CC2C(C1(C(C(O)O2)O)O)O)=O,32,4,0,4,0,0.00018999999999999998
G5,C1(CCC2(C(C1(CO2)O)O)O)=O,8,5,0,5,12,0.00023700000000000001
G5,C1(CC2COC(C1(C2O)O)O)=O,16,5,0,5,55,0.00023700000000000001
G5,C1(CCC2(C(C1(C(C)O2)O)O)O)=O,16,5,0,5,12,0.00023700000000000001
G5,C1(CCC2CC(C1(C(O)O2)O)O)=O,16,4,0,4,44,0.00018999999999999998
G5,C1(CC2C(C1(C(O)OC2C)O)O)=O,32,4,0,4,46,0.00018999999999999998
G5,C1(CC2COC(C1(C(C2)O)O)O)=O,16,4,0,4,55,0.00018999999999999998
G5,C1(CC2C(C1(CO)OC(C2)O)O)=O,16,4,0,4,43,0.00018999999999999998
G5,C1(CC2C(O)OCC1(C(C2)O)O)=O,16,4,0,4,38,0.00018999999999999998
G5,C1(C2(COC(CC1CC2O)O)O)=O,16,3,0,3,46,0.00014199999999999998
G5,C1(C2(C(C(C(C2O)O)O1)O)O)=O,32,6,0,6,29,0.000285
G5,C1(CC2C(C1(C(C2O)O)O)O)=O,32,3,0,3,12,0.00014199999999999998
G5,C1(CC2C(C(C1(C2(C)O)O)O)O)=O,32,3,0,3,32,0.00014199999999999998
G5,C(C1(CO)CCC(C1O)=O)=O,4,2,0,2,7,9.499999999999999e-05
G5,C(C1(CCC(C1O)=O)C(C)O)=O,8,2,0,2,7,9.499999999999999e-05
G5,C(C1(C(CCCC1(C=O)O)O)O)=O,8,2,0,2,7,9.499999999999999e-05
G5,C(C1(C(C)(CCC1(C=O)O)O)O)=O,8,2,0,2,7,9.499999999999999e-05
G5,C(C1(C(CCCC1(CO)O)O)O)=O,8,2,0,2,27,9.499999999999999e-05
G5,C(C1(C(CO)(CCC1(C)O)O)O)=O,8,2,0,2,7,9.499999999999999e-05
G5,C(C1CC(C(C=O)(C(C1)O)O)O)=O,3,2,0,2,43,9.499999999999999e-05
G5,C(C1CC(C(C=O)(C1(C)O)O)O)=O,16,2,0,2,45,9.499999999999999e-05
G5,C(C1(CCC(C1O)=O)C(CO)O)=O,8,2,0,2,7,9.499999999999999e-05
G5,C(C1(C(C(CC1O)O)O)CC=O)=O,16,2,0,2,43,9.499999999999999e-05
G5,C(C1(C=O)CCC(C1O)=O)=O,2,2,0,2,7,9.499999999999999e-05
G5,C(C1(C=O)C(C(CC1C(C)=O)=O)O)=O,4,2,0,2,45,9.499999999999999e-05
G5,C(CC1CC(C(C1(C=O)C=O)O)=O)=O,4,3,0,3,45,0.00014199999999999998
G5,C1(CC(C=O)C(C=O)(C=O)C1(C)O)=O,4,2,0,2,45,9.499999999999999e-05
G5,C1(CC(C=O)C(C=O)(C=O)C(C1)O)=O,4,2,0,2,45,9.499999999999999e-05
G5,C(CC1C(CC(C1(C=O)C=O)O)=O)=O,4,2,0,2,45,9.499999999999999e-05
G5,C(C1(C=O)CCC(CC(C1O)=O)=O)=O,2,2,0,2,45,9.499999999999999e-05
G5,C1(CC(C=O)(C(C=O)(C=O)CC1)O)=O,2,2,0,2,45,9.499999999999999e-05
G5,C(C1(C=O)CCC(C(CC1O)=O)=O)=O,2,2,0,2,45,9.499999999999999e-05
G5,C(CC1(C(CCC1(C=O)C=O)=O)O)=O,2,2,0,2,45,9.499999999999999e-05
G5,C(C)(C1(C(C=O)=O)CCC(C1O)=O)=O,4,2,0,2,7,9.499999999999999e-05
G5,C(C1(C(C=O)=O)CCC(C1O)=O)=O,4,2,0,2,23,9.499999999999999e-05
G5,C(C1(C(C(C)=O)=O)CCC(C1O)=O)=O,4,2,0,2,14,9.499999999999999e-05
G5,C(C)(C1(C=O)CCC(C1O)=O)=O,4,2,0,2,7,9.499999999999999e-05
G5,C1(COC(C21CCC(C2O)=O)O)=O,8,2,0,2,7,9.499999999999999e-05
G5,C(CC1(C=O)C(C(C=CC1O)=O)O)=O,8,1,0,1,43,4.7e-05
G5,C1(C2(CCC(C2O)=O)C(CO1)O)=O,8,2,0,2,8,9.499999999999999e-05
G5,C1(C2C(CCC(C2O)=O)(CO1)O)=O,8,2,0,2,8,9.499999999999999e-05
G5,C1(C2C(CO1)(CCC2(C=O)O)O)=O,8,1,0,1,8,4.7e-05
G5,C1(C2C(C(CCC(C2O)=O)O1)O)=O,16,2,0,2,7,9.499999999999999e-05
G5,C1(C2C(C(CCC2(C=O)O)O1)O)=O,16,1,0,1,7,4.7e-05
G5,C(C1(C(CCC1(C=O)O)O)O)(O)=O,8,2,0,2,20,9.499999999999999e-05
G5,C1(C2(COC1CCC(C2O)=O)O)=O,8,3,0,3,10,0.00014199999999999998
G5,C1(C2(COC1CCC2(C=O)O)O)=O,8,2,0,2,10,9.499999999999999e-05
G5,C1(COC2CCC(C(C12O)O)=O)=O,8,3,0,3,10,0.00014199999999999998
G5,C(C1(CCC2C1(C(CO2)=O)O)O)=O,8,2,0,2,10,9.499999999999999e-05
G5,C1(C(O)OCC21CCC(C2O)=O)=O,8,2,0,2,7,9.499999999999999e-05
G5,C1(C2C(CO)(CCC2(CO1)O)O)=O,8,1,0,1,8,4.7e-05
G5,C1(C2C(C(CCC2(CO)O)O1)O)=O,16,1,0,1,7,4.7e-05
G5,C(C1(C(CCC1(CO)O)O)O)(O)=O,8,2,0,2,20,9.499999999999999e-05
G5,C1(C2CCC(CO)(C1(CO2)O)O)=O,8,2,0,2,10,9.499999999999999e-05
G5,C1(COC2CCC(CO)(C12O)O)=O,8,2,0,2,10,9.499999999999999e-05
G5,C1(C2C(CC(C=O)C2(CO1)O)O)=O,16,1,0,1,8,4.7e-05
G5,C1(C2C(C(C(C2O)O1)CC=O)O)=O,32,2,0,2,8,9.499999999999999e-05
G5,C1(C2C(CC(C=O)C(C2O)O1)O)=O,32,1,0,1,8,4.7e-05
G5,C(C1C(C(C(O)=O)(C(C1)O)O)O)=O,16,2,0,2,43,9.499999999999999e-05
G5,C(CC1C(C2(C(C1OC2)=O)O)O)=O,16,3,0,3,10,0.00014199999999999998
G5,C(C1CC(C2(C(C1OC2)=O)O)O)=O,16,2,0,2,10,9.499999999999999e-05
G5,C(C1C2C(C(CO2)=O)(C(C1)O)O)=O,16,2,0,2,10,9.499999999999999e-05
G5,C(C1(C(C(CO)CC1O)O)O)(O)=O,16,2,0,2,29,9.499999999999999e-05
G5,C(C1(CO)C(CC(C1)=O)O)=O,4,2,0,2,55,9.499999999999999e-05
G5,C(C1(C(CC(C1)=O)O)C(C)O)=O,8,2,0,2,46,9.499999999999999e-05
G5,C1(CC(C=O)(C(C1)O)C(C=O)O)=O,8,2,0,2,0,9.6e-05
G5,C(C1(C(CCC1(C=O)O)O)O)=O,8,2,0,2,20,9.499999999999999e-05
G5,C(C1(C(CCC1(CO)O)O)O)=O,8,2,0,2,7,9.499999999999999e-05
G5,C(CO)(C1(C=O)CCC(C1O)=O)=O,4,2,0,2,7,9.499999999999999e-05
G5,C(CC1(C=O)C(CC(C1O)=O)O)=O,8,2,0,2,43,9.499999999999999e-05
G5,C1(CCCC(C(C1(C=O)O)O)=O)=O,4,3,0,3,7,0.00014199999999999998
G5,C1(CCCC(C=O)(C1(C=O)O)O)=O,4,2,0,2,7,9.499999999999999e-05
G5,C(C1(C(CCCC1(CO)O)=O)O)=O,4,2,0,2,7,9.499999999999999e-05
G5,C(C1(C(CC(C1O)CC=O)=O)O)=O,8,3,0,3,43,0.00014199999999999998
G5,C(C1CC(C(C=O)(C(C1)=O)O)O)=O,8,2,0,2,43,9.499999999999999e-05
G5,C1(C(CO)(C(C=O)(CCC1)O)O)=O,4,2,0,2,7,9.499999999999999e-05
G5,C(C1(CCC(C1(C(C)=O)O)O)O)=O,8,2,0,2,20,9.499999999999999e-05
G5,C1(CCCC(CO)(C1(CO)O)O)=O,4,2,0,2,7,9.499999999999999e-05
G5,C(C)(C1(C(CCC1(CO)O)O)O)=O,8,2,0,2,7,9.499999999999999e-05
G5,C(C1C(C(C(C)=O)(C(C1)O)O)O)=O,16,2,0,2,43,9.499999999999999e-05
G5,C1(C(C(C(C=O)=O)(CO)CC1)O)=O,4,2,0,2,7,9.499999999999999e-05
G5,C(CO)(C1(CO)CCC(C1O)=O)=O,4,2,0,2,7,9.499999999999999e-05
G5,C(C1(CCC(C1O)=O)C(C=O)O)=O,8,2,0,2,7,9.499999999999999e-05
G5,C1(C2(C(CC(C2O)C1CO)O)O)=O,32,3,0,3,43,0.00014199999999999998
G5,C(C1(C(CC(C1)=O)O)C(CO)O)=O,8,2,0,2,46,9.499999999999999e-05
G5,C(C1(C(C(CO)CC1O)O)O)=O,16,2,0,2,55,9.499999999999999e-05
G5,C(C1(C(C(CC1O)C(C)O)O)O)=O,32,2,0,2,46,9.499999999999999e-05
G5,C(C1(C(CC=CC1O)=O)O)=O,4,2,0,2,55,9.499999999999999e-05
G5,C(C1(C(C=CCC1O)=O)O)=O,4,3,0,3,55,0.00014199999999999998
G5,C1(C(CC(C1(C(C)(C)O)O)O)O)=O,8,2,0,2,2,9.499999999999999e-05
G5,C1(C(C(CC1O)O)(C(C=C)O)O)=O,16,2,0,2,2,9.499999999999999e-05
G5,C1C(C(C(C=1)=O)(C(C)(C)O)O)O,4,2,0,2,28,9.499999999999999e-05
G5,C1C(COC=1)(C2(C(C=CC2O)=O)O)O,8,2,0,2,28,9.499999999999999e-05
G5,C=CC(C1(C(C=CC1O)=O)O)O,8,2,0,2,28,9.499999999999999e-05
G5,C(C(C1(C(C=CC1O)=O)O)O)=CC,16,2,0,2,28,9.499999999999999e-05
G5,C(CC(C1(C(C=CC1O)=O)O)O)=C,8,2,0,2,28,9.499999999999999e-05
G5,C(C1(C=CC(C1O)=O)C(C)(C)O)=O,4,1,0,1,45,4.8e-05
G5,C(C1(C=CC(C1O)=O)C(C=C)O)=O,8,1,0,1,45,4.8e-05
G5,C(C1(C=CC(C1O)=O)C(C=CC)O)=O,16,1,0,1,45,4.8e-05
G5,C(C1(C=CC(C1O)=O)C(CC=C)O)=O,8,1,0,1,45,4.8e-05
G5,C(C1(C(C=CC1O)=O)C(C)(C)O)=O,4,1,0,1,45,4.8e-05
G5,C(C1(C(C=CC1O)=O)C(C=C)O)=O,8,1,0,1,45,4.8e-05
G5,C(C1(C(C=CC1O)=O)C(C=CC)O)=O,16,1,0,1,45,4.8e-05
G5,C(C1(C(C=CC1O)=O)C(CC=C)O)=O,8,1,0,1,45,4.8e-05
G5,C(C(C=O)(CO)C(C)(C)O)(O)=O,2,1,0,1,18,4.8e-05
G5,C(C(C=O)(CO)C(C=C)O)(O)=O,4,1,0,1,18,4.8e-05
G5,C(C(C=O)(CO)C(C=CC)O)(O)=O,8,1,0,1,18,4.8e-05
G5,C(C(C=O)(CO)C(CC=C)O)(O)=O,4,1,0,1,18,4.8e-05
G5,C(C(C=O)(C(C)O)C(C)(C)O)(O)=O,4,1,0,1,4,4.8e-05
G5,C(C(C=O)(C(C)O)C(C=C)O)(O)=O,8,1,0,1,4,4.8e-05
G5,C(C(C(C=O)=O)(C(C)(C)O)O)(O)=O,2,2,0,2,17,9.499999999999999e-05
G5,C(C(C(C=O)=O)(C(C=C)O)O)(O)=O,4,5,0,5,27,0.00025
G5,C(C(C=O)(C=O)C(C)(C)O)(O)=O,1,1,0,1,17,4.8e-05
G5,C(C(C=O)(C=O)C(C=C)O)(O)=O,2,1,0,1,17,4.8e-05
G5,C(C(C=O)(C=O)C(C=CC)O)(O)=O,4,1,0,1,17,4.8e-05
G5,C(C(C=O)(C=O)C(CC=C)O)(O)=O,2,1,0,1,17,4.8e-05
G5,C(C(C=O)(C(C)=O)C(C)(C)O)(O)=O,2,1,0,1,17,4.8e-05
G5,C(C(C=O)(C(C)=O)C(C=C)O)(O)=O,4,1,0,1,17,4.8e-05
G5,C(C(C(C=C)=O)(C(C)(C)O)O)(O)=O,2,2,0,2,17,9.499999999999999e-05
G5,C(C(C(C=C)=O)(C(C=C)O)O)(O)=O,4,2,0,2,17,9.499999999999999e-05
G5,C(C(C(CCO)O)(C(C)(C)O)O)=O,4,2,0,2,0,9.499999999999999e-05
G5,C(C(C(CCO)O)(C(C=C)O)O)=O,8,4,0,4,0,0.00019099999999999998
G5,C(C(CO)(C(CO)O)C(C)(C)O)=O,4,1,0,1,6,4.8e-05
G5,C(C(CO)(C(CO)O)C(C=C)O)=O,8,1,0,1,6,4.8e-05
G5,C(C(C=O)(C(CO)O)C(C)(C)O)=O,2,1,0,1,0,4.8e-05
G5,C(C(C=O)(C(CO)O)C(C=C)O)=O,4,1,0,1,0,4.8e-05
G5,C(C(C(C(C)O)O)(C(C)(C)O)O)=O,8,2,0,2,11,9.499999999999999e-05
G5,C(C(C(C(C)O)O)(C(C=C)O)O)=O,16,4,0,4,11,0.00019099999999999998
G5,C(C(C(CO)=O)(C(C)(C)O)O)(O)=O,2,2,0,2,17,9.499999999999999e-05
G5,C(C(C(CO)=O)(C(C=C)O)O)(O)=O,4,4,0,4,27,0.000192
G5,C(C(C=O)(C(C)(C)O)C(C=O)O)=O,2,1,0,1,0,4.8e-05
G5,C(C(C=O)(C(C=C)O)C(C=O)O)=O,4,1,0,1,0,4.8e-05
G5,C(C(CO)(CO)C(CC(O)=O)O)=O,2,1,0,1,18,4.8e-05
G5,C(C(C=O)(C(C=O)(CO)CO)O)=O,1,2,0,2,1,9.7e-05
G5,C(C(CO)(CO)C(C(C=O)=O)O)=O,2,1,0,1,18,4.8e-05
G5,C(C(CO)(CO)C(C)(CCO)O)=O,2,1,0,1,18,4.8e-05
G5,C(C(CO)(CO)C(C)(C)O)=O,1,1,0,1,18,4.8e-05
G5,C(OCC(C(C=O)(CO)CO)O)=O,2,1,0,1,18,4.8e-05
G5,C(C(CO)(CO)C(CCC=O)O)=O,2,1,0,1,18,4.8e-05
G5,C(C(CO)(CO)C(C=CCO)O)=O,4,1,0,1,18,4.8e-05
G5,C(C(CO)(CO)C(C(C=C)O)O)=O,4,1,0,1,18,4.8e-05
G5,C(C(CO)(CO)C1(C=COC1)O)=O,2,1,0,1,18,4.8e-05
G5,C(C(CO)C(C(CO)CO)O)(O)=O,4,1,0,1,18,4.8e-05
G5,C(C(CO)(CO)C(C(CC)=O)O)=O,2,1,0,1,18,4.8e-05
G5,C(C(CO)(CO)C(C=O)(CC)O)=O,2,1,0,1,18,4.8e-05
G5,C(C(CO)(CO)C(C=C)O)=O,2,1,0,1,18,4.8e-05
G5,C(C(CO)(CO)C(C=CC)O)=O,4,1,0,1,18,4.8e-05
G5,C(C(CO)(CO)C(CC=C)O)=O,2,1,0,1,18,4.8e-05
G5,C(C(CO)(C(C)O)C(C)(C)O)=O,4,1,0,1,18,4.8e-05
G5,C(C(CO)(C(C)O)C(C=C)O)=O,8,1,0,1,18,4.8e-05
G5,C(C(CO)(C(C)O)C(C=CC)O)=O,16,1,0,1,18,4.8e-05
G5,C(C(CO)(C(CC=C)O)C(C)O)=O,8,1,0,1,18,4.8e-05
G5,C(C(C)=O)(C(CO)(C(C)(C)O)O)=O,2,2,0,2,0,9.499999999999999e-05
G5,C=CC(C(C(C(C)=O)=O)(CO)O)O,4,2,0,2,0,9.499999999999999e-05
G5,C(C(C)O)(C(CO)(C(C)(C)O)O)=O,4,2,0,2,2,9.499999999999999e-05
G5,C(C(CO)(C(C=C)O)O)(C(C)O)=O,8,2,0,2,2,9.499999999999999e-05
G5,C(C(C=O)(CO)C(CC(O)=O)O)=O,2,1,0,1,18,4.8e-05
G5,C(C(C=O)(CO)C(C=O)(C=O)O)=O,1,1,0,1,18,4.8e-05
G5,C(C(C=O)(CO)C(C(C=O)=O)O)=O,2,1,0,1,18,4.8e-05
G5,C(C(C=O)(CO)C(C)(CCO)O)=O,2,1,0,1,18,4.8e-05
G5,C(C(C=O)(CO)C(C)(C)O)=O,1,1,0,1,18,4.8e-05
G5,C(OCC(C(C=O)(C=O)CO)O)=O,2,1,0,1,18,4.8e-05
G5,C(C(C=O)(CO)C(CCC=O)O)=O,2,1,0,1,18,4.8e-05
G5,C(C(C=O)(CO)C(C=CCO)O)=O,4,1,0,1,18,4.8e-05
G5,C(C(C=O)(CO)C(C(C=C)O)O)=O,4,1,0,1,18,4.8e-05
G5,C(C(C=O)(CO)C1(C=COC1)O)=O,2,1,0,1,18,4.8e-05
G5,C(C(C=O)(CO)C(C(CC)=O)O)=O,2,1,0,1,18,4.8e-05
G5,C(C(C=O)(CO)C(C=O)(CC)O)=O,2,1,0,1,18,4.8e-05
G5,C(C(C=O)(CO)C(C=C)O)=O,2,1,0,1,18,4.8e-05
G5,C(C(C=O)(CO)C(C=CC)O)=O,4,1,0,1,18,4.8e-05
G5,C(C(C=O)(CO)C(CC=C)O)=O,2,1,0,1,18,4.8e-05
G5,C(C(C(C=O)=O)(CO)C(C)(C)O)=O,2,1,0,1,2,4.8e-05
G5,C(C(C(C=O)=O)(CO)C(C=C)O)=O,4,1,0,1,2,4.8e-05
G5,C(C(C(C)=O)(CO)C(C)(C)O)=O,2,1,0,1,6,4.8e-05
G5,C(C)(C(C=O)(CO)C(C=C)O)=O,4,1,0,1,6,4.8e-05
G5,C(C)(C(C=O)(CO)C(C=CC)O)=O,8,1,0,1,6,4.8e-05
G5,C(C(C(C)=O)(CO)C(CC=C)O)=O,4,1,0,1,6,4.8e-05
G5,C1(COC(C1(CO)C(C)(C)O)O)=O,4,1,0,1,27,4.8e-05
G5,C1(COC(C1(CO)C(C=C)O)O)=O,8,1,0,1,27,4.8e-05
G5,C1(CC(OC1(CO)C(C)(C)O)O)=O,4,2,0,2,27,9.499999999999999e-05
G5,C1(C(CO)(C(C=C)O)OC(C1)O)=O,8,2,0,2,27,9.499999999999999e-05
G5,C=CC(C(CO)(C(C)(C)O)O)=O,2,2,0,2,7,9.499999999999999e-05
G5,C=CC(C(C(C=C)=O)(CO)O)O,4,2,0,2,7,9.499999999999999e-05
G5,C(C)=CC(C(C(C=C)=O)(CO)O)O,8,2,0,2,7,9.499999999999999e-05
G5,C=CCC(C(C(C=C)=O)(CO)O)O,4,2,0,2,7,9.499999999999999e-05
G5,C1(C(COC1(CO)C(C)(C)O)O)=O,4,2,0,2,27,9.499999999999999e-05
G5,C1(C(CO)OCC1(C(C)(C)O)O)=O,4,2,0,2,27,9.499999999999999e-05
G5,C1(C(CO)(C(C=C)O)OCC1O)=O,8,2,0,2,27,9.499999999999999e-05
G5,C1(C(COC1CO)(C(C=C)O)O)=O,8,2,0,2,27,9.499999999999999e-05
G5,C1(C(O)OCC1(CO)C(C)(C)O)=O,4,1,0,1,34,4.8e-05
G5,C1(C(O)OCC1(CO)C(C=C)O)=O,8,1,0,1,34,4.8e-05
G5,C(C(C(C)O)(C(C)O)C(C)(C)O)=O,3,1,0,1,4,4.8e-05
G5,C(C(C(C)O)(C(C)O)C(C=C)O)=O,6,1,0,1,4,4.8e-05
G5,C(C(C(C(C)O)(C(C)(C)O)O)=O)=O,4,2,0,2,0,9.499999999999999e-05
G5,C=CC(C(C(C=O)=O)(C(C)O)O)O,8,5,0,5,27,0.000251
G5,C(C(C=O)(C(C)O)C(C)(C)O)=O,2,1,0,1,4,4.8e-05
G5,C(C(C=O)(C(C)O)C(C=C)O)=O,4,1,0,1,4,4.8e-05
G5,C(C(C=O)(C(C)O)C(C=CC)O)=O,8,1,0,1,4,4.8e-05
G5,C(C(C=O)(C(CC=C)O)C(C)O)=O,4,1,0,1,4,4.8e-05
G5,C(C(CO)C(CC(O)=O)O)(O)=O,4,1,0,1,18,4.8e-05
G5,C(C(C(CC(O)=O)O)C(C)O)(O)=O,8,1,0,1,28,4.8e-05
G5,C(C(C=O)(C=O)C(CC(O)=O)O)=O,2,1,0,1,1,4.8e-05
G5,C(C(C(C)=O)(C(C)O)C(C)(C)O)=O,4,1,0,1,4,4.8e-05
G5,C(C)(C(C=O)(C(C)O)C(C=C)O)=O,8,1,0,1,4,4.8e-05
G5,C=CC(C(C(C)O)(C(C)(C)O)O)=O,4,2,0,2,4,9.499999999999999e-05
G5,C=CC(C(C(C=C)=O)(C(C)O)O)O,8,2,0,2,4,9.499999999999999e-05
G5,C(C(CO)C(C(C=O)=O)(C)O)(O)=O,4,1,0,1,18,4.8e-05
G5,C(C)(C(C(C=O)=O)(C(C)(C)O)O)=O,2,2,0,2,0,9.499999999999999e-05
G5,C(C)(C(C(C=O)=O)(C(C=C)O)O)=O,4,2,0,2,0,9.499999999999999e-05
G5,C(C(C=O)(C(C(O)=O)C(C)O)O)=O,4,1,0,1,28,4.8e-05
G5,C(C(C=O)(C=O)C(C=O)(C=O)O)=O,1,1,0,1,1,4.8e-05
G5,C(C(C=O)(C=O)C(C(C=O)=O)O)=O,2,1,0,1,1,4.8e-05
G5,C(C(C=O)(C1(C(C=CC1=O)=O)O)O)=O,1,2,0,2,47,9.499999999999999e-05
G5,C(C(C(C1(C(C=CC1=O)=O)O)O)=O)=O,2,2,0,2,47,9.499999999999999e-05
G5,C(C(C(C=O)=O)(C(C)(C)O)O)=O,2,2,0,2,5,9.499999999999999e-05
G5,C(C(C(C=O)=O)(C(C=C)O)O)=O,4,2,0,2,5,9.499999999999999e-05
G5,C(C(C(C=O)=O)(C(C=CC)O)O)=O,8,2,0,2,5,9.499999999999999e-05
G5,C(C(C(C=O)=O)(C(CC=C)O)O)=O,4,2,0,2,5,9.499999999999999e-05
G5,C=CC(C(C(C=C)=O)(C(C=O)=O)O)O,4,2,0,2,33,9.499999999999999e-05
G5,C(C(C=O)(C(CO)=O)C(C)(C)O)=O,1,1,0,1,1,4.8e-05
G5,C(C(C=O)(C(CO)=O)C(C=C)O)=O,2,1,0,1,1,4.8e-05
G5,C(C(C(CC=O)=O)(C(C)(C)O)O)=O,2,2,0,2,1,9.499999999999999e-05
G5,C(C(C(CC=O)=O)(C(C=C)O)O)=O,4,2,0,2,1,9.499999999999999e-05
G5,C(C)(C(C(C)=O)(C(C)(C)O)O)=O,1,2,0,2,49,9.499999999999999e-05
G5,C(C)(C(C(C)=O)(C(C=C)O)O)=O,2,2,0,2,49,9.499999999999999e-05
G5,C(C)(C(C(C)=O)(C(C=CC)O)O)=O,4,2,0,2,49,9.499999999999999e-05
G5,C(C)(C(C(C)=O)(C(CC=C)O)O)=O,2,2,0,2,49,9.499999999999999e-05
G5,C(C(CO)C(C)(CCO)O)(O)=O,4,1,0,1,18,4.8e-05
G5,C(C(C(C)O)C(C)(CCO)O)(O)=O,8,1,0,1,28,4.8e-05
G5,C(C(C=O)(C=O)C(C)(CCO)O)=O,2,1,0,1,1,4.8e-05
G5,C(C(C(C(C)=O)=O)(C(C)(C)O)O)=O,2,2,0,2,25,9.499999999999999e-05
G5,C(C(C(CO)(C(C)(C)O)O)=O)(O)=O,2,2,0,2,0,9.499999999999999e-05
G5,C1(CCC(C1(C(C)(C)O)O)=O)=O,1,2,0,2,47,9.499999999999999e-05
G5,C1(COC(CO)C1(C(C)(C)O)O)=O,4,2,0,2,27,9.499999999999999e-05
G5,C1(COCC(C1(C(C)(C)O)O)O)=O,4,2,0,2,27,9.499999999999999e-05
G5,C(C(C(CO)O)C(C)(C)O)(O)=O,4,1,0,1,45,4.8e-05
G5,C(C(C(C)(C)O)C(C(C)=O)O)(O)=O,4,1,0,1,27,4.8e-05
G5,C(C(C(C)(C)O)C(C=O)(C)O)(O)=O,4,1,0,1,29,4.8e-05
G5,C(C(CO)C(C)(C)O)(O)=O,2,1,0,1,18,4.8e-05
G5,C(C(C(C)(C)O)C(C)(CO)O)(O)=O,4,1,0,1,29,4.8e-05
G5,C(C(C(C)O)C(C)(C)O)(O)=O,4,1,0,1,28,4.8e-05
G5,C(C(C(O)=O)(C(C)(C)O)O)(O)=O,1,2,0,2,17,9.499999999999999e-05
G5,C(C(C(C)(C)O)C(C(O)=O)O)(O)=O,4,1,0,1,29,4.8e-05
G5,C1(C(CO)(C(CO1)O)C(C)(C)O)=O,4,1,0,1,27,4.8e-05
G5,C(C1(C(C(CC1)=O)=O)C(C)(C)O)=O,2,1,0,1,45,4.8e-05
G5,C(C1(C(CC(C1)=O)=O)C(C)(C)O)=O,2,1,0,1,45,4.8e-05
G5,C(C1(C(CCC1=O)=O)C(C)(C)O)=O,1,1,0,1,45,4.8e-05
G5,C1(CC=CC(C1(C(C)(C)O)O)=O)=O,2,2,0,2,32,9.499999999999999e-05
G5,C(C(CO)(C(C)(C)O)CC=O)=O,2,1,0,1,55,4.8e-05
G5,C(C(C(C(C)=O)=O)(C)C(C)(C)O)=O,2,1,0,1,45,4.8e-05
G5,C(C(C)=O)(C(C)(CO)C(C)(C)O)=O,2,1,0,1,27,4.8e-05
G5,C(C(C)(C(C)(C)O)C(C(C)=O)O)=O,4,1,0,1,27,4.8e-05
G5,C(C(C(C=O)=O)(C)C(C)(C)O)=O,2,1,0,1,49,4.8e-05
G5,C(C(C(C)(CO)C(C)(C)O)=O)=O,2,1,0,1,28,4.8e-05
G5,C(C(C)(C(C)(C)O)C(C=O)O)=O,4,1,0,1,49,4.8e-05
G5,C(C)(C(C(C=C)=O)(C(C)(C)O)O)=O,2,2,0,2,9,9.499999999999999e-05
G5,C1(C=CC(C1(CO)C(C)(C)O)=O)=O,1,1,0,1,45,4.8e-05
G5,C(C(C=O)(C(C)=O)C(C)(C)O)=O,1,1,0,1,6,4.8e-05
G5,C(C(C(C)=O)(C(C)=O)C(C)(C)O)=O,1,1,0,1,6,4.8e-05
G5,C(C(C=O)(C(C=O)=O)C(C)(C)O)=O,1,1,0,1,23,4.8e-05
G5,C(C)(C(C(C)=O)(CO)C(C)(C)O)=O,1,1,0,1,28,4.8e-05
G5,C(C(C=O)(C=O)C(C)(C)O)=O,1,1,0,1,1,4.8e-05
G5,C(C(C(C(O)=O)=O)(C)C(C)(C)O)=O,2,1,0,1,27,4.8e-05
G5,C(C(C=O)(C(C)(C)O)CC=O)=O,1,1,0,1,43,4.8e-05
G5,C(C(C)(C(C)(C)O)C(C(O)=O)O)=O,4,1,0,1,49,4.8e-05
G5,C(C(C(C)(CO)C(C)(C)O)=O)(O)=O,2,1,0,1,28,4.8e-05
G5,C(C)(C(C=O)(C(C)(C)O)CC=O)=O,2,1,0,1,45,4.8e-05
G5,C1(CC(C(C1(C(C)(C)O)O)=O)=C)=O,2,2,0,2,47,9.499999999999999e-05
G5,C(C(C(CC=C)=O)(C(C)(C)O)O)=O,2,2,0,2,4,9.499999999999999e-05
G5,C(C1(C(C(C=C1)O)=O)C(C)(C)O)=O,4,1,0,1,45,4.8e-05
G5,C(C)(C1(C(C=CO1)=O)C(C)(C)O)=O,2,2,0,2,9,9.499999999999999e-05
G5,C(C1(C(CC(O1)=C)=O)C(C)(C)O)=O,2,2,0,2,26,9.499999999999999e-05
G5,C(C1(C(CC=CO1)=O)C(C)(C)O)=O,2,2,0,2,37,9.499999999999999e-05
G5,C1C(C(C(C=1)=O)=O)(CO)C(C)(C)O,2,1,0,1,45,4.8e-05
G5,C(C(C(CO)=O)(C=C)C(C)(C)O)=O,2,1,0,1,45,4.8e-05
G5,C(C(C(C=C)=O)(C(C)(C)O)O)=O,2,2,0,2,0,9.499999999999999e-05
G5,C(C(C(C=CC)=O)(C(C)(C)O)O)=O,4,2,0,2,28,9.499999999999999e-05
G5,C(C)=CC(C(CO)(C(C)(C)O)O)=O,4,2,0,2,28,9.499999999999999e-05
G5,C(C(CO)(C(C)(C)O)O)(CC=C)=O,2,2,0,2,28,9.499999999999999e-05
G5,C=CC(C(C=O)=O)(CO)C(C)(C)O,2,1,0,1,28,4.8e-05
G5,C(CO)(C(C=C)(CO)C(C)(C)O)=O,2,1,0,1,28,4.8e-05
G5,C(C(C=C)(C(C)(C)O)C(C=O)O)=O,4,1,0,1,45,4.8e-05
G5,C(C1(C(C=C(C)O1)=O)C(C)(C)O)=O,2,2,0,2,26,9.499999999999999e-05
G5,C(C(C(C)(C)O)(C(C=C)O)O)=O,4,2,0,2,27,9.499999999999999e-05
G5,C(C1(COC(C1O)O)C(C)(C)O)=O,8,1,0,1,27,4.8e-05
G5,C(C1(C(CC(O1)O)O)C(C)(C)O)=O,8,2,0,2,0,9.499999999999999e-05
G5,C1(C(O)OCC1(C(C)(C)O)O)=O,4,2,0,2,0,9.499999999999999e-05
G5,C1(COC(C)(C1(C(C)(C)O)O)O)=O,4,2,0,2,0,9.499999999999999e-05
G5,C1(COC(C1(C(C)(C)O)O)O)=O,4,2,0,2,5,9.499999999999999e-05
G5,C1(C(C(C(O)O1)O)(C(C)(C)O)O)=O,8,2,0,2,0,9.499999999999999e-05
G5,C1(C(C(C(O)O1)O)C(C)(C)O)=O,8,1,0,1,45,4.8e-05
G5,C1(C(C)OC(C1(C(C)(C)O)O)O)=O,8,2,0,2,0,9.499999999999999e-05
G5,C1(CC(O)OCC1(C(C)(C)O)O)=O,4,2,0,2,27,9.499999999999999e-05
G5,C1(CCOC(C1(C(C)(C)O)O)O)=O,4,2,0,2,27,9.499999999999999e-05
G5,C1(C(C(C)(C)O)(C(C)(CO1)O)O)=O,4,2,0,2,27,9.499999999999999e-05
G5,C(C(C(C)O)(C(C)(C)O)CC=O)=O,4,1,0,1,27,4.8e-05
G5,C1(C=CC(C1(C(C)(C)O)O)=O)=O,1,2,0,2,47,9.499999999999999e-05
G5,C(OCC(C)(C(C(O)=O)CO)O)=O,4,1,0,1,18,4.8e-05
G5,C(OCC(C(C(O)=O)CO)O)=O,4,1,0,1,18,4.8e-05
G5,C(OCC(C(C(O)=O)C(C)O)O)=O,8,1,0,1,28,4.8e-05
G5,C(OCC(C(C=O)(C=O)C=O)O)=O,2,1,0,1,1,4.8e-05
G5,C(C(CO)C(COC(C)=O)O)(O)=O,4,1,0,1,18,4.8e-05
G5,C(C(CO)C(CCC=O)O)(O)=O,4,1,0,1,18,4.8e-05
G5,C(C(C(C)O)C(CCC=O)O)(O)=O,8,1,0,1,28,4.8e-05
G5,C(C(C=O)(C=O)C(CCC=O)O)=O,2,1,0,1,1,4.8e-05
G5,C(CCC(C1(C(C=CC1=O)=O)O)O)=O,2,2,0,2,47,9.499999999999999e-05
G5,C(C(CO)C(C=CCO)O)(O)=O,8,1,0,1,18,4.8e-05
G5,C(C(C(C)O)C(C=CCO)O)(O)=O,16,1,0,1,28,4.8e-05
G5,C(C(C=O)(C=O)C(C=CCO)O)=O,4,1,0,1,1,4.8e-05
G5,C(CO)=CC(C1(C(C=CC1=O)=O)O)O,4,2,0,2,47,9.499999999999999e-05
G5,C(C(CO)C(C(O)=O)(CO)O)(O)=O,4,1,0,1,18,4.8e-05
G5,C(C(CO)C(C)(CC(O)=O)O)(O)=O,4,1,0,1,18,4.8e-05
G5,C(C(CO)C(C=CC(O)=O)O)(O)=O,8,1,0,1,18,4.8e-05
G5,C(C(C(C(C)=O)=O)(C(C=C)O)O)=O,4,2,0,2,25,9.499999999999999e-05
G5,C=CC(C(C(C(O)=O)=O)(CO)O)O,4,2,0,2,0,9.499999999999999e-05
G5,C1(CCC(C1(C2(C=COC2)O)O)=O)=O,2,2,0,2,47,9.499999999999999e-05
G5,C1(CCC(C1(C(C=C)O)O)=O)=O,2,2,0,2,47,9.499999999999999e-05
G5,C1(CCC(C1(C(C=CC)O)O)=O)=O,4,2,0,2,47,9.499999999999999e-05
G5,C1(CCC(C1(C(CC=C)O)O)=O)=O,2,2,0,2,47,9.499999999999999e-05
G5,C1(COC(CO)C1(C(C=C)O)O)=O,8,2,0,2,27,9.499999999999999e-05
G5,C(C(CO)C1(C(OCC1)=O)O)(O)=O,4,1,0,1,18,4.8e-05
G5,C(C(CO)C1(COC(C1)=O)O)(O)=O,4,1,0,1,18,4.8e-05
G5,C1(COCC(C1(C(C=C)O)O)O)=O,8,2,0,2,27,9.499999999999999e-05
G5,C(C(CO)C(C(C=C)O)O)(O)=O,8,1,0,1,18,4.8e-05
G5,C(C(C(C(C=C)O)O)C(C)O)(O)=O,16,1,0,1,28,4.8e-05
G5,C(C(C=O)(C=O)C(C(C=C)O)O)=O,4,1,0,1,1,4.8e-05
G5,C=CC(C(C1(C(C=CC1=O)=O)O)O)O,4,2,0,2,47,9.499999999999999e-05
G5,C(C(CO)C1(C=COC1)O)(O)=O,4,1,0,1,18,4.8e-05
G5,C(C(C(C)O)C1(C=COC1)O)(O)=O,8,1,0,1,28,4.8e-05
G5,C(C(C(C=O)=O)(C)C1(C=COC1)O)=O,4,1,0,1,49,4.8e-05
G5,C(C(C=O)(C(C)=O)C1(C=COC1)O)=O,2,1,0,1,6,4.8e-05
G5,C(C(C=O)(C=O)C1(C=COC1)O)=O,2,1,0,1,1,4.8e-05
G5,C(C(C=O)(CC=O)C1(C=COC1)O)=O,2,1,0,1,43,4.8e-05
G5,C(C(C(C=C)=O)(C1(C=COC1)O)O)=O,4,2,0,2,0,9.499999999999999e-05
G5,C1OCC(C=1)(C2(C(C=CC2=O)=O)O)O,2,2,0,2,47,9.499999999999999e-05
G5,C(C(C(CO)O)C(C=C)O)(O)=O,8,1,0,1,45,4.8e-05
G5,C(C(C(CO)O)C(C=CC)O)(O)=O,16,1,0,1,45,4.8e-05
G5,C(C(C(CC=C)O)C(CO)O)(O)=O,8,1,0,1,45,4.8e-05
G5,C(C(C(C=C)O)C(C(C)=O)O)(O)=O,8,1,0,1,27,4.8e-05
G5,C(C(C)(C(C(O)=O)C(C=C)O)O)=O,8,1,0,1,29,4.8e-05
G5,C(C(C=C)(C(C(O)=O)CO)O)(O)=O,4,1,0,1,18,4.8e-05
G5,C(C(CO)C(C(C)(CO)O)O)(O)=O,8,1,0,1,11,4.8e-05
G5,C(C(CO)C(C(CC)=O)(C)O)(O)=O,4,1,0,1,18,4.8e-05
G5,C(C(CO)C(C(C)=O)(CC)O)(O)=O,4,1,0,1,18,4.8e-05
G5,C(C(CO)C(C)(CC(C)=O)O)(O)=O,4,1,0,1,18,4.8e-05
G5,C(C(CO)C(C(C)CC=O)O)(O)=O,8,1,0,1,18,4.8e-05
G5,C(C(CO)C(CC(C=O)C)O)(O)=O,8,1,0,1,18,4.8e-05
G5,C(C(CO)C(C(CC)=O)O)(O)=O,4,1,0,1,18,4.8e-05
G5,C(C(CO)C(C=O)(CC)O)(O)=O,4,1,0,1,18,4.8e-05
G5,C(C(CO)C(C(O)=O)(CC)O)(O)=O,4,1,0,1,18,4.8e-05
G5,C(C(CO)C(C(C=CC)=O)O)(O)=O,8,1,0,1,18,4.8e-05
G5,C(C(CO)C(C=O)(C=CC)O)(O)=O,8,1,0,1,18,4.8e-05
G5,C(C(CO)C(C(CC=C)=O)O)(O)=O,4,1,0,1,18,4.8e-05
G5,C(C(CO)C(C=O)(CC=C)O)(O)=O,4,1,0,1,18,4.8e-05
G5,C(C(CO)C(C=CC=O)(C)O)(O)=O,8,1,0,1,18,4.8e-05
G5,C(C(CO)C(C=CC(C)=O)O)(O)=O,8,1,0,1,18,4.8e-05
G5,C(C(CO)C(C(CC=O)=C)O)(O)=O,4,1,0,1,18,4.8e-05
G5,C(C(CO)C(CC(C=O)=C)O)(O)=O,4,1,0,1,18,4.8e-05
G5,C(C(CO)C(C(C)=CC=O)O)(O)=O,8,1,0,1,18,4.8e-05
G5,C(C(CO)C(C=C(C=O)C)O)(O)=O,8,1,0,1,18,4.8e-05
G5,C(C(CO)C(C=C)O)(O)=O,4,1,0,1,18,4.8e-05
G5,C(C(CO)C(C=CC)(CO)O)(O)=O,8,1,0,1,18,4.8e-05
G5,C(C(CO)C(CO)(CC=C)O)(O)=O,4,1,0,1,18,4.8e-05
G5,C(C(CO)C(C)(C(C=C)O)O)(O)=O,8,1,0,1,18,4.8e-05
G5,C(C(CO)C(CC(CO)=C)O)(O)=O,4,1,0,1,18,4.8e-05
G5,C(C(CO)C(C=C(CO)C)O)(O)=O,8,1,0,1,28,4.8e-05
G5,C(C(CO)C(C=CC)O)(O)=O,8,1,0,1,18,4.8e-05
G5,C(C(CO)C(CC=C)O)(O)=O,4,1,0,1,18,4.8e-05
G5,C(C(CO)C(C=CCC=O)O)(O)=O,8,1,0,1,18,4.8e-05
G5,C(C(CO)C(CC=CC=O)O)(O)=O,8,1,0,1,18,4.8e-05
G5,C(C(C(CO)(C)O)C(C=C)O)(O)=O,8,1,0,1,29,4.8e-05
G5,C(C(C(C)O)C(C(CC)=O)O)(O)=O,8,1,0,1,28,4.8e-05
G5,C(C(C(C)O)C(C=O)(CC)O)(O)=O,8,1,0,1,28,4.8e-05
G5,C(C(C(C)O)C(C=C)O)(O)=O,8,1,0,1,28,4.8e-05
G5,C(C(C(C)O)C(C=CC)O)(O)=O,16,1,0,1,28,4.8e-05
G5,C(C(C(CC=C)O)C(C)O)(O)=O,8,1,0,1,28,4.8e-05
G5,C(C(C(O)=O)(C(C=C)O)O)(O)=O,2,2,0,2,17,9.499999999999999e-05
G5,C(C(C(O)=O)(C(C=CC)O)O)(O)=O,4,2,0,2,17,9.499999999999999e-05
G5,C(C(C(O)=O)(C(CC=C)O)O)(O)=O,2,2,0,2,17,9.499999999999999e-05
G5,C(C(C(C(O)=O)C(C=C)O)O)(O)=O,8,1,0,1,29,4.8e-05
G5,C1(C(CO)(C(CO1)O)C(C=C)O)=O,8,1,0,1,27,4.8e-05
G5,C(C1(C(C(CC1)=O)=O)C(C=C)O)=O,4,1,0,1,45,4.8e-05
G5,C(C1(C(C(CC1)=O)=O)C(C=CC)O)=O,8,1,0,1,45,4.8e-05
G5,C(C1(C(C(CC1)=O)=O)C(CC=C)O)=O,4,1,0,1,45,4.8e-05
G5,C(C1(C(CC(C1)=O)=O)C(C=C)O)=O,4,1,0,1,45,4.8e-05
G5,C(C1(C(CC(C1)=O)=O)C(C=CC)O)=O,8,1,0,1,45,4.8e-05
G5,C(C1(C(CC(C1)=O)=O)C(CC=C)O)=O,4,1,0,1,45,4.8e-05
G5,C(C1(C(CCC1=O)=O)C(C=C)O)=O,2,1,0,1,45,4.8e-05
G5,C(C1(C(CCC1=O)=O)C(C=CC)O)=O,4,1,0,1,45,4.8e-05
G5,C(C1(C(CCC1=O)=O)C(CC=C)O)=O,2,1,0,1,45,4.8e-05
G5,C1(CC=CC(C1(C(C=C)O)O)=O)=O,4,2,0,2,32,9.499999999999999e-05
G5,C1(CC=CC(C1(C(C=CC)O)O)=O)=O,8,2,0,2,32,9.499999999999999e-05
G5,C1(CC=CC(C1(C(CC=C)O)O)=O)=O,4,2,0,2,32,9.499999999999999e-05
G5,C(CC(C=O)(CO)C(C=C)O)=O,4,1,0,1,55,4.8e-05
G5,C(CC(C=O)(CO)C(C=CC)O)=O,8,1,0,1,55,4.8e-05
G5,C(C(CO)(C(CC=C)O)CC=O)=O,4,1,0,1,55,4.8e-05
G5,C(C(C(C(C)=O)=O)(C)C(C=C)O)=O,4,1,0,1,45,4.8e-05
G5,C(C(C(C(C)=O)=O)(C)C(C=CC)O)=O,8,1,0,1,45,4.8e-05
G5,C(C(C(C(C)=O)=O)(C)C(CC=C)O)=O,4,1,0,1,45,4.8e-05
G5,C=CC(C(C(C(C)=O)=O)(CO)C)O,4,1,0,1,27,4.8e-05
G5,C(C(C)(C(C(C)=O)O)C(C=C)O)=O,8,1,0,1,27,4.8e-05
G5,C(C(C(C=O)=O)(C)C(C=C)O)=O,4,1,0,1,49,4.8e-05
G5,C(C(C(C=O)=O)(C)C(C=CC)O)=O,8,1,0,1,49,4.8e-05
G5,C(C(C(C=O)=O)(C)C(CC=C)O)=O,4,1,0,1,49,4.8e-05
G5,C=CC(C(C(C=O)=O)(CO)C)O,4,1,0,1,28,4.8e-05
G5,C(C)=CC(C(C(C=O)=O)(CO)C)O,8,1,0,1,28,4.8e-05
G5,C=CCC(C(C(C=O)=O)(C)CO)O,4,1,0,1,28,4.8e-05
G5,C(C(C)(C(C=O)O)C(C=C)O)=O,8,1,0,1,49,4.8e-05
G5,C(C(C)(C(C=O)O)C(C=CC)O)=O,16,1,0,1,49,4.8e-05
G5,C(C(C)(C(CC=C)O)C(C=O)O)=O,8,1,0,1,49,4.8e-05
G5,C(C(C=O)(C=O)C(C(CC)=O)O)=O,2,1,0,1,1,4.8e-05
G5,C(C(C=O)(C=O)C(C=O)(CC)O)=O,2,1,0,1,1,4.8e-05
G5,C(C(C1(C(C=CC1=O)=O)O)O)(CC)=O,2,2,0,2,47,9.499999999999999e-05
G5,C(C(CC)(C1(C(C=CC1=O)=O)O)O)=O,2,2,0,2,47,9.499999999999999e-05
G5,C(C)(C(C(C=C)=O)(C(C=C)O)O)=O,4,2,0,2,9,9.499999999999999e-05
G5,C(C)(C(C(C=C)=O)(C(C=CC)O)O)=O,8,2,0,2,9,9.499999999999999e-05
G5,C(C)(C(C(C=C)=O)(C(CC=C)O)O)=O,4,2,0,2,9,9.499999999999999e-05
G5,C=CC(C1(C(C=CC1=O)=O)CO)O,2,1,0,1,45,4.8e-05
G5,C(C)=CC(C1(C(C=CC1=O)=O)CO)O,4,1,0,1,45,4.8e-05
G5,C=CCC(C1(C(C=CC1=O)=O)CO)O,2,1,0,1,45,4.8e-05
G5,C(C(C=O)(C(C(C)=O)=O)C(C=C)O)=O,2,1,0,1,14,4.8e-05
G5,C(C(C(C)=O)(C(C=O)=O)C(C=C)O)=O,4,1,0,1,23,4.8e-05
G5,C(C(C=O)(C(C)=O)C(C=C)O)=O,2,1,0,1,6,4.8e-05
G5,C(C(C=O)(C(C)=O)C(C=CC)O)=O,4,1,0,1,6,4.8e-05
G5,C(C(C=O)(C(C)=O)C(CC=C)O)=O,2,1,0,1,6,4.8e-05
G5,C(C(C(C)=O)(C(C)=O)C(C=C)O)=O,2,1,0,1,6,4.8e-05
G5,C(C(C(C)=O)(C(C)=O)C(C=CC)O)=O,4,1,0,1,6,4.8e-05
G5,C(C(C(C)=O)(C(C)=O)C(CC=C)O)=O,2,1,0,1,6,4.8e-05
G5,C(C(C=O)(C(C=O)=O)C(C=C)O)=O,2,1,0,1,23,4.8e-05
G5,C(C(C=O)(C(C=O)=O)C(C=CC)O)=O,4,1,0,1,23,4.8e-05
G5,C(C(C=O)(C(C=O)=O)C(CC=C)O)=O,2,1,0,1,23,4.8e-05
G5,C(C)(C(C(C)=O)(CO)C(C=C)O)=O,2,1,0,1,28,4.8e-05
G5,C(C(C=O)(C=O)C(C(C=CC)=O)O)=O,4,1,0,1,1,4.8e-05
G5,C(C(C=O)(C=O)C(C=O)(C=CC)O)=O,4,1,0,1,1,4.8e-05
G5,C(C(C=O)(C=O)C(C(CC=C)=O)O)=O,2,1,0,1,1,4.8e-05
G5,C(C(C=O)(C=O)C(C=O)(CC=C)O)=O,2,1,0,1,1,4.8e-05
G5,C(C(C=O)(C=O)C(C=CC=O)(C)O)=O,4,1,0,1,1,4.8e-05
G5,C(C(C=O)(C=O)C(C=CC(C)=O)O)=O,4,1,0,1,1,4.8e-05
G5,C(C(C=O)(C=O)C(C(CC=O)=C)O)=O,2,1,0,1,1,4.8e-05
G5,C(C(C=O)(C=O)C(CC(C=O)=C)O)=O,2,1,0,1,1,4.8e-05
G5,C(C(C=O)(C=O)C(C(C)=CC=O)O)=O,4,1,0,1,1,4.8e-05
G5,C(C(C=O)(C=O)C(C=C(C=O)C)O)=O,4,1,0,1,1,4.8e-05
G5,C(C(C=O)(C=O)C(C=C)O)=O,2,1,0,1,1,4.8e-05
G5,C(C(C=O)(C=O)C(C=CC)O)=O,4,1,0,1,1,4.8e-05
G5,C(C(C=O)(C=O)C(CC=C)O)=O,2,1,0,1,1,4.8e-05
G5,C(C(C=O)(C=O)C(C=CCC=O)O)=O,4,1,0,1,1,4.8e-05
G5,C(C(C=O)(C=O)C(CC=CC=O)O)=O,4,1,0,1,1,4.8e-05
G5,C(C(C(C(O)=O)=O)(C)C(C=C)O)=O,4,1,0,1,27,4.8e-05
G5,C(C(C(C=O)=O)(CC=O)C(C=C)O)=O,4,1,0,1,33,4.8e-05
G5,C(C(C=O)(CC=O)C(C=C)O)=O,2,1,0,1,43,4.8e-05
G5,C(C(C=O)(CC=O)C(C=CC)O)=O,4,1,0,1,43,4.8e-05
G5,C(C(C=O)(C(CC=C)O)CC=O)=O,2,1,0,1,43,4.8e-05
G5,C(C(C)(C(C(O)=O)O)C(C=C)O)=O,8,1,0,1,49,4.8e-05
G5,C=CC(C(C(C(O)=O)=O)(CO)C)O,4,1,0,1,28,4.8e-05
G5,C(C(C(C)=O)(CC=O)C(C=C)O)=O,4,1,0,1,45,4.8e-05
G5,C(C(C(C)=O)(CC=O)C(C=CC)O)=O,8,1,0,1,45,4.8e-05
G5,C(C)(C(C=O)(C(CC=C)O)CC=O)=O,4,1,0,1,45,4.8e-05
G5,C1(CC(OC1(C(C)=O)C(C=C)O)=O)=O,4,2,0,2,27,9.499999999999999e-05
G5,C1(CC(C(C1(C(C=C)O)O)=O)=C)=O,4,2,0,2,47,9.499999999999999e-05
G5,C1(CC(C(C1(C(C=CC)O)O)=O)=C)=O,8,2,0,2,47,9.499999999999999e-05
G5,C1(CC(C(C1(C(CC=C)O)O)=O)=C)=O,4,2,0,2,47,9.499999999999999e-05
G5,C(C(C(CC=C)=O)(C(C=C)O)O)=O,4,2,0,2,4,9.499999999999999e-05
G5,C(C(C(CC=C)=O)(C(C=CC)O)O)=O,8,2,0,2,4,9.499999999999999e-05
G5,C(C(C(CC=C)=O)(C(CC=C)O)O)=O,4,2,0,2,4,9.499999999999999e-05
G5,C(C1(C(C(C=C1)O)=O)C(C=C)O)=O,8,1,0,1,45,4.8e-05
G5,C(C1(C(C(C=C1)O)=O)C(C=CC)O)=O,16,1,0,1,45,4.8e-05
G5,C(C1(C(C(C=C1)O)=O)C(CC=C)O)=O,8,1,0,1,45,4.8e-05
G5,C(C)(C1(C(C=CO1)=O)C(C=C)O)=O,4,2,0,2,9,9.499999999999999e-05
G5,C(C)(C1(C(C=CO1)=O)C(C=CC)O)=O,8,2,0,2,9,9.499999999999999e-05
G5,C(C)(C1(C(C=CO1)=O)C(CC=C)O)=O,4,2,0,2,9,9.499999999999999e-05
G5,C(C1(C(CC(O1)=C)=O)C(C=C)O)=O,4,2,0,2,26,9.499999999999999e-05
G5,C(C1(C(CC(O1)=C)=O)C(C=CC)O)=O,8,2,0,2,26,9.499999999999999e-05
G5,C(C1(C(CC(O1)=C)=O)C(CC=C)O)=O,4,2,0,2,26,9.499999999999999e-05
G5,C(C1(C(CC=CO1)=O)C(C=C)O)=O,4,2,0,2,37,9.499999999999999e-05
G5,C(C1(C(CC=CO1)=O)C(C=CC)O)=O,8,2,0,2,37,9.499999999999999e-05
G5,C(C1(C(CC=CO1)=O)C(CC=C)O)=O,4,2,0,2,37,9.499999999999999e-05
G5,C(C1(C(CCC(O1)=O)=O)C(C=C)O)=O,4,2,0,2,27,9.499999999999999e-05
G5,C=CC(C1(C=CC(C1=O)=O)CO)O,4,1,0,1,45,4.8e-05
G5,C(C)=CC(C1(C=CC(C1=O)=O)CO)O,8,1,0,1,45,4.8e-05
G5,C=CCC(C1(C=CC(C1=O)=O)CO)O,4,1,0,1,45,4.8e-05
G5,C(C(C(CO)=O)(C=C)C(C=C)O)=O,4,1,0,1,45,4.8e-05
G5,C(C(C(CO)=O)(C=C)C(C=CC)O)=O,8,1,0,1,45,4.8e-05
G5,C(C(C(CO)=O)(C=C)C(CC=C)O)=O,4,1,0,1,45,4.8e-05
G5,C(C(C(C=CC=O)=O)(C(C=C)O)O)=O,8,2,0,2,46,9.499999999999999e-05
G5,C(C(C(C=C)=O)(C(C=C)O)O)=O,4,2,0,2,0,9.499999999999999e-05
G5,C(C(C(C=C)=O)(C(C=CC)O)O)=O,8,2,0,2,0,9.499999999999999e-05
G5,C(C(C(C=C)=O)(C(CC=C)O)O)=O,4,2,0,2,0,9.499999999999999e-05
G5,C(C(C(C=CC)=O)(C(C=C)O)O)=O,8,2,0,2,28,9.499999999999999e-05
G5,C(C(C(C=CC)=O)(C(C=CC)O)O)=O,16,2,0,2,28,9.499999999999999e-05
G5,C(C(C(C=CC)=O)(C(CC=C)O)O)=O,8,2,0,2,28,9.499999999999999e-05
G5,C=CC(C(C(C=CC)=O)(CO)O)O,8,2,0,2,28,9.499999999999999e-05
G5,C(C(CO)(C(C=C)O)O)(CC=C)=O,4,2,0,2,28,9.499999999999999e-05
G5,C=CC(C(C=O)=O)(CO)C(C=C)O,4,1,0,1,28,4.8e-05
G5,C(CO)(C(C=C)(CO)C(C=C)O)=O,4,1,0,1,28,4.8e-05
G5,C(C(C=C)(C(C=C)O)C(C=O)O)=O,8,1,0,1,45,4.8e-05
G5,C(C1(C(C=C(C)O1)=O)C(C=C)O)=O,4,2,0,2,26,9.499999999999999e-05
G5,C=CC(C1(C(C=CC(O1)=O)=O)CO)O,4,2,0,2,2,9.499999999999999e-05
G5,C1(C(C(C=CCO1)=O)(C(C=C)O)O)=O,4,2,0,2,2,9.499999999999999e-05
G5,C=CC(C1(C(C=CC(OC1)=O)=O)O)O,4,2,0,2,46,9.499999999999999e-05
G5,C(C(C1C=CC(O1)=O)(C(C=C)O)O)=O,8,2,0,2,8,9.499999999999999e-05
G5,C(C1(C(C=C)O)C(C=CC(O1)=O)O)=O,8,2,0,2,8,9.499999999999999e-05
G5,C(C(C(C=C)O)(C(C=C)O)O)=O,3,2,0,2,27,9.499999999999999e-05
G5,C(C1(COC(C1O)O)C(C=C)O)=O,16,1,0,1,27,4.8e-05
G5,C(C1(C(CC(O1)O)O)C(C=C)O)=O,16,2,0,2,0,9.499999999999999e-05
G5,C1(C(O)OCC1(C(C=C)O)O)=O,8,2,0,2,0,9.499999999999999e-05
G5,C1(COC(C)(C1(C(C=C)O)O)O)=O,8,2,0,2,0,9.499999999999999e-05
G5,C1(COC(C1(C(C=C)O)O)O)=O,8,2,0,2,5,9.499999999999999e-05
G5,C1(C(C(C(O)O1)O)(C(C=C)O)O)=O,16,2,0,2,0,9.499999999999999e-05
G5,C1(C(C(C(O)O1)O)C(C=C)O)=O,16,1,0,1,45,4.8e-05
G5,C1(C(C(OC1C)O)(C(C=C)O)O)=O,16,2,0,2,0,9.499999999999999e-05
G5,C1(C(COC(C1)O)(C(C=C)O)O)=O,8,2,0,2,27,9.499999999999999e-05
G5,C1(C(C(O)OCC1)(C(C=C)O)O)=O,8,2,0,2,27,9.499999999999999e-05
G5,C1(C(C(C)(CO1)O)(C(C=C)O)O)=O,8,2,0,2,27,9.499999999999999e-05
G5,C(CC(C=O)(C(C)O)C(C=C)O)=O,8,1,0,1,27,4.8e-05
G5,C=CC(C1(C(C=CC1=O)=O)O)O,2,2,0,2,47,9.499999999999999e-05
G5,C(C)=CC(C(C=C)(C(C=O)=O)CO)O,8,1,0,1,28,4.8e-05
G5,C=CC(C(C=O)=O)(CO)C(CC=C)O,4,1,0,1,28,4.8e-05
G5,C(C(C=C)(C(C=CC)O)C(C=O)O)=O,16,1,0,1,45,4.8e-05
G5,C(C(C=C)(C(CC=C)O)C(C=O)O)=O,8,1,0,1,45,4.8e-05
G5,C(C1(C(C=C(C)O1)=O)C(C=CC)O)=O,8,2,0,2,26,9.499999999999999e-05
G5,C(C(C(C=CC)O)(C(C=C)O)O)=O,16,2,0,2,27,9.499999999999999e-05
G5,C1(C(O)OCC1(C(C=CC)O)O)=O,16,2,0,2,0,9.499999999999999e-05
G5,C1(COC(C1(C(C=CC)O)O)O)=O,16,2,0,2,5,9.499999999999999e-05
G5,C1(C(C(C(O)O1)O)C(C=CC)O)=O,32,1,0,1,45,4.8e-05
G5,C(C)=CC(C1(C(C=CC1=O)=O)O)O,4,2,0,2,47,9.499999999999999e-05
G5,C(C1(C(C=C(C)O1)=O)C(CC=C)O)=O,4,2,0,2,26,9.499999999999999e-05
G5,C(C(C(CC=C)O)(C(C=C)O)O)=O,8,2,0,2,27,9.499999999999999e-05
G5,C1(C(O)OCC1(C(CC=C)O)O)=O,8,2,0,2,0,9.499999999999999e-05
G5,C1(COC(C1(C(CC=C)O)O)O)=O,8,2,0,2,5,9.499999999999999e-05
G5,C1(C(C(CC=C)O)C(C(O)O1)O)=O,16,1,0,1,45,4.8e-05
G5,C=CCC(C1(C(C=CC1=O)=O)O)O,2,2,0,2,47,9.499999999999999e-05
G5,C(C(C(C=O)=O)(C(CO)O)O)(O)=O,4,4,0,4,0,0.000193
G5,C(C(C=O)(C=O)C(CO)O)(O)=O,2,2,0,2,0,9.7e-05
G5,C(C(C=O)(C(C)=O)C(CO)O)(O)=O,4,2,0,2,0,9.7e-05
G5,C(C(C=O)(C(CO)O)C(CO)O)=O,3,1,0,1,0,4.8e-05
G5,C(C(C=O)(C(CO)O)C(C=O)O)=O,4,2,0,2,0,9.6e-05
G5,C(C(C=O)(CO)C(CO)O)=O,2,2,0,2,0,9.8e-05
G5,C(C(C(C=O)=O)(CO)C(CO)O)=O,4,2,0,2,0,9.8e-05
G5,C(C(C(C)=O)(CO)C(CO)O)=O,4,2,0,2,0,9.8e-05
G5,C1(COC(C1(CO)C(CO)O)O)=O,8,3,0,3,0,0.000145
G5,C1(C(O)OCC1(CO)C(CO)O)=O,8,3,0,3,0,0.000145
G5,C(C(C(C(CO)O)(C(C)O)O)=O)=O,8,5,0,5,0,0.00025299999999999997
G5,C(C(C=O)(C(CO)O)C(C)O)=O,4,2,0,2,0,9.7e-05
G5,C(C(C(C)=O)(C(CO)O)C(C)O)=O,8,2,0,2,0,9.7e-05
G5,C(C)(C(C(C=O)=O)(C(CO)O)O)=O,4,2,0,2,0,9.7e-05
G5,C(C(C=O)(C(CO)=O)C(CO)O)=O,2,1,0,1,1,4.8e-05
G5,C(C(C(CC=O)=O)(C(CO)O)O)=O,4,5,0,5,1,0.000272
G5,C(C(C(C(C)=O)=O)(C(CO)O)O)=O,4,2,0,2,25,9.7e-05
G5,C1(CCC(C1(C(CO)O)O)=O)=O,2,3,0,3,47,0.000144
G5,C1(COC(CO)C1(C(CO)O)O)=O,8,2,0,2,27,9.7e-05
G5,C1(COCC(C1(C(CO)O)O)O)=O,8,2,0,2,27,9.7e-05
G5,C1(C(CO)(C(CO)O)C(CO1)O)=O,8,2,0,2,0,9.8e-05
G5,C(C1(C(C(CC1)=O)=O)C(CO)O)=O,4,2,0,2,0,9.6e-05
G5,C(C1(C(CC(C1)=O)=O)C(CO)O)=O,4,1,0,1,45,4.8e-05
G5,C(C1(C(CCC1=O)=O)C(CO)O)=O,2,1,0,1,45,4.8e-05
G5,C1(CC=CC(C1(C(CO)O)O)=O)=O,4,2,0,2,32,9.7e-05
G5,C(C(CO)(C(CO)O)CC=O)=O,4,4,0,4,46,0.000193
G5,C(C(C(C(C)=O)=O)(C)C(CO)O)=O,4,1,0,1,45,4.8e-05
G5,C(C(C)=O)(C(C)(CO)C(CO)O)=O,4,2,0,2,28,9.8e-05
G5,C(C(C)(C(CO)O)C(C(C)=O)O)=O,8,1,0,1,27,4.8e-05
G5,C(C(C(C=O)=O)(C)C(CO)O)=O,4,1,0,1,49,4.8e-05
G5,C(C(C(C)(CO)C(CO)O)=O)=O,4,2,0,2,28,9.8e-05
G5,C(C(C)(C(CO)O)C(C=O)O)=O,8,1,0,1,49,4.8e-05
G5,C(C)(C(C(C=C)=O)(C(CO)O)O)=O,4,2,0,2,9,9.7e-05
G5,C1(C=CC(C1(CO)C(CO)O)=O)=O,2,1,0,1,45,4.8e-05
G5,C(C(C=O)(C(C)=O)C(CO)O)=O,2,1,0,1,6,4.8e-05
G5,C(C(C(C)=O)(C(C)=O)C(CO)O)=O,2,1,0,1,6,4.8e-05
G5,C(C(C=O)(C(C=O)=O)C(CO)O)=O,2,1,0,1,23,4.8e-05
G5,C(C)(C(C(C)=O)(CO)C(CO)O)=O,2,1,0,1,28,4.8e-05
G5,C(C(C=O)(C=O)C(CO)O)=O,2,1,0,1,1,4.8e-05
G5,C(C(C(C(O)=O)=O)(C)C(CO)O)=O,4,1,0,1,27,4.8e-05
G5,C(C(C=O)(C(CO)O)CC=O)=O,2,1,0,1,43,4.8e-05
G5,C(C(C)(C(CO)O)C(C(O)=O)O)=O,8,1,0,1,49,4.8e-05
G5,C(C(C(C)(CO)C(CO)O)=O)(O)=O,4,2,0,2,0,9.8e-05
G5,C(C)(C(C=O)(C(CO)O)CC=O)=O,4,1,0,1,45,4.8e-05
G5,C1(CC(C(C1(C(CO)O)O)=O)=C)=O,4,2,0,2,47,9.7e-05
G5,C(C(C(CC=C)=O)(C(CO)O)O)=O,4,2,0,2,4,9.7e-05
G5,C(C1(C(C(C=C1)O)=O)C(CO)O)=O,8,1,0,1,45,4.8e-05
G5,C(C)(C1(C(C=CO1)=O)C(CO)O)=O,4,2,0,2,9,9.7e-05
G5,C(C1(C(CC(O1)=C)=O)C(CO)O)=O,4,2,0,2,26,9.7e-05
G5,C(C1(C(CC=CO1)=O)C(CO)O)=O,4,2,0,2,37,9.7e-05
G5,C1C(C(C(C=1)=O)=O)(CO)C(CO)O,4,1,0,1,45,4.8e-05
G5,C(C(C(CO)=O)(C=C)C(CO)O)=O,4,1,0,1,45,4.8e-05
G5,C(C(C(C=C)=O)(C(CO)O)O)=O,4,4,0,4,0,0.000192
G5,C(C(C(C=CC)=O)(C(CO)O)O)=O,8,2,0,2,28,9.7e-05
G5,C(C)=CC(C(CO)(C(CO)O)O)=O,8,2,0,2,28,9.7e-05
G5,C(C(CO)(C(CO)O)O)(CC=C)=O,4,2,0,2,28,9.7e-05
G5,C=CC(C(C=O)=O)(CO)C(CO)O,4,1,0,1,28,4.8e-05
G5,C(CO)(C(C=C)(CO)C(CO)O)=O,4,1,0,1,28,4.8e-05
G5,C(C(C=C)(C(CO)O)C(C=O)O)=O,8,1,0,1,45,4.8e-05
G5,C(C1(C(C=C(C)O1)=O)C(CO)O)=O,4,2,0,2,26,9.7e-05
G5,C(C(C(CO)O)(C(C=C)O)O)=O,8,6,0,6,0,0.00028700000000000004
G5,C(C1(COC(C1O)O)C(CO)O)=O,16,2,0,2,0,9.6e-05
G5,C(C1(C(CO)O)C(CC(O1)O)O)=O,16,3,0,3,0,0.000144
G5,C1(C(O)OCC1(C(CO)O)O)=O,8,3,0,3,0,0.000144
G5,C1(COC(C)(C1(C(CO)O)O)O)=O,8,3,0,3,0,0.000144
G5,C1(COC(C1(C(CO)O)O)O)=O,8,3,0,3,5,0.000144
G5,C1(C(C(CO)O)C(C(O)O1)O)=O,16,2,0,2,45,9.6e-05
G5,C1(C(C)OC(C1(C(CO)O)O)O)=O,16,3,0,3,0,0.000144
G5,C1(CCOC(C1(C(CO)O)O)O)=O,8,3,0,3,27,0.000144
G5,C1(C(C(CO)O)(C(C)(CO1)O)O)=O,8,3,0,3,27,0.000144
G5,C(C(C(CO)O)(C(C)O)CC=O)=O,8,4,0,4,46,0.000193
G5,C1(C=CC(C1(C(CO)O)O)=O)=O,2,2,0,2,47,9.7e-05
G5,C(C(C(CO)O)(C(C)(C)O)O)=O,4,2,0,2,0,9.499999999999999e-05
G5,C(C(C(CO)O)(C(C=CC)O)O)=O,16,2,0,2,0,9.499999999999999e-05
G5,C(C(C(CC=C)O)(C(CO)O)O)=O,8,2,0,2,0,9.499999999999999e-05
G5,C(C(CO)(CO)C(CO)(CO)O)=O,1,2,0,2,5,9.7e-05
G5,C(C(C=O)(CO)C(CO)(CO)O)=O,1,2,0,2,5,9.7e-05
G5,C(C(C=O)(C=O)C(CO)(CO)O)=O,1,1,0,1,1,4.8e-05
G5,C(C(CO)(CO)C(C(CO)O)O)=O,4,2,0,2,41,9.7e-05
G5,C(C(C=O)(CO)C(C(CO)O)O)=O,4,2,0,2,45,9.7e-05
G5,C(C(CO)(C(C)(C)O)O)=O,2,2,0,2,41,9.6e-05
G5,C(OCC(C)(C(C=O)(CO)O)O)=O,4,2,0,2,35,9.6e-05
G5,C(OCC(C(C=O)(CO)O)O)=O,4,2,0,2,41,9.6e-05
G5,C(C(CO)(C(COC(C)=O)O)O)=O,4,2,0,2,28,9.6e-05
G5,C(C(CO)(C(CCC=O)O)O)=O,4,6,0,6,27,0.00029
G5,C1(C(CCO1)(C(C=O)(CO)O)O)=O,4,3,0,3,28,0.000144
G5,C(C(CO)(C1(COC(C1)=O)O)O)=O,4,2,0,2,41,9.6e-05
G5,C(C(CO)(C1(C=COC1)O)O)=O,4,3,0,3,41,0.000143
G5,C(C(C)(C(C=O)(CO)O)O)(CC)=O,4,2,0,2,41,9.6e-05
G5,C(C(CO)(C(C(C)=O)(CC)O)O)=O,4,2,0,2,41,9.6e-05
G5,C(C(CO)(C(C(C)CC=O)O)O)=O,8,3,0,3,28,0.000143
G5,C(C(C)CC(C(C=O)(CO)O)O)=O,8,2,0,2,28,9.6e-05
G5,C(C(CO)(C(C(CC)=O)O)O)=O,4,3,0,3,28,0.000143
G5,C(C(CC)(C(C=O)(CO)O)O)=O,4,2,0,2,28,9.6e-05
G5,C(C(C=O)(C=O)C(C(CO)O)O)=O,4,1,0,1,1,4.8e-05
G5,C(C(CC)(C(C=O)(CO)O)O)(O)=O,4,2,0,2,28,9.6e-05
G5,C(C(CO)(C(C=O)(C=CC)O)O)=O,8,2,0,2,28,9.6e-05
G5,C(C(CO)(C(C=O)(CC=C)O)O)=O,4,2,0,2,28,9.6e-05
G5,C(C(CO)(C(C=CC=O)(C)O)O)=O,8,2,0,2,28,9.6e-05
G5,C(C(CO)(C(C=CC(C)=O)O)O)=O,8,2,0,2,28,9.6e-05
G5,C(C(CO)(C(C(CC=O)=C)O)O)=O,4,4,0,4,28,0.000195
G5,C(C(CO)(C(CC(C=O)=C)O)O)=O,4,2,0,2,28,9.6e-05
G5,C(C(CO)(C(C(C)=CC=O)O)O)=O,8,4,0,4,28,0.000195
G5,C(C(CO)(C(C=C(C=O)C)O)O)=O,8,2,0,2,28,9.6e-05
G5,C(C(CO)(C(C=C)O)O)=O,4,7,0,7,27,0.000337
G5,C(C(CO)(C(C=CC)(CO)O)O)=O,8,2,0,2,41,9.6e-05
G5,C(C(CO)(C(CO)(CC=C)O)O)=O,4,2,0,2,41,9.6e-05
G5,C(C(CO)(C(C)(C(C=C)O)O)O)=O,8,2,0,2,28,9.6e-05
G5,C(C(CO)(C(CC(CO)=C)O)O)=O,4,2,0,2,28,9.6e-05
G5,C(C(CO)(C(C=C(CO)C)O)O)=O,8,2,0,2,28,9.6e-05
G5,C(C(CO)(C(C=CC)O)O)=O,8,3,0,3,41,0.000143
G5,C(C(CO)(C(CC=C)O)O)=O,4,3,0,3,41,0.000143
G5,C(C(CO)(C(C=CCC=O)O)O)=O,8,2,0,2,41,9.6e-05
G5,C(C(CO)(C(CC=CC=O)O)O)=O,8,3,0,3,41,0.000143
G5,C(C(C=O)(CO)C(C(C)=O)O)(O)=O,4,3,0,3,17,0.000146
G5,C(C(C=O)(CO)C(C=O)(C)O)(O)=O,4,3,0,3,17,0.000146
G5,C(C(C=O)(C=O)C(C=O)(C)O)(O)=O,2,2,0,2,45,9.6e-05
G5,C(C(CO)(CO)C(C(C)=O)O)=O,2,2,0,2,2,9.7e-05
G5,C(C(CO)(CO)C(C=O)(C)O)=O,2,2,0,2,45,9.7e-05
G5,C(C(CO)(C(C)O)C(C(C)=O)O)=O,8,3,0,3,45,0.000146
G5,C(C(CO)(C(C)O)C(C=O)(C)O)=O,8,3,0,3,45,0.000146
G5,C(C(C=O)(CO)C(C=O)(C)O)=O,2,2,0,2,45,9.7e-05
G5,C(C)(C(C=O)(CO)C(C(C)=O)O)=O,4,2,0,2,45,9.7e-05
G5,C(C(C)(C(C=O)(C(C)=O)CO)O)=O,4,2,0,2,45,9.7e-05
G5,C(C(C)(C(C(C=C)=O)(CO)O)O)=O,4,5,0,5,45,0.00024300000000000002
G5,C(C(C=O)(C(C)O)C(C=O)(C)O)=O,4,2,0,2,45,9.7e-05
G5,C(C(C(C=O)=O)(C(C(C)=O)O)O)=O,4,2,0,2,5,9.6e-05
G5,C(C(C(C=O)=O)(C(C=O)(C)O)O)=O,4,2,0,2,5,9.6e-05
G5,C(C)(C(C(C)=O)(C(C(C)=O)O)O)=O,2,2,0,2,49,9.6e-05
G5,C(C(C)(C(C(C)=O)(C(C)=O)O)O)=O,2,2,0,2,49,9.6e-05
G5,C1(CCC(C1(C(C(C)=O)O)O)=O)=O,2,2,0,2,47,9.6e-05
G5,C(C(C)(C1(C(CCC1=O)=O)O)O)=O,2,2,0,2,47,9.6e-05
G5,C(C1(C(C(CC1)=O)=O)C(C(C)=O)O)=O,4,2,0,2,45,9.499999999999999e-05
G5,C(C1(C(C(CC1)=O)=O)C(C=O)(C)O)=O,4,2,0,2,45,9.499999999999999e-05
G5,C(C1(C(CC(C1)=O)=O)C(C(C)=O)O)=O,4,1,0,1,45,4.8e-05
G5,C(C(C)(C1(C(CC(C1)=O)=O)C=O)O)=O,4,1,0,1,45,4.8e-05
G5,C(C1(C(CCC1=O)=O)C(C(C)=O)O)=O,2,1,0,1,45,4.8e-05
G5,C(C(C)(C1(C=O)C(CCC1=O)=O)O)=O,2,1,0,1,45,4.8e-05
G5,C1(CC=CC(C1(C(C(C)=O)O)O)=O)=O,4,2,0,2,32,9.6e-05
G5,C1(C(C(C=CC1)=O)(C(C=O)(C)O)O)=O,4,2,0,2,32,9.6e-05
G5,C(CC(C=O)(CO)C(C(C)=O)O)=O,4,4,0,4,55,0.000193
G5,C(C(C)(C(C=O)(CO)CC=O)O)=O,4,4,0,4,55,0.000193
G5,C(C(C(C=O)=O)(C)C(C(C)=O)O)=O,4,1,0,1,49,4.8e-05
G5,C(C(C(C=O)=O)(C)C(C=O)(C)O)=O,4,1,0,1,49,4.8e-05
G5,C(C(C(C(C=O)=O)(CO)C)O)(C)=O,4,2,0,2,28,9.7e-05
G5,C(C(C)(C(C(C=O)=O)(CO)C)O)=O,4,1,0,1,28,4.8e-05
G5,C(C(C)(C(C(C)=O)O)C(C=O)O)=O,8,2,0,2,27,9.6e-05
G5,C(C(C)(C(C=O)(C)C(C=O)O)O)=O,8,1,0,1,49,4.8e-05
G5,C(C(C1(C(C=CC1=O)=O)CO)O)(C)=O,2,1,0,1,45,4.8e-05
G5,C(C(C)(C1(C(C=CC1=O)=O)CO)O)=O,2,1,0,1,45,4.8e-05
G5,C(C(C=O)(C(C)=O)C(C(C)=O)O)=O,2,1,0,1,6,4.8e-05
G5,C(C(C)(C(C=O)(C=O)C(C)=O)O)=O,2,1,0,1,6,4.8e-05
G5,C(C(C=O)(C=O)C(C(C)=O)O)=O,2,1,0,1,1,4.8e-05
G5,C(C(C=O)(C=O)C(C=O)(C)O)=O,2,1,0,1,1,4.8e-05
G5,C(C(C=O)(CC=O)C(C(C)=O)O)=O,2,1,0,1,43,4.8e-05
G5,C(C(C)(C(C=O)(C=O)CC=O)O)=O,2,1,0,1,43,4.8e-05
G5,C1(CC(C(C1(C(C(C)=O)O)O)=O)=C)=O,4,2,0,2,47,9.6e-05
G5,C1(C(C(C(C1)=C)=O)(C(C=O)(C)O)O)=O,4,2,0,2,47,9.6e-05
G5,C(C1(C(C(C=C1)O)=O)C(C(C)=O)O)=O,8,1,0,1,45,4.8e-05
G5,C(C1(C(C(C=C1)O)=O)C(C=O)(C)O)=O,8,1,0,1,45,4.8e-05
G5,C(C)(C1(C(C=CO1)=O)C(C(C)=O)O)=O,4,2,0,2,9,9.6e-05
G5,C(C(C)(C1(C(C)=O)C(C=CO1)=O)O)=O,4,2,0,2,9,9.6e-05
G5,C(C1(C(CC(O1)=C)=O)C(C(C)=O)O)=O,4,2,0,2,26,9.6e-05
G5,C1(C(C=O)(C(C=O)(C)O)OC(C1)=C)=O,4,2,0,2,26,9.6e-05
G5,C(C1(C(CC=CO1)=O)C(C(C)=O)O)=O,4,2,0,2,37,9.6e-05
G5,C1(C(C=O)(C(C=O)(C)O)OC=CC1)=O,4,2,0,2,37,9.6e-05
G5,C(C(C1(C=CC(C1=O)=O)CO)O)(C)=O,4,1,0,1,45,4.8e-05
G5,C(C(C)(C1(C=CC(C1=O)=O)CO)O)=O,4,1,0,1,45,4.8e-05
G5,C(C(C(C=C)=O)(C(C(C)=O)O)O)=O,4,2,0,2,0,9.6e-05
G5,C(C(C(C=C)=O)(C(C=O)(C)O)O)=O,4,2,0,2,0,9.6e-05
G5,C(C1(C(C=C(C)O1)=O)C(C(C)=O)O)=O,4,2,0,2,26,9.6e-05
G5,C(C(C)(C1(C=O)C(C=C(C)O1)=O)O)=O,4,2,0,2,26,9.6e-05
G5,C(C(C(C=C)O)(C(C(C)=O)O)O)=O,8,4,0,4,0,0.000192
G5,C(C(C)(C(C=O)(C(C=C)O)O)O)=O,8,4,0,4,45,0.00019099999999999998
G5,C(C(C1(C(C(O)OC1)=O)O)O)(C)=O,8,3,0,3,0,0.000144
G5,C(C(C)(C1(C(C(O)OC1)=O)O)O)=O,8,3,0,3,0,0.000144
G5,C1(COC(C1(C(C(C)=O)O)O)O)=O,8,3,0,3,5,0.000144
G5,C(C(C)(C1(C(COC1O)=O)O)O)=O,8,3,0,3,5,0.000144
G5,C1(C(C(C(O)O1)O)C(C(C)=O)O)=O,16,2,0,2,45,9.499999999999999e-05
G5,C1(C(C(C(O)O1)O)C(C=O)(C)O)=O,16,2,0,2,29,9.499999999999999e-05
G5,C(C)(C(C1(C(C=CC1=O)=O)O)O)=O,2,2,0,2,47,9.6e-05
G5,C(C(C)(C1(C(C=CC1=O)=O)O)O)=O,2,2,0,2,47,9.6e-05
G5,C(C(C=O)(C(C=O)(C(C)=O)O)O)=O,2,4,0,4,1,0.00019099999999999998
G5,C(C(C(C)=O)(C(C)(C)O)O)=O,2,2,0,2,1,9.6e-05
G5,C(OCC(C(C=O)(C(C)=O)O)O)=O,4,2,0,2,1,9.6e-05
G5,C(CCC(C(C=O)(C(C)=O)O)O)=O,4,4,0,4,1,0.000202
G5,C(C(C(C)=O)(C(C(C=C)O)O)O)=O,8,2,0,2,1,9.6e-05
G5,C(C(C(C)=O)(C1(C=COC1)O)O)=O,4,2,0,2,1,9.6e-05
G5,C(C)(C(C=O)(C(C(CC)=O)O)O)=O,4,2,0,2,1,9.6e-05
G5,C(C(CC)(C(C=O)(C(C)=O)O)O)=O,4,2,0,2,1,9.6e-05
G5,C(C(C(C)=O)(C(C=C)O)O)=O,4,4,0,4,1,0.00019099999999999998
G5,C(C(C(C)=O)(C(C=CC)O)O)=O,8,3,0,3,1,0.000143
G5,C(C(C(C)=O)(C(CC=C)O)O)=O,4,3,0,3,1,0.000143
G5,C(C(C(C=O)=O)(C(C=O)O)O)(O)=O,4,4,0,4,1,0.000193
G5,C(C(C=O)(C=O)C(C=O)O)(O)=O,2,2,0,2,0,9.6e-05
G5,C(C(C=O)(C(C=O)O)C(C=O)O)=O,3,1,0,1,0,4.8e-05
G5,C(C(C(C(C(C)=O)=O)(CO)O)O)=O,4,5,0,5,25,0.000254
G5,C(C(C=O)(CO)C(C=O)O)=O,2,2,0,2,0,9.8e-05
G5,C(C(C(C=O)=O)(CO)C(C=O)O)=O,4,2,0,2,0,9.8e-05
G5,C1(COC(C1(CO)C(C=O)O)O)=O,8,3,0,3,2,0.000145
G5,C1(C(CO)(C(C=O)O)OC(C1)O)=O,8,5,0,5,0,0.000242
G5,C1(C(CO)(C(C=O)O)OCC1O)=O,8,4,0,4,10,0.000195
G5,C1(C(O)OCC1(CO)C(C=O)O)=O,8,3,0,3,34,0.000145
G5,C(C(C(C(C=O)=O)(C(C)O)O)O)=O,8,5,0,5,0,0.000252
G5,C(C(C=O)(C(C)O)C(C=O)O)=O,4,2,0,2,0,9.7e-05
G5,C(C(C(C(C)=O)(C(C=O)=O)O)O)=O,4,2,0,2,0,9.6e-05
G5,C(C(C=O)(C(CO)=O)C(C=O)O)=O,2,1,0,1,1,4.8e-05
G5,C(C(C(CC=O)=O)(C(C=O)O)O)=O,4,2,0,2,1,9.6e-05
G5,C(C(C(C(C)=O)=O)(C(C=O)O)O)=O,4,2,0,2,25,9.6e-05
G5,C(C(C1(C(CCC1=O)=O)O)O)=O,2,3,0,3,47,0.000144
G5,C1(COC(CO)C1(C(C=O)O)O)=O,8,2,0,2,27,9.6e-05
G5,C1(COCC(C1(C(C=O)O)O)O)=O,8,2,0,2,27,9.6e-05
G5,C1(C(CO)(C(CO1)O)C(C=O)O)=O,8,2,0,2,8,9.8e-05
G5,C(C1(C(C(CC1)=O)=O)C(C=O)O)=O,4,2,0,2,0,9.6e-05
G5,C(C1(C(CC(C1)=O)=O)C(C=O)O)=O,4,1,0,1,45,4.8e-05
G5,C(C1(C(CCC1=O)=O)C(C=O)O)=O,2,1,0,1,45,4.8e-05
G5,C1(CC=CC(C1(C(C=O)O)O)=O)=O,4,2,0,2,32,9.6e-05
G5,C(CC(C=O)(CO)C(C=O)O)=O,4,5,0,5,0,0.000241
G5,C(C(C(C(C)=O)=O)(C)C(C=O)O)=O,4,1,0,1,45,4.8e-05
G5,C(C(C(C(C(C)=O)=O)(CO)C)O)=O,4,2,0,2,0,9.8e-05
G5,C(C(C(C=O)=O)(C)C(C=O)O)=O,4,1,0,1,49,4.8e-05
G5,C(C(C(C(C=O)=O)(CO)C)O)=O,4,2,0,2,28,9.8e-05
G5,C(C(C)(C(C=O)O)C(C=O)O)=O,3,1,0,1,49,4.8e-05
G5,C(C(C(C(C)=O)(C(C=C)=O)O)O)=O,4,2,0,2,9,9.6e-05
G5,C(C(C1(C(C=CC1=O)=O)CO)O)=O,2,1,0,1,45,4.8e-05
G5,C(C(C=O)(C(C)=O)C(C=O)O)=O,2,1,0,1,6,4.8e-05
G5,C(C(C(C)=O)(C(C)=O)C(C=O)O)=O,2,1,0,1,6,4.8e-05
G5,C(C(C=O)(C(C=O)=O)C(C=O)O)=O,2,1,0,1,23,4.8e-05
G5,C(C)(C(C(C)=O)(CO)C(C=O)O)=O,2,2,0,2,28,9.8e-05
G5,C(C(C=O)(C=O)C(C=O)O)=O,2,1,0,1,1,4.8e-05
G5,C(C(C(C(O)=O)=O)(C)C(C=O)O)=O,4,1,0,1,27,4.8e-05
G5,C(C(C=O)(CC=O)C(C=O)O)=O,2,1,0,1,43,4.8e-05
G5,C(C(C)(C(C(O)=O)O)C(C=O)O)=O,8,2,0,2,49,9.6e-05
G5,C(C(C(C(C(O)=O)=O)(CO)C)O)=O,4,2,0,2,28,9.8e-05
G5,C(C(C(C)=O)(CC=O)C(C=O)O)=O,4,1,0,1,45,4.8e-05
G5,C1(CC(C(C1(C(C=O)O)O)=O)=C)=O,4,2,0,2,47,9.6e-05
G5,C(C(C(CC=C)=O)(C(C=O)O)O)=O,4,2,0,2,4,9.6e-05
G5,C(C1(C(C(C=C1)O)=O)C(C=O)O)=O,8,1,0,1,45,4.8e-05
G5,C(C(C1(C(C)=O)C(C=CO1)=O)O)=O,4,2,0,2,9,9.6e-05
G5,C(C1(C(CC(O1)=C)=O)C(C=O)O)=O,4,2,0,2,26,9.6e-05
G5,C(C1(C(CC=CO1)=O)C(C=O)O)=O,4,2,0,2,37,9.6e-05
G5,C(C(C1(C=CC(C1=O)=O)CO)O)=O,4,1,0,1,45,4.8e-05
G5,C(C(C(CO)=O)(C=C)C(C=O)O)=O,4,1,0,1,45,4.8e-05
G5,C(C(C(C=C)=O)(C(C=O)O)O)=O,4,4,0,4,0,0.00019099999999999998
G5,C(C(C(C=CC)=O)(C(C=O)O)O)=O,8,2,0,2,28,9.6e-05
G5,C(C(C(C(C=CC)=O)(CO)O)O)=O,8,4,0,4,28,0.000195
G5,C(C(CO)(C(C=O)O)O)(CC=C)=O,4,4,0,4,28,0.000195
G5,C(C(C(C=C)(C(C=O)=O)CO)O)=O,4,1,0,1,28,4.8e-05
G5,C(CO)(C(C=C)(CO)C(C=O)O)=O,4,2,0,2,11,9.8e-05
G5,C(C(C=C)(C(C=O)O)C(C=O)O)=O,3,1,0,1,45,4.8e-05
G5,C(C1(C(C=C(C)O1)=O)C(C=O)O)=O,4,2,0,2,26,9.6e-05
G5,C(C(C(C=O)(C(C=C)O)O)O)=O,8,7,0,7,0,0.00034500000000000004
G5,C(C1(COC(C1O)O)C(C=O)O)=O,16,2,0,2,2,9.6e-05
G5,C(C1(C(CC(O1)O)O)C(C=O)O)=O,16,3,0,3,0,0.000144
G5,C1(C(O)OCC1(C(C=O)O)O)=O,8,3,0,3,0,0.000144
G5,C1(COC(C)(C1(C(C=O)O)O)O)=O,8,3,0,3,0,0.000144
G5,C1(COC(C1(C(C=O)O)O)O)=O,8,3,0,3,5,0.000144
G5,C1(C(C(C(O)O1)O)(C(C=O)O)O)=O,16,3,0,3,0,0.000144
G5,C1(C(C(C(O)O1)O)C(C=O)O)=O,16,2,0,2,29,9.6e-05
G5,C1(C(C(OC1C)O)(C(C=O)O)O)=O,16,3,0,3,0,0.000144
G5,C1(C(COC(C1)O)(C(C=O)O)O)=O,8,3,0,3,27,0.000144
G5,C1(C(C(O)OCC1)(C(C=O)O)O)=O,8,3,0,3,27,0.000144
G5,C1(C(C(C)(CO1)O)(C(C=O)O)O)=O,8,2,0,2,27,9.6e-05
G5,C(CC(C=O)(C(C)O)C(C=O)O)=O,8,4,0,4,43,0.000193
G5,C(C(C1(C(C=CC1=O)=O)O)O)=O,2,2,0,2,47,9.6e-05
G5,C(C)(C(CO)(C(C)(C)O)O)=O,2,2,0,2,28,9.6e-05
G5,C(CCC(C(C(C)=O)(CO)O)O)=O,4,3,0,3,27,0.000143
G5,C(C)(C(CO)(C(C(C=C)O)O)O)=O,8,2,0,2,28,9.6e-05
G5,C(C)(C(CO)(C1(C=COC1)O)O)=O,4,2,0,2,28,9.6e-05
G5,C(C)(C(CO)(C(C(CC)=O)O)O)=O,4,2,0,2,28,9.6e-05
G5,C(C(CC)(C(C(C)=O)(CO)O)O)=O,4,2,0,2,28,9.6e-05
G5,C(C)(C(CO)(C(C=C)O)O)=O,4,4,0,4,28,0.00018999999999999998
G5,C(C)(C(CO)(C(C=CC)O)O)=O,8,3,0,3,28,0.000143
G5,C(C)(C(CO)(C(CC=C)O)O)=O,4,3,0,3,28,0.000143
G5,C(C(CO)(CO)C(CCO)O)=O,2,2,0,2,18,9.7e-05
G5,C(C(CO)(CO)C(CC(C)O)O)=O,4,2,0,2,28,9.7e-05
G5,C(C(CO)(C(C)O)C(CCO)O)=O,8,3,0,3,18,0.000146
G5,C(C(CO)(CO)C(C=O)(CO)O)=O,2,3,0,3,2,0.000147
G5,C(C(CO)(CO)C(CC=O)O)=O,2,2,0,2,18,9.7e-05
G5,C(C(C=O)(CO)C(CCO)O)=O,2,2,0,2,18,9.7e-05
G5,C(C(CO)(CO)C(C(O)=O)(C)O)=O,2,2,0,2,28,9.7e-05
G5,C(C(C=O)(CO)CO)(O)=O,1,2,0,2,18,9.8e-05
G5,C(C(CO)(CO)C(C(C)=O)(C)O)=O,2,2,0,2,14,9.7e-05
G5,C(C(CO)(CO)C(C)(CC=O)O)=O,2,2,0,2,6,9.7e-05
G5,C(C(CO)(CO)C(CC(C)=O)O)=O,2,2,0,2,18,9.7e-05
G5,C(C(C(C)=O)(CO)C(CCO)O)=O,4,2,0,2,18,9.7e-05
G5,C(C(CO)(CO)C(C(C=C)=O)O)=O,2,2,0,2,7,9.7e-05
G5,C(C(C=C)(C(C=O)(CO)CO)O)=O,2,2,0,2,7,9.7e-05
G5,C(C(CO)(CO)C(C=C)(CO)O)=O,2,2,0,2,7,9.7e-05
G5,C=CC(C(CO)(C(CCO)O)O)=O,4,4,0,4,7,0.000195
G5,C(C(CO)(CO)C(C=CC=O)O)=O,4,2,0,2,43,9.7e-05
G5,C(C(CO)(CO)C(C(C)O)O)=O,4,2,0,2,11,9.7e-05
G5,C(C(C=O)(CO)C(C)(CO)O)(O)=O,4,3,0,3,49,0.000146
G5,C(C(CO)(C(CC=O)O)C(C)O)=O,8,3,0,3,4,0.000146
G5,C(C(C=O)(CO)C(CC(C)O)O)=O,4,2,0,2,28,9.7e-05
G5,C(C(C=O)(CO)C(C)O)(O)=O,4,3,0,3,4,0.000146
G5,C(C(CO)(C(C)O)C(C(C)O)O)=O,16,3,0,3,11,0.000146
G5,C(C(C=O)(CO)C(C=O)(CO)O)=O,2,2,0,2,5,9.7e-05
G5,C(C(C=O)(CO)C(C(CO)=O)O)=O,2,2,0,2,5,9.7e-05
G5,C(C(C=O)(CO)C(CC=O)O)=O,2,2,0,2,45,9.7e-05
G5,C(C(C=O)(CO)C(C(O)=O)(C)O)=O,2,2,0,2,28,9.7e-05
G5,C(C(C=O)(C=O)CO)(O)=O,1,2,0,2,17,9.8e-05
G5,C(C(C=O)(CO)C(C(O)=O)O)=O,2,2,0,2,33,9.7e-05
G5,C(C(C=O)(CO)C(C(C)=O)(C)O)=O,2,2,0,2,14,9.7e-05
G5,C(C(C=O)(CO)C(C)(CC=O)O)=O,2,2,0,2,6,9.7e-05
G5,C(C(C=O)(CO)C(CC(C)=O)O)=O,2,2,0,2,45,9.7e-05
G5,C(CC(C(C=O)(C(C)=O)CO)O)=O,4,2,0,2,6,9.7e-05
G5,C(C(C=O)(CO)C(C(C=C)=O)O)=O,2,2,0,2,7,9.7e-05
G5,C(C(C=O)(CO)C(C=O)(C=C)O)=O,2,2,0,2,7,9.7e-05
G5,C(C(C=O)(CO)C(C=C)(CO)O)=O,2,2,0,2,7,9.7e-05
G5,C(C(C=O)(CO)C(C=CC=O)O)=O,4,2,0,2,43,9.7e-05
G5,C(C(C=O)(CO)C(C(C)O)O)=O,4,2,0,2,11,9.7e-05
G5,C(C(C(C(C=O)O)=O)(CO)O)(O)=O,4,4,0,4,17,0.000195
G5,C(C(C=O)(C(C=O)=O)CO)(O)=O,2,2,0,2,17,9.8e-05
G5,C(C(C=O)(C(C)=O)CO)(O)=O,2,2,0,2,17,9.8e-05
G5,C(C1(C(COC1O)=O)CO)(O)=O,4,3,0,3,2,0.000145
G5,C(C1(C(CC(O1)O)=O)CO)(O)=O,4,5,0,5,17,0.00024300000000000002
G5,C(C1(C(C(CO1)O)=O)CO)(O)=O,4,4,0,4,17,0.000195
G5,C(C1(C(C(O)OC1)=O)CO)(O)=O,4,3,0,3,17,0.000145
G5,C(C)(C(C=O)(CO)C(C(O)=O)O)=O,4,2,0,2,33,9.7e-05
G5,C(C(C(C)=O)(CO)C(C(C)O)O)=O,8,2,0,2,11,9.7e-05
G5,C=CC(C(CO)(C(C(C)O)O)O)=O,8,4,0,4,11,0.000195
G5,C(C(C(C(CO)(CO)CO)=O)O)=O,2,1,0,1,2,4.9e-05
G5,C(C(CO)(CO)CO)=O,1,1,0,1,18,4.9e-05
G5,C(C(CO)(CO)C(C(C=O)O)O)=O,4,2,0,2,18,9.7e-05
G5,C(C(CO)(CO)C(C)(CO)O)=O,2,2,0,2,49,9.7e-05
G5,C(C(CO)(CO)C(C)O)=O,2,2,0,2,18,9.8e-05
G5,C(C(C=O)(CO)CO)=O,1,1,0,1,18,4.9e-05
G5,C(C(C(C=O)=O)(CO)CO)=O,1,1,0,1,2,4.9e-05
G5,C(C(C(C)=O)(CO)CO)=O,1,1,0,1,6,4.9e-05
G5,C1(COC(C1(CO)CO)O)=O,2,2,0,2,2,9.7e-05
G5,C1(CC(OC1(CO)CO)O)=O,2,3,0,3,27,0.000146
G5,C1(COC(C(C1(CO)CO)O)O)=O,4,2,0,2,2,9.7e-05
G5,C(C(C=CC(C=O)=O)(CO)CO)=O,2,1,0,1,2,4.9e-05
G5,C(C(C(C=CC=O)=O)(CO)CO)=O,2,1,0,1,2,4.9e-05
G5,C=CC(C(C(C=O)=O)(CO)CO)=O,1,1,0,1,2,4.9e-05
G5,C(C(C(C(C=C)=O)=O)(CO)CO)=O,1,1,0,1,2,4.9e-05
G5,C(C(C(C=O)=O)(CO)CO)=CC=O,2,1,0,1,29,4.9e-05
G5,C1(C(COC1(CO)CO)O)=O,2,2,0,2,27,9.9e-05
G5,C1(C(O)OCC1(CO)CO)=O,2,2,0,2,2,9.7e-05
G5,C(C(C=O)(CO)C(C(C=O)O)O)=O,4,2,0,2,1,9.7e-05
G5,C(C(CO)(C(C)O)C(C)(CO)O)=O,8,3,0,3,49,0.000146
G5,C(C(C=O)(CO)C(C)(CO)O)=O,2,2,0,2,49,9.7e-05
G5,C(C(C(C)=O)(CO)C(C)(CO)O)=O,4,2,0,2,49,9.7e-05
G5,C=CC(C(CO)(C(CO)(C)O)O)=O,4,4,0,4,7,0.000195
G5,C(C(CO)(C(C)O)C(C)O)=O,3,2,0,2,4,9.8e-05
G5,C(C(C=O)(CO)C(C)O)=O,2,2,0,2,4,9.8e-05
G5,C(C(C(C=O)=O)(CO)C(C)O)=O,4,2,0,2,4,9.8e-05
G5,C(C(C(C)=O)(CO)C(C)O)=O,4,2,0,2,4,9.8e-05
G5,C1(COC(C1(CO)C(C)O)O)=O,8,3,0,3,4,0.000146
G5,C1(CC(OC1(CO)C(C)O)O)=O,8,5,0,5,4,0.000244
G5,C=CC(C(CO)(C(C)O)O)=O,4,5,0,5,4,0.000244
G5,C1(C(COC1(CO)C(C)O)O)=O,8,4,0,4,4,0.000196
G5,C1(C(O)OCC1(CO)C(C)O)=O,8,3,0,3,4,0.000146
G5,C(C(CO)(C(CCC=O)O)O)(O)=O,4,5,0,5,33,0.000242
G5,C(C(CO)(C1CC(CO1)O)O)(O)=O,8,2,0,2,39,9.9e-05
G5,C1(C(C(CC(C1(CO)O)O)O)=O)=O,8,2,0,2,43,9.9e-05
G5,C(C(C1(CO)C(CC(O1)O)O)=O)=O,8,3,0,3,5,0.000146
G5,C(C(C=O)(C(CO)=O)CO)=O,1,1,0,1,1,4.9e-05
G5,C(C(CO)(C(CO)OCC=O)O)=O,4,2,0,2,26,9.9e-05
G5,C(C(CO)(C(COCC=O)O)O)=O,4,2,0,2,37,9.9e-05
G5,C(C(CO)(CO)OC(C(C)=O)=O)=O,1,2,0,2,50,9.9e-05
G5,C(C(CO)(COC(C(C)=O)=O)O)=O,2,2,0,2,27,9.9e-05
G5,C(C(C(OCC=O)=C)(CO)O)=O,2,3,0,3,26,0.000146
G5,C(C(C(C(CO)(CO)O)=O)(C)O)=O,2,2,0,2,2,9.9e-05
G5,C(C(CO)(CO)O)(C(CO)(C)O)=O,2,3,0,3,2,0.000148
G5,C(C(C(C(CCO)=O)=O)(CO)O)=O,2,4,0,4,2,0.000205
G5,C(C(CO)(COC(C=O)CO)O)=O,4,2,0,2,2,9.9e-05
G5,C(OC(C(C(C)O)=O)(CO)CO)=O,2,2,0,2,2,9.9e-05
G5,C(OCC(C(C(C)O)=O)(CO)O)=O,4,2,0,2,2,9.9e-05
G5,C1(C(CO)(C(CC(CO)O1)O)O)=O,8,3,0,3,19,0.000157
G5,C1(C(CO)(C(CC(CO1)O)O)O)=O,8,3,0,3,19,0.000157
G5,C1(C(O)OCCC(C1(CO)O)O)=O,8,4,0,4,18,0.000205
G5,C=CC(C(C(CO)(CO)O)=O)=O,1,4,0,4,2,0.000205
G5,C=CC(C(C(C=O)=O)(CO)O)O,4,7,0,7,27,0.000348
G5,C1(C(CO)(COC1C(C)=O)O)=O,4,3,0,3,4,0.000146
G5,C1(C(CCOCC1(CO)O)=O)=O,2,3,0,3,36,0.000146
G5,C(C1C(C(CO)(C(C)O1)O)=O)=O,8,2,0,2,17,9.9e-05
G5,C1(CC(C(C(CO)(CO)O1)=O)O)=O,2,2,0,2,2,9.9e-05
G5,C1(CC(C(C(CO)(CO1)O)=O)O)=O,4,2,0,2,2,9.9e-05
G5,C(CO)(C(CO)(C(C=C)O)O)=O,4,6,0,6,27,0.00028900000000000003
G5,C1(C(CO)(CO)OC=CC1O)=O,2,3,0,3,2,0.000146
G5,C1(C(CO)(COC=CC1O)O)=O,4,3,0,3,38,0.000146
G5,C(CO)(C1(CO)C(C=CO1)O)=O,4,3,0,3,38,0.000146
G5,C1(C(CCO)(O)OCC1(CO)O)=O,4,4,0,4,2,0.000205
G5,C1(C(O)OC(CCO)C1(CO)O)=O,8,3,0,3,18,0.000146
G5,C1(C(C(C)(O)OCC1(CO)O)O)=O,8,4,0,4,2,0.000205
G5,C1(C(C(O)OC(C)C1(CO)O)O)=O,16,3,0,3,2,0.000146
G5,C1(CC(C(C(CO)=O)(CO)O1)O)=O,4,2,0,2,2,9.9e-05
G5,C1(C(CO)(C(C(C1)=O)(CO)O)O)=O,3,2,0,2,2,9.9e-05
G5,C1(C(C(O)=O)(CO)C(CO1)O)=O,4,2,0,2,17,9.8e-05
G5,C1(C(CO)(CO)C(CO1)O)=O,2,1,0,1,27,4.9e-05
G5,C1(C(CO)(C(C)O)C(CO1)O)=O,8,2,0,2,4,9.8e-05
G5,C(C(C(C(CO)(C)O)=O)(CO)O)=O,4,3,0,3,2,0.000148
G5,C(C)(C(C=O)(CO)OC(CO)=O)=O,2,3,0,3,2,0.000146
G5,C1(C(C(C(C1(CO)C)O)O)=O)=O,8,1,0,1,42,4.9e-05
G5,C1(C(C)C(C(C1(CO)O)=O)O)=O,8,3,0,3,42,0.000146
G5,C1(C(CO)(C)C(C(C1O)=O)O)=O,8,1,0,1,42,4.9e-05
G5,C(C1(C(C(CC1)=O)=O)CO)=O,2,2,0,2,2,9.7e-05
G5,C(C1(C(CC(C1)=O)=O)CO)=O,2,3,0,3,29,0.000144
G5,C(C1(C(CCC1=O)=O)CO)=O,1,2,0,2,2,9.7e-05
G5,C1(CC=CC(C1(CO)O)=O)=O,2,4,0,4,32,0.000194
G5,C(C(CO)=O)(C(CO)(CO)CO)=O,1,1,0,1,2,4.9e-05
G5,C(C(C(C(CO)=O)=O)(CO)C)=O,2,1,0,1,42,4.9e-05
G5,C(C(CO)(CO)CC(C=O)=O)=O,1,1,0,1,55,4.9e-05
G5,C(C(CO)=O)(C(CO)(CO)C)=O,1,1,0,1,42,4.9e-05
G5,C(C(CO)(C)C(C(CO)=O)O)=O,4,1,0,1,49,4.9e-05
G5,C(C(CO)(CO)CC(CO)=O)=O,1,2,0,2,46,9.7e-05
G5,C(C(C)=O)(C(CO)(CO)CO)=O,1,1,0,1,2,4.9e-05
G5,C(C(CO)(CO)CC=O)=O,1,2,0,2,18,9.7e-05
G5,C(C(C(C(CC=O)=O)=O)(C)CO)=O,2,1,0,1,42,4.9e-05
G5,C(C(C(C(CCO)=O)=O)(C)CO)=O,2,1,0,1,29,4.9e-05
G5,C(C(C(C(C)=O)=O)(C)CO)=O,2,1,0,1,45,4.9e-05
G5,C(C(C)C(C=O)(C(CO)=O)CO)=O,4,2,0,2,49,9.7e-05
G5,C(CC(C(C(C)(CO)CO)=O)=O)=O,1,1,0,1,42,4.9e-05
G5,C(C(CO)(C)C(C(CC=O)=O)O)=O,4,1,0,1,49,4.9e-05
G5,C(CC(C(C(C)=O)=O)(CO)CO)=O,1,2,0,2,55,9.7e-05
G5,C(C(C)CC(C(C=O)(CO)O)=O)=O,4,2,0,2,49,9.9e-05
G5,C(CC(C)=O)(C(C(C)=O)(CO)O)=O,2,3,0,3,49,0.000157
G5,C(CC(C(C(CO)(CO)O)=O)=O)=O,1,2,0,2,2,9.9e-05
G5,C(C(C)CC(C(CO)(CO)O)=O)=O,2,2,0,2,28,9.9e-05
G5,C(CO)(C(CO)(C)C(C(C)=O)O)=O,4,1,0,1,2,4.9e-05
G5,C(C(C)C(C(C=O)=O)(CO)CO)=O,2,2,0,2,29,9.7e-05
G5,C(C(C(C(C)=O)=O)(CO)CCO)=O,2,1,0,1,29,4.9e-05
G5,C(C(CCO)=O)(C(C)(CO)CO)=O,1,1,0,1,2,4.9e-05
G5,C(C(CO)(C)C(C(CCO)=O)O)=O,4,1,0,1,3,4.9e-05
G5,C(C(C)C(C(CO)=O)(CO)CO)=O,2,2,0,2,3,9.7e-05
G5,C(C(CO)(CCO)C(C(C)=O)O)=O,4,1,0,1,3,4.9e-05
G5,C(C(C)=O)(C(CO)(CO)CCO)=O,1,1,0,1,29,4.9e-05
G5,C(C(C)CC=O)(C(C=O)(CO)O)=O,4,2,0,2,16,9.9e-05
G5,C(C(C)=O)(C(C)(CO)CO)=O,1,1,0,1,27,4.9e-05
G5,C(C(CO)(C)C(C(C)=O)O)=O,4,1,0,1,27,4.9e-05
G5,C(C(C)C(C=O)(CO)C(C=O)O)=O,8,2,0,2,49,9.7e-05
G5,C(CO)(C(CO)(CO)CC=O)=O,1,3,0,3,2,0.000145
G5,C(C(CC)=O)(C(CO)(CO)O)=O,1,3,0,3,42,0.000146
G5,C(C(C(C=O)=O)(C)CO)=O,2,1,0,1,49,4.9e-05
G5,C(CC(C(C=O)=O)(CO)CO)=O,1,3,0,3,0,0.000145
G5,C(C)(C(C=O)(C(CO)=O)CO)=O,2,2,0,2,0,9.7e-05
G5,C(CO)(C(C=O)(CO)CC=O)=O,2,3,0,3,0,0.000145
G5,C(CO)(C(CO)(C)C(C=O)O)=O,4,1,0,1,28,4.9e-05
G5,C(C(C(C=O)=O)(CO)CCO)=O,2,1,0,1,29,4.9e-05
G5,C(C(C(CO)(CO)CCO)=O)=O,1,1,0,1,55,4.9e-05
G5,C(C(CO)(CCO)C(C=O)O)=O,4,1,0,1,3,4.9e-05
G5,C(C)(C(C(CO)=O)(CO)CO)=O,1,2,0,2,2,9.7e-05
G5,C(C(C(C)(CO)CO)=O)=O,1,1,0,1,28,4.9e-05
G5,C(C(CO)(C)C(C=O)O)=O,4,1,0,1,49,4.9e-05
G5,C(C(C=O)(CO)CC(CO)O)(O)=O,4,1,0,1,29,4.9e-05
G5,C(C(C(C(CC)=O)=O)(CO)O)=O,2,3,0,3,42,0.000146
G5,C(C)(C(C(C=C)=O)(CO)O)=O,2,5,0,5,9,0.000241
G5,C(C)(C1(CO)C(CC(O1)O)O)=O,8,3,0,3,45,0.000146
G5,C1(C=CC(C1(CO)CO)=O)=O,1,2,0,2,2,9.7e-05
G5,C(C(C=O)C(C(CO)(CO)O)=O)=O,1,2,0,2,2,9.9e-05
G5,C(C(C=O)(C(C(CO)O)=O)CO)=O,2,1,0,1,2,4.9e-05
G5,C(C(C(C(C=O)O)=O)(CO)CO)=O,2,1,0,1,2,4.9e-05
G5,C(C(CO)(C)C(C=O)(CO)O)=O,4,1,0,1,49,4.9e-05
G5,C(C(C(C)=O)(C(C(C)=O)=O)CO)=O,2,1,0,1,29,4.9e-05
G5,C(C)(C(C(C(C)=O)=O)(CO)CO)=O,1,1,0,1,2,4.9e-05
G5,C(C(C=O)(C(C(C)=O)=O)CO)=O,1,1,0,1,14,4.9e-05
G5,C(C(C(C)=O)(C(C=O)=O)CO)=O,2,1,0,1,23,4.9e-05
G5,C(C(C=O)(C(C)=O)CO)=O,1,1,0,1,6,4.9e-05
G5,C(C(CO)(C)C(C=O)(C(C)=O)O)=O,4,1,0,1,29,4.9e-05
G5,C(C(C(C)=O)(C(C)=O)CO)=O,1,1,0,1,6,4.9e-05
G5,C(C(C=O)(C(C=O)=O)CO)=O,1,1,0,1,23,4.9e-05
G5,C(C(CO)(C)C(C(C)=O)(CO)O)=O,4,1,0,1,29,4.9e-05
G5,C(C)(C(C(C)=O)(CO)CO)=O,1,1,0,1,28,4.9e-05
G5,C(C(C=O)(C=O)CO)=O,1,1,0,1,1,4.9e-05
G5,C(C(C(CC=O)=O)(C(C)=O)CO)=O,2,1,0,1,1,4.9e-05
G5,C(C(C=O)(C(CC(C)=O)=O)CO)=O,1,1,0,1,1,4.9e-05
G5,C(C(C=O)(C(CCC=O)=O)CO)=O,1,1,0,1,29,4.9e-05
G5,C(C(C=O)(C(C=CCO)=O)CO)=O,2,1,0,1,29,4.9e-05
G5,C(C(C(C=C)=O)(CO)C(C=O)O)=O,4,1,0,1,7,4.9e-05
G5,C(C(C=O)C(C(C=O)(CO)O)=O)=O,2,2,0,2,1,9.9e-05
G5,C(C(C=O)(C(C(C=O)O)=O)CO)=O,2,1,0,1,1,4.9e-05
G5,C(C(C=O)(C(C=O)(CO)C)O)=O,2,1,0,1,49,4.9e-05
G5,C(C(C(C)=O)(CO)C(CO)O)(O)=O,4,1,0,1,0,4.9e-05
G5,C(C1(C(C(C(C1)O)O)=O)CO)=O,8,1,0,1,41,4.9e-05
G5,C1(C(CO)(C(C(C1C)=O)O)O)=O,8,4,0,4,42,0.000194
G5,C1(C(C(C(C1(CO)C)=O)O)O)=O,3,1,0,1,42,4.9e-05
G5,C1(C(C)(CC(C1(CO)O)=O)O)=O,4,3,0,3,25,0.000146
G5,C(C(C(C(C)=O)=O)(CO)CC=O)=O,2,1,0,1,29,4.9e-05
G5,C(C(C(C(O)=O)=O)(C)CO)=O,2,1,0,1,27,4.9e-05
G5,C(CC(C=O)(CO)C(C(O)=O)O)=O,4,3,0,3,33,0.000145
G5,C(CC(C(C(O)=O)=O)(CO)CO)=O,1,1,0,1,29,4.9e-05
G5,C(C(C(C(C=O)=O)(CO)C)O)(O)=O,4,2,0,2,28,9.7e-05
G5,C(C(C(C=O)=O)(CO)CC=O)=O,2,1,0,1,33,4.9e-05
G5,C(CO)(C(CO)(C)C(C(O)=O)O)=O,4,1,0,1,28,4.9e-05
G5,C(C)(C(C=O)(CO)CC(CO)=O)=O,2,1,0,1,41,4.9e-05
G5,C(C(C=O)(CO)CC=O)=O,1,1,0,1,43,4.9e-05
G5,C(C)(C(C=O)(CO)CC(C=O)=O)=O,2,1,0,1,29,4.9e-05
G5,C(C(C(CC=O)=O)(CO)CC=O)=O,2,1,0,1,2,4.9e-05
G5,C(C(C=O)(CO)CC(C(C)=O)=O)=O,1,1,0,1,14,4.9e-05
G5,C(C(C=O)(CO)CC(CC=O)=O)=O,1,1,0,1,2,4.9e-05
G5,C(C(C=O)(C=CC(CO)=O)CO)=O,2,1,0,1,43,4.9e-05
G5,C(C(C(C(O)=O)=O)(CO)CCO)=O,2,1,0,1,29,4.9e-05
G5,C(C(CO)(CCO)C(C(O)=O)O)=O,4,1,0,1,29,4.9e-05
G5,C(C(C(CO)(CO)CCO)=O)(O)=O,1,1,0,1,29,4.9e-05
G5,C(CC(C=O)(C(C=O)(CO)C)O)=O,4,1,0,1,49,4.9e-05
G5,C(C(CO)(C)C(C(O)=O)O)=O,4,1,0,1,49,4.9e-05
G5,C(C(C(C)(CO)CO)=O)(O)=O,1,1,0,1,28,4.9e-05
G5,C(C)(C(C=O)(CO)CC=O)=O,2,1,0,1,45,4.9e-05
G5,C(C1(C(CC(CO)O1)=O)CO)=O,4,3,0,3,26,0.000146
G5,C1(CC(C=O)OC1(CO)CO)=O,2,3,0,3,2,0.000146
G5,C(C1(C(CC(CO1)O)=O)CO)=O,4,3,0,3,37,0.000146
G5,C1(CC(C=O)OCC1(CO)O)=O,4,3,0,3,37,0.000146
G5,C(C1(CO)C(C(CCO1)=O)O)=O,4,3,0,3,37,0.000146
G5,C1(C(CO)(C(C=O)OCC1)O)=O,4,3,0,3,37,0.000146
G5,C(C1(CO)C(CC(CO1)=O)O)=O,4,4,0,4,37,0.000194
G5,C1(C(CCOC1(CO)CO)=O)=O,1,3,0,3,2,0.000146
G5,C1(CC(OC1(C(C)=O)CO)=O)=O,2,5,0,5,27,0.000241
G5,C1(CC(C(C1(CO)O)=O)=C)=O,2,4,0,4,47,0.000194
G5,C(C(C(CC=C)=O)(CO)O)=O,2,5,0,5,4,0.000241
G5,C(C1(C(C(C=C1)O)=O)CO)=O,4,2,0,2,2,9.7e-05
G5,C(C)(C1(C(C=CO1)=O)CO)=O,2,4,0,4,9,0.000194
G5,C(C1(C(CC(O1)=C)=O)CO)=O,2,4,0,4,26,0.000194
G5,C(C1(C(CC=CO1)=O)CO)=O,2,4,0,4,37,0.000194
G5,C1(C2CC(C(C1(CO)O)O2)O)=O,16,2,0,2,9,9.9e-05
G5,C1(CC2C(C1(CO)OC2O)O)=O,16,5,0,5,2,0.000241
G5,C(C1C(C(C(O1)O)=O)(CO)O)(C)=O,8,3,0,3,1,0.000146
G5,C(C)(C1(CO)C(C(C(O1)O)=O)O)=O,8,3,0,3,1,0.000146
G5,C(CC1C(C(C(O)O1)=O)(CO)O)=O,8,3,0,3,5,0.000146
G5,C(C1(C(C(C(CO)O1)O)=O)CO)=O,8,2,0,2,2,9.9e-05
G5,C(C1C(C(CO)(C(CO)O1)O)=O)=O,8,2,0,2,2,9.9e-05
G5,C1(CC(C=O)(OC1(CO)CO)O)=O,2,3,0,3,2,0.000146
G5,C(C(C1(CO)C(CCO1)O)=O)=O,4,2,0,2,39,9.9e-05
G5,C(C(CO)(C1C(CCO1)=O)O)=O,4,3,0,3,4,0.000146
G5,C1(C(CO)(C(C=O)O)OCC1)=O,4,2,0,2,4,9.9e-05
G5,C(C(CO)(C1CC(CO1)=O)O)=O,4,3,0,3,4,0.000146
G5,C(C(CO)(C1CCC(O1)=O)O)=O,4,3,0,3,32,0.000146
G5,C1(C(C(C(CCO)O1)=O)(CO)O)=O,4,2,0,2,2,9.9e-05
G5,C1(C2C(CO)OC1(CO)CO2)=O,8,2,0,2,17,9.9e-05
G5,C1(C2COC1(CO)C(CO)O2)=O,8,2,0,2,17,9.9e-05
G5,C1(C(CO)C2C(CC(O)O2)O1)=O,16,3,0,3,43,0.000144
G5,C1(COC2CC(OC12CO)O)=O,8,3,0,3,9,0.000146
G5,C1(C2CC(OC1(CO)CO2)O)=O,8,3,0,3,9,0.000146
G5,C1(C(CO)C2(CC(CO2)O1)O)=O,8,3,0,3,19,0.000144
G5,C1(C(C2COCC1(CO)O2)O)=O,8,2,0,2,4,9.9e-05
G5,C1(C2COCC(C1(CO)O)O2)=O,8,2,0,2,4,9.9e-05
G5,C1(CC2(COCC1(CO)O2)O)=O,4,3,0,3,36,0.000146
G5,C1(C2CCOC(C1(CO)O)O2)=O,8,2,0,2,4,9.9e-05
G5,C1(C(CO)(CO)OC(C(C1)=O)O)=O,2,3,0,3,2,0.000146
G5,C(C1(C(C(C(CO1)O)O)=O)CO)=O,8,2,0,2,2,9.9e-05
G5,C(C1C(C(CO)(C(CO1)O)O)=O)=O,8,2,0,2,2,9.9e-05
G5,C1(CC(C=O)(O)OCC1(CO)O)=O,4,3,0,3,2,0.000146
G5,C1(C(CO)(C(C=O)(O)OCC1)O)=O,4,3,0,3,2,0.000146
G5,C(C1(CO)C(CCC(O1)=O)O)=O,4,3,0,3,37,0.000146
G5,C1(C(CO)C(CC(C=O)O1)O)=O,8,2,0,2,43,9.7e-05
G5,C1(C(C)OCC(C1(CO)O)=O)=O,4,4,0,4,24,0.000194
G5,C1(C(CO)C(C(C(C)O1)=O)O)=O,8,2,0,2,25,9.7e-05
G5,C1(CCOC(C)(C1(CO)O)O)=O,4,4,0,4,9,0.000194
G5,C1(C(C)OCC(C1(CO)O)O)=O,8,3,0,3,4,0.000146
G5,C1(C(CO)(C(CC(C=O)O1)O)O)=O,8,2,0,2,27,9.9e-05
G5,C1(CC(C(CO)(C(C)(O)O1)O)=O)=O,4,3,0,3,17,0.000146
G5,C1(C(C(CC(C)(O)O1)=O)(CO)O)=O,4,3,0,3,14,0.000146
G5,C1(C(CO)(C(C(C(C)O1)=O)O)O)=O,8,2,0,2,2,9.9e-05
G5,C1(C(CO)(C(C(OC1C)=O)O)O)=O,8,2,0,2,2,9.9e-05
G5,C1(C2C(COC1(CO)CO2)O)=O,8,2,0,2,17,9.9e-05
G5,C1(C2COC1(CO)C(CO2)O)=O,8,2,0,2,17,9.9e-05
G5,C1(C(C2COC1(CO)CO2)O)=O,8,2,0,2,4,9.9e-05
G5,C1(C2COC(CO2)C1(CO)O)=O,8,2,0,2,4,9.9e-05
G5,C1(CC2(COC1(CO)CO2)O)=O,4,3,0,3,54,0.000146
G5,C1(C(CO)(COC(C(C1)=O)O)O)=O,4,3,0,3,2,0.000146
G5,C1(CCOC(C(C1(CO)O)=O)O)=O,4,3,0,3,2,0.000146
G5,C1(C(CO)C(C(CCO1)O)O)=O,8,2,0,2,29,9.7e-05
G5,C1(COCCC(C1(CO)O)O)=O,4,2,0,2,4,9.9e-05
G5,C1(CCCOC(C1(CO)O)O)=O,4,4,0,4,29,0.000194
G5,C1(C(C(CCC(O)O1)=O)(CO)O)=O,4,3,0,3,17,0.000146
G5,C1(C(CO)C(C(CC(O1)=O)O)O)=O,8,1,0,1,29,4.9e-05
G5,C1(CC(C(C(CO1)=O)(CO)O)O)=O,4,2,0,2,2,9.9e-05
G5,C1(C(CO)C(C(C(CO1)=O)O)O)=O,8,1,0,1,2,4.9e-05
G5,C1(C(CO)C(CC(C(O)O1)=O)O)=O,8,2,0,2,28,9.7e-05
G5,C1(C(CO)C(C(CC(O)O1)=O)O)=O,8,2,0,2,29,9.7e-05
G5,C1(CCC(OC(C1(CO)O)O)=O)=O,4,3,0,3,29,0.000146
G5,C1(C(CO)C2C(CC(O2)O1)O)=O,16,2,0,2,2,9.7e-05
G5,C1(COC2CC(C1(CO)O2)O)=O,8,2,0,2,17,9.9e-05
G5,C(C1(C(CCC(O1)=O)=O)CO)=O,2,4,0,4,27,0.000194
G5,C1C(C(C(C=1)=O)=O)(CO)CO,1,2,0,2,2,9.7e-05
G5,C(C(C(CO)=O)(C(C=O)=C)CO)=O,2,1,0,1,55,4.9e-05
G5,C(C(C(C=CC(C)=O)=O)(CO)O)=O,4,2,0,2,29,9.9e-05
G5,C(C(C(CC(C=O)=C)=O)(CO)O)=O,2,2,0,2,16,9.9e-05
G5,C(C(C(C=C(C=O)C)=O)(CO)O)=O,4,2,0,2,16,9.9e-05
G5,C(C=CC(C)=O)(C(CO)(CO)O)=O,2,2,0,2,45,9.9e-05
G5,C(C(CO)(CO)O)(CC(C=O)=C)=O,1,3,0,3,16,0.000146
G5,C(C=C(C=O)C)(C(CO)(CO)O)=O,2,2,0,2,16,9.9e-05
G5,C=C(C=O)C(C(C=O)=O)(CO)CO,1,1,0,1,29,4.9e-05
G5,C(CO)(C(C(C=O)=C)(CO)CO)=O,1,1,0,1,55,4.9e-05
G5,C(C(C(C=O)=C)(CO)C(C=O)O)=O,4,1,0,1,45,4.9e-05
G5,C(C(C(CO)=O)(C(CO)=C)CO)=O,2,1,0,1,49,4.9e-05
G5,C(C(C(CO)=O)(C=C)CO)=O,2,2,0,2,4,9.7e-05
G5,C(C(C(C=CC=O)=O)(CO)O)=O,4,3,0,3,46,0.000146
G5,C(C(C(C=C(CO)C)=O)(CO)O)=O,4,2,0,2,49,9.9e-05
G5,C(C(C(CC(CO)=C)=O)(CO)O)=O,2,2,0,2,49,9.9e-05
G5,C(C(C(C=CC)=O)(CO)O)=O,4,3,0,3,28,0.000146
G5,C(CO)(C)=CC(C(CO)(CO)O)=O,2,2,0,2,49,9.9e-05
G5,C(C(CO)(CO)O)(CC(CO)=C)=O,1,2,0,2,49,9.9e-05
G5,C(C)=CC(C(CO)(CO)O)=O,2,3,0,3,28,0.000146
G5,C(C(CO)(CO)O)(CC=C)=O,1,3,0,3,28,0.000146
G5,C(C)(C(C(C(C=O)=C)=O)(CO)O)=O,2,2,0,2,9,9.9e-05
G5,C(CC=O)(C(C(C=C)=O)(CO)O)=O,2,2,0,2,9,9.9e-05
G5,C(C(C(C(C(C)=O)=C)=O)(CO)O)=O,2,2,0,2,29,9.9e-05
G5,C(C(C(CC(C=C)=O)=O)(CO)O)=O,2,2,0,2,2,9.9e-05
G5,C(C(C(C(CC=O)=C)=O)(CO)O)=O,2,2,0,2,29,9.9e-05
G5,C=C(CO)C(C(C=O)=O)(CO)CO,1,1,0,1,29,4.9e-05
G5,C=CC(C(C=O)=O)(CO)CO,1,2,0,2,4,9.7e-05
G5,C(CO)(C(C(CO)=C)(CO)CO)=O,1,1,0,1,29,4.9e-05
G5,C(CO)(C(C=C)(CO)CO)=O,1,2,0,2,4,9.7e-05
G5,C(C(C(CO)=C)(CO)C(C=O)O)=O,4,1,0,1,49,4.9e-05
G5,C(C(C=C)(CO)C(C=O)O)=O,4,2,0,2,4,9.7e-05
G5,C(C(CO)(C(C(C)=O)(C=C)O)O)=O,4,3,0,3,0,0.000147
G5,C1(CO)OC(C(C=1)=O)(CO)CO,1,3,0,3,2,0.000146
G5,C(C1(C(C=C(C)O1)=O)CO)=O,2,3,0,3,26,0.000146
G5,C1(CO)OCC(C(C=1)=O)(CO)O,2,3,0,3,32,0.000146
G5,C1(C=CC(C(CO)(CO)O1)=O)=O,1,3,0,3,2,0.000146
G5,C1(C(C(C=CCO1)=O)(CO)O)=O,2,3,0,3,2,0.000146
G5,C1(C=CC(C(CO)(CO1)O)=O)=O,2,3,0,3,46,0.000146
G5,C1(COC(C1(CO)O)=CCO)=O,4,3,0,3,2,0.000146
G5,C1(COC(C=C)(C1(CO)O)O)=O,4,4,0,4,32,0.000194
G5,C1(C(C(OC1C=C)O)(CO)O)=O,8,4,0,4,2,0.000194
G5,C1(C(CO)(C(C(O1)=CCO)O)O)=O,8,2,0,2,2,9.9e-05
G5,C1(C(CO)(C(C(C=C)(O)O1)O)O)=O,8,3,0,3,2,0.000146
G5,C1(COC(C(C1(CO)O)O)=C)=O,4,3,0,3,24,0.000146
G5,C1(C(CO)(C(C=C(CO)O1)O)O)=O,4,2,0,2,17,9.9e-05
G5,C1(C(CO)(C(C(C(O1)=C)O)O)O)=O,8,2,0,2,14,9.9e-05
G5,C1(COC=CC(C1(CO)O)O)=O,4,3,0,3,38,0.000146
G5,C1(C(CO)(C(C=CC(O)O1)O)O)=O,8,2,0,2,43,9.9e-05
G5,C1(C(CO)(C(C(C=CO1)O)O)O)=O,8,2,0,2,43,9.9e-05
G5,C(C(CO)(C1C=CC(O1)=O)O)=O,4,3,0,3,8,0.000146
G5,C(C1(CO)C(C=CC(O1)=O)O)=O,4,3,0,3,8,0.000146
G5,C(C(CO)(C1C(C(CO1)O)O)O)=O,16,5,0,5,36,0.00027400000000000005
G5,C(C(CO)(C1CC(C(O)O1)=O)O)=O,8,3,0,3,15,0.000146
G5,C(C1(CO)C(CC(C=O)(O1)O)O)=O,8,3,0,3,15,0.000146
G5,C(C1(CO)C(C)(CC(O1)O)O)=O,8,3,0,3,6,0.000146
G5,C1(C(OC(C=O)C1(CO)CO)O)=O,4,2,0,2,0,9.7e-05
G5,C(C(C1(COC(C1O)O)CO)=O)=O,8,2,0,2,0,9.7e-05
G5,C(C1(CO)C(C(OC1C=O)O)O)=O,16,2,0,2,2,9.7e-05
G5,C(C1(COC(C1O)O)CO)=O,8,2,0,2,2,9.7e-05
G5,C1(C(O)OC(C)C1(CO)CO)=O,4,2,0,2,4,9.7e-05
G5,C(C1(CO)C(CC(O1)O)O)=O,8,3,0,3,0,0.000146
G5,C(C1(CO)C(C)OC(C1O)O)=O,16,2,0,2,4,9.7e-05
G5,C1(C(O)OC(CO)C1(CO)CO)=O,4,2,0,2,0,9.7e-05
G5,C(C1(CO)C(CO)OC(C1O)O)=O,16,2,0,2,41,9.7e-05
G5,C1(COC(C)(C1(CO)O)O)=O,4,3,0,3,0,0.000146
G5,C1(C(CO)(C(C(C)(O)O1)O)O)=O,8,3,0,3,17,0.000146
G5,C1(C(CO)(C(C(O)O1)O)O)=O,8,3,0,3,0,0.000146
G5,C1(C(CO)C(C(O)O1)O)=O,8,2,0,2,29,9.7e-05
G5,C1(C(C)OC(C1(CO)O)O)=O,8,3,0,3,0,0.000146
G5,C1(C(C(C)(OC1(CO)CO)O)O)=O,4,3,0,3,0,0.000146
G5,C1(C(CO)OC(C)(C1(CO)O)O)=O,8,3,0,3,0,0.000146
G5,C1(COC(C(C)O)(C1(CO)O)O)=O,8,3,0,3,2,0.000146
G5,C1(C(C)OC(CO)(C1(CO)O)O)=O,8,3,0,3,2,0.000146
G5,C1(C(C(C)O)OC(C1(CO)O)O)=O,16,3,0,3,2,0.000146
G5,C1(C(C(OC1(CO)C(C)O)O)O)=O,16,3,0,3,2,0.000146
G5,C(C(CO)(C1(CCCO1)O)O)=O,4,3,0,3,29,0.000146
G5,C1(C(CO)C(C(CC=O)(O)O1)O)=O,8,2,0,2,29,9.7e-05
G5,C(C(CO)(C1(CCC(O1)=O)O)O)=O,4,3,0,3,45,0.000146
G5,C1(C(CO)(C(C)(C(O)O1)O)O)=O,8,3,0,3,45,0.000146
G5,C(C1(CC(OC1(C=O)CO)O)O)=O,8,3,0,3,2,0.000146
G5,C1(C(CO)(C2(CC1CO2)O)O)=O,8,4,0,4,2,0.000194
G5,C1(C(C2(CC1(CO2)CO)O)O)=O,8,3,0,3,2,0.000144
G5,C1(C(C)(O)OC(CO)C1(CO)O)=O,8,3,0,3,0,0.000146
G5,C(C1(CO)C2CC(C(O)O2)O1)=O,16,3,0,3,40,0.000146
G5,C1(C(CO)C2(C(C(CO2)O)O1)O)=O,16,2,0,2,2,9.7e-05
G5,C1(C2(CO)C(C(C(C)(O2)O)O1)O)=O,16,3,0,3,2,0.000146
G5,C1(C(CO)(C2C(CC(O)O2)O1)O)=O,16,3,0,3,27,0.000146
G5,C1(C(CO)C2(C(C(CO2)O1)O)O)=O,16,2,0,2,2,9.7e-05
G5,C1(C(CO)(C2(CC(CO2)O1)O)O)=O,8,3,0,3,50,0.000146
G5,C1(C2(CO)C(CC(CO1)(O2)O)O)=O,8,3,0,3,2,0.000146
G5,C1(C(CO)C2C(C(C(O)O2)O)O1)=O,32,2,0,2,8,9.7e-05
G5,C1(C(CO)C2C(C(C(O)O2)O1)O)=O,32,2,0,2,8,9.7e-05
G5,C(C1(CO)C(CC(C(O1)O)=O)O)=O,8,3,0,3,15,0.000146
G5,C(C1(C(COC(C1O)O)=O)CO)=O,8,2,0,2,2,9.7e-05
G5,C1(C(CO)(C(C=O)OC(C1)O)O)=O,8,3,0,3,2,0.000146
G5,C(C1(CO)C(C(CC(O1)O)=O)O)=O,8,3,0,3,2,0.000146
G5,C1(CC(O)OCC1(CO)O)=O,4,3,0,3,27,0.000146
G5,C1(CC(O)OC(C)C1(CO)O)=O,8,3,0,3,4,0.000146
G5,C(C1(C(CC(C(O1)O)O)=O)CO)=O,8,3,0,3,15,0.000146
G5,C1(CC(C=O)OC(C1(CO)O)O)=O,8,3,0,3,15,0.000146
G5,C1(CCOC(C1(CO)O)O)=O,4,4,0,4,27,0.000194
G5,C1(CC(C)OC(C1(CO)O)O)=O,8,3,0,3,4,0.000146
G5,C1(C(O)OCC(C1(CO)CO)O)=O,4,2,0,2,2,9.7e-05
G5,C(C1(CO)C(C(O)OCC1O)O)=O,16,2,0,2,30,9.7e-05
G5,C1(C(CO)C(CC(C=O)(O)O1)O)=O,8,2,0,2,29,9.7e-05
G5,C1(C(CO)(C(C(C(O)O1)O)O)O)=O,16,3,0,3,17,0.000146
G5,C1(C(C)(O)OCC(C1(CO)O)O)=O,8,3,0,3,2,0.000146
G5,C1(C2(CO)C(C(CC(O2)O)O1)O)=O,16,3,0,3,27,0.000146
G5,C(C(CO)(C1CC(C(O1)=O)O)O)=O,8,2,0,2,29,9.9e-05
G5,C1(C(CO)(C(CO)(CO1)O)O)=O,4,3,0,3,5,0.000146
G5,C1(C(CO)(C(C(CO)O1)O)O)=O,8,3,0,3,33,0.000146
G5,C1(C(CO)(C(CO1)(CC=O)O)O)=O,4,2,0,2,29,9.9e-05
G5,C(C1(CO)C(C)(C(C(O1)=O)O)O)=O,8,2,0,2,2,9.9e-05
G5,C1(C(CO)(C(C)(C(C=O)O1)O)O)=O,8,2,0,2,2,9.9e-05
G5,C1(C(CO)(C(C)(C(CO)O1)O)O)=O,8,2,0,2,2,9.9e-05
G5,C1(C(CO)(C(CO1)(CCO)O)O)=O,4,2,0,2,29,9.9e-05
G5,C(C1(CO)C(C(C(O1)=O)O)O)=O,8,3,0,3,17,0.000146
G5,C1(C(CO)(C(C(C=O)O1)O)O)=O,8,3,0,3,17,0.000146
G5,C(C1(CO)C(CC(C(O1)=O)O)O)=O,8,2,0,2,29,9.9e-05
G5,C1(C2(CO)C(CC(CO)(O2)O1)O)=O,8,2,0,2,2,9.9e-05
G5,C1(C2(CO)C(C(C(C)(O2)O1)O)O)=O,16,2,0,2,2,9.9e-05
G5,C1(C(CO)(C(C(CO1)O)O)O)=O,8,3,0,3,33,0.000146
G5,C1(C(CO)(C(C)(C(CO1)O)O)O)=O,8,2,0,2,2,9.9e-05
G5,C1(C(CO)(C(C=O)(CCO1)O)O)=O,4,2,0,2,29,9.9e-05
G5,C1(C(CO)(C(CO)(CCO1)O)O)=O,4,2,0,2,29,9.9e-05
G5,C1(C(CO)(C(C(CCO1)O)O)O)=O,8,2,0,2,29,9.9e-05
G5,C1(C(CO)C2C(C(C(O2)O1)O)O)=O,32,1,0,1,2,4.9e-05
G5,C1(C(CO)(C2C(CC(O2)O1)O)O)=O,16,2,0,2,2,9.9e-05
G5,C1(C2(CO)C(C(CC(O2)O1)O)O)=O,16,2,0,2,2,9.9e-05
G5,C1(CCC(C(C1(CO)O)O)O)=O,8,3,0,3,7,0.000146
G5,C(C(CCC(C=O)=O)(CO)CO)=O,1,2,0,2,7,9.7e-05
G5,C(C(CO)(CO)CCC(CO)=O)=O,1,2,0,2,7,9.7e-05
G5,C(C(CO)(C(CC=O)O)CC=O)=O,4,3,0,3,18,0.000145
G5,C(CC(C=O)C(C=O)(CO)CO)=O,2,2,0,2,18,9.7e-05
G5,C(C(C=O)(CCC(C=O)=O)CO)=O,1,2,0,2,45,9.7e-05
G5,C(C(C=O)(CO)CCC(CO)=O)=O,1,2,0,2,45,9.7e-05
G5,C(CC(C=O)C(C=O)(C=O)CO)=O,2,2,0,2,29,9.7e-05
G5,C(C(CO)(C(C)O)CC(CO)=O)=O,4,4,0,4,41,0.000194
G5,C(CO)(C(CO)(C(C)O)CC=O)=O,4,4,0,4,11,0.000194
G5,C(C(CO)(C(C)O)CC=O)=O,4,4,0,4,28,0.000194
G5,C(CC(C(C=O)=O)(CO)CO)(C)=O,1,2,0,2,29,9.7e-05
G5,C(C)(C(CO)(CO)CC(C=O)=O)=O,1,2,0,2,29,9.7e-05
G5,C(C(CO)(CO)CC(C(C)=O)=O)=O,1,2,0,2,2,9.7e-05
G5,C(C(CO)(CO)CC(CC=O)=O)=O,1,2,0,2,2,9.7e-05
G5,C(C(CO)(CO)CC=O)(CC=O)=O,1,2,0,2,2,9.7e-05
G5,C1(C=CC(C1(CO)O)=O)=O,1,4,0,4,47,0.000194
G5,C(C(C(C=C)=O)(CO)OCO)=O,2,3,0,3,37,0.000146
G5,C(C(C(CC=CC=O)=O)(CO)O)=O,4,2,0,2,55,9.9e-05
G5,C(C(C(C=CCC=O)=O)(CO)O)=O,4,2,0,2,55,9.9e-05
G5,C(C(C(C)(C)O)(C(C(C)=O)O)O)=O,4,2,0,2,0,9.499999999999999e-05
G5,C(C)(C(C(C)(C)O)(C(C=O)O)O)=O,4,2,0,2,0,9.499999999999999e-05
G5,C(C(C(C(C)=O)(C(C=C)O)O)O)=O,8,3,0,3,0,0.000154
G5,C(C(C=O)(C(C(CO)CO)O)O)=O,2,2,0,2,18,9.6e-05
G5,C(C(C=O)(C(C(C=O)=O)(C)O)O)=O,2,3,0,3,25,0.000144
G5,C(C(C=O)(C(C=O)(C=O)O)O)=O,1,2,0,2,1,9.6e-05
G5,C(C(C=O)(C(C)(C)O)O)=O,1,2,0,2,1,9.6e-05
G5,C(OCC(C)(C(C=O)(C=O)O)O)=O,2,2,0,2,1,9.6e-05
G5,C(OCC(C(C=O)(C=O)O)O)=O,2,2,0,2,1,9.6e-05
G5,C(C(C=O)(C(COC(C)=O)O)O)=O,2,2,0,2,28,9.6e-05
G5,C(C(C=O)(C(CCC=O)O)O)=O,2,5,0,5,27,0.00024900000000000004
G5,C(C(C=O)(C1(C(OCC1)=O)O)O)=O,2,3,0,3,1,0.000143
G5,C(C(C=O)(C1(COC(C1)=O)O)O)=O,2,2,0,2,1,9.6e-05
G5,C(C(C=O)(C(C(C=C)O)O)O)=O,4,4,0,4,28,0.00019099999999999998
G5,C(C(C=O)(C1(C=COC1)O)O)=O,2,3,0,3,1,0.000143
G5,C(C(C=O)(C(C(CO)(C)O)O)O)=O,4,2,0,2,11,9.6e-05
G5,C(C(C=O)(C(C(CC)=O)(C)O)O)=O,2,2,0,2,1,9.6e-05
G5,C(C(C=O)(C(C(C)=O)(CC)O)O)=O,2,2,0,2,1,9.6e-05
G5,C(C(C=O)(C(C(C)CC=O)O)O)=O,4,3,0,3,28,0.000143
G5,C(C(C=O)(C(CC(C=O)C)O)O)=O,4,2,0,2,28,9.6e-05
G5,C(C(C=O)(C(C(CC)=O)O)O)=O,2,3,0,3,1,0.000143
G5,C(C(C=O)(C(C=O)(CC)O)O)=O,2,2,0,2,1,9.6e-05
G5,C(C(C=O)(C=O)C(C(C=O)O)O)=O,4,1,0,1,1,4.8e-05
G5,C(C(C=O)(C(C(O)=O)(CC)O)O)=O,2,2,0,2,28,9.6e-05
G5,C(C(C=CC)(C(C=O)(C=O)O)O)=O,4,2,0,2,28,9.6e-05
G5,C(C(C=O)(C(C=O)(CC=C)O)O)=O,2,2,0,2,28,9.6e-05
G5,C(C(C=O)(C(C=CC=O)(C)O)O)=O,4,2,0,2,28,9.6e-05
G5,C(C(C=O)(C(C=CC(C)=O)O)O)=O,4,2,0,2,28,9.6e-05
G5,C(C(C=O)(C(C(CC=O)=C)O)O)=O,2,2,0,2,28,9.6e-05
G5,C(C(C=O)(C(CC(C=O)=C)O)O)=O,2,2,0,2,28,9.6e-05
G5,C(C(C=O)(C(C(C)=CC=O)O)O)=O,4,2,0,2,28,9.6e-05
G5,C(C(C=O)(C(C=C(C=O)C)O)O)=O,4,2,0,2,28,9.6e-05
G5,C(C(C=O)(C(C=C)O)O)=O,2,4,0,4,1,0.00019099999999999998
G5,C(C(C=O)(C(C=CC)(CO)O)O)=O,4,2,0,2,28,9.6e-05
G5,C(C(C=O)(C(CO)(CC=C)O)O)=O,2,2,0,2,1,9.6e-05
G5,C(C(C=O)(C(C)(C(C=C)O)O)O)=O,4,2,0,2,28,9.6e-05
G5,C(C(C=O)(C(CC(CO)=C)O)O)=O,2,2,0,2,28,9.6e-05
G5,C(C(C=O)(C(C=C(CO)C)O)O)=O,4,2,0,2,28,9.6e-05
G5,C(C(C=O)(C(C=CC)O)O)=O,4,3,0,3,1,0.000143
G5,C(C(C=O)(C(CC=C)O)O)=O,2,3,0,3,1,0.000143
G5,C(C(C=O)(C(C=CCC=O)O)O)=O,4,2,0,2,1,9.6e-05
G5,C(C(C=O)(C(CC=CC=O)O)O)=O,4,2,0,2,1,9.6e-05
G5,C(C(C=O)(C=O)C(C)(CO)O)(O)=O,2,2,0,2,49,9.6e-05
G5,C(C(C=O)(C(C)O)C(C)(CO)O)=O,4,2,0,2,49,9.7e-05
G5,C(C(C(C=O)=O)(C(CO)(C)O)O)=O,4,2,0,2,5,9.6e-05
G5,C(C)(C(C(C)=O)(C(CO)(C)O)O)=O,2,2,0,2,49,9.6e-05
G5,C1(CCC(C1(C(CO)(C)O)O)=O)=O,2,2,0,2,47,9.6e-05
G5,C(C(CO)(C(C)(CO)O)CC=O)=O,4,3,0,3,55,0.000143
G5,C(C(C(C=O)=O)(C)C(C)(CO)O)=O,4,1,0,1,49,4.8e-05
G5,C(C(C(C)(CO)C(C)(CO)O)=O)=O,4,1,0,1,28,4.8e-05
G5,C(C(C)(C(CO)(C)O)C(C=O)O)=O,8,1,0,1,49,4.8e-05
G5,C(C(C=O)(C(C)=O)C(C)(CO)O)=O,2,1,0,1,6,4.8e-05
G5,C(C(C=O)(C=O)C(C)(CO)O)=O,2,1,0,1,1,4.8e-05
G5,C(C(C=O)(C(C)(CO)O)CC=O)=O,2,1,0,1,43,4.8e-05
G5,C(C(C(C=C)=O)(C(CO)(C)O)O)=O,4,2,0,2,0,9.6e-05
G5,C(C(C(CO)(C)O)(C(C=C)O)O)=O,8,4,0,4,49,0.00019099999999999998
G5,C1(C(O)OCC1(C(CO)(C)O)O)=O,8,3,0,3,0,0.000143
G5,C1(COC(C1(C(CO)(C)O)O)O)=O,8,3,0,3,5,0.000143
G5,C1(C(C(C(O)O1)O)C(C)(CO)O)=O,16,2,0,2,29,9.499999999999999e-05
G5,C1(C=CC(C1(C(CO)(C)O)O)=O)=O,2,2,0,2,47,9.6e-05
G5,C(C(C(C)(C)O)(C(C=O)O)O)=O,4,2,0,2,0,9.499999999999999e-05
G5,C(C(C(C=O)(C(C=CC)O)O)O)=O,16,2,0,2,0,9.499999999999999e-05
G5,C(C(C(CC=C)O)(C(C=O)O)O)=O,8,2,0,2,0,9.499999999999999e-05
G5,C(C(C=O)(C(C)O)C(CCO)O)=O,4,2,0,2,18,9.7e-05
G5,C(C(C=O)(C(C)O)C(C)O)(O)=O,3,2,0,2,4,9.7e-05
G5,C(C(C(C(C)=O)=O)(C(C)O)O)(O)=O,4,4,0,4,4,0.000194
G5,C(C(C=O)(C(CC=O)O)C(C)O)=O,4,2,0,2,45,9.7e-05
G5,C(C(C=O)(C=O)C(C)O)(O)=O,2,2,0,2,17,9.7e-05
G5,C(C(C=O)(C(C)O)C(C(O)=O)O)=O,4,2,0,2,33,9.7e-05
G5,C(C(C=O)(C(C)O)C(C(C)O)O)=O,8,2,0,2,11,9.7e-05
G5,C(C(C=O)(C(C=O)=O)C(C)O)(O)=O,4,2,0,2,17,9.7e-05
G5,C(C(C=O)(C(C)=O)C(C)O)(O)=O,4,2,0,2,17,9.7e-05
G5,C(C1(C(COC1O)=O)C(C)O)(O)=O,8,3,0,3,4,0.000144
G5,C(C1(C(CC(O1)O)=O)C(C)O)(O)=O,8,5,0,5,4,0.000241
G5,C(C(C(C=C)=O)(C(C)O)O)(O)=O,4,5,0,5,4,0.000241
G5,C(C1(C(C(CO1)O)=O)C(C)O)(O)=O,8,4,0,4,17,0.000194
G5,C(C1(C(C(O)OC1)=O)C(C)O)(O)=O,8,3,0,3,4,0.000144
G5,C(C(C(C)O)(C(C)O)C(C)O)=O,4,1,0,1,4,4.9e-05
G5,C(C(C(C(C)O)(C(C)O)O)=O)=O,3,3,0,3,0,0.000156
G5,C(C(C)=O)(C(C(C)O)(C(C)O)O)=O,3,2,0,2,4,9.8e-05
G5,C(C(C)O)(C(C(C)O)(C(C)O)O)=O,6,2,0,2,4,9.8e-05
G5,C(C(C=O)(C(C)O)C(C)O)=O,3,1,0,1,4,4.9e-05
G5,C(C(C(C=O)=O)(C(C)O)C(C)O)=O,3,1,0,1,4,4.9e-05
G5,C(C(C(C)=O)(C(C)O)C(C)O)=O,3,1,0,1,4,4.9e-05
G5,C1(COC(C1(C(C)O)C(C)O)O)=O,6,2,0,2,4,9.6e-05
G5,C1(CC(OC1(C(C)O)C(C)O)O)=O,6,3,0,3,4,0.000145
G5,C=CC(C(C(C)O)(C(C)O)O)=O,3,3,0,3,4,0.000145
G5,C1(C(COC1(C(C)O)C(C)O)O)=O,6,2,0,2,4,9.8e-05
G5,C1(C(O)OCC1(C(C)O)C(C)O)=O,6,2,0,2,4,9.6e-05
G5,C=CC(C(C(C=O)=O)(C(C)O)O)=O,4,2,0,2,33,9.8e-05
G5,C(C(C=O)(C(CO)=O)C(C)O)=O,2,1,0,1,1,4.9e-05
G5,C(C(C(CC=O)=O)(C(C)O)O)=O,4,4,0,4,1,0.00020299999999999997
G5,C1(COC(CO)C1(C(C)O)O)=O,8,2,0,2,27,9.8e-05
G5,C1(COCC(C1(C(C)O)O)O)=O,8,2,0,2,27,9.8e-05
G5,C(C(C(OCC=O)=C)(C(C)O)O)=O,4,2,0,2,26,9.8e-05
G5,C=CC(C(C(CO)(C(C)O)O)=O)=O,4,3,0,3,2,0.000156
G5,C1(C(COC1C(C)=O)(C(C)O)O)=O,8,2,0,2,4,9.8e-05
G5,C1(C(CCOCC1(C(C)O)O)=O)=O,4,2,0,2,36,9.8e-05
G5,C(C1C(C(C(C)O)(C(C)O1)O)=O)=O,16,2,0,2,17,9.8e-05
G5,C1(C(C(C)O)(C(C(C1O)=C)O)O)=O,16,2,0,2,2,9.8e-05
G5,C(CO)(C(C(C)O)(C(C=C)O)O)=O,8,4,0,4,2,0.000193
G5,C1(C(CO)(C(C)O)OC=CC1O)=O,8,2,0,2,2,9.8e-05
G5,C1(C(COC=CC1O)(C(C)O)O)=O,8,2,0,2,38,9.8e-05
G5,C(CO)(C1(C(C)O)C(C=CO1)O)=O,8,2,0,2,38,9.8e-05
G5,C1(C(C(O)=O)(C(CO1)O)C(C)O)=O,8,2,0,2,17,9.7e-05
G5,C1(C(C(C)O)(C(C)O)C(CO1)O)=O,6,1,0,1,4,4.9e-05
G5,C1(C(C(C(C1C)O)(C(C)O)O)=O)=O,16,2,0,2,42,9.8e-05
G5,C1(C(C(C(C1(C)C(C)O)O)O)=O)=O,16,1,0,1,42,4.9e-05
G5,C1(C(C)C(C(C1(C(C)O)O)=O)O)=O,16,2,0,2,42,9.8e-05
G5,C1(C(C)(C(C)O)C(C(C1O)=O)O)=O,16,1,0,1,42,4.9e-05
G5,C(C1(C(C(CC1)=O)=O)C(C)O)=O,4,2,0,2,45,9.6e-05
G5,C(C1(C(CC(C1)=O)=O)C(C)O)=O,4,3,0,3,29,0.000144
G5,C(C1(C(CCC1=O)=O)C(C)O)=O,2,2,0,2,4,9.6e-05
G5,C1(CC=CC(C1(C(C)O)O)=O)=O,4,4,0,4,32,0.000192
G5,C(C(C(C(CO)=O)=O)(C)C(C)O)=O,4,1,0,1,42,4.9e-05
G5,C(C(CO)(C(C)O)CC(C=O)=O)=O,4,1,0,1,55,4.9e-05
G5,C(C(CO)=O)(C(CO)(C)C(C)O)=O,4,1,0,1,42,4.9e-05
G5,C(C(C)(C(C)O)C(C(CO)=O)O)=O,8,1,0,1,49,4.9e-05
G5,C(C(C)=O)(C(CO)(CO)C(C)O)=O,2,1,0,1,2,4.9e-05
G5,C(C(C(C(C)=O)=O)(C)C(C)O)=O,4,1,0,1,45,4.9e-05
G5,C(C(C)=O)(C(C)(CO)C(C)O)=O,4,1,0,1,27,4.9e-05
G5,C(C(C)(C(C)O)C(C(C)=O)O)=O,8,1,0,1,27,4.9e-05
G5,C(C(CC)=O)(C(CO)(C(C)O)O)=O,4,2,0,2,42,9.8e-05
G5,C(C(C(C=O)=O)(C)C(C)O)=O,4,1,0,1,49,4.9e-05
G5,C(CC(C(C=O)=O)(CO)C(C)O)=O,4,2,0,2,55,9.6e-05
G5,C(C)(C(C=O)(C(CO)=O)C(C)O)=O,4,1,0,1,2,4.9e-05
G5,C(CO)(C(C=O)(C(C)O)CC=O)=O,4,2,0,2,55,9.6e-05
G5,C(C(C(C(C=O)=O)(C)C(C)O)O)=O,8,1,0,1,28,4.9e-05
G5,C(C(C(C)(C(CO)O)C(C)O)=O)=O,8,1,0,1,28,4.9e-05
G5,C(CO)(C(C)(C(C)O)C(C=O)O)=O,8,1,0,1,28,4.9e-05
G5,C(C(C(C=O)=O)(CCO)C(C)O)=O,4,1,0,1,29,4.9e-05
G5,C(C(C(CO)(CCO)C(C)O)=O)=O,4,1,0,1,55,4.9e-05
G5,C(C(C(C)O)(CCO)C(C=O)O)=O,8,1,0,1,3,4.9e-05
G5,C(C)(C(C(CO)=O)(CO)C(C)O)=O,4,1,0,1,2,4.9e-05
G5,C(C(C(C)(CO)C(C)O)=O)=O,4,1,0,1,28,4.9e-05
G5,C(C(C)(C(C)O)C(C=O)O)=O,8,1,0,1,49,4.9e-05
G5,C(C)(C(C(C(C)=O)=O)(C(C)O)O)=O,4,2,0,2,25,9.8e-05
G5,C(C(C(C(CC)=O)=O)(C(C)O)O)=O,4,2,0,2,42,9.8e-05
G5,C(C(C(C)O)(C(CCC=O)O)O)=O,8,5,0,5,27,0.000241
G5,C(C)(C(C(C=C)=O)(C(C)O)O)=O,4,4,0,4,9,0.000192
G5,C(C)(C1(C(C)O)C(CC(O1)O)O)=O,16,3,0,3,45,0.000145
G5,C1(C=CC(C1(CO)C(C)O)=O)=O,2,2,0,2,4,9.6e-05
G5,C(C(C)(C(C)O)C(C=O)(CO)O)=O,8,1,0,1,49,4.9e-05
G5,C(C(C=O)(C(C(C)=O)=O)C(C)O)=O,2,1,0,1,14,4.9e-05
G5,C(C(C(C)=O)(C(C=O)=O)C(C)O)=O,4,1,0,1,23,4.9e-05
G5,C(C(C=O)(C(C)=O)C(C)O)=O,2,1,0,1,6,4.9e-05
G5,C(C(C(C)=O)(C(C)=O)C(C)O)=O,2,1,0,1,6,4.9e-05
G5,C(C(C=O)(C(C=O)=O)C(C)O)=O,2,1,0,1,23,4.9e-05
G5,C(C)(C(C(C)=O)(CO)C(C)O)=O,2,1,0,1,28,4.9e-05
G5,C(C(C=O)(C=O)C(C)O)=O,2,1,0,1,1,4.9e-05
G5,C(C(C=O)(C(C=O)(C)C(C)O)O)=O,4,1,0,1,49,4.9e-05
G5,C(C1C(C(C(C)O)(C(C1)O)O)=O)=O,16,2,0,2,41,9.8e-05
G5,C(C1(C(C(C(C1)O)O)=O)C(C)O)=O,16,1,0,1,41,4.9e-05
G5,C1(C(C(C)O)(C(C(C1C)=O)O)O)=O,16,2,0,2,42,9.8e-05
G5,C1(C(C(C(C1(C)C(C)O)=O)O)O)=O,6,1,0,1,42,4.9e-05
G5,C1(C(C)(CC(C1(C(C)O)O)=O)O)=O,8,2,0,2,25,9.8e-05
G5,C(C(C(C(O)=O)=O)(C)C(C)O)=O,4,1,0,1,27,4.9e-05
G5,C(C(C(C=O)=O)(C(C)O)CC=O)=O,4,1,0,1,33,4.9e-05
G5,C(C(C=O)(C(C)O)CC=O)=O,2,1,0,1,43,4.9e-05
G5,C(C(C)(C(C)O)C(C(O)=O)O)=O,8,1,0,1,49,4.9e-05
G5,C(C(C(C)(CO)C(C)O)=O)(O)=O,4,1,0,1,28,4.9e-05
G5,C(C)(C(C=O)(C(C)O)CC=O)=O,4,1,0,1,45,4.9e-05
G5,C(C1(C(CC(CO)O1)=O)C(C)O)=O,8,2,0,2,26,9.8e-05
G5,C1(CC(C=O)OC1(CO)C(C)O)=O,8,2,0,2,2,9.8e-05
G5,C(C1(C(CC(CO1)O)=O)C(C)O)=O,8,2,0,2,37,9.8e-05
G5,C1(CC(C=O)OCC1(C(C)O)O)=O,8,2,0,2,37,9.8e-05
G5,C(C1(C(C)O)C(C(CCO1)=O)O)=O,8,2,0,2,37,9.8e-05
G5,C1(C(C(C)O)(C(C=O)OCC1)O)=O,8,2,0,2,37,9.8e-05
G5,C(C1(C(CC(CO1)=O)O)C(C)O)=O,8,2,0,2,37,9.8e-05
G5,C1(C(CCOC1(CO)C(C)O)=O)=O,4,2,0,2,2,9.8e-05
G5,C1(CC(OC1(C(C)=O)C(C)O)=O)=O,4,2,0,2,27,9.8e-05
G5,C1(CC(C(C1(C(C)O)O)=O)=C)=O,4,4,0,4,47,0.000192
G5,C(C(C(CC=C)=O)(C(C)O)O)=O,4,5,0,5,4,0.00023999999999999998
G5,C(C1(C(C(C=C1)O)=O)C(C)O)=O,8,2,0,2,4,9.6e-05
G5,C(C)(C1(C(C=CO1)=O)C(C)O)=O,4,4,0,4,9,0.000192
G5,C(C1(C(CC(O1)=C)=O)C(C)O)=O,4,4,0,4,26,0.000192
G5,C(C1(C(CC=CO1)=O)C(C)O)=O,4,4,0,4,37,0.000192
G5,C1(C2CC(C(C1(C(C)O)O)O2)O)=O,32,2,0,2,9,9.8e-05
G5,C1(CC2C(C1(C(C)O)OC2O)O)=O,32,5,0,5,4,0.00023999999999999998
G5,C(C(C1(C(C)O)C(CCO1)O)=O)=O,8,2,0,2,39,9.8e-05
G5,C(C(C(C)O)(C1C(CCO1)=O)O)=O,8,2,0,2,4,9.8e-05
G5,C1(C(C(C)O)(C(C=O)O)OCC1)=O,8,2,0,2,4,9.8e-05
G5,C(C(C1CC(CO1)=O)(C(C)O)O)=O,8,2,0,2,4,9.8e-05
G5,C(C(C(C)O)(C1CCC(O1)=O)O)=O,8,2,0,2,32,9.8e-05
G5,C1(C2C(CO)OC1(CO2)C(C)O)=O,16,2,0,2,17,9.8e-05
G5,C1(C2COC1(C(C)O)C(CO)O2)=O,16,2,0,2,17,9.8e-05
G5,C1(C(C2C(CC(O)O2)O1)C(C)O)=O,32,2,0,2,48,9.6e-05
G5,C1(COC2CC(OC12C(C)O)O)=O,16,3,0,3,9,0.000145
G5,C1(C2CC(OC1(CO2)C(C)O)O)=O,16,3,0,3,9,0.000145
G5,C1(C(C(C)O)C2(CC(CO2)O1)O)=O,16,2,0,2,19,9.6e-05
G5,C1(C(C2COCC1(C(C)O)O2)O)=O,16,2,0,2,4,9.8e-05
G5,C1(C2COCC(C1(C(C)O)O)O2)=O,16,2,0,2,4,9.8e-05
G5,C1(CC2(COCC1(C(C)O)O2)O)=O,8,3,0,3,36,0.000145
G5,C1(C2CCOC(C1(C(C)O)O)O2)=O,16,2,0,2,4,9.7e-05
G5,C(C1(C(C)O)C(CCC(O1)=O)O)=O,8,2,0,2,37,9.7e-05
G5,C1(C(C(C)O)C(CC(C=O)O1)O)=O,16,1,0,1,48,4.9e-05
G5,C1(C(C)OCC(C1(C(C)O)O)=O)=O,8,2,0,2,24,9.8e-05
G5,C1(C(C(C)O)C(C(C(C)O1)=O)O)=O,16,1,0,1,24,4.9e-05
G5,C1(CCOC(C)(C1(C(C)O)O)O)=O,8,3,0,3,9,0.000145
G5,C1(CC(C)(O)OCC1(C(C)O)O)=O,8,3,0,3,26,0.000145
G5,C1(C(C)OCC(C1(C(C)O)O)O)=O,16,2,0,2,4,9.7e-05
G5,C1(C2C(COC1(CO2)C(C)O)O)=O,16,2,0,2,17,9.8e-05
G5,C1(C2COC1(C(C)O)C(CO2)O)=O,16,2,0,2,17,9.8e-05
G5,C1(C(C2COC1(CO2)C(C)O)O)=O,16,2,0,2,4,9.8e-05
G5,C1(C2COC(CO2)C1(C(C)O)O)=O,16,2,0,2,4,9.8e-05
G5,C1(CC2(COC1(CO2)C(C)O)O)=O,8,3,0,3,54,0.000145
G5,C1(CCC(O)OCC1(C(C)O)O)=O,8,3,0,3,7,0.000145
G5,C1(C(C(C)O)C(C(CCO1)O)O)=O,16,1,0,1,29,4.9e-05
G5,C1(COCCC(C1(C(C)O)O)O)=O,8,2,0,2,4,9.7e-05
G5,C1(CCCOC(C1(C(C)O)O)O)=O,8,3,0,3,29,0.000145
G5,C1(C(C2C(CC(O2)O1)O)C(C)O)=O,32,1,0,1,43,4.9e-05
G5,C1(COC2CC(C1(C(C)O)O2)O)=O,16,2,0,2,17,9.8e-05
G5,C(C1(C(CCC(O1)=O)=O)C(C)O)=O,4,2,0,2,27,9.8e-05
G5,C1(C(C(C(C=1)=O)(C(C)O)O)O)CO,8,2,0,2,46,9.8e-05
G5,C1C(C(C(C=1)=O)=O)(CO)C(C)O,4,2,0,2,4,9.6e-05
G5,C(C(C(CO)=O)(C=C)C(C)O)=O,4,2,0,2,4,9.6e-05
G5,C(C(C(C=CC=O)=O)(C(C)O)O)=O,8,2,0,2,46,9.8e-05
G5,C(C(C(C=C)=O)(C(C)O)O)=O,4,5,0,5,0,0.00023999999999999998
G5,C(C(C(C=CC)=O)(C(C)O)O)=O,8,3,0,3,28,0.000145
G5,C(C)=CC(C(CO)(C(C)O)O)=O,8,3,0,3,28,0.000145
G5,C(C(CO)(C(C)O)O)(CC=C)=O,4,3,0,3,28,0.000145
G5,C=CC(C(C=O)=O)(CO)C(C)O,4,2,0,2,4,9.6e-05
G5,C(CO)(C(C=C)(CO)C(C)O)=O,4,2,0,2,4,9.6e-05
G5,C(C(C=C)(C(C)O)C(C=O)O)=O,8,2,0,2,4,9.6e-05
G5,C1(CO)OC(C(C=1)=O)(CO)C(C)O,4,2,0,2,2,9.7e-05
G5,C(C1(C(C=C(C)O1)=O)C(C)O)=O,4,3,0,3,26,0.000145
G5,C1(CO)OCC(C(C=1)=O)(C(C)O)O,4,2,0,2,32,9.8e-05
G5,C1(C=CC(C(CO)(C(C)O)O1)=O)=O,4,2,0,2,2,9.8e-05
G5,C1(C(C(C=CCO1)=O)(C(C)O)O)=O,4,2,0,2,2,9.8e-05
G5,C1(C=CC(C(CO1)(C(C)O)O)=O)=O,4,2,0,2,46,9.8e-05
G5,C1(COC(C1(C(C)O)O)=CCO)=O,8,2,0,2,2,9.7e-05
G5,C1(COC(C=C)(C1(C(C)O)O)O)=O,8,3,0,3,32,0.000145
G5,C1(C(C(OC1C=C)O)(C(C)O)O)=O,16,3,0,3,2,0.000145
G5,C1(COC(C(C1(C(C)O)O)O)=C)=O,8,2,0,2,24,9.7e-05
G5,C1(COC=CC(C1(C(C)O)O)O)=O,8,2,0,2,38,9.8e-05
G5,C(C(C(C)O)(C1C=CC(O1)=O)O)=O,8,2,0,2,8,9.8e-05
G5,C(C1(C(C)O)C(C=CC(O1)=O)O)=O,8,2,0,2,8,9.8e-05
G5,C(C(C(C)O)(C(C=C)O)O)=O,8,6,0,6,27,0.000288
G5,C(C1(C(C)O)C(C)(CC(O1)O)O)=O,16,3,0,3,6,0.000145
G5,C(C1(COC(C1O)O)C(C)O)=O,16,2,0,2,4,9.6e-05
G5,C1(C(O)OC(C)C1(CO)C(C)O)=O,16,2,0,2,4,9.6e-05
G5,C(C1(C(C)O)C(CC(O1)O)O)=O,16,3,0,3,0,0.000145
G5,C(C1(C(C)OC(C1O)O)C(C)O)=O,32,2,0,2,4,9.6e-05
G5,C(C1(C(C)O)C(C(C(O1)O)O)O)=O,32,3,0,3,1,0.000145
G5,C1(C(O)OCC1(C(C)O)O)=O,8,3,0,3,0,0.000145
G5,C1(COC(C)(C1(C(C)O)O)O)=O,8,3,0,3,0,0.000145
G5,C1(COC(C1(C(C)O)O)O)=O,8,3,0,3,5,0.000145
G5,C1(C(C(C)O)(C(C(C)(O)O1)O)O)=O,16,3,0,3,17,0.000145
G5,C1(C(C(C)O)(C(C(O)O1)O)O)=O,16,3,0,3,0,0.000145
G5,C1(C(C(C(O)O1)O)C(C)O)=O,16,2,0,2,29,9.6e-05
G5,C1(C(C)OC(C1(C(C)O)O)O)=O,16,3,0,3,0,0.000145
G5,C(C(C(C)O)(C1(CCCO1)O)O)=O,8,3,0,3,29,0.000145
G5,C1(C(C(C)O)(C(C)(C(O)O1)O)O)=O,16,3,0,3,45,0.000145
G5,C1(C(C2(CC1CO2)O)(C(C)O)O)=O,16,4,0,4,47,0.000192
G5,C1(C(C2(CC1(CO2)C(C)O)O)O)=O,16,3,0,3,47,0.000144
G5,C(C1(C(C)O)C2CC(C(O)O2)O1)=O,32,3,0,3,40,0.000145
G5,C1(COC(C(C1(C(C)O)O)O)O)=O,16,3,0,3,5,0.000145
G5,C1(CC(O)OCC1(C(C)O)O)=O,8,3,0,3,27,0.000145
G5,C1(CC(O)OC(C)C1(C(C)O)O)=O,16,3,0,3,4,0.000145
G5,C1(CCOC(C1(C(C)O)O)O)=O,8,3,0,3,27,0.000145
G5,C1(CC(C)OC(C1(C(C)O)O)O)=O,16,3,0,3,4,0.000145
G5,C1(C(C(C)O)(C(CO)(CO1)O)O)=O,8,2,0,2,5,9.8e-05
G5,C1(C(C(C)O)(C(C(CO)O1)O)O)=O,16,2,0,2,33,9.8e-05
G5,C(C1(C(C(C(O1)=O)O)O)C(C)O)=O,16,2,0,2,17,9.8e-05
G5,C1(C(C(C(C=O)O1)O)(C(C)O)O)=O,16,2,0,2,17,9.8e-05
G5,C1(C(C(C)O)(C(C)(CO1)O)O)=O,8,3,0,3,27,0.000145
G5,C1(C(C(C)O)(C(C(CO1)O)O)O)=O,16,2,0,2,33,9.8e-05
G5,C1(CCC(C(C1(C(C)O)O)O)O)=O,16,3,0,3,7,0.000145
G5,C(C(C(C)O)(C(C)O)CC=O)=O,3,2,0,2,28,9.6e-05
G5,C1(C=CC(C1(C(C)O)O)=O)=O,2,3,0,3,47,0.000145
G5,C(C(C(C=C)=O)(C(C)O)OCO)=O,4,3,0,3,37,0.000145
G5,C(CO)(C(CO)(C(C)(C)O)O)=O,2,2,0,2,2,9.6e-05
G5,C(CO)(C(CO)(C(C=CC)O)O)=O,8,2,0,2,2,9.499999999999999e-05
G5,C(CO)(C(CO)(C(CC=C)O)O)=O,4,2,0,2,2,9.499999999999999e-05
G5,C(C(C(CO)O)(C(C)(C)O)O)(O)=O,4,2,0,2,0,9.499999999999999e-05
G5,C(C(C(CO)O)(C(C=C)O)O)(O)=O,8,2,0,2,0,9.499999999999999e-05
G5,C1(CC(C(C1(C(C)(C)O)O)O)O)=O,8,2,0,2,4,9.499999999999999e-05
G5,C1(C(C(C(C1)O)O)(C(C=C)O)O)=O,16,2,0,2,4,9.499999999999999e-05
G5,C(CO)(C(C(C)O)(C(C)(C)O)O)=O,4,2,0,2,2,9.499999999999999e-05
G5,C(C(C(CO)=O)(CO)C(C)(C)O)=O,2,1,0,1,2,4.8e-05
G5,C(CO)(C(C=O)(CO)C(C=C)O)=O,4,1,0,1,2,4.8e-05
G5,C(CC(C(CO)(C(C)(C)O)O)=O)=O,2,2,0,2,2,9.499999999999999e-05
G5,C(C(CO)(C(C=C)O)O)(CC=O)=O,4,2,0,2,2,9.499999999999999e-05
G5,C(C(C(CCO)=O)(C(C)(C)O)O)=O,2,2,0,2,27,9.499999999999999e-05
G5,C(CCO)(C(C=O)(C(C=C)O)O)=O,4,2,0,2,27,9.499999999999999e-05
G5,C(CCO)(C(CO)(C(C)(C)O)O)=O,2,2,0,2,2,9.499999999999999e-05
G5,C(C(CO)(C(C=C)O)O)(CCO)=O,4,2,0,2,2,9.499999999999999e-05
G5,C(C(C(CO)(CO)C(C)(C)O)=O)=O,1,1,0,1,2,4.8e-05
G5,C=CC(C(C(C=O)=O)(CO)CO)O,2,1,0,1,2,4.8e-05
G5,C(CO)(C(CO)(CO)C(C)(C)O)=O,1,1,0,1,2,4.8e-05
G5,C(CO)(C(CO)(CO)C(C=C)O)=O,2,1,0,1,2,4.8e-05
G5,C(C(CO)(C(C)(C)O)C(C=O)O)=O,4,1,0,1,43,4.8e-05
G5,C(C(CO)(C(C=O)O)C(C=C)O)=O,8,1,0,1,43,4.8e-05
G5,C(C(C=O)(CO)C(CCO)O)(O)=O,4,2,0,2,18,9.6e-05
G5,C(C(C=O)(C=O)C(CCO)O)(O)=O,2,2,0,2,18,9.6e-05
G5,C(C(C(C=O)=O)(C(CCO)O)O)=O,4,2,0,2,5,9.6e-05
G5,C(C)(C(C(C)=O)(C(CCO)O)O)=O,2,2,0,2,49,9.6e-05
G5,C1(CCC(C1(C(CCO)O)O)=O)=O,2,2,0,2,47,9.6e-05
G5,C(C(CO)(C(CCO)O)CC=O)=O,4,2,0,2,18,9.6e-05
G5,C(C(C(C=O)=O)(C)C(CCO)O)=O,4,1,0,1,49,4.8e-05
G5,C(C(C(C)(CO)C(CCO)O)=O)=O,4,1,0,1,28,4.8e-05
G5,C(C(C)(C(CCO)O)C(C=O)O)=O,8,1,0,1,49,4.8e-05
G5,C(C(C=O)(C(C)=O)C(CCO)O)=O,2,1,0,1,6,4.8e-05
G5,C(C(C=O)(C=O)C(CCO)O)=O,2,1,0,1,1,4.8e-05
G5,C(C(C=O)(C(CCO)O)CC=O)=O,2,1,0,1,43,4.8e-05
G5,C(C(C(C=C)=O)(C(CCO)O)O)=O,4,3,0,3,0,0.000143
G5,C1(C(O)OCC1(C(CCO)O)O)=O,8,4,0,4,0,0.000202
G5,C1(COC(C1(C(CCO)O)O)O)=O,8,3,0,3,5,0.000143
G5,C1(C(C(C(O)O1)O)C(CCO)O)=O,16,2,0,2,45,9.499999999999999e-05
G5,C1(C=CC(C1(C(CCO)O)O)=O)=O,2,2,0,2,47,9.6e-05
G5,C(C(C(CC=O)O)(C(C)(C)O)O)=O,4,2,0,2,0,9.499999999999999e-05
G5,C(CC(C(C=O)(C(C=C)O)O)O)=O,8,4,0,4,0,0.00019099999999999998
G5,C(C)(C(C(C)O)(C(C)(C)O)O)=O,4,2,0,2,4,9.6e-05
G5,C(C)(C(C(C)O)(C(C=C)O)O)=O,8,4,0,4,4,0.00018999999999999998
G5,C(C)(C(C(C)O)(C(C=CC)O)O)=O,16,2,0,2,4,9.499999999999999e-05
G5,C(C)(C(C(CC=C)O)(C(C)O)O)=O,8,2,0,2,4,9.499999999999999e-05
G5,C(C(C=O)(C=O)C(CC(C)O)O)=O,4,1,0,1,1,4.8e-05
G5,C(C(C(C)(C)O)(C(C=O)(C)O)O)=O,4,2,0,2,45,9.499999999999999e-05
G5,C(C(C(C)(C)O)(C(CO)(C)O)O)=O,4,2,0,2,49,9.499999999999999e-05
G5,C(C)(C(C(CO)O)(C(C)(C)O)O)=O,4,2,0,2,0,9.499999999999999e-05
G5,C(C)(C(C(CO)O)(C(C=C)O)O)=O,8,2,0,2,0,9.499999999999999e-05
G5,C(C(C(C)O)(C(C)(C)O)O)=O,4,2,0,2,28,9.6e-05
G5,C(OCC(C(C=O)(C(C)O)O)O)=O,8,2,0,2,28,9.6e-05
G5,C(C(C(C)O)(C1(C=COC1)O)O)=O,8,2,0,2,28,9.499999999999999e-05
G5,C(C(C(C)O)(C(C(CC)=O)O)O)=O,8,2,0,2,28,9.6e-05
G5,C(C(CC)(C(C=O)(C(C)O)O)O)=O,8,2,0,2,28,9.6e-05
G5,C(C(C(C)O)(C(C=CC)O)O)=O,16,3,0,3,28,0.000143
G5,C(C(C(CC=C)O)(C(C)O)O)=O,8,3,0,3,28,0.000143
G5,C(C(C(CO)(C(C)(C)O)O)=O)=O,2,2,0,2,0,9.6e-05
G5,C(C)=CC(C(C(C=O)=O)(CO)O)O,8,2,0,2,0,9.499999999999999e-05
G5,C=CCC(C(C(C=O)=O)(CO)O)O,4,2,0,2,0,9.499999999999999e-05
G5,C(C(C=O)(C=O)C(C=O)(CO)O)=O,2,1,0,1,1,4.8e-05
G5,C(C(C=O)(C=O)C(C(CO)=O)O)=O,2,1,0,1,1,4.8e-05
G5,C(C)(C(C(CO)=O)(C(C)(C)O)O)=O,2,2,0,2,0,9.499999999999999e-05
G5,C(CO)(C(C(C)=O)(C(C=C)O)O)=O,4,2,0,2,0,9.499999999999999e-05
G5,C(C(C=O)(CO)C(CC=O)O)(O)=O,4,2,0,2,18,9.6e-05
G5,C(C(C=O)(C=O)C(CC=O)O)(O)=O,2,2,0,2,17,9.6e-05
G5,C(C(C(C=O)=O)(C(CC=O)O)O)=O,4,2,0,2,5,9.6e-05
G5,C(CC(C1(C(CCC1=O)=O)O)O)=O,2,2,0,2,47,9.6e-05
G5,C(C1(C(C(CC1)=O)=O)C(CC=O)O)=O,4,2,0,2,45,9.499999999999999e-05
G5,C(C1(C(CC(C1)=O)=O)C(CC=O)O)=O,4,1,0,1,45,4.8e-05
G5,C(CC(C1(C=O)C(CCC1=O)=O)O)=O,2,1,0,1,45,4.8e-05
G5,C1(CC=CC(C1(C(CC=O)O)O)=O)=O,4,2,0,2,32,9.6e-05
G5,C(C(C(C=O)=O)(C)C(CC=O)O)=O,4,1,0,1,49,4.8e-05
G5,C(CC(C(C(C=O)=O)(C)CO)O)=O,4,1,0,1,28,4.8e-05
G5,C(C(C)(C(CC=O)O)C(C=O)O)=O,8,1,0,1,49,4.8e-05
G5,C(CC(C1(C(C=CC1=O)=O)CO)O)=O,2,1,0,1,45,4.8e-05
G5,C(CC(C(C=O)(C=O)C(C)=O)O)=O,2,1,0,1,6,4.8e-05
G5,C(C(C=O)(C=O)C(CC=O)O)=O,2,1,0,1,1,4.8e-05
G5,C(CC(C(C=O)(C=O)CC=O)O)=O,2,1,0,1,43,4.8e-05
G5,C1(CC(C(C1(C(CC=O)O)O)=O)=C)=O,4,2,0,2,47,9.6e-05
G5,C(C1(C(C(C=C1)O)=O)C(CC=O)O)=O,8,1,0,1,45,4.8e-05
G5,C(CC(C1(C(C)=O)C(C=CO1)=O)O)=O,4,2,0,2,9,9.6e-05
G5,C(C1(C(CC(O1)=C)=O)C(CC=O)O)=O,4,2,0,2,26,9.6e-05
G5,C(C1(C(CC=CO1)=O)C(CC=O)O)=O,4,2,0,2,37,9.6e-05
G5,C(CC(C1(C=CC(C1=O)=O)CO)O)=O,4,1,0,1,45,4.8e-05
G5,C(C(C(C=C)=O)(C(CC=O)O)O)=O,4,2,0,2,0,9.6e-05
G5,C(CC(C1(C=O)C(C=C(C)O1)=O)O)=O,4,2,0,2,26,9.6e-05
G5,C(CC(C1(C(C(O)OC1)=O)O)O)=O,8,3,0,3,0,0.000143
G5,C(CC(C1(C(COC1O)=O)O)O)=O,8,3,0,3,5,0.000143
G5,C1(C(C(CC=O)O)C(C(O)O1)O)=O,16,2,0,2,43,9.499999999999999e-05
G5,C(CC(C1(C(C=CC1=O)=O)O)O)=O,2,2,0,2,47,9.6e-05
G5,C(C(C(CO)=O)(C(C)(C)O)O)=O,2,2,0,2,5,9.6e-05
G5,C(C(C(CO)=O)(C(C=C)O)O)=O,4,4,0,4,5,0.00018999999999999998
G5,C(C(C(CO)=O)(C(C=CC)O)O)=O,8,2,0,2,5,9.499999999999999e-05
G5,C(C(C(CO)=O)(C(CC=C)O)O)=O,4,2,0,2,5,9.499999999999999e-05
G5,C(C(C=O)(C=O)C(C(O)=O)(C)O)=O,2,1,0,1,1,4.8e-05
G5,C(C(C(O)=O)(C=O)CO)(O)=O,1,1,0,1,18,4.8e-05
G5,C(C(C=O)(CO)C(C(C)O)O)(O)=O,8,2,0,2,11,9.6e-05
G5,C(C(C(O)=O)(C=O)C(C)O)(O)=O,2,1,0,1,4,4.8e-05
G5,C(C(C(O)=O)(C=O)C(CO)O)(O)=O,2,1,0,1,0,4.8e-05
G5,C(C(C(O)=O)(C(C=O)=O)O)(O)=O,1,2,0,2,17,9.6e-05
G5,C(C(C(O)=O)(C(C(C)=O)=O)O)(O)=O,1,2,0,2,17,9.6e-05
G5,C(C(C=O)(C(O)=O)C(O)=O)=O,1,1,0,1,17,4.8e-05
G5,C(C(C=O)(C=O)C(C(O)=O)O)(O)=O,2,2,0,2,33,9.6e-05
G5,C(C(C=O)(C=O)C(C(C)O)O)(O)=O,4,2,0,2,11,9.6e-05
G5,C(C(C(O)=O)(C(O)=O)C(C=O)=O)=O,1,1,0,1,17,4.8e-05
G5,C(C(C(O)=O)(C(O)=O)C(C)=O)=O,1,1,0,1,17,4.8e-05
G5,C(C1(C(O)=O)C(COC1O)=O)(O)=O,2,1,0,1,17,4.8e-05
G5,C(C1(C(O)=O)C(CC(O1)O)=O)(O)=O,2,2,0,2,17,9.6e-05
G5,C(C(C(O)=O)(C(C=C)=O)O)(O)=O,1,2,0,2,17,9.6e-05
G5,C(C1(C(O)=O)C(C(CO1)O)=O)(O)=O,2,2,0,2,17,9.6e-05
G5,C(C1(C(O)=O)C(C(O)OC1)=O)(O)=O,2,1,0,1,17,4.8e-05
G5,C(C(C(O)=O)(C=O)C(CO)=O)(O)=O,1,1,0,1,17,4.8e-05
G5,C(C(C(O)=O)(C(CC=O)=O)O)(O)=O,1,2,0,2,17,9.6e-05
G5,C(C(C=O)(C(C(C=O)=O)O)O)(O)=O,4,4,0,4,1,0.000192
G5,C(C(C(O)=O)(C(C=O)=O)CO)(O)=O,1,1,0,1,17,4.8e-05
G5,C(C(C(O)=O)(C=O)C(C=O)O)(O)=O,2,1,0,1,43,4.8e-05
G5,C(C(C(C=O)=O)(C(C=C)=O)O)(O)=O,2,2,0,2,33,9.6e-05
G5,C(C(C(C(CO)=O)=O)(CO)O)(O)=O,2,2,0,2,0,9.6e-05
G5,C(C(C=O)(C=O)C(CO)=O)(O)=O,1,1,0,1,1,4.8e-05
G5,C(C1(C(COC1CO)=O)O)(O)=O,4,3,0,3,27,0.000144
G5,C(C1(C(COCC1O)=O)O)(O)=O,4,3,0,3,27,0.000144
G5,C(C(C=O)(C(OCC=O)=C)O)(O)=O,2,2,0,2,26,9.6e-05
G5,C(C(C(C(C=C)=O)=O)(CO)O)(O)=O,2,3,0,3,2,0.000155
G5,C(C1(C(C(C(C)=O)OC1)=O)O)(O)=O,4,2,0,2,4,9.6e-05
G5,C(C1(C(C(CCOC1)=O)=O)O)(O)=O,2,2,0,2,36,9.6e-05
G5,C(C1(C(C(C=O)OC1C)=O)O)(O)=O,8,2,0,2,17,9.6e-05
G5,C(C1(C(C(C(C1O)=C)O)=O)O)(O)=O,8,2,0,2,2,9.6e-05
G5,C(C1(C(C(C=CO1)O)=O)CO)(O)=O,4,2,0,2,2,9.6e-05
G5,C(C1(C(C(C=COC1)O)=O)O)(O)=O,4,2,0,2,38,9.6e-05
G5,C(C1(C(CO)=O)C(C=CO1)O)(O)=O,4,2,0,2,38,9.6e-05
G5,C1(C(C(O)=O)(C(O)=O)C(CO1)O)=O,2,1,0,1,17,4.8e-05
G5,C(C1(C(C(C(C)C1O)=O)=O)O)(O)=O,8,2,0,2,42,9.6e-05
G5,C(C1(C(C(C(C1O)O)=O)=O)C)(O)=O,8,1,0,1,42,4.8e-05
G5,C1(C(C)C(C(C1(C(O)=O)O)=O)O)=O,8,2,0,2,42,9.6e-05
G5,C(C1(C(C(C(C1O)=O)O)=O)C)(O)=O,8,1,0,1,42,4.8e-05
G5,C(C1(C(O)=O)C(C(CC1)=O)=O)=O,2,1,0,1,45,4.8e-05
G5,C(C1(C(CC(C1)=O)=O)C(O)=O)=O,2,3,0,3,29,0.000143
G5,C(C1(C(O)=O)C(CCC1=O)=O)=O,1,2,0,2,17,9.6e-05
G5,C(C1(C(CC=CC1=O)=O)O)(O)=O,2,4,0,4,32,0.00019099999999999998
G5,C(C(C=O)(C(C(CO)=O)=O)C)(O)=O,2,1,0,1,42,4.8e-05
G5,C(C(C=O)(CO)CC(C=O)=O)(O)=O,2,1,0,1,55,4.8e-05
G5,C(C(C(C(CO)=O)=O)(CO)C)(O)=O,2,1,0,1,42,4.8e-05
G5,C(C(C=O)(C)C(C(CO)=O)O)(O)=O,4,1,0,1,49,4.8e-05
G5,C(C(C=O)(CO)CC(CO)=O)(O)=O,2,1,0,1,55,4.8e-05
G5,C(C(C(C(C)=O)=O)(CO)CO)(O)=O,1,1,0,1,2,4.8e-05
G5,C(C(C=O)(CO)CC=O)(O)=O,2,1,0,1,55,4.8e-05
G5,C(C(C(O)=O)(C(C(C)=O)=O)C)=O,2,1,0,1,45,4.8e-05
G5,C(C(C(C(C)=O)=O)(C)CO)(O)=O,2,1,0,1,27,4.8e-05
G5,C(C(C=O)(C)C(C(C)=O)O)(O)=O,4,1,0,1,27,4.8e-05
G5,C(C(C=O)(C(CO)O)CC=O)(O)=O,4,1,0,1,46,4.8e-05
G5,C(CO)(C(C(O)=O)(CO)CC=O)=O,2,1,0,1,2,4.8e-05
G5,C(C(C(C(CC)=O)=O)(CO)O)(O)=O,2,2,0,2,42,9.6e-05
G5,C(C(C(O)=O)(C(C=O)=O)C)=O,2,1,0,1,49,4.8e-05
G5,C(C(C(C=O)=O)(CO)CC=O)(O)=O,2,1,0,1,55,4.8e-05
G5,C(C(C=O)(CC=O)C(C=O)O)(O)=O,4,1,0,1,43,4.8e-05
G5,C(C(C=O)(C(C)=O)C(CO)=O)(O)=O,2,1,0,1,2,4.8e-05
G5,C(C(C=O)(C(CO)=O)CC=O)(O)=O,2,1,0,1,41,4.8e-05
G5,C(C(C(C=O)=O)(C)C(C=O)O)(O)=O,4,1,0,1,28,4.8e-05
G5,C(C(C(C=O)=O)(C)C(CO)O)(O)=O,4,1,0,1,28,4.8e-05
G5,C(CO)(C(C(O)=O)(C)C(C=O)O)=O,4,1,0,1,28,4.8e-05
G5,C(C(C=O)(C(C=O)=O)CCO)(O)=O,2,1,0,1,29,4.8e-05
G5,C(C(C(C=O)=O)(CO)CCO)(O)=O,2,1,0,1,55,4.8e-05
G5,C(C(C=O)(CCO)C(C=O)O)(O)=O,4,1,0,1,3,4.8e-05
G5,C(C)(C(C(O)=O)(C(CO)=O)CO)=O,2,1,0,1,2,4.8e-05
G5,C(C(C(C=O)=O)(C)CO)(O)=O,2,1,0,1,28,4.8e-05
G5,C(C(C=O)(C)C(C=O)O)(O)=O,4,1,0,1,49,4.8e-05
G5,C(C(C(C)=O)(C(C(C)=O)=O)O)(O)=O,2,2,0,2,25,9.6e-05
G5,C(C(C=O)(C(C(CC)=O)=O)O)(O)=O,2,2,0,2,42,9.6e-05
G5,C(C(C=O)(C(CCC=O)O)O)(O)=O,4,5,0,5,27,0.00023999999999999998
G5,C(C(C(C)=O)(C(C=C)=O)O)(O)=O,2,4,0,4,9,0.00019099999999999998
G5,C(C1(C(C)=O)C(CC(O1)O)O)(O)=O,8,3,0,3,45,0.000144
G5,C(C1(C(C=CC1=O)=O)CO)(O)=O,1,2,0,2,17,9.6e-05
G5,C(C(C=O)(C)C(C=O)(CO)O)(O)=O,4,1,0,1,49,4.8e-05
G5,C(C(C=O)(C(O)=O)C(C(C)=O)=O)=O,1,1,0,1,14,4.8e-05
G5,C(C(C(O)=O)(C(C)=O)C(C=O)=O)=O,2,1,0,1,23,4.8e-05
G5,C(C(C=O)(C(O)=O)C(C)=O)=O,1,1,0,1,6,4.8e-05
G5,C(C(C(O)=O)(C(C)=O)C(C)=O)=O,1,1,0,1,6,4.8e-05
G5,C(C(C=O)(C(O)=O)C(C=O)=O)=O,1,1,0,1,23,4.8e-05
G5,C(C(C(C)=O)(C(C)=O)CO)(O)=O,1,1,0,1,28,4.8e-05
G5,C(C(C=O)(C=O)C(O)=O)=O,1,1,0,1,1,4.8e-05
G5,C(C(C=O)(C)C(C=O)(C=O)O)(O)=O,2,1,0,1,49,4.8e-05
G5,C(C1C(C(C(O)=O)(C(C1)O)O)=O)=O,8,2,0,2,41,9.6e-05
G5,C(C1(C=O)C(C(C(C1)O)O)=O)(O)=O,8,1,0,1,41,4.8e-05
G5,C1(C(C(O)=O)(C(C(C1C)=O)O)O)=O,8,2,0,2,42,9.6e-05
G5,C(C1(C(C(C(C1=O)O)O)=O)C)(O)=O,3,1,0,1,42,4.8e-05
G5,C1(C(C)(CC(C1(C(O)=O)O)=O)O)=O,4,2,0,2,25,9.6e-05
G5,C(C(C(O)=O)(C(C(O)=O)=O)C)=O,2,1,0,1,27,4.8e-05
G5,C(C(C(O)=O)(C(C=O)=O)CC=O)=O,2,1,0,1,33,4.8e-05
G5,C(C(C=O)(C(O)=O)CC=O)=O,1,1,0,1,43,4.8e-05
G5,C(C(C=O)(C)C(C(O)=O)O)(O)=O,4,1,0,1,49,4.8e-05
G5,C(C(C(C(O)=O)=O)(C)CO)(O)=O,2,1,0,1,28,4.8e-05
G5,C(C(C(O)=O)(C(C)=O)CC=O)=O,2,1,0,1,45,4.8e-05
G5,C(C1(C=O)C(CC(CO)O1)=O)(O)=O,4,2,0,2,26,9.6e-05
G5,C1(CC(C=O)OC1(C(O)=O)CO)=O,4,2,0,2,2,9.6e-05
G5,C(C1(C=O)C(CC(CO1)O)=O)(O)=O,4,2,0,2,37,9.6e-05
G5,C1(CC(C=O)OCC1(C(O)=O)O)=O,4,2,0,2,37,9.6e-05
G5,C(C1(C=O)C(C(CCO1)=O)O)(O)=O,4,2,0,2,37,9.6e-05
G5,C1(CCOC(C=O)C1(C(O)=O)O)=O,4,2,0,2,37,9.6e-05
G5,C(C1(C=O)C(CC(CO1)=O)O)(O)=O,4,2,0,2,37,9.6e-05
G5,C(C1(C(C(CCO1)=O)=O)CO)(O)=O,2,2,0,2,2,9.6e-05
G5,C(C1(C(CC(O1)=O)=O)C(C)=O)(O)=O,2,2,0,2,27,9.6e-05
G5,C(C1(C(CC(C1=O)=C)=O)O)(O)=O,2,4,0,4,47,0.00019099999999999998
G5,C(C(C=O)(C(CC=C)=O)O)(O)=O,2,5,0,5,4,0.000239
G5,C(C1(C=O)C(C(C=C1)O)=O)(O)=O,4,2,0,2,17,9.6e-05
G5,C(C1(C(C)=O)C(C=CO1)=O)(O)=O,2,4,0,4,9,0.00019099999999999998
G5,C(C1(C=O)C(CC(O1)=C)=O)(O)=O,2,4,0,4,26,0.00019099999999999998
G5,C(C1(C=O)C(CC=CO1)=O)(O)=O,2,4,0,4,37,0.00019099999999999998
G5,C(C1(C(C2CC(C1O2)O)=O)O)(O)=O,16,2,0,2,9,9.6e-05
G5,C(C12C(CC(C1O)C(O2)O)=O)(O)=O,16,5,0,5,17,0.000239
G5,C(C1(C(C=O)=O)C(CCO1)O)(O)=O,4,2,0,2,39,9.6e-05
G5,C(C(C=O)(C1C(CCO1)=O)O)(O)=O,4,2,0,2,4,9.6e-05
G5,C1(CCOC1(C(O)=O)C(C=O)O)=O,4,2,0,2,4,9.6e-05
G5,C(C(C=O)(C1CC(CO1)=O)O)(O)=O,4,2,0,2,4,9.6e-05
G5,C(C(C=O)(C1CCC(O1)=O)O)(O)=O,4,2,0,2,32,9.6e-05
G5,C(C12C(C(C(CO)O1)OC2)=O)(O)=O,8,2,0,2,17,9.6e-05
G5,C(C12C(C(CO1)OC2CO)=O)(O)=O,8,2,0,2,17,9.6e-05
G5,C1(C(C(O)=O)C2C(CC(O)O2)O1)=O,16,2,0,2,48,9.6e-05
G5,C(C12C(COC1CC(O2)O)=O)(O)=O,8,3,0,3,9,0.000144
G5,C(C12C(C(CC(O1)O)OC2)=O)(O)=O,8,3,0,3,9,0.000144
G5,C1(C(C(O)=O)C2(CC(CO2)O1)O)=O,8,2,0,2,17,9.6e-05
G5,C(C12C(C(C(COC1)O2)O)=O)(O)=O,8,2,0,2,4,9.6e-05
G5,C(C1(C(C2COCC1O2)=O)O)(O)=O,8,2,0,2,4,9.6e-05
G5,C(C12C(CC(COC1)(O2)O)=O)(O)=O,4,3,0,3,36,0.000144
G5,C(C1(C(C2CCOC1O2)=O)O)(O)=O,8,2,0,2,4,9.6e-05
G5,C(C1(C=O)C(CCC(O1)=O)O)(O)=O,4,2,0,2,37,9.6e-05
G5,C(C1C(OC(C=O)CC1O)=O)(O)=O,8,1,0,1,48,4.8e-05
G5,C1(C(C)OCC(C1(C(O)=O)O)=O)=O,4,2,0,2,24,9.6e-05
G5,C(C1C(OC(C(C1O)=O)C)=O)(O)=O,8,1,0,1,24,4.8e-05
G5,C(C1(C(CCOC1(C)O)=O)O)(O)=O,4,3,0,3,9,0.000144
G5,C(C1(C(C(C)OCC1O)=O)O)(O)=O,8,2,0,2,4,9.6e-05
G5,C(C12C(C(C(CO1)O)OC2)=O)(O)=O,8,2,0,2,17,9.6e-05
G5,C(C12C(C(CO1)OCC2O)=O)(O)=O,8,2,0,2,17,9.6e-05
G5,C(C12C(C(C(CO1)OC2)O)=O)(O)=O,8,2,0,2,4,9.6e-05
G5,C(C1(C(C2COC1CO2)=O)O)(O)=O,8,2,0,2,4,9.6e-05
G5,C(C12C(CC(CO1)(O)OC2)=O)(O)=O,4,3,0,3,54,0.000144
G5,C1(C(C(O)=O)C(C(CCO1)O)O)=O,8,1,0,1,29,4.8e-05
G5,C(C1(C(COCCC1O)=O)O)(O)=O,4,2,0,2,4,9.6e-05
G5,C(C1(C(CCCOC1O)=O)O)(O)=O,4,3,0,3,29,0.000144
G5,C1(C(C(O)=O)C2C(CC(O2)O1)O)=O,16,1,0,1,43,4.8e-05
G5,C(C12C(COC(CC1O)O2)=O)(O)=O,8,2,0,2,17,9.6e-05
G5,C(C1(C=O)C(CCC(O1)=O)=O)(O)=O,2,2,0,2,27,9.6e-05
G5,C(C1(C(C=C(CO)C1O)=O)O)(O)=O,4,2,0,2,46,9.6e-05
G5,C(C1(C=CC(C1=O)=O)CO)(O)=O,2,2,0,2,17,9.6e-05
G5,C(C(C=O)(C(CO)=O)C=C)(O)=O,2,2,0,2,4,9.6e-05
G5,C(C(C=O)(C(C=CC=O)=O)O)(O)=O,4,2,0,2,46,9.6e-05
G5,C(C(C=O)(C(C=C)=O)O)(O)=O,2,5,0,5,0,0.000239
G5,C(C(C=O)(C(C=CC)=O)O)(O)=O,4,3,0,3,28,0.000144
G5,C(C(C(C=CC)=O)(CO)O)(O)=O,4,3,0,3,28,0.000144
G5,C(C(C(CC=C)=O)(CO)O)(O)=O,2,3,0,3,28,0.000144
G5,C(C(C=C)(C(C=O)=O)CO)(O)=O,2,2,0,2,4,9.6e-05
G5,C(C(C(CO)=O)(C=C)CO)(O)=O,2,2,0,2,4,9.6e-05
G5,C(C(C=O)(C=C)C(C=O)O)(O)=O,4,2,0,2,4,9.6e-05
G5,C(C1(C(C=C(CO)O1)=O)CO)(O)=O,2,2,0,2,2,9.6e-05
G5,C(C1(C=O)C(C=C(C)O1)=O)(O)=O,2,3,0,3,26,0.000144
G5,C(C1(C(C=C(CO)OC1)=O)O)(O)=O,2,2,0,2,32,9.6e-05
G5,C(C1(C(C=CC(O1)=O)=O)CO)(O)=O,2,2,0,2,2,9.6e-05
G5,C1(C(C(O)=O)(C(C=CCO1)=O)O)=O,2,2,0,2,2,9.6e-05
G5,C(C1(C(C=CC(OC1)=O)=O)O)(O)=O,2,2,0,2,46,9.6e-05
G5,C(C1(C(COC1=CCO)=O)O)(O)=O,4,2,0,2,2,9.6e-05
G5,C(C1(C(COC1(C=C)O)=O)O)(O)=O,4,3,0,3,32,0.000144
G5,C(C1(C(C(C=C)OC1O)=O)O)(O)=O,8,3,0,3,2,0.000144
G5,C(C1(C(COC(C1O)=C)=O)O)(O)=O,4,2,0,2,24,9.6e-05
G5,C(C1(C(COC=CC1O)=O)O)(O)=O,4,2,0,2,38,9.6e-05
G5,C(C(C=O)(C1C=CC(O1)=O)O)(O)=O,4,2,0,2,8,9.6e-05
G5,C(C1(C=O)C(C=CC(O1)=O)O)(O)=O,4,2,0,2,8,9.6e-05
G5,C(C(C=O)(C(C=C)O)O)(O)=O,4,6,0,6,27,0.00028700000000000004
G5,C(C1(C=O)C(C)(CC(O1)O)O)(O)=O,8,3,0,3,6,0.000144
G5,C(C1(C=O)COC(C1O)O)(O)=O,8,2,0,2,17,9.6e-05
G5,C(C1(C(C(O)OC1C)=O)CO)(O)=O,8,2,0,2,4,9.6e-05
G5,C(C1(C=O)C(CC(O1)O)O)(O)=O,8,3,0,3,0,0.000144
G5,C(C1(C=O)C(C)OC(C1O)O)(O)=O,16,2,0,2,4,9.6e-05
G5,C(C1(C(C(O)OC1)=O)O)(O)=O,4,3,0,3,0,0.000144
G5,C(C1(C(COC1(C)O)=O)O)(O)=O,4,3,0,3,0,0.000144
G5,C(C1(C(COC1O)=O)O)(O)=O,4,3,0,3,5,0.000144
G5,C1(C(C(O)=O)(C(C(C)(O)O1)O)O)=O,8,3,0,3,17,0.000144
G5,C1(C(C(O)=O)(C(C(O)O1)O)O)=O,8,3,0,3,0,0.000144
G5,C1(C(C(O)=O)C(C(O)O1)O)=O,8,2,0,2,17,9.6e-05
G5,C(C1(C(C(C)OC1O)=O)O)(O)=O,8,3,0,3,0,0.000144
G5,C(C(C=O)(C1(CCCO1)O)O)(O)=O,4,3,0,3,29,0.000144
G5,C1(C(C(O)=O)(C(C(O)O1)(C)O)O)=O,8,3,0,3,45,0.000144
G5,C(C1(C(C2COC1(C2)O)=O)O)(O)=O,8,4,0,4,17,0.00019099999999999998
G5,C(C12C(C(C(C1)(O)OC2)O)=O)(O)=O,8,3,0,3,17,0.000143
G5,C(C1(C=O)C2CC(C(O)O2)O1)(O)=O,16,3,0,3,40,0.000144
G5,C(C1(C(COC(C1O)O)=O)O)(O)=O,8,3,0,3,5,0.000144
G5,C(C1(C(CC(O)OC1)=O)O)(O)=O,4,3,0,3,27,0.000144
G5,C(C1(C(CC(O)OC1C)=O)O)(O)=O,8,3,0,3,4,0.000144
G5,C(C1(C(CCOC1O)=O)O)(O)=O,4,3,0,3,27,0.000144
G5,C(C1(C(CC(C)OC1O)=O)O)(O)=O,8,3,0,3,4,0.000144
G5,C1(C(C(O)=O)(C(CO1)(CO)O)O)=O,4,2,0,2,5,9.6e-05
G5,C1(C(C(O)=O)(C(C(CO)O1)O)O)=O,8,2,0,2,33,9.6e-05
G5,C(C1(C=O)C(C(C(O1)=O)O)O)(O)=O,8,2,0,2,17,9.6e-05
G5,C(C1(C(OC(C=O)C1O)=O)O)(O)=O,8,2,0,2,17,9.6e-05
G5,C1(C(C(O)=O)(C(CO1)(C)O)O)=O,4,3,0,3,27,0.000144
G5,C1(C(C(O)=O)(C(C(CO1)O)O)O)=O,8,2,0,2,33,9.6e-05
G5,C(C1(C(CCC(C1O)O)=O)O)(O)=O,8,3,0,3,7,0.000144
G5,C(C(C=O)(C(C)O)CC=O)(O)=O,4,1,0,1,27,4.8e-05
G5,C(C1(C(C=CC1=O)=O)O)(O)=O,1,3,0,3,47,0.000144
G5,C(C(C=O)(C(C=C)=O)OCO)(O)=O,2,3,0,3,37,0.000144
G5,C(C(C(C)=O)(C(C)(C)O)O)(O)=O,2,2,0,2,0,9.6e-05
G5,C(C(C(C)=O)(C(C=C)O)O)(O)=O,4,4,0,4,0,0.00018999999999999998
G5,C(C(C(C)=O)(C(C=CC)O)O)(O)=O,8,2,0,2,0,9.499999999999999e-05
G5,C(C(C(C)=O)(C(CC=C)O)O)(O)=O,4,2,0,2,0,9.499999999999999e-05
G5,C(C(C(C=O)=O)(C(C(O)=O)O)O)=O,4,2,0,2,5,9.6e-05
G5,C(C(C1(C(CCC1=O)=O)O)O)(O)=O,2,2,0,2,47,9.6e-05
G5,C(C(C(C=O)=O)(C)C(C(O)=O)O)=O,4,1,0,1,49,4.8e-05
G5,C(C(C=O)(C(C)=O)C(C(O)=O)O)=O,2,1,0,1,6,4.8e-05
G5,C(C(C=O)(C=O)C(C(O)=O)O)=O,2,1,0,1,1,4.8e-05
G5,C(C(C=O)(CC=O)C(C(O)=O)O)=O,2,1,0,1,43,4.8e-05
G5,C(C(C(C=C)=O)(C(C(O)=O)O)O)=O,4,2,0,2,0,9.6e-05
G5,C(C(C(C=O)(C(C=C)O)O)O)(O)=O,8,4,0,4,33,0.00019099999999999998
G5,C1(C(O)OCC1(C(C(O)=O)O)O)=O,8,3,0,3,0,0.000143
G5,C1(COC(C1(C(C(O)=O)O)O)O)=O,8,3,0,3,5,0.000143
G5,C1(C(C(C(O)O1)O)C(C(O)=O)O)=O,16,2,0,2,33,9.499999999999999e-05
G5,C(C(C1(C(C=CC1=O)=O)O)O)(O)=O,2,2,0,2,47,9.6e-05
G5,C(C(C=O)(C(C)(C)O)O)(O)=O,2,2,0,2,17,9.6e-05
G5,C(OCC(C(C(O)=O)(C=O)O)O)=O,4,2,0,2,17,9.6e-05
G5,C(C(C=O)(C1(C=COC1)O)O)(O)=O,4,2,0,2,17,9.499999999999999e-05
G5,C(C(C=O)(C(C(CC)=O)O)O)(O)=O,4,2,0,2,17,9.6e-05
G5,C(C(C=O)(C(C=O)(CC)O)O)(O)=O,4,2,0,2,17,9.6e-05
G5,C(C(C=O)(C(C=CC)O)O)(O)=O,8,3,0,3,17,0.000143
G5,C(C(C=O)(C(CC=C)O)O)(O)=O,4,3,0,3,17,0.000143
G5,C(C(C(C)(C)O)(C(C=O)O)O)(O)=O,4,2,0,2,33,9.499999999999999e-05
G5,C(C(C(C)(C)O)(C(C(O)=O)O)O)=O,4,2,0,2,33,9.499999999999999e-05
G5,C(C(C(C=O)O)(C(C=C)O)O)(O)=O,8,2,0,2,33,9.499999999999999e-05
G5,C(C(C(C)(C)O)C(C=O)O)(O)=O,4,1,0,1,29,4.8e-05
G5,C(C(C(C=O)O)C(C=C)O)(O)=O,8,3,0,3,29,0.000143
G5,C(C(C(C=O)O)C(C=CC)O)(O)=O,16,1,0,1,29,4.8e-05
G5,C(C(C(CC=C)O)C(C=O)O)(O)=O,8,1,0,1,29,4.8e-05
G5,C(C(C=O)(C=O)C(C(C)=O)(C)O)=O,2,1,0,1,1,4.8e-05
G5,C(C)(C(C)(C1(C(C=CC1=O)=O)O)O)=O,2,2,0,2,47,9.6e-05
G5,C(C(C=O)(C=O)C(C)(CC=O)O)=O,2,1,0,1,1,4.8e-05
G5,C(C(C=O)(C=O)C(CC(C)=O)O)=O,2,1,0,1,1,4.8e-05
G5,C(CC(C)(C1(C(C=CC1=O)=O)O)O)=O,2,2,0,2,47,9.6e-05
G5,C(C)(CC(C1(C(C=CC1=O)=O)O)O)=O,2,2,0,2,47,9.6e-05
G5,C1(CCC(C1(C(C(C=C)=O)O)O)=O)=O,2,2,0,2,47,9.6e-05
G5,C(C(C=C)(C1(C(CCC1=O)=O)O)O)=O,2,2,0,2,47,9.6e-05
G5,C(C(C(C=O)=O)(C)C(C(C=C)=O)O)=O,4,1,0,1,49,4.8e-05
G5,C(C(C(C=O)=O)(C)C(C=O)(C=C)O)=O,4,1,0,1,49,4.8e-05
G5,C(C(C=O)(C(C)=O)C(C(C=C)=O)O)=O,2,1,0,1,6,4.8e-05
G5,C(C(C=O)(C(C)=O)C(C=O)(C=C)O)=O,2,1,0,1,6,4.8e-05
G5,C(C(C=O)(C=O)C(C(C=C)=O)O)=O,2,1,0,1,1,4.8e-05
G5,C(C(C=O)(C=O)C(C=O)(C=C)O)=O,2,1,0,1,1,4.8e-05
G5,C(C(C=O)(CC=O)C(C(C=C)=O)O)=O,2,1,0,1,43,4.8e-05
G5,C(C(C=O)(CC=O)C(C=O)(C=C)O)=O,2,1,0,1,43,4.8e-05
G5,C(C(C(C=C)=O)(C(C(C=C)=O)O)O)=O,4,2,0,2,0,9.6e-05
G5,C(C(C=C)(C(C=O)(C(C=C)=O)O)O)=O,4,2,0,2,0,9.6e-05
G5,C=CC(C(C1(C(C=CC1=O)=O)O)O)=O,2,2,0,2,47,9.6e-05
G5,C(C(C=C)(C1(C(C=CC1=O)=O)O)O)=O,2,2,0,2,47,9.6e-05
G5,C(C(C=O)(C=O)C(C=C)(CO)O)=O,2,1,0,1,1,4.8e-05
G5,C=CC(CO)(C1(C(C=CC1=O)=O)O)O,2,2,0,2,47,9.6e-05
G5,C1(CCC(C1(C(C=CC=O)O)O)=O)=O,4,2,0,2,47,9.6e-05
G5,C(C(C(C=O)=O)(C)C(C=CC=O)O)=O,8,1,0,1,49,4.8e-05
G5,C(C(C=O)(C(C)=O)C(C=CC=O)O)=O,4,1,0,1,6,4.8e-05
G5,C(C(C=O)(C=O)C(C=CC=O)O)=O,4,1,0,1,1,4.8e-05
G5,C(C(C=O)(CC=O)C(C=CC=O)O)=O,4,1,0,1,43,4.8e-05
G5,C(C(C(C=C)=O)(C(C=CC=O)O)O)=O,8,2,0,2,0,9.6e-05
G5,C(C(C1(C(C=CC1=O)=O)O)O)=CC=O,4,2,0,2,47,9.6e-05
G5,C1(C(C(CO1)O)(C(C)(C)O)O)=O,4,2,0,2,40,9.499999999999999e-05
G5,C1(C(C(CO1)O)(C(C=C)O)O)=O,8,4,0,4,40,0.00018999999999999998
G5,C1(C(C(CO1)O)(C(C=CC)O)O)=O,16,2,0,2,40,9.499999999999999e-05
G5,C1(C(C(CC=C)O)(C(CO1)O)O)=O,8,2,0,2,40,9.499999999999999e-05
G5,C(C(C=O)(C1C(OCC1O)=O)O)=O,4,1,0,1,8,4.8e-05
G5,C1(C(C(CO1)O)C(C(C=O)=O)O)=O,8,1,0,1,8,4.8e-05
G5,C1(C(C(CO1)O)C(C)(C)O)=O,4,1,0,1,8,4.8e-05
G5,C(OCC(C1C(OCC1O)=O)O)=O,8,1,0,1,8,4.8e-05
G5,C1(C(C(CO1)O)C(CCC=O)O)=O,8,2,0,2,27,9.499999999999999e-05
G5,C1(C(C(C(C=C)O)O)C(CO1)O)=O,16,1,0,1,8,4.8e-05
G5,C1(C(C(CO1)O)C2(C=COC2)O)=O,8,1,0,1,8,4.8e-05
G5,C1(C(C(CO1)O)C(C(CC)=O)O)=O,8,1,0,1,8,4.8e-05
G5,C1(C(C(CO1)O)C(C=O)(CC)O)=O,8,1,0,1,8,4.8e-05
G5,C1(C(C(CO1)O)C(C=C)O)=O,8,3,0,3,8,0.000143
G5,C1(C(C(CO1)O)C(C=CC)O)=O,16,2,0,2,8,9.499999999999999e-05
G5,C1(C(C(CC=C)O)C(CO1)O)=O,8,2,0,2,8,9.499999999999999e-05
G5,C(C(C(C(C)O)=O)(C(C)(C)O)O)=O,4,2,0,2,0,9.499999999999999e-05
G5,C(C(C)O)(C(C=O)(C(C=C)O)O)=O,8,2,0,2,0,9.499999999999999e-05
G5,C(C(C(C=O)=O)(C(C(C)O)O)O)=O,8,2,0,2,5,9.6e-05
G5,C(C)(C(C(C)=O)(C(C(C)O)O)O)=O,4,2,0,2,49,9.6e-05
G5,C1(CCC(C1(C(C(C)O)O)O)=O)=O,4,2,0,2,47,9.6e-05
G5,C(C(CO)(C(C(C)O)O)CC=O)=O,8,2,0,2,55,9.6e-05
G5,C(C(C(C=O)=O)(C)C(C(C)O)O)=O,8,1,0,1,49,4.8e-05
G5,C(C(C(C)(CO)C(C(C)O)O)=O)=O,8,1,0,1,28,4.8e-05
G5,C(C(C)(C(C(C)O)O)C(C=O)O)=O,16,1,0,1,49,4.8e-05
G5,C(C(C=O)(C(C)=O)C(C(C)O)O)=O,4,1,0,1,6,4.8e-05
G5,C(C(C=O)(C=O)C(C(C)O)O)=O,4,1,0,1,1,4.8e-05
G5,C(C(C=O)(C(C(C)O)O)CC=O)=O,4,1,0,1,43,4.8e-05
G5,C(C(C(C=C)=O)(C(C(C)O)O)O)=O,8,2,0,2,0,9.6e-05
G5,C1(C(O)OCC1(C(C(C)O)O)O)=O,16,3,0,3,0,0.000143
G5,C1(COC(C1(C(C(C)O)O)O)O)=O,16,3,0,3,5,0.000143
G5,C1(C(C(C(O)O1)O)C(C(C)O)O)=O,32,2,0,2,11,9.499999999999999e-05
G5,C1(C=CC(C1(C(C(C)O)O)O)=O)=O,4,2,0,2,47,9.6e-05
G5,C(C(CO)(C(C)(C)O)O)(O)=O,2,2,0,2,33,9.6e-05
G5,C(OCC(C(C(O)=O)(CO)O)O)=O,4,2,0,2,33,9.499999999999999e-05
G5,C(C(CO)(C1(C=COC1)O)O)(O)=O,4,2,0,2,33,9.499999999999999e-05
G5,C(C(CO)(C(C(CC)=O)O)O)(O)=O,4,2,0,2,33,9.499999999999999e-05
G5,C(C(CO)(C(C=O)(CC)O)O)(O)=O,4,2,0,2,33,9.499999999999999e-05
G5,C(C(CO)(C(C=CC)O)O)(O)=O,8,3,0,3,33,0.000143
G5,C(C(CO)(C(CC=C)O)O)(O)=O,4,3,0,3,33,0.000143
G5,C(C(C(C)O)(C(C)(C)O)O)(O)=O,4,2,0,2,4,9.499999999999999e-05
G5,C(C(C(C)O)(C(C=C)O)O)(O)=O,8,4,0,4,4,0.00018999999999999998
G5,C(C(C(C)O)(C(C=CC)O)O)(O)=O,16,2,0,2,4,9.499999999999999e-05
G5,C(C(C(CC=C)O)(C(C)O)O)(O)=O,8,2,0,2,4,9.499999999999999e-05
G5,C(C(C=O)(C1(C(COC1)=O)O)O)=O,2,2,0,2,10,9.6e-05
G5,C1(COCC1(C(C(C=O)=O)O)O)=O,4,2,0,2,10,9.6e-05
G5,C1(COCC1(C(C)(C)O)O)=O,2,2,0,2,10,9.6e-05
G5,C(OCC(C1(C(COC1)=O)O)O)=O,4,2,0,2,10,9.6e-05
G5,C(CCC(C1(C(COC1)=O)O)O)=O,4,3,0,3,10,0.000143
G5,C1(COCC1(C(C(C=C)O)O)O)=O,8,2,0,2,10,9.6e-05
G5,C1(COCC1(C2(C=COC2)O)O)=O,4,2,0,2,10,9.6e-05
G5,C1(COCC1(C(C(CC)=O)O)O)=O,4,2,0,2,10,9.6e-05
G5,C(C(CC)(C1(C(COC1)=O)O)O)=O,4,2,0,2,10,9.6e-05
G5,C1(COCC1(C(C=C)O)O)=O,4,4,0,4,10,0.00018999999999999998
G5,C1(COCC1(C(C=CC)O)O)=O,8,3,0,3,10,0.000143
G5,C1(COCC1(C(CC=C)O)O)=O,4,3,0,3,10,0.000143
G5,C1(CC2C(CC1(C2(CO)O)O)O)=O,16,1,0,1,7,4.7e-05
G5,C1(CCC2(C(C(CC12O)O)O)O)=O,16,1,0,1,7,4.7e-05
G5,C1(CC(C2(CC(CC12O)O)O)O)=O,16,1,0,1,22,4.7e-05
G5,C1(CC(C2C(C1(CC2O)O)O)O)=O,32,1,0,1,13,4.7e-05
G5,C(C)(C1(C(C(CO)C(C1)O)O)O)=O,16,1,0,1,45,4.7e-05
G5,C(C1(C(CC(C(C1)=O)O)O)O)(O)=O,8,1,0,1,33,4.7e-05
G5,C(C1(C(C(CO)C(C1)O)O)O)(O)=O,16,1,0,1,33,4.7e-05
G5,C(C1C(C(C=O)(CC1O)O)O)(O)=O,16,1,0,1,43,4.7e-05
G5,C1(C(C(C(C1(C)O)O)C(C)O)O)=O,32,1,0,1,25,4.7e-05
G5,C(CO)(C1(C(CC(C1)=O)O)O)=O,4,2,0,2,51,9.499999999999999e-05
G5,C1(C(C)(C(C(O)=O)(CC1O)O)O)=O,8,1,0,1,49,4.7e-05
G5,C1(C(C)(C(C(C)=O)(CC1O)O)O)=O,8,1,0,1,14,4.7e-05
G5,C(C1(C(CC(C1)=O)O)O)(C(C)O)=O,8,1,0,1,9,4.7e-05
G5,C(C(C=O)C1(C(C=CC1(C)O)=O)O)=O,4,1,0,1,45,4.7e-05
G5,C(C(C=O)C1(C(C=CCC1O)=O)O)=O,4,1,0,1,45,4.7e-05
G5,C(C(C=O)C1(C(CC=CC1O)=O)O)=O,4,1,0,1,45,4.7e-05
G5,C(C1C2CC(C(C1O)(O)O2)=O)(O)=O,16,1,0,1,23,4.7e-05
G5,C(C1(CC(CC(C1O)=O)=O)O)(O)=O,4,1,0,1,33,4.7e-05
G5,C1(CC(C(C=C)=O)(C(C(C1)=O)O)O)=O,4,1,0,1,7,4.7e-05
G5,C(C1(CC(CC1(C(C=C)=O)O)=O)O)=O,4,1,0,1,7,4.7e-05
G5,C(C1(C(CC(C1)=O)O)O)(CC=O)=O,4,1,0,1,23,4.7e-05
G5,C=CC(C1(C(CC(C(C1)=O)=O)O)O)=O,4,1,0,1,14,4.7e-05
G5,C1(CC(C(C=C)=O)(C(C1)O)O)=O,4,2,0,2,7,9.499999999999999e-05
G5,C(C1(CC(C=O)(C(C1O)O)O)O)=O,10,1,0,1,0,4.7e-05
G5,C(C)(C1(C(C(C(C1)O)O)O)O)=O,16,1,0,1,0,4.7e-05
G5,C(C1(C(C(C(C(C1)O)O)O)O)O)=O,32,3,0,3,29,0.000164
G5,C(C1(CC(CC1(C(C)=O)O)O)O)=O,8,2,0,2,22,9.499999999999999e-05
G5,C1(C(C)(C(C=O)(CC1O)O)O)=O,8,2,0,2,32,9.499999999999999e-05
G5,C1(CC(C(C)=O)(C(C(C1)=O)O)O)=O,4,1,0,1,45,4.7e-05
G5,C(C1(CC(CC1(C(C)=O)O)=O)O)=O,4,1,0,1,45,4.7e-05
G5,C(C)(C1(C(CC(C(C1)=O)=O)O)O)=O,4,1,0,1,45,4.7e-05
G5,C(C)(C1(C(CC(C1)=O)O)O)=O,4,2,0,2,49,9.499999999999999e-05
G5,C1C(C)(C(C(C=1)=O)(CC(C=O)=O)O)O,4,1,0,1,45,4.7e-05
G5,C(C)(C1(CC(C=CC(C1O)=O)=O)O)=O,4,1,0,1,45,4.7e-05
G5,C(C1(C=CC(CC1(C(C)=O)O)=O)O)=O,4,1,0,1,45,4.7e-05
G5,C1CC(C(C(C=1)=O)(CC(C=O)=O)O)O,4,1,0,1,45,4.7e-05
G5,C(C1C=CC(C(C1(C(C)=O)O)O)=O)=O,8,1,0,1,45,4.7e-05
G5,C(C1C=CC(C=O)(C1(C(C)=O)O)O)=O,8,1,0,1,45,4.7e-05
G5,C(C)(C1(CC(C(C=CC1O)=O)=O)O)=O,4,1,0,1,45,4.7e-05
G5,C(C1C(C=CC(C1(C(C)=O)O)O)=O)=O,8,1,0,1,45,4.7e-05
G5,C1(C(CC(C=O)=O)(C(C=CC1)O)O)=O,4,1,0,1,45,4.7e-05
G5,C(C)(C1(C(C=CC1C(C=O)=O)O)O)=O,8,1,0,1,45,4.7e-05
G5,C1(CC(C(C=C)=O)(C(C1O)O)O)=O,8,1,0,1,1,4.7e-05
G5,C(C1(CC(CC(C1O)=O)=O)O)=O,4,3,0,3,29,0.00014199999999999998
G5,C(C1(CC(CC1(C=O)O)=O)O)=O,3,2,0,2,0,9.499999999999999e-05
G5,C(C1(CC(C=CC(C1O)=O)=O)O)=O,4,1,0,1,0,4.7e-05
G5,C(C1(C=CC(CC1(C=O)O)=O)O)=O,4,1,0,1,0,4.7e-05
G5,C(C1C=CC(C(C1(C=O)O)O)=O)=O,8,1,0,1,45,4.7e-05
G5,C(C1C=CC(C=O)(C1(C=O)O)O)=O,8,1,0,1,45,4.7e-05
G5,C(C1(CC(C(C=CC1O)=O)=O)O)=O,4,1,0,1,0,4.7e-05
G5,C(C1C(C=CC(C1(C=O)O)O)=O)=O,8,1,0,1,45,4.7e-05
G5,C(C1(C(C=CC1C(C=O)=O)O)O)=O,8,1,0,1,0,4.7e-05
G5,C(C1(C(C(CO)C(C1)O)O)O)=O,16,1,0,1,43,4.7e-05
G5,C(C1(C(C(CO1)O)(CCO)O)O)=O,8,1,0,1,2,4.7e-05
G5,C(C1(C(C(CO)O)(CCO1)O)O)=O,8,1,0,1,30,4.7e-05
G5,C(C1(C(CO)(C(CO)CO1)O)O)=O,8,1,0,1,30,4.7e-05
G5,C1(C2(C(C(C(C1)O2)CO)O)O)=O,16,1,0,1,23,4.7e-05
G5,C(C1(C(CC(C1)=O)O)O)(CCO)=O,4,1,0,1,30,4.7e-05
G5,C(C)(C1(CC(CC1(CO)O)O)O)=O,8,1,0,1,49,4.7e-05
G5,C(C)(C1(CC(C(C1(C)O)O)O)O)=O,16,1,0,1,45,4.7e-05
G5,C1(C(CC(CO)(C1(C)O)O)O)=O,8,1,0,1,49,4.7e-05
G5,C(C1(C(C(C(C1)O)C(C)O)O)O)=O,32,1,0,1,43,4.7e-05
G5,C(C1(CC(C(C1(C=C)O)O)O)O)=O,16,1,0,1,7,4.7e-05
G5,C1(CC2(CC(C1(C2CO)O)O)O)=O,16,1,0,1,30,4.7e-05
G5,C1(CC(C2C(CC(C12O)O)O)O)=O,32,1,0,1,4,4.7e-05
G5,C(C1(CC(C=O)(CC1O)O)O)=O,8,1,0,1,20,4.7e-05
G5,C(C)(C1(C(CC(C1)O)O)O)=O,8,1,0,1,45,4.7e-05
G5,C(C1(C(CC(C1CO)O)O)O)=O,16,1,0,1,43,4.7e-05
G5,C(C1(C(CC(C1C(C)O)O)O)O)=O,32,1,0,1,4,4.7e-05
G5,C(C1(C(CC(CC(C1)O)O)O)O)=O,16,1,0,1,4,4.7e-05
G5,C(CO)(C1(C(CC(C1)O)O)O)=O,8,1,0,1,41,4.7e-05
G5,C(C1(C(CC(C(C1)O)O)O)O)=O,16,1,0,1,4,4.7e-05
G5,C(C1(CCC(C(CC1O)O)=O)O)=O,8,1,0,1,7,4.7e-05
G5,C(C1(CCC(C=O)(C(C1)O)O)O)=O,8,1,0,1,29,4.7e-05
G5,C1(C(C)(C(CC(C(C1)=O)O)O)O)=O,8,1,0,1,45,4.7e-05
G5,C(C1(CC(C(C(C1)=O)(C)O)O)O)=O,8,1,0,1,4,4.7e-05
G5,C(C(C)=O)(C1(C(CC(C1)O)O)O)=O,8,1,0,1,9,4.7e-05
G5,C1(C(C(CC1(C)O)O)(CC=O)O)=O,8,1,0,1,6,4.7e-05
G5,C1(C(CC(CC(C1(C)O)O)O)=O)=O,8,1,0,1,4,4.7e-05
G5,C1(C(C(CC1O)(C)O)(CC=O)O)=O,8,1,0,1,26,4.7e-05
G5,C1(C(C(CC1O)O)(CC(C)=O)O)=O,8,1,0,1,26,4.7e-05
G5,C(C(C1(CC(C)(CC1O)O)O)=O)=O,8,1,0,1,6,4.7e-05
G5,C1(C(C(CCC1O)O)(CC=O)O)=O,8,1,0,1,27,4.7e-05
G5,C(CCC1(C(C(CC1O)O)=O)O)=O,8,2,0,2,27,9.499999999999999e-05
G5,C(C(C1(C(CC(CC1)O)O)O)=O)=O,8,1,0,1,27,4.7e-05
G5,C1(C(CC(C1(C=CCO)O)O)O)=O,16,1,0,1,29,4.7e-05
G5,C(CO)(C1(C=CC(CC1O)O)O)=O,8,1,0,1,32,4.7e-05
G5,C1(C(C(CC(C1(C=C)O)O)O)O)=O,16,1,0,1,31,4.7e-05
G5,C(C1(C=CC(C(CC1O)O)O)O)=O,16,1,0,1,32,4.7e-05
G5,C1(C2(C(CC(C2)(C1CO)O)O)O)=O,16,1,0,1,30,4.7e-05
G5,C(C)(C12CC(C(O1)O)(CC2O)O)=O,16,3,0,3,22,0.00014199999999999998
G5,C1(C2(C(CC(C(C1)O2)(C)O)O)O)=O,16,1,0,1,22,4.7e-05
G5,C1(C2(C(CC(CC(C1)O2)O)O)O)=O,16,1,0,1,13,4.7e-05
G5,C1(C2(C(C(C(C1)O2)C(C)O)O)O)=O,32,1,0,1,23,4.7e-05
G5,C1(CC(OC21C(CC(C2)O)O)O)=O,16,2,0,2,13,9.499999999999999e-05
G5,C1(COCC2(CC1(C(C2)O)O)O)=O,8,1,0,1,36,4.7e-05
G5,C1(C2(C(CC(CCO2)(C1)O)O)O)=O,8,1,0,1,30,4.7e-05
G5,C1(C2(C(CC(CC1)(CO2)O)O)O)=O,8,1,0,1,29,4.7e-05
G5,C(CC1(C(C=CC1(C)O)=O)O)=O,4,2,0,2,29,9.499999999999999e-05
G5,C(CC1(C(C=CCC1O)=O)O)=O,4,2,0,2,13,9.499999999999999e-05
G5,C(CC1(C(CC=CC1O)=O)O)=O,4,2,0,2,13,9.499999999999999e-05
G5,C1(C(COC21C(CC(C2)O)O)O)=O,16,1,0,1,9,4.7e-05
G5,C1(C(CC(C21CC(CO2)O)O)O)=O,16,1,0,1,39,4.7e-05
G5,C(C12C(CC(C(C(C1)O)O2)O)O)=O,32,1,0,1,40,4.7e-05
G5,C(C12CC(CC1O)(C(C)(O2)O)O)=O,16,3,0,3,21,0.00014199999999999998
G5,C1(C(C2C(CC(C1(C)O2)O)O)O)=O,32,1,0,1,29,4.7e-05
G5,C(C12CC(CC1O)(CC(O2)O)O)=O,16,3,0,3,4,0.00014199999999999998
G5,C(C1(CC(C)(C(C1O)O)O)O)(O)=O,16,1,0,1,26,4.7e-05
G5,C(C1(C(CC(C(C1)O)O)O)O)(O)=O,16,1,0,1,29,4.7e-05
G5,C(C1(C(C(CC(C1)O)O)O)O)(O)=O,16,1,0,1,20,4.7e-05
G5,C(C1(C(CC(C1CO)O)O)O)(O)=O,16,1,0,1,33,4.7e-05
G5,C(C1(C=CCC1O)O)(O)=O,4,2,0,2,9,9.499999999999999e-05
G5,C(C1(CC=CC1O)O)(O)=O,4,2,0,2,9,9.499999999999999e-05
G5,C1(C(C)(C(C(C1O)=O)O)O)=O,8,1,0,1,1,4.7e-05
G5,C(C1(C(C)(C(CO)(CO1)O)O)O)=O,8,2,0,2,25,9.499999999999999e-05
G5,C(C1(C=COCC1O)O)=O,4,2,0,2,37,9.499999999999999e-05
G5,C(C1(C(COC(C1)=O)O)O)=O,4,3,0,3,29,0.00014199999999999998
G5,C1(C(C)(C(CC(C1O)=O)O)O)=O,8,1,0,1,9,4.7e-05
G5,C1(C(C)(C(C(C(C1)=O)O)O)O)=O,8,1,0,1,5,4.7e-05
G5,C1(C(CO)(CC(C1(C)O)O)O)=O,8,1,0,1,25,4.7e-05
G5,C(C(C1(C(C(C(C1)O)O)O)O)=O)=O,16,1,0,1,0,4.7e-05
G5,C(C1(CC(C)(C(C1O)O)O)O)=O,16,1,0,1,0,4.7e-05
G5,C1(C(C)(C(C(C1(C)O)O)O)O)=O,10,1,0,1,49,4.7e-05
G5,C1(C(CC(C1(CCO)O)O)=O)=O,4,1,0,1,31,4.7e-05
G5,C(C1(C=CC(C1(CO)O)O)O)=O,8,2,0,2,51,9.499999999999999e-05
G5,C(CO)(C1(C=CC(C1O)O)O)=O,8,2,0,2,51,9.499999999999999e-05
G5,C(C1(C(C(CC(C1)O)O)O)O)=O,16,1,0,1,21,4.7e-05
G5,C1(C(C)(C(C=O)(CCC1O)O)O)=O,8,1,0,1,12,4.7e-05
G5,C(C1(CCC(C1O)=O)O)(C(C)O)=O,8,2,0,2,12,9.499999999999999e-05
G5,C1(C(CC(C1(CC(C)O)O)O)=O)=O,8,1,0,1,9,4.7e-05
G5,C1(C(C)(C(C(C=CC1O)O)O)O)=O,16,1,0,1,32,4.7e-05
G5,C(C1(C=CC(C1(C(C)O)O)O)O)=O,16,1,0,1,32,4.7e-05
G5,C(C(C)O)(C1(C=CC(C1O)O)O)=O,16,1,0,1,32,4.7e-05
G5,C1(C(C)(C(C(CO)O1)O)O)=O,8,2,0,2,2,9.499999999999999e-05
G5,C1(C(C)(C(C(CO1)O)O)O)=O,8,2,0,2,41,9.499999999999999e-05
G5,C1(C(O)OCC(C1(C)O)O)=O,8,2,0,2,19,9.499999999999999e-05
G5,C1(COC(C(C1(C)O)O)O)=O,8,2,0,2,2,9.499999999999999e-05
G5,C(C1(C(C(C)(C(C1)O)O)=O)O)=O,8,1,0,1,29,4.7e-05
G5,C(C1(C=CC(CO)(C1O)O)O)=O,8,3,0,3,29,0.00014199999999999998
G5,C(C1(C=CC(C1O)(C(C)O)O)O)=O,16,1,0,1,32,4.7e-05
G5,C1(C2(CC(CC2O)O1)O)=O,8,3,0,3,9,0.00014199999999999998
G5,C(C(C1(CC(CO)CC1O)O)=O)=O,8,1,0,1,55,4.7e-05
G5,C(C1CC(C(CO)=O)(C(C1)O)O)=O,8,1,0,1,25,4.7e-05
G5,C(C(C(C1(C(CCC1)O)O)=O)O)=O,8,1,0,1,27,4.7e-05
G5,C(C1(C(C(CC1CC=O)O)O)O)=O,16,1,0,1,27,4.7e-05
G5,C(C1(CC(CC1O)C(C=O)O)O)=O,16,1,0,1,27,4.7e-05
G5,C(C1(CC(C(C1O)O)CC=O)O)=O,16,1,0,1,27,4.7e-05
G5,C(C)(C1(C(C(CO)(CO1)O)O)O)=O,8,2,0,2,41,9.499999999999999e-05
G5,C1(CC2(C(CC1(C2(C)O)O)O)O)=O,16,1,0,1,45,4.7e-05
G5,C(C)(C1(C(C(C)(C(C1)O)O)O)O)=O,16,1,0,1,11,4.7e-05
G5,C(C1(C=CC(C=O)(C1O)O)O)(O)=O,8,1,0,1,17,4.7e-05
G5,C(C1(C(C(C)(C(C1)O)O)O)O)(O)=O,16,1,0,1,11,4.7e-05
G5,C(C1(C(C(C)(C(C1)O)O)O)O)=O,16,1,0,1,11,4.7e-05
G5,C(C1(C(C)(CC(C1)=O)O)O)=O,4,2,0,2,49,9.499999999999999e-05
G5,C(C1CC(C=O)(C(C1)O)O)=O,8,2,0,2,21,9.499999999999999e-05
G5,C(C1(C(CC(C(C1)O)=O)O)O)=O,8,1,0,1,32,4.7e-05
G5,C(C1(C=CC(CC1O)=O)O)=O,4,1,0,1,29,4.7e-05
G5,C(C1(C=CC(C1(C)O)=O)O)=O,4,1,0,1,29,4.7e-05
G5,C1(CC(C(C=O)(C1C=O)O)O)=O,8,2,0,2,43,9.499999999999999e-05
G5,C1(C(C)(C(C=O)(CC1)O)O)=O,4,2,0,2,49,9.499999999999999e-05
G5,C(C1C=CC(C=O)(C(C1)O)O)=O,8,2,0,2,32,9.499999999999999e-05
G5,C(C1(C=CC(C1O)CC=O)O)=O,8,2,0,2,43,9.499999999999999e-05
G5,C(C1(C=CC(CC1(C)O)=O)O)=O,4,1,0,1,29,4.7e-05
G5,C(C1(C=CC(C1(CC)O)=O)O)=O,4,1,0,1,32,4.7e-05
G5,C1(CCC(C1(C=CC=O)O)O)=O,8,2,0,2,45,9.499999999999999e-05
G5,C(C1CC(C(C1(C=O)O)O)O)=O,16,3,0,3,0,0.00014199999999999998
G5,C(C1CC(C=O)(C(C1O)O)O)=O,16,3,0,3,20,0.00014199999999999998
G5,C1(C2(C(CC(C1O)O2)O)O)=O,16,2,0,2,43,9.499999999999999e-05
G5,C1(C2(CC(CC2O)(O)O1)O)=O,8,3,0,3,29,0.00014199999999999998
G5,C(C)(C1(C=CC(C1O)=O)O)=O,4,2,0,2,49,9.499999999999999e-05
G5,C(C1(C(C)=CC(C1O)=O)O)=O,4,2,0,2,26,9.499999999999999e-05
G5,C(C1(C=CCC1(C=O)O)O)=O,4,3,0,3,20,0.00014199999999999998
G5,C(C1(C=C(CO)CC1O)O)=O,4,2,0,2,21,9.499999999999999e-05
G5,C(C1(CC(CO)=CC1O)O)=O,4,2,0,2,21,9.499999999999999e-05
G5,C(C1(C(C(CC1O)=O)=C)O)=O,4,2,0,2,2,9.499999999999999e-05
G5,C(C1(CC(C(C1O)=C)=O)O)=O,4,2,0,2,2,9.499999999999999e-05
G5,C(C1(C=C(C(C1O)=O)CO)O)=O,4,2,0,2,15,9.499999999999999e-05
G5,C(C1(C=C(C=O)C(C1O)O)O)=O,8,2,0,2,29,9.499999999999999e-05
G5,C(C1(C(C=O)=CC(C1O)O)O)=O,8,3,0,3,29,0.00014199999999999998
G5,C(C1(CC=CC1(CO)O)O)=O,4,2,0,2,21,9.499999999999999e-05
G5,C(C1(C=CCC1(CO)O)O)=O,4,2,0,2,21,9.499999999999999e-05
G5,C(C)(C1(C=CC(C1O)O)O)=O,8,2,0,2,49,9.499999999999999e-05
G5,C(C1(C=CC(C1(C)O)O)O)=O,8,2,0,2,49,9.499999999999999e-05
G5,C(C1(C=CCC1O)O)=O,4,2,0,2,43,9.499999999999999e-05
G5,C(C1(CC=CC1O)O)=O,4,2,0,2,43,9.499999999999999e-05
G5,C1(CCC(C(C1(C=C)O)O)=O)=O,4,2,0,2,12,9.499999999999999e-05
G5,C1(CCC(C=O)(C1(C=C)O)O)=O,4,3,0,3,12,0.00014199999999999998
G5,C(C)(C1(CC(C=CC1O)=O)O)=O,4,2,0,2,45,9.499999999999999e-05
G5,C(C)(C1(CC(C=O)=CC1O)O)=O,4,2,0,2,29,9.499999999999999e-05
G5,C(C)(C1(C=C(C=O)CC1O)O)=O,4,2,0,2,29,9.499999999999999e-05
G5,C(CC(C1(CC=CC1O)O)=O)=O,4,2,0,2,13,9.499999999999999e-05
G5,C(CC=O)(C1(C=CCC1O)O)=O,4,2,0,2,13,9.499999999999999e-05
G5,C(C1(C(CCC1O)=CC=O)O)=O,8,2,0,2,29,9.499999999999999e-05
G5,C(C1(C(CC=O)=CCC1O)O)=O,4,2,0,2,44,9.499999999999999e-05
G5,C(C1(CC(C(C)=O)=CC1O)O)=O,4,2,0,2,29,9.499999999999999e-05
G5,C(C1(C=C(C(C)=O)CC1O)O)=O,4,2,0,2,29,9.499999999999999e-05
G5,C(C1(CC(C(C)=CC1O)=O)O)=O,4,2,0,2,21,9.499999999999999e-05
G5,C(C1(C(CC(C(C1)=O)=C)O)O)=O,4,2,0,2,21,9.499999999999999e-05
G5,C(CC1CC(C=O)(C(C=1)O)O)=O,4,2,0,2,29,9.499999999999999e-05
G5,C(C1(C(CC(C1)=CC=O)O)O)=O,8,2,0,2,4,9.499999999999999e-05
G5,C(C1(C=C(CC1O)CC=O)O)=O,4,3,0,3,29,0.00014199999999999998
G5,C(C1(CC(CC=CC1O)=O)O)=O,4,2,0,2,26,9.499999999999999e-05
G5,C(C1(C(CC=CC(C1)=O)O)O)=O,4,2,0,2,29,9.499999999999999e-05
G5,C1(CC(C(C=O)(C1C=C)O)O)=O,8,2,0,2,17,9.499999999999999e-05
G5,C(C1(C(C(CC1O)=O)=CC)O)=O,8,2,0,2,17,9.499999999999999e-05
G5,C(C1(C(C(C(C1)=O)C=C)O)O)=O,8,2,0,2,29,9.499999999999999e-05
G5,C(C1(CC(C(C1O)=CC)=O)O)=O,8,2,0,2,29,9.499999999999999e-05
G5,C(C1(C=CC(CO)=CC1O)O)=O,4,2,0,2,32,9.499999999999999e-05
G5,C=CC1(C(C=CC(C1O)O)=O)O,8,2,0,2,29,9.499999999999999e-05
G5,C(C1(C(CO)=CC(C1O)O)O)=O,8,2,0,2,29,9.499999999999999e-05
G5,C(C1(C=C(CO)C(C1O)O)O)=O,8,3,0,3,29,0.00014199999999999998
G5,C(C1(C(C(C(C1O)O)O)=C)O)=O,16,2,0,2,49,9.499999999999999e-05
G5,C(C1(C=CC(C=O)(C1O)O)O)=O,3,2,0,2,29,9.499999999999999e-05
G5,C1(C2(C(CO)(CC(C1)O2)O)O)=O,8,1,0,1,20,4.7e-05
G5,C1(C2(C(CC(CO)(C1)O2)O)O)=O,8,1,0,1,51,4.7e-05
G5,C1(C2(C(C)(C(C(C1)O2)O)O)O)=O,16,1,0,1,20,4.7e-05
G5,C1(C2(C(C(C(C)(C1)O2)O)O)O)=O,16,1,0,1,26,4.7e-05
G5,C1(C2(C(C(C(C1)O2)O)O)O)=O,16,1,0,1,15,4.7e-05
G5,C1(C2(C(CC(C(C1)O2)O)O)O)=O,16,1,0,1,20,4.7e-05
G5,C1(C2(C(C(CC(C1)O2)O)O)O)=O,16,1,0,1,20,4.7e-05
G5,C(C1(CC2CC1(C(O)O2)O)O)=O,16,3,0,3,20,0.00014199999999999998
G5,C1(C2(C(C(C(C(C1)O2)O)O)O)O)=O,32,1,0,1,0,4.7e-05
G5,C1(C2(C(CO)(CC1CO2)O)O)=O,8,1,0,1,12,4.7e-05
G5,C1(C2(C(C(C(C1CO)O2)O)O)O)=O,32,1,0,1,15,4.7e-05
G5,C(C1(C(C2C(C1C(O)O2)O)O)O)=O,64,3,0,3,43,0.00014199999999999998
G5,C1(C2(C(CC(CCO)(C1)O2)O)O)=O,8,1,0,1,30,4.7e-05
G5,C1(C2(C(CO)(CC1C(C)O2)O)O)=O,16,1,0,1,12,4.7e-05
G5,C1(C2(C(C)(C(C1C(C)O2)O)O)O)=O,32,1,0,1,45,4.7e-05
G5,C1(C2(C(CC(C1C(C)O2)O)O)O)=O,32,1,0,1,45,4.7e-05
G5,C1(C2(C(CC(CO2)(C1)O)O)O)=O,8,1,0,1,51,4.7e-05
G5,C1(C2(C(CC(C(C1)O)O2)O)O)=O,16,1,0,1,20,4.7e-05
G5,C1(C2(C(C(C(C(C1)O)O2)O)O)O)=O,32,1,0,1,0,4.7e-05
G5,C1(C2(C(CO)(C(CO2)C1)O)O)=O,8,1,0,1,12,4.7e-05
G5,C1(C2(C(CC(CO)(CC1)O2)O)O)=O,8,1,0,1,29,4.7e-05
G5,C1(C2(C(CO)(C(C(C)O2)C1)O)O)=O,16,1,0,1,12,4.7e-05
G5,C1(C2(C(CC(C(C1)O)(C)O2)O)O)=O,16,1,0,1,22,4.7e-05
G5,C(C12C(C(C(O1)O)(C(C2)O)O)O)=O,32,3,0,3,1,0.00014199999999999998
G5,C1(C2(C(C)(C(CO2)(C1)O)O)O)=O,8,1,0,1,45,4.7e-05
G5,C1(C2(C(C)(C(C(C)O2)(C1)O)O)O)=O,16,1,0,1,45,4.7e-05
G5,C1(C2(C(CC(C(CO)O2)C1)O)O)=O,16,2,0,2,46,9.499999999999999e-05
G5,C1(C2(C(C(CCO2)(C1)O)O)O)=O,8,1,0,1,29,4.7e-05
G5,C1(C2(C(C(C(C1)O)CO2)O)O)=O,16,1,0,1,23,4.7e-05
G5,C1(CC2C(C)(C1(CC(O)O2)O)O)=O,16,3,0,3,45,0.00014199999999999998
G5,C1(CC2CC(C1(CC(O)O2)O)O)=O,16,2,0,2,13,9.499999999999999e-05
G5,C1(C2(C(CC(CC(C1)O)O2)O)O)=O,16,1,0,1,13,4.7e-05
G5,C1(C2(C(C(C(C1)O)C(C)O2)O)O)=O,32,1,0,1,23,4.7e-05
G5,C1(CC(O)OC2CC1(C(C2)O)O)=O,16,2,0,2,13,9.499999999999999e-05
G5,C1(C2(C(CC(C(CO2)O)C1)O)O)=O,16,2,0,2,41,9.499999999999999e-05
G5,C1(C2(CC(C(C2O)O)O1)O)=O,16,3,0,3,29,0.00014199999999999998
G5,C1(C2(C(C(C(C2)O)O1)O)O)=O,16,3,0,3,29,0.00014199999999999998
G5,C(C1(CCCC1(C=O)O)O)(O)=O,4,1,0,1,7,4.7e-05
G5,C(C1(CCCC1(CO)O)O)(O)=O,4,1,0,1,7,4.7e-05
G5,C(C1CC(C(O)=O)(C(C1)O)O)=O,8,1,0,1,25,4.7e-05
G5,C1(C(C(C(C=O)=O)(CC1)O)O)=O,4,2,0,2,20,9.499999999999999e-05
G5,C1(C(C(C(C(C)=O)=O)(CC1)O)O)=O,4,2,0,2,25,9.499999999999999e-05
G5,C1(C(C(C(C=O)=O)(CCC1)O)O)=O,4,2,0,2,7,9.499999999999999e-05
G5,C(C1(CCCC1(C(C=O)=O)O)O)=O,4,1,0,1,7,4.7e-05
G5,C(C(C1(CCCC1(CO)O)O)=O)=O,4,1,0,1,7,4.7e-05
G5,C(C1CC(C(C=O)=O)(C(C1)O)O)=O,8,1,0,1,43,4.7e-05
G5,C(C1(CCCC1(C(CO)=O)O)O)=O,4,1,0,1,7,4.7e-05
G5,C1(C(CCC(CO)(C1(C)O)O)O)=O,8,1,0,1,7,4.7e-05
G5,C(CO)(C1(CCCC1(CO)O)O)=O,4,1,0,1,7,4.7e-05
G5,C(CC1C(C(C(C1O)=O)(C)O)O)=O,16,2,0,2,25,9.499999999999999e-05
G5,C(C1CC(C(C(C1O)=O)(C)O)O)=O,16,1,0,1,25,4.7e-05
G5,C(C1(C(CO)CCC1(C=O)O)O)=O,8,1,0,1,7,4.7e-05
G5,C(C1(CCC(CC1(C=O)O)O)O)=O,8,1,0,1,7,4.7e-05
G5,C(C1(C(CO)(CCC1CO)O)O)=O,8,1,0,1,7,4.7e-05
G5,C(C1(CC(CCC1(CO)O)O)O)=O,8,1,0,1,7,4.7e-05
G5,C(C1CC(C(C=O)(C1CO)O)O)=O,16,1,0,1,29,4.7e-05
G5,C(C1(C(C(C(C1)O)CC=O)O)O)=O,16,2,0,2,43,9.499999999999999e-05
G5,C1(C2(CCC(C2O)=O)OC(C1)O)=O,8,2,0,2,7,9.499999999999999e-05
G5,C1C(C(C(C=1)=O)(CCC(C=O)=O)O)O,4,2,0,2,7,9.499999999999999e-05
G5,C1(C(C(C(C=CC=O)=O)(CC1)O)O)=O,8,2,0,2,7,9.499999999999999e-05
G5,C(CC(C=O)C1(C(C=CC1O)=O)O)=O,8,2,0,2,43,9.499999999999999e-05
G5,C(C1CC(C=O)(C(C1)(CO)O)O)=O,8,1,0,1,11,4.7e-05
G5,C(C1(CC(C(CO)=O)CC1O)O)=O,8,1,0,1,11,4.7e-05
G5,C1(C(C(C(C=C)=O)(CC1)O)O)=O,4,2,0,2,7,9.499999999999999e-05
G5,C(C1(CCCC1(C=O)O)O)=O,3,1,0,1,7,4.7e-05
G5,C1(C2(CCC(C2O)=O)OCC1O)=O,8,2,0,2,10,9.499999999999999e-05
G5,C1(C(C2(C(C(CO2)CC1)=O)O)O)=O,8,2,0,2,7,9.499999999999999e-05
G5,C(C1(CCC2C(C1(O)OC2)=O)O)=O,8,1,0,1,7,4.7e-05
G5,C1(C(C2(C(CC(CC1)O2)=O)O)O)=O,8,2,0,2,7,9.499999999999999e-05
G5,C(C1(CCC2CC(C1(O)O2)=O)O)=O,8,1,0,1,7,4.7e-05
G5,C(C1(CCCC1(CO)O)O)=O,4,1,0,1,11,4.7e-05
G5,C1(C2(C(CO)(CCC1CO2)O)O)=O,8,1,0,1,7,4.7e-05
G5,C1(C2(C(CO)(CCC(C1)O2)O)O)=O,8,1,0,1,7,4.7e-05
G5,C(CC1C(C2(C(C1CO2)=O)O)O)=O,16,2,0,2,34,9.499999999999999e-05
G5,C(C1CC(C2(C(C1CO2)=O)O)O)=O,16,1,0,1,34,4.7e-05
G5,C(CC1C2CC(C(C1O)(O)O2)=O)=O,16,2,0,2,34,9.499999999999999e-05
G5,C(C1C2CC(C(C(C1)O)(O)O2)=O)=O,16,1,0,1,34,4.7e-05
G5,C(C1(C(C(CC1C(C)=O)=O)O)O)=O,8,2,0,2,0,9.499999999999999e-05
G5,C(CC1C(C=O)(C(C(C1)=O)O)O)=O,8,3,0,3,0,0.00014199999999999998
G5,C1(CC(C=O)C(C=O)(C1(C)O)O)=O,8,2,0,2,45,9.499999999999999e-05
G5,C1(CC(C=O)C(C=O)(C(C1)O)O)=O,8,2,0,2,0,9.499999999999999e-05
G5,C(CC1C(CC(C1(C=O)O)O)=O)=O,8,2,0,2,45,9.499999999999999e-05
G5,C(C1(CCC(CC(C1O)=O)=O)O)=O,4,2,0,2,0,9.499999999999999e-05
G5,C1(CC(C=O)(C(C=O)(CC1)O)O)=O,4,2,0,2,0,9.499999999999999e-05
G5,C(C1(C(CC(C(CC1)=O)=O)O)O)=O,4,2,0,2,0,9.499999999999999e-05
G5,C(CC1(C(CCC1(C=O)O)=O)O)=O,4,2,0,2,0,9.499999999999999e-05
G5,C(C1(CCC(C1O)=O)O)(CC=O)=O,4,2,0,2,7,9.499999999999999e-05
G5,C(C1(CCC(C1O)=O)O)(CCO)=O,4,2,0,2,7,9.499999999999999e-05
G5,C(C1CCC(C=O)(C1(C=O)O)O)=O,8,1,0,1,7,4.7e-05
G5,C(C1CCC(CO)(C1(C=O)O)O)=O,8,1,0,1,7,4.7e-05
G5,C1(CC(CC1(C(C)(C)O)O)O)=O,4,1,0,1,45,4.8e-05
G5,C1(C(CC(C1)O)(C(C=C)O)O)=O,8,1,0,1,45,4.8e-05
G5,C1(C(CC(C1)O)(C(C=CC)O)O)=O,16,1,0,1,45,4.8e-05
G5,C1(CC(CC1(C(CC=C)O)O)O)=O,8,1,0,1,45,4.8e-05
G5,C1(C(C(CC1(C(C)(C)O)O)O)O)=O,8,1,0,1,2,4.8e-05
G5,C1(C(CC(C1O)O)(C(C=C)O)O)=O,16,1,0,1,2,4.8e-05
G5,C1(C(C(C)(C)O)(CC(C1)=O)O)=O,2,1,0,1,26,4.8e-05
G5,C1(CC(C(C1)=O)(C2(C=COC2)O)O)=O,4,1,0,1,26,4.8e-05
G5,C1(CC(C(C1)=O)(C(C=C)O)O)=O,4,1,0,1,26,4.8e-05
G5,C1(CC(C(C1)=O)(C(C=CC)O)O)=O,8,1,0,1,26,4.8e-05
G5,C1(C(C(CC=C)O)(CC(C1)=O)O)=O,4,1,0,1,26,4.8e-05
G5,C1(C=CC(CC1(C(C)(C)O)O)=O)=O,2,1,0,1,45,4.8e-05
G5,C=CC(C1(C(C=CC(C1)=O)=O)O)O,4,1,0,1,45,4.8e-05
G5,C(C(C1(C(C=CC(C1)=O)=O)O)O)=CC,8,1,0,1,45,4.8e-05
G5,C(CC(C1(C(C=CC(C1)=O)=O)O)O)=C,4,1,0,1,45,4.8e-05
G5,C(C1C=CC(C1(C(C)(C)O)O)=O)=O,4,1,0,1,45,4.8e-05
G5,C(C1C=CC(C1(C(C=C)O)O)=O)=O,8,1,0,1,45,4.8e-05
G5,C(C1C=CC(C1(C(C=CC)O)O)=O)=O,16,1,0,1,45,4.8e-05
G5,C(C1C=CC(C1(C(CC=C)O)O)=O)=O,8,1,0,1,45,4.8e-05
G5,C(C(C=O)C(C=O)(C(C)(C)O)O)=O,2,1,0,1,0,4.8e-05
G5,C(C(C=O)C(C=O)(C(C=C)O)O)=O,4,1,0,1,0,4.8e-05
G5,C(C(C=C)(C(C(CO)CO)O)O)=O,4,1,0,1,18,4.8e-05
G5,C(C(CO)O)(C(C)(C(C)(C)O)O)=O,4,1,0,1,2,4.8e-05
G5,C(C(C)(C(C=C)O)O)(C(CO)O)=O,8,1,0,1,2,4.8e-05
G5,C1(C(C(C)(C)O)(O)OCC1CO)=O,4,1,0,1,34,4.8e-05
G5,C1(C(C(C=C)O)(O)OCC1CO)=O,8,1,0,1,34,4.8e-05
G5,C(C(C=C)(C(CC(O)=O)O)O)(O)=O,4,1,0,1,7,4.8e-05
G5,C(C(C=C)(C(CC(O)=O)O)O)=O,4,1,0,1,28,4.8e-05
G5,C1(C(C(CC(O)=O)O)(CCO1)O)=O,4,1,0,1,28,4.8e-05
G5,C(CC(C(C(C)=O)(C=C)O)O)(O)=O,4,1,0,1,28,4.8e-05
G5,C(CC(C(C=C)=O)(C(C)(C)O)O)=O,2,1,0,1,7,4.8e-05
G5,C(CC(C(C=C)=O)(C(C=C)O)O)=O,4,1,0,1,7,4.8e-05
G5,C(CC(C(C=C)=O)(C(C=CC)O)O)=O,8,1,0,1,7,4.8e-05
G5,C(CC(C(C=C)=O)(C(CC=C)O)O)=O,4,1,0,1,7,4.8e-05
G5,C(C(CC(C)O)(C(C)(C)O)O)(O)=O,4,1,0,1,27,4.8e-05
G5,C(C(CC(C)O)(C(C=C)O)O)(O)=O,8,1,0,1,27,4.8e-05
G5,C(C(C(C)(C)O)(CC(C)=O)O)(O)=O,2,1,0,1,26,4.8e-05
G5,C(C(CC(C)=O)(C(C=C)O)O)(O)=O,4,1,0,1,26,4.8e-05
G5,C(C(C=C)(C(C)(CCO)O)O)(O)=O,4,1,0,1,7,4.8e-05
G5,C(C(C=C)(C(C)(C)O)O)(O)=O,2,1,0,1,7,4.8e-05
G5,C(OCC(C(C(O)=O)(C=C)O)O)=O,4,1,0,1,7,4.8e-05
G5,C(C(C=C)(C(CCC=O)O)O)(O)=O,4,1,0,1,7,4.8e-05
G5,C(C(C=C)(C(C=CCO)O)O)(O)=O,8,1,0,1,7,4.8e-05
G5,C(C(C=C)(C(C(C=C)O)O)O)(O)=O,8,1,0,1,7,4.8e-05
G5,C(C(C=C)(C1(C=COC1)O)O)(O)=O,4,1,0,1,7,4.8e-05
G5,C(C(C=C)(C(C(CC)=O)O)O)(O)=O,4,1,0,1,7,4.8e-05
G5,C(C(C=C)(C(C=O)(CC)O)O)(O)=O,4,1,0,1,7,4.8e-05
G5,C(C(C=C)(C(C=C)O)O)(O)=O,4,1,0,1,7,4.8e-05
G5,C(C(C=C)(C(C=CC)O)O)(O)=O,8,1,0,1,7,4.8e-05
G5,C(C(C=C)(C(CC=C)O)O)(O)=O,4,1,0,1,7,4.8e-05
G5,C(C(C=O)(C(C(C)=O)(C=C)O)O)=O,2,1,0,1,28,4.8e-05
G5,C(C)(C(C=C)(C(C(C=O)=O)O)O)=O,4,1,0,1,28,4.8e-05
G5,C=CC(C(C=CC=O)(C(C=O)=O)O)O,8,1,0,1,43,4.8e-05
G5,C(C(C=C)(C(C)(CCO)O)O)=O,4,1,0,1,28,4.8e-05
G5,C1(C(CCO1)(C(C)(CCO)O)O)=O,4,1,0,1,28,4.8e-05
G5,C(C)(C(C=C)(C(C)(CCO)O)O)=O,4,1,0,1,28,4.8e-05
G5,C(C(C(C)(C)O)(CC(C)=O)O)=O,2,1,0,1,27,4.8e-05
G5,C(C)(C(C(C)(C)O)(OCC=O)O)=O,2,1,0,1,27,4.8e-05
G5,C(C(C(C)(C)O)(OCC(C)=O)O)=O,2,1,0,1,27,4.8e-05
G5,C(C(C(C)(C)O)O)(OCC=O)=O,2,1,0,1,40,4.8e-05
G5,C(C(C(CCO)(C(C)(C)O)O)=O)=O,2,1,0,1,27,4.8e-05
G5,C(CO)(C(CCO)(C(C)(C)O)O)=O,2,1,0,1,31,4.8e-05
G5,C1(COC(CC1(C(C)(C)O)O)O)=O,4,1,0,1,27,4.8e-05
G5,C(C(CO)=O)(C(C)(C(C)(C)O)O)=O,2,1,0,1,0,4.8e-05
G5,C(C(C)=O)(C(C)(C(C)(C)O)O)=O,2,1,0,1,49,4.8e-05
G5,C=CC(C(C(C)(C(C)(C)O)O)=O)=O,2,1,0,1,7,4.8e-05
G5,C1(C(C(C)(C)O)(O)OC(CO)C1)=O,4,1,0,1,27,4.8e-05
G5,C1(C(C(C)(C)O)(O)OCC(C1)O)=O,4,1,0,1,27,4.8e-05
G5,C1(C(C(C)(C)O)(CC(CO1)=O)O)=O,2,1,0,1,27,4.8e-05
G5,C(C(C=C)(C(C)(C)O)O)=O,2,1,0,1,28,4.8e-05
G5,C1(C(CCO1)(C(C)(C)O)O)=O,2,1,0,1,28,4.8e-05
G5,C(CC(C(C)(C(C)(C)O)O)=O)=O,2,1,0,1,45,4.8e-05
G5,C(C(C(C)(C)O)(C(CO)CO)O)=O,2,1,0,1,2,4.8e-05
G5,C(C(CC(C)O)(C(C)(C)O)O)=O,4,1,0,1,11,4.8e-05
G5,C(C(C)O)(C(C)(C(C)(C)O)O)=O,4,1,0,1,49,4.8e-05
G5,C(C(CC(CO)O)(C(C)(C)O)O)=O,4,1,0,1,0,4.8e-05
G5,C(C(C(C)(C(C)(C)O)O)=O)(O)=O,2,1,0,1,4,4.8e-05
G5,C(C(C=CC=O)(C(C)(C)O)O)=O,4,1,0,1,20,4.8e-05
G5,C(C)(C(CCO)(C(C)(C)O)O)=O,2,1,0,1,45,4.8e-05
G5,C(C)(C(C(C)(C)O)(CC(O)=O)O)=O,2,1,0,1,27,4.8e-05
G5,C(C(C(C)(C)O)(CC(O)=O)O)(O)=O,2,1,0,1,29,4.8e-05
G5,C1(CC(C=CC1(C(C)(C)O)O)=O)=O,2,1,0,1,45,4.8e-05
G5,C(C(C)C(C(C)=O)(C(C)(C)O)O)=O,4,1,0,1,27,4.8e-05
G5,C(C(C)C(C=O)(C(C)(C)O)O)=O,4,1,0,1,49,4.8e-05
G5,C(C)(C(C=CC=O)(C(C)(C)O)O)=O,4,1,0,1,45,4.8e-05
G5,C(C(C)C(C(O)=O)(C(C)(C)O)O)=O,4,1,0,1,49,4.8e-05
G5,C=C1C(C(C(C)(C)O)(CC1=O)O)=O,2,1,0,1,45,4.8e-05
G5,C1(CC(C(C1(C(C)(C)O)O)=C)=O)=O,2,1,0,1,45,4.8e-05
G5,C1(CC=C(C=O)C1(C(C)(C)O)O)=O,2,1,0,1,27,4.8e-05
G5,C1(CC(C=O)=CC1(C(C)(C)O)O)=O,2,1,0,1,45,4.8e-05
G5,C(CC=O)(C(C=C)(C(C)(C)O)O)=O,2,1,0,1,27,4.8e-05
G5,C(C(C(C)(C)O)(CC(C=C)=O)O)=O,2,1,0,1,27,4.8e-05
G5,C(C1C(C(C=C1)(C(C)(C)O)O)=O)=O,4,1,0,1,45,4.8e-05
G5,C(C)(C1(C=CC(O1)=O)C(C)(C)O)=O,2,1,0,1,48,4.8e-05
G5,C(CC1(C(C=CO1)=O)C(C)(C)O)=O,2,1,0,1,45,4.8e-05
G5,C1C(C(C=O)=O)(C(C)(C)O)OCC=1,2,1,0,1,39,4.8e-05
G5,C(C1(C=CC(C=O)O1)C(C)(C)O)=O,4,1,0,1,40,4.8e-05
G5,C(C1(C(C)(C)O)CC(C(O1)=C)=O)=O,2,1,0,1,14,4.8e-05
G5,C(C1(C(C)(C)O)CC(C=CO1)=O)=O,2,1,0,1,37,4.8e-05
G5,C1(C=C(C=O)CC1(C(C)(C)O)O)=O,2,1,0,1,45,4.8e-05
G5,C1CC(C(C=1C=O)=O)(C(C)(C)O)O,2,1,0,1,27,4.8e-05
G5,C(CO)(C(C=C)(C(C)(C)O)O)=O,2,1,0,1,31,4.8e-05
G5,C(C)(C(C(C=O)=C)(C(C)(C)O)O)=O,2,1,0,1,45,4.8e-05
G5,C(C(C(CC=O)=C)(C(C)(C)O)O)=O,2,1,0,1,6,4.8e-05
G5,C(C(C(C)=CC=O)(C(C)(C)O)O)=O,4,1,0,1,6,4.8e-05
G5,C(C(C(C=O)=C)(C(C)(C)O)O)=O,2,1,0,1,16,4.8e-05
G5,C(CCO)(C(C=C)(C(C)(C)O)O)=O,2,1,0,1,27,4.8e-05
G5,C(C)(C(C(CO)=C)(C(C)(C)O)O)=O,2,1,0,1,49,4.8e-05
G5,C(C)(C(C=C)(C(C)(C)O)O)=O,2,1,0,1,28,4.8e-05
G5,C(C(C(C=O)=CC)(C(C)(C)O)O)=O,4,1,0,1,45,4.8e-05
G5,C(C(C=C)C(C=O)(C(C)(C)O)O)=O,4,1,0,1,45,4.8e-05
G5,C(C(C=CCC=O)(C(C)(C)O)O)=O,4,1,0,1,43,4.8e-05
G5,C(C(C(C)(C)O)(CC=CC=O)O)=O,4,1,0,1,27,4.8e-05
G5,C(C(C(CO)=C)(C(C)(C)O)O)=O,2,1,0,1,49,4.8e-05
G5,C(C(C(C=O)=C)(C(C)(C)O)O)(O)=O,2,1,0,1,33,4.8e-05
G5,C(C(C(CO)=C)(C(C)(C)O)O)(O)=O,2,1,0,1,49,4.8e-05
G5,C1(CC(C=O)OC1(C(C)(C)O)O)=O,4,1,0,1,0,4.8e-05
G5,C(C1(C(C)(C)O)CC(C(O1)O)=O)=O,4,1,0,1,0,4.8e-05
G5,C1(C(C(C)(C)O)(O)OC(C)C1)=O,4,1,0,1,45,4.8e-05
G5,C1(C(C(C)(C)O)(O)OCC1O)=O,4,1,0,1,0,4.8e-05
G5,C(C1(CC(C(O1)O)O)C(C)(C)O)=O,8,1,0,1,27,4.8e-05
G5,C1(C(C(OC1(C)C(C)(C)O)O)O)=O,8,1,0,1,0,4.8e-05
G5,C1(C(CC(O)O1)(C(C)(C)O)O)=O,4,1,0,1,45,4.8e-05
G5,C(C(CC(C)=O)(C(C=C)O)O)=O,4,1,0,1,27,4.8e-05
G5,C(C(CC(C)=O)(C(C=CC)O)O)=O,8,1,0,1,27,4.8e-05
G5,C(C(C(CC=C)O)(CC(C)=O)O)=O,4,1,0,1,27,4.8e-05
G5,C(OCC(C)(C(C=O)(C=C)O)O)=O,4,1,0,1,28,4.8e-05
G5,C(COC(C(C)=O)(C(C=C)O)O)=O,4,1,0,1,27,4.8e-05
G5,C(C(C(C=C)O)(O)OCC(C)=O)=O,4,1,0,1,27,4.8e-05
G5,C(OCC(C(C=O)(C=C)O)O)=O,4,1,0,1,28,4.8e-05
G5,C(OCC(C1(C(OCC1)=O)O)O)=O,4,1,0,1,28,4.8e-05
G5,C(OCC(C(C(C)=O)(C=C)O)O)=O,4,1,0,1,28,4.8e-05
G5,C(C(C(C=C)O)O)(OCC=O)=O,4,1,0,1,40,4.8e-05
G5,C(C(C(C=CC)O)O)(OCC=O)=O,8,1,0,1,40,4.8e-05
G5,C(C(C(CC=C)O)O)(OCC=O)=O,4,1,0,1,40,4.8e-05
G5,C(C(C=C)(C(COC(C)=O)O)O)=O,4,1,0,1,28,4.8e-05
G5,C=CC(C(C(C=O)=O)(CCO)O)O,4,1,0,1,27,4.8e-05
G5,C(CO)(C(CCO)(C(C=C)O)O)=O,4,1,0,1,31,4.8e-05
G5,C(C(C=C)(C(CCC=O)O)O)=O,4,2,0,2,29,9.499999999999999e-05
G5,C1(C(C(CCC=O)O)(CCO1)O)=O,4,1,0,1,28,4.8e-05
G5,C(CCC(C(C(C)=O)(C=C)O)O)=O,4,2,0,2,27,9.499999999999999e-05
G5,C1(COC(CC1(C(C=C)O)O)O)=O,8,1,0,1,27,4.8e-05
G5,C1(C(CCO1)(C(C=CCO)O)O)=O,8,1,0,1,28,4.8e-05
G5,C(C)(C(C=C)(C(C=CCO)O)O)=O,8,1,0,1,28,4.8e-05
G5,C(C(C=C)(C(C)(CC(O)=O)O)O)=O,4,1,0,1,28,4.8e-05
G5,C=CC(C(C(C(CO)=O)=O)(C)O)O,4,1,0,1,0,4.8e-05
G5,C=CC(C(C(C(C)=O)=O)(C)O)O,4,1,0,1,49,4.8e-05
G5,C(C)=CC(C(C(C(C)=O)=O)(C)O)O,8,1,0,1,49,4.8e-05
G5,C(CC(C(C(C(C)=O)=O)(C)O)O)=C,4,1,0,1,49,4.8e-05
G5,C=CC(C(C(C(C=C)=O)=O)(C)O)O,4,1,0,1,7,4.8e-05
G5,C(C)=CC(C(C(C(C=C)=O)=O)(C)O)O,8,1,0,1,7,4.8e-05
G5,C=CCC(C(C(C(C=C)=O)=O)(C)O)O,4,1,0,1,7,4.8e-05
G5,C1(C(C(C=C)O)(O)OC(CO)C1)=O,8,1,0,1,27,4.8e-05
G5,C(C(C=C)(C1(C(OCC1)=O)O)O)=O,4,2,0,2,28,9.6e-05
G5,C(C(C=C)(C1(COC(C1)=O)O)O)=O,4,1,0,1,28,4.8e-05
G5,C1(C(C(C=C)O)(O)OCC(C1)O)=O,8,1,0,1,27,4.8e-05
G5,C1(C(CC(CO1)=O)(C(C=C)O)O)=O,4,1,0,1,27,4.8e-05
G5,C(C(C=C)(C(C(C=C)O)O)O)=O,8,2,0,2,28,9.499999999999999e-05
G5,C(C(C=C)(C1(C=COC1)O)O)=O,4,1,0,1,28,4.8e-05
G5,C1(C(C(C(C=C)O)O)(CCO1)O)=O,8,1,0,1,28,4.8e-05
G5,C(C(C=C)(C(C(O)=O)(C=C)O)O)=O,4,2,0,2,7,9.6e-05
G5,C(C(C=C)(C(C(CO)(C)O)O)O)=O,8,1,0,1,11,4.8e-05
G5,C(C(C=C)(C(C(CC)=O)(C)O)O)=O,4,1,0,1,28,4.8e-05
G5,C(C(C=C)(C(C(C)=O)(CC)O)O)=O,4,1,0,1,28,4.8e-05
G5,C(C(C=C)(C(C(C)CC=O)O)O)=O,8,2,0,2,29,9.499999999999999e-05
G5,C(C(C=C)(C(CC(C=O)C)O)O)=O,8,1,0,1,28,4.8e-05
G5,C(C(C=C)(C(C(CC)=O)O)O)=O,4,1,0,1,28,4.8e-05
G5,C(C(C=C)(C(C=O)(CC)O)O)=O,4,1,0,1,28,4.8e-05
G5,C(C(C=C)(C(C(O)=O)(CC)O)O)=O,4,1,0,1,28,4.8e-05
G5,C(C(C=C)(C(C=O)(C=CC=O)O)O)=O,8,2,0,2,20,9.6e-05
G5,C(C(C=C)(C(C=CC(C=O)=O)O)O)=O,8,1,0,1,20,4.8e-05
G5,C(C(C=C)(C(C=O)(C=CC)O)O)=O,8,1,0,1,28,4.8e-05
G5,C(C(C=C)(C(C=O)(CC=C)O)O)=O,4,1,0,1,28,4.8e-05
G5,C(C(C=C)(C(C=CC=O)(C)O)O)=O,8,1,0,1,28,4.8e-05
G5,C(C(C=C)(C(C=CC(C)=O)O)O)=O,8,1,0,1,28,4.8e-05
G5,C(C(C=C)(C(C(CC=O)=C)O)O)=O,4,1,0,1,28,4.8e-05
G5,C(C(C=C)(C(CC(C=O)=C)O)O)=O,4,1,0,1,28,4.8e-05
G5,C(C(C=C)(C(C(C)=CC=O)O)O)=O,8,1,0,1,28,4.8e-05
G5,C(C(C=C)(C(C=C(C=O)C)O)O)=O,8,1,0,1,28,4.8e-05
G5,C(C(C=C)(C(C=C)O)O)=O,4,1,0,1,28,4.8e-05
G5,C(C(C=C)(C(C=CC)(CO)O)O)=O,8,1,0,1,28,4.8e-05
G5,C(C(C=C)(C(CO)(CC=C)O)O)=O,4,1,0,1,28,4.8e-05
G5,C(C)(C(C=C)(C(C(C=C)O)O)O)=O,8,1,0,1,28,4.8e-05
G5,C(C(C=C)(C(C)(C(C=C)O)O)O)=O,8,1,0,1,28,4.8e-05
G5,C(C(C=C)(C(CC(CO)=C)O)O)=O,4,1,0,1,28,4.8e-05
G5,C(C(C=C)(C(C=C(CO)C)O)O)=O,8,1,0,1,28,4.8e-05
G5,C(C(C=C)(C(C=CC)O)O)=O,8,1,0,1,28,4.8e-05
G5,C(C(C=C)(C(CC=C)O)O)=O,4,1,0,1,28,4.8e-05
G5,C(C(C=C)(C1(C=CC(C1O)=O)O)O)=O,8,1,0,1,47,4.8e-05
G5,C(C(C=C)(C(C=CCC=O)O)O)=O,8,1,0,1,28,4.8e-05
G5,C(C(C=C)(C(CC=CC=O)O)O)=O,8,1,0,1,28,4.8e-05
G5,C1(C(CCO1)(C2(C=COC2)O)O)=O,4,1,0,1,28,4.8e-05
G5,C(C(C=CC=O)(C1(C=COC1)O)O)=O,8,1,0,1,20,4.8e-05
G5,C(C(C(C=O)=C)(C1(C=COC1)O)O)=O,4,1,0,1,16,4.8e-05
G5,C(C)(C(C=C)(C1(C=COC1)O)O)=O,4,1,0,1,28,4.8e-05
G5,C1(C(CCO1)(C(C(CC)=O)O)O)=O,4,1,0,1,28,4.8e-05
G5,C1(C(CCO1)(C(C=O)(CC)O)O)=O,4,1,0,1,28,4.8e-05
G5,C1(C(CCO1)(C(C=C)O)O)=O,4,1,0,1,28,4.8e-05
G5,C1(C(CCO1)(C(C=CC)O)O)=O,8,1,0,1,28,4.8e-05
G5,C1(C(C(CC=C)O)(CCO1)O)=O,4,1,0,1,28,4.8e-05
G5,C(C(C)(C(C=C)O)O)(CC=O)=O,4,1,0,1,45,4.8e-05
G5,C(C(C)(C(C=CC)O)O)(CC=O)=O,8,1,0,1,45,4.8e-05
G5,C(C(C)(C(CC=C)O)O)(CC=O)=O,4,1,0,1,45,4.8e-05
G5,C(C(C(CO)CO)(C(C=C)O)O)=O,4,1,0,1,2,4.8e-05
G5,C(C(CC(C)O)(C(C=C)O)O)=O,8,1,0,1,11,4.8e-05
G5,C(C(CC(C)O)(C(C=CC)O)O)=O,16,1,0,1,11,4.8e-05
G5,C(C(C(CC=C)O)(CC(C)O)O)=O,8,1,0,1,11,4.8e-05
G5,C(C(C)(C(C=C)O)O)(C(C)O)=O,8,1,0,1,49,4.8e-05
G5,C(C(C)(C(C=CC)O)O)(C(C)O)=O,16,1,0,1,49,4.8e-05
G5,C(C(C)O)(C(C(CC=C)O)(C)O)=O,8,1,0,1,49,4.8e-05
G5,C(C(CC(CO)O)(C(C=C)O)O)=O,8,1,0,1,0,4.8e-05
G5,C=CC(C(C(C(O)=O)=O)(C)O)O,4,1,0,1,4,4.8e-05
G5,C(C)=CC(C(C(C(O)=O)=O)(C)O)O,8,1,0,1,4,4.8e-05
G5,C=CCC(C(C(C(O)=O)=O)(C)O)O,4,1,0,1,4,4.8e-05
G5,C(C(C=CC=O)(C(C=C)O)O)=O,8,1,0,1,20,4.8e-05
G5,C(C(C=CC=O)(C(C=CC)O)O)=O,16,1,0,1,20,4.8e-05
G5,C(C(C=CC=O)(C(CC=C)O)O)=O,8,1,0,1,20,4.8e-05
G5,C(C)(C(CCO)(C(C=C)O)O)=O,4,1,0,1,45,4.8e-05
G5,C(C)(C(CCO)(C(C=CC)O)O)=O,8,1,0,1,45,4.8e-05
G5,C(C)(C(C(CC=C)O)(CCO)O)=O,4,1,0,1,45,4.8e-05
G5,C(CC(C(C)=O)(C(C=C)O)O)(O)=O,4,1,0,1,27,4.8e-05
G5,C(CC(C(O)=O)(C(C=C)O)O)(O)=O,4,1,0,1,29,4.8e-05
G5,C1(CC(C=CC1(C(C=C)O)O)=O)=O,4,1,0,1,45,4.8e-05
G5,C1(CC(C=CC1(C(C=CC)O)O)=O)=O,8,1,0,1,45,4.8e-05
G5,C1(CC(C=CC1(C(CC=C)O)O)=O)=O,4,1,0,1,45,4.8e-05
G5,C(C(C)C(C(C)=O)(C(C=C)O)O)=O,8,1,0,1,27,4.8e-05
G5,C(C(C)C(C=O)(C(C=C)O)O)=O,8,1,0,1,49,4.8e-05
G5,C(C(C)C(C=O)(C(C=CC)O)O)=O,16,1,0,1,49,4.8e-05
G5,C(C(C)C(C=O)(C(CC=C)O)O)=O,8,1,0,1,49,4.8e-05
G5,C(C)(C(C=C)(C(C(CC)=O)O)O)=O,4,1,0,1,28,4.8e-05
G5,C(C(CC)(C(C(C)=O)(C=C)O)O)=O,4,1,0,1,28,4.8e-05
G5,C(C)(C(C=CC=O)(C(C=C)O)O)=O,8,1,0,1,45,4.8e-05
G5,C(C)(C(C=CC=O)(C(C=CC)O)O)=O,16,1,0,1,45,4.8e-05
G5,C(C)(C(C=CC=O)(C(CC=C)O)O)=O,8,1,0,1,45,4.8e-05
G5,C(C(C)C(C(O)=O)(C(C=C)O)O)=O,8,1,0,1,49,4.8e-05
G5,C(C)(C1(CC(C(O1)=O)=O)C(C=C)O)=O,4,1,0,1,27,4.8e-05
G5,C1(CC(C(CC=O)(C(C=C)O)O1)=O)=O,4,1,0,1,27,4.8e-05
G5,C=CC(C1(C(C(C(C1)=O)=C)=O)O)O,4,1,0,1,45,4.8e-05
G5,C=C1C(CC(C1=O)(C(C=CC)O)O)=O,8,1,0,1,45,4.8e-05
G5,C(CC(C1(C(C(C(C1)=O)=C)=O)O)O)=C,4,1,0,1,45,4.8e-05
G5,C1(CC(C(C1(C(C=C)O)O)=C)=O)=O,4,1,0,1,45,4.8e-05
G5,C1(CC(C(C1(C(C=CC)O)O)=C)=O)=O,8,1,0,1,45,4.8e-05
G5,C1(CC(C(C1(C(CC=C)O)O)=C)=O)=O,4,1,0,1,45,4.8e-05
G5,C1(CC=C(C=O)C1(C(C=C)O)O)=O,4,1,0,1,27,4.8e-05
G5,C1(CC=C(C=O)C1(C(C=CC)O)O)=O,8,1,0,1,27,4.8e-05
G5,C1(CC=C(C=O)C1(C(CC=C)O)O)=O,4,1,0,1,27,4.8e-05
G5,C1(CC(C=O)=CC1(C(C=C)O)O)=O,4,1,0,1,45,4.8e-05
G5,C1(CC(C=O)=CC1(C(C=CC)O)O)=O,8,1,0,1,45,4.8e-05
G5,C1(CC(C=O)=CC1(C(CC=C)O)O)=O,4,1,0,1,45,4.8e-05
G5,C(CC(C(C=C)(C(C=C)O)O)=O)=O,4,1,0,1,27,4.8e-05
G5,C(CC(C(C=C)(C(C=CC)O)O)=O)=O,8,1,0,1,27,4.8e-05
G5,C(CC(C(C=C)(C(CC=C)O)O)=O)=O,4,1,0,1,27,4.8e-05
G5,C(C(CC(C=C)=O)(C(C=C)O)O)=O,4,1,0,1,27,4.8e-05
G5,C(C(CC(C=C)=O)(C(C=CC)O)O)=O,8,1,0,1,27,4.8e-05
G5,C(C(C(CC=C)O)(CC(C=C)=O)O)=O,4,1,0,1,27,4.8e-05
G5,C(C1C(C(C=C1)(C(C=C)O)O)=O)=O,8,1,0,1,45,4.8e-05
G5,C(C1C(C(C=C1)(C(C=CC)O)O)=O)=O,16,1,0,1,45,4.8e-05
G5,C(C1C(C(C=C1)(C(CC=C)O)O)=O)=O,8,1,0,1,45,4.8e-05
G5,C(C)(C1(C=CC(O1)=O)C(C=C)O)=O,4,1,0,1,48,4.8e-05
G5,C(C)(C1(C=CC(O1)=O)C(C=CC)O)=O,8,1,0,1,48,4.8e-05
G5,C(C)(C1(C=CC(O1)=O)C(CC=C)O)=O,4,1,0,1,48,4.8e-05
G5,C(CC1(C(C=CO1)=O)C(C=C)O)=O,4,1,0,1,45,4.8e-05
G5,C(CC1(C(C=CO1)=O)C(C=CC)O)=O,8,1,0,1,45,4.8e-05
G5,C(CC1(C(C=CO1)=O)C(CC=C)O)=O,4,1,0,1,45,4.8e-05
G5,C=CC(C1(C=CCO1)C(C=O)=O)O,4,1,0,1,39,4.8e-05
G5,C1C(C(C=O)=O)(C(C=CC)O)OCC=1,8,1,0,1,39,4.8e-05
G5,C(CC(C1(C=CCO1)C(C=O)=O)O)=C,4,1,0,1,39,4.8e-05
G5,C(C1(C=CC(C=O)O1)C(C=C)O)=O,8,1,0,1,40,4.8e-05
G5,C(C1(C=CC(C=O)O1)C(C=CC)O)=O,16,1,0,1,40,4.8e-05
G5,C(C1(C=CC(C=O)O1)C(CC=C)O)=O,8,1,0,1,40,4.8e-05
G5,C(C1(CC(C(O1)=C)=O)C(C=C)O)=O,4,1,0,1,14,4.8e-05
G5,C(C1(CC(C(O1)=C)=O)C(C=CC)O)=O,8,1,0,1,14,4.8e-05
G5,C(C1(C(CC=C)O)CC(C(O1)=C)=O)=O,4,1,0,1,14,4.8e-05
G5,C(C1(CC(C=CO1)=O)C(C=C)O)=O,4,1,0,1,37,4.8e-05
G5,C(C1(CC(C=CO1)=O)C(C=CC)O)=O,8,1,0,1,37,4.8e-05
G5,C(C1(C(CC=C)O)CC(C=CO1)=O)=O,4,1,0,1,37,4.8e-05
G5,C1(CC(CC(C=O)(C(C=C)O)O1)=O)=O,4,1,0,1,27,4.8e-05
G5,C=CC(C1(C(C=C(C=O)C1)=O)O)O,4,1,0,1,45,4.8e-05
G5,C(C(C1(C(C=C(C=O)C1)=O)O)O)=CC,8,1,0,1,45,4.8e-05
G5,C(CC(C1(C(C=C(C=O)C1)=O)O)O)=C,4,1,0,1,45,4.8e-05
G5,C=CC(C1(C(C(C=O)=CC1)=O)O)O,4,1,0,1,27,4.8e-05
G5,C(C(C1(C(C(C=O)=CC1)=O)O)O)=CC,8,1,0,1,27,4.8e-05
G5,C(CC(C1(C(C(C=O)=CC1)=O)O)O)=C,4,1,0,1,27,4.8e-05
G5,C(CO)(C(C=C)(C(C=C)O)O)=O,4,1,0,1,31,4.8e-05
G5,C(CO)(C(C=C)(C(C=CC)O)O)=O,8,1,0,1,31,4.8e-05
G5,C(CO)(C(C=C)(C(CC=C)O)O)=O,4,1,0,1,31,4.8e-05
G5,C(C(C=CC(C=O)=O)(C(C=C)O)O)=O,8,1,0,1,12,4.8e-05
G5,C(C)(C(C(C=O)=C)(C(C=C)O)O)=O,4,1,0,1,45,4.8e-05
G5,C(C)(C(C(C=O)=C)(C(C=CC)O)O)=O,8,1,0,1,45,4.8e-05
G5,C(C)(C(C(C=O)=C)(C(CC=C)O)O)=O,4,1,0,1,45,4.8e-05
G5,C(C)(C(C=C)(C(C(C=CC)=O)O)O)=O,8,1,0,1,28,4.8e-05
G5,C(C(C=CC)(C(C(C)=O)(C=C)O)O)=O,8,1,0,1,28,4.8e-05
G5,C(C)(C(C=C)(C(C(CC=C)=O)O)O)=O,4,1,0,1,28,4.8e-05
G5,C(C(CC=C)(C(C(C)=O)(C=C)O)O)=O,4,1,0,1,28,4.8e-05
G5,C(C)(C(C=C)(C(C=CC=O)(C)O)O)=O,8,1,0,1,28,4.8e-05
G5,C(C)(C(C=C)(C(C=CC(C)=O)O)O)=O,8,1,0,1,28,4.8e-05
G5,C(CC(C(C(C(C)=O)(C=C)O)O)=C)=O,4,1,0,1,28,4.8e-05
G5,C(C)(C(C=C)(C(CC(C=O)=C)O)O)=O,4,1,0,1,28,4.8e-05
G5,C(C)(C(C=C)(C(C(C)=CC=O)O)O)=O,8,1,0,1,28,4.8e-05
G5,C(C)(C(C=C)(C(C=C(C=O)C)O)O)=O,8,1,0,1,28,4.8e-05
G5,C(C(C(CC=O)=C)(C(C=C)O)O)=O,4,1,0,1,6,4.8e-05
G5,C(C(C(CC=O)=C)(C(C=CC)O)O)=O,8,1,0,1,6,4.8e-05
G5,C(C(C(CC=O)=C)(C(CC=C)O)O)=O,4,1,0,1,6,4.8e-05
G5,C(C(C(C)=CC=O)(C(C=C)O)O)=O,8,1,0,1,6,4.8e-05
G5,C(C(C(C)=CC=O)(C(C=CC)O)O)=O,16,1,0,1,6,4.8e-05
G5,C(C(C(C)=CC=O)(C(CC=C)O)O)=O,8,1,0,1,6,4.8e-05
G5,C(C(C(C(C=O)=O)=C)(C(C=C)O)O)=O,4,1,0,1,0,4.8e-05
G5,C(C(C(C=O)=CC=O)(C(C=C)O)O)=O,8,1,0,1,43,4.8e-05
G5,C(C(C(C=O)=C)(C(C=C)O)O)=O,4,1,0,1,16,4.8e-05
G5,C(C(C(C=O)=C)(C(C=CC)O)O)=O,8,1,0,1,16,4.8e-05
G5,C(C(C(C=O)=C)(C(CC=C)O)O)=O,4,1,0,1,16,4.8e-05
G5,C(CCO)(C(C=C)(C(C=C)O)O)=O,4,1,0,1,27,4.8e-05
G5,C(C)(C(C(CO)=C)(C(C=C)O)O)=O,4,1,0,1,49,4.8e-05
G5,C(C)(C(C=C)(C(C=C)O)O)=O,4,1,0,1,28,4.8e-05
G5,C(C(C(C=O)=CC)(C(C=C)O)O)=O,8,1,0,1,45,4.8e-05
G5,C(C(C=C)C(C=O)(C(C=C)O)O)=O,8,1,0,1,45,4.8e-05
G5,C(C(C=CCC=O)(C(C=C)O)O)=O,8,1,0,1,43,4.8e-05
G5,C(C(CC=CC=O)(C(C=C)O)O)=O,8,1,0,1,27,4.8e-05
G5,C(C(C(CO)=C)(C(C=C)O)O)=O,4,1,0,1,49,4.8e-05
G5,C(C(C(C=O)=C)(C(C=C)O)O)(O)=O,4,1,0,1,33,4.8e-05
G5,C(C(C(CO)=C)(C(C=C)O)O)(O)=O,4,1,0,1,49,4.8e-05
G5,C1(C(C=CC(CO1)=O)(C(C=C)O)O)=O,4,1,0,1,27,4.8e-05
G5,C(C1CC(C(C(C=C)O)(O)O1)=O)=O,8,1,0,1,0,4.8e-05
G5,C(C1(CC(C(O)O1)=O)C(C=C)O)=O,8,1,0,1,0,4.8e-05
G5,C1(C(C(C=C)O)(O)OC(C)C1)=O,8,1,0,1,45,4.8e-05
G5,C1(C(C(C=C)O)(O)OCC1O)=O,8,1,0,1,0,4.8e-05
G5,C(C1(CC(C(O1)O)O)C(C=C)O)=O,16,1,0,1,27,4.8e-05
G5,C1(C(C)(C(C=C)O)OC(C1O)O)=O,16,1,0,1,0,4.8e-05
G5,C1(C(CC(O)O1)(C(C=C)O)O)=O,8,1,0,1,45,4.8e-05
G5,C(C)(C(C=C)(C(C=CC)O)O)=O,8,1,0,1,28,4.8e-05
G5,C(C)(C(C=C)(C(CC=C)O)O)=O,4,1,0,1,28,4.8e-05
G5,C(CC=CC(C(C(C)=O)(C=C)O)O)=O,8,1,0,1,28,4.8e-05
G5,C(C)(C(C=C)(C(CC=CC=O)O)O)=O,8,1,0,1,28,4.8e-05
G5,C(C(C(C=O)=CC)(C(C=CC)O)O)=O,16,1,0,1,45,4.8e-05
G5,C(C(C(C=O)=CC)(C(CC=C)O)O)=O,8,1,0,1,45,4.8e-05
G5,C(C(C=C)C(C=O)(C(C=CC)O)O)=O,16,1,0,1,45,4.8e-05
G5,C(C(C=C)C(C=O)(C(CC=C)O)O)=O,8,1,0,1,45,4.8e-05
G5,C(C(C=CCC=O)(C(C=CC)O)O)=O,16,1,0,1,43,4.8e-05
G5,C(C(C=CCC=O)(C(CC=C)O)O)=O,8,1,0,1,43,4.8e-05
G5,C(C(CC=CC=O)(C(C=CC)O)O)=O,16,1,0,1,27,4.8e-05
G5,C(C(C(CC=C)O)(CC=CC=O)O)=O,8,1,0,1,27,4.8e-05
G5,C(C(C(CO)=C)(C(C=CC)O)O)=O,8,1,0,1,49,4.8e-05
G5,C1(C(C(C=CC)O)(O)OC(C)C1)=O,16,1,0,1,45,4.8e-05
G5,C1(C(C(C=CC)O)(O)OCC1O)=O,16,1,0,1,0,4.8e-05
G5,C1(C(CC(O)O1)(C(C=CC)O)O)=O,16,1,0,1,45,4.8e-05
G5,C(C(C(CO)=C)(C(CC=C)O)O)=O,4,1,0,1,49,4.8e-05
G5,C1(C(C(CC=C)O)(O)OC(C)C1)=O,8,1,0,1,45,4.8e-05
G5,C1(C(C(CC=C)O)(O)OCC1O)=O,8,1,0,1,0,4.8e-05
G5,C1(C(C(CC=C)O)(CC(O)O1)O)=O,8,1,0,1,45,4.8e-05
G5,C1(C=CC(CC1(C(CO)O)O)=O)=O,4,1,0,1,45,4.8e-05
G5,C(C1C=CC(C1(C(CO)O)O)=O)=O,8,1,0,1,45,4.8e-05
G5,C(C(C(CO)O)(CC(C)O)O)(O)=O,8,1,0,1,27,4.8e-05
G5,C(C(C(CO)O)O)(OCC=O)=O,4,5,0,5,0,0.00026000000000000003
G5,C(C(C(C(CO)O)(CCO)O)=O)=O,4,1,0,1,27,4.8e-05
G5,C1(COC(CC1(C(CO)O)O)O)=O,8,2,0,2,0,9.6e-05
G5,C=CC(C(C(C)(C(CO)O)O)=O)=O,4,1,0,1,7,4.8e-05
G5,C1(C(C(CO)O)(CC(CO1)=O)O)=O,4,1,0,1,27,4.8e-05
G5,C1(C(C(CO)O)(CCO1)O)=O,4,3,0,3,29,0.000154
G5,C(C(C=CC=O)(C(CO)O)O)=O,8,3,0,3,0,0.000143
G5,C1(CC(C=CC1(C(CO)O)O)=O)=O,4,1,0,1,45,4.8e-05
G5,C(C(C)C(C(C)=O)(C(CO)O)O)=O,8,1,0,1,27,4.8e-05
G5,C=C1C(C(C(CO)O)(CC1=O)O)=O,4,1,0,1,45,4.8e-05
G5,C1(CC(C(C1(C(CO)O)O)=C)=O)=O,4,1,0,1,45,4.8e-05
G5,C1(CC=C(C=O)C1(C(CO)O)O)=O,4,1,0,1,27,4.8e-05
G5,C1(CC(C=O)=CC1(C(CO)O)O)=O,4,1,0,1,45,4.8e-05
G5,C(C1C(C(C=C1)(C(CO)O)O)=O)=O,8,1,0,1,45,4.8e-05
G5,C(C)(C1(C=CC(O1)=O)C(CO)O)=O,4,1,0,1,48,4.8e-05
G5,C(CC1(C(C=CO1)=O)C(CO)O)=O,4,1,0,1,45,4.8e-05
G5,C1C(C(C=O)=O)(C(CO)O)OCC=1,4,1,0,1,39,4.8e-05
G5,C(C1(C=CC(C=O)O1)C(CO)O)=O,8,1,0,1,40,4.8e-05
G5,C(C1(C(CO)O)CC(C(O1)=C)=O)=O,4,1,0,1,14,4.8e-05
G5,C(C1(C(CO)O)CC(C=CO1)=O)=O,4,1,0,1,37,4.8e-05
G5,C1(C=C(C=O)CC1(C(CO)O)O)=O,4,1,0,1,45,4.8e-05
G5,C1CC(C(C=1C=O)=O)(C(CO)O)O,4,1,0,1,27,4.8e-05
G5,C(CO)(C(C=C)(C(CO)O)O)=O,4,2,0,2,2,9.6e-05
G5,C(C)(C(C(C=O)=C)(C(CO)O)O)=O,4,1,0,1,45,4.8e-05
G5,C(C(C(CC=O)=C)(C(CO)O)O)=O,4,1,0,1,6,4.8e-05
G5,C(C(C(C)=CC=O)(C(CO)O)O)=O,8,1,0,1,6,4.8e-05
G5,C(CCO)(C(C=C)(C(CO)O)O)=O,4,1,0,1,27,4.8e-05
G5,C(C)(C(C(CO)=C)(C(CO)O)O)=O,4,1,0,1,49,4.8e-05
G5,C(C(C(C=O)=CC)(C(CO)O)O)=O,8,1,0,1,45,4.8e-05
G5,C1(CC(C=O)OC1(C(CO)O)O)=O,8,1,0,1,0,4.8e-05
G5,C(C1(C(CO)O)CC(C(O1)O)=O)=O,8,2,0,2,0,9.6e-05
G5,C1(C(C(CO)O)(O)OC(C)C1)=O,8,1,0,1,45,4.8e-05
G5,C1(C(C(CO)O)(O)OCC1O)=O,8,2,0,2,0,9.6e-05
G5,C(C1(C(CO)O)CC(C(O1)O)O)=O,16,2,0,2,0,9.6e-05
G5,C1(C(C(OC1(C)C(CO)O)O)O)=O,16,2,0,2,0,9.6e-05
G5,C1(C(C(CO)O)(CC(O)O1)O)=O,8,2,0,2,0,9.6e-05
G5,C(C(C=C)(C(CO)(CO)O)O)(O)=O,2,1,0,1,7,4.8e-05
G5,C1(C(CCO1)(C(CO)(CO)O)O)=O,2,1,0,1,28,4.8e-05
G5,C(C)(C(C=C)(C(CO)(CO)O)O)=O,2,1,0,1,28,4.8e-05
G5,C(C(C=C)(C(C(CO)O)O)O)(O)=O,8,1,0,1,7,4.8e-05
G5,C(C(C=C)(C(C(CO)O)O)O)=O,8,5,0,5,29,0.00026000000000000003
G5,C1(C(CCO1)(C(C(CO)O)O)O)=O,8,1,0,1,28,4.8e-05
G5,C(C)(C(C=C)(C(C(CO)O)O)O)=O,8,1,0,1,28,4.8e-05
G5,C1(CC(C(C1)=O)(C(C(C)=O)O)O)=O,4,1,0,1,26,4.8e-05
G5,C(C(C)(C1(C(CC(C1)=O)=O)O)O)=O,4,1,0,1,26,4.8e-05
G5,C(C)(C(C1(C(C=CC(C1)=O)=O)O)O)=O,4,1,0,1,45,4.8e-05
G5,C(C(C)(C1(C(C=CC(C1)=O)=O)O)O)=O,4,1,0,1,45,4.8e-05
G5,C(C1C=CC(C1(C(C(C)=O)O)O)=O)=O,8,1,0,1,45,4.8e-05
G5,C(C(C)(C1(C(C=CC1C=O)=O)O)O)=O,8,1,0,1,45,4.8e-05
G5,C(C(C(C(C)=O)O)O)(OCC=O)=O,4,3,0,3,45,0.000143
G5,C(COC(C(C(C=O)(C)O)O)=O)=O,4,3,0,3,45,0.000143
G5,C(C(C(C(C(C)=O)=O)(C)O)O)(C)=O,4,1,0,1,49,4.8e-05
G5,C(C(C)(C(C(C(C)=O)=O)(C)O)O)=O,4,1,0,1,49,4.8e-05
G5,C1(C(CCO1)(C(C=O)(C)O)O)=O,4,3,0,3,11,0.000143
G5,C(C(C)(C(C=O)(C)O)O)(C(C)O)=O,8,2,0,2,49,9.6e-05
G5,C(C(C=CC=O)(C(C=O)(C)O)O)=O,8,2,0,2,20,9.6e-05
G5,C1(CC(C=CC1(C(C(C)=O)O)O)=O)=O,4,1,0,1,45,4.8e-05
G5,C1(C(C=CC(C1)=O)(C(C=O)(C)O)O)=O,4,1,0,1,45,4.8e-05
G5,C(C(C)C(C=O)(C(C=O)(C)O)O)=O,8,2,0,2,49,9.6e-05
G5,C(C)(C(C1(C(C(C(C1)=O)=C)=O)O)O)=O,4,1,0,1,45,4.8e-05
G5,C(C(C)(C1(C(C(C(C1)=O)=C)=O)O)O)=O,4,1,0,1,45,4.8e-05
G5,C1(CC(C(C1(C(C(C)=O)O)O)=C)=O)=O,4,1,0,1,45,4.8e-05
G5,C1(C(C(C(C1)=O)=C)(C(C=O)(C)O)O)=O,4,1,0,1,45,4.8e-05
G5,C1(CC=C(C=O)C1(C(C(C)=O)O)O)=O,4,1,0,1,27,4.8e-05
G5,C1(C(C(C=O)=CC1)(C(C=O)(C)O)O)=O,4,1,0,1,27,4.8e-05
G5,C1(CC(C=O)=CC1(C(C(C)=O)O)O)=O,4,1,0,1,45,4.8e-05
G5,C1(C(C=C(C=O)C1)(C(C=O)(C)O)O)=O,4,1,0,1,45,4.8e-05
G5,C(C1C(C(C=C1)(C(C(C)=O)O)O)=O)=O,8,1,0,1,45,4.8e-05
G5,C(C1C(C(C=C1)(C(C=O)(C)O)O)=O)=O,8,1,0,1,45,4.8e-05
G5,C(C)(C1(C=CC(O1)=O)C(C(C)=O)O)=O,4,1,0,1,48,4.8e-05
G5,C(C(C)(C1(C(C)=O)C=CC(O1)=O)O)=O,4,1,0,1,48,4.8e-05
G5,C(CC1(C(C=CO1)=O)C(C(C)=O)O)=O,4,1,0,1,45,4.8e-05
G5,C(CC1(C(C=CO1)=O)C(C=O)(C)O)=O,4,1,0,1,45,4.8e-05
G5,C(C)(C(C1(C=CCO1)C(C=O)=O)O)=O,4,1,0,1,39,4.8e-05
G5,C(C(C)(C1(C=CCO1)C(C=O)=O)O)=O,4,1,0,1,39,4.8e-05
G5,C(C1(C=CC(C=O)O1)C(C(C)=O)O)=O,8,1,0,1,40,4.8e-05
G5,C(C1C=CC(C=O)(C(C=O)(C)O)O1)=O,8,1,0,1,40,4.8e-05
G5,C(C1(CC(C(O1)=C)=O)C(C(C)=O)O)=O,4,1,0,1,14,4.8e-05
G5,C(C(C)(C1(C=O)CC(C(O1)=C)=O)O)=O,4,1,0,1,14,4.8e-05
G5,C(C1(CC(C=CO1)=O)C(C(C)=O)O)=O,4,1,0,1,37,4.8e-05
G5,C(C(C)(C1(C=O)CC(C=CO1)=O)O)=O,4,1,0,1,37,4.8e-05
G5,C(C)(C(C1(C(C=C(C=O)C1)=O)O)O)=O,4,1,0,1,45,4.8e-05
G5,C(C(C)(C1(C(C=C(C=O)C1)=O)O)O)=O,4,1,0,1,45,4.8e-05
G5,C(C)(C(C1(C(C(C=O)=CC1)=O)O)O)=O,4,1,0,1,27,4.8e-05
G5,C(C(C)(C1(C(C(C=O)=CC1)=O)O)O)=O,4,1,0,1,27,4.8e-05
G5,C(C(C)(C(C(CO)=O)(C=C)O)O)=O,4,2,0,2,31,9.6e-05
G5,C(C(C(C=O)=C)(C(C(C)=O)O)O)=O,4,1,0,1,16,4.8e-05
G5,C(C(C(C=O)=C)(C(C=O)(C)O)O)=O,4,1,0,1,16,4.8e-05
G5,C(C)(C(C=C)(C(C(C)=O)O)O)=O,4,2,0,2,45,9.499999999999999e-05
G5,C(C(C)(C(C(C)=O)(C=C)O)O)=O,4,2,0,2,45,9.499999999999999e-05
G5,C(C(C)(C(C=O)(C(CO)=C)O)O)=O,4,2,0,2,49,9.6e-05
G5,C(C(C1(C(CC(C)O1)=O)O)O)(C)=O,8,1,0,1,45,4.8e-05
G5,C(C(C)(C1(C(CC(C)O1)=O)O)O)=O,8,1,0,1,45,4.8e-05
G5,C(C(C1(C(C(CO1)O)=O)O)O)(C)=O,8,1,0,1,0,4.8e-05
G5,C(C(C)(C1(C(C(CO1)O)=O)O)O)=O,8,1,0,1,0,4.8e-05
G5,C1(C(CC(O)O1)(C(C(C)=O)O)O)=O,8,2,0,2,49,9.499999999999999e-05
G5,C1(C(CC(O)O1)(C(C=O)(C)O)O)=O,8,2,0,2,11,9.499999999999999e-05
G5,C(C(C1(C(CC(C1)=O)=O)O)O)=O,4,3,0,3,29,0.000143
G5,C(C(C1(C(C=CC(C1)=O)=O)O)O)=O,4,1,0,1,45,4.8e-05
G5,C(C1C=CC(C1(C(C=O)O)O)=O)=O,8,1,0,1,45,4.8e-05
G5,C(COC(C(C)=O)(C(C=O)O)O)=O,4,1,0,1,27,4.8e-05
G5,C(C(C(C=O)(O)OCC(C)=O)O)=O,4,1,0,1,27,4.8e-05
G5,C(C(C(C(C=O)=O)(CCO)O)O)=O,4,1,0,1,27,4.8e-05
G5,C1(COC(CC1(C(C=O)O)O)O)=O,8,2,0,2,0,9.6e-05
G5,C(C(C(C(C(C=C)=O)=O)(C)O)O)=O,4,1,0,1,7,4.8e-05
G5,C(C(C1(C(CC(CO)O1)=O)O)O)=O,8,1,0,1,27,4.8e-05
G5,C(C(C1(C(CC(CO1)O)=O)O)O)=O,8,1,0,1,27,4.8e-05
G5,C1(C(CC(CO1)=O)(C(C=O)O)O)=O,4,1,0,1,27,4.8e-05
G5,C1(CC(C=CC1(C(C=O)O)O)=O)=O,4,1,0,1,45,4.8e-05
G5,C(C(C1(C(C(C(C1)=O)=C)=O)O)O)=O,4,1,0,1,45,4.8e-05
G5,C1(CC(C(C1(C(C=O)O)O)=C)=O)=O,4,1,0,1,45,4.8e-05
G5,C1(CC=C(C=O)C1(C(C=O)O)O)=O,4,1,0,1,27,4.8e-05
G5,C1(CC(C=O)=CC1(C(C=O)O)O)=O,4,1,0,1,45,4.8e-05
G5,C(C1C(C(C=C1)(C(C=O)O)O)=O)=O,8,1,0,1,45,4.8e-05
G5,C(C(C1(C(C)=O)C=CC(O1)=O)O)=O,4,1,0,1,48,4.8e-05
G5,C(CC1(C(C=CO1)=O)C(C=O)O)=O,4,1,0,1,45,4.8e-05
G5,C(C(C1(C=CCO1)C(C=O)=O)O)=O,4,1,0,1,39,4.8e-05
G5,C(C1(C=CC(C=O)O1)C(C=O)O)=O,8,1,0,1,40,4.8e-05
G5,C(C(C1(C=O)CC(C(O1)=C)=O)O)=O,4,1,0,1,14,4.8e-05
G5,C(C(C1(C=O)CC(C=CO1)=O)O)=O,4,1,0,1,37,4.8e-05
G5,C(C(C1(C(C=C(C=O)C1)=O)O)O)=O,4,1,0,1,45,4.8e-05
G5,C(C(C1(C(C(C=O)=CC1)=O)O)O)=O,4,1,0,1,27,4.8e-05
G5,C(C(C(C(C)=O)(C(C=O)=C)O)O)=O,4,1,0,1,45,4.8e-05
G5,C(C(C(CC=O)=C)(C(C=O)O)O)=O,4,1,0,1,6,4.8e-05
G5,C(C(C(C)=CC=O)(C(C=O)O)O)=O,8,1,0,1,6,4.8e-05
G5,C(C(C(C(C)=O)(C(CO)=C)O)O)=O,4,1,0,1,49,4.8e-05
G5,C(C(C(C=O)=CC)(C(C=O)O)O)=O,8,1,0,1,45,4.8e-05
G5,C(C1CC(C(C(C=O)O)(O)O1)=O)=O,8,1,0,1,0,4.8e-05
G5,C(C(C1(C=O)CC(C(O)O1)=O)O)=O,8,2,0,2,0,9.6e-05
G5,C(C(C1(C(CC(C)O1)=O)O)O)=O,8,1,0,1,45,4.8e-05
G5,C(C(C1(C(C(CO1)O)=O)O)O)=O,8,2,0,2,0,9.6e-05
G5,C(C1(CC(C(O1)O)O)C(C=O)O)=O,16,2,0,2,0,9.6e-05
G5,C1(C(C)(C(C=O)O)OC(C1O)O)=O,16,2,0,2,25,9.6e-05
G5,C1(C(CC(O)O1)(C(C=O)O)O)=O,8,2,0,2,0,9.6e-05
G5,C(C(C=C)(C(C)(C(CO)O)O)O)=O,8,1,0,1,28,4.8e-05
G5,C(C(C(C)(C)O)(CC(CO)=O)O)=O,2,1,0,1,27,4.8e-05
G5,C(C(CC(CO)=O)(C(C=C)O)O)=O,4,1,0,1,27,4.8e-05
G5,C1(C(CO)C(C(C1O)=O)(CO)O)=O,8,1,0,1,2,4.9e-05
G5,C(C1C(C(C(C1(CO)O)=O)O)O)=O,16,1,0,1,5,4.9e-05
G5,C(C1CC(C(C1(CO)O)=O)O)=O,8,3,0,3,32,0.000144
G5,C1(C=CC(CC1(CO)O)=O)=O,2,3,0,3,29,0.000144
G5,C(C1C=CC(C1(CO)O)=O)=O,4,2,0,2,2,9.7e-05
G5,C(C(CO)(C(CO)C(C)O)O)(O)=O,8,1,0,1,29,4.9e-05
G5,C(C(C=CC(C)=O)(CO)O)(O)=O,4,4,0,4,29,0.000192
G5,C(C(C=CCC=O)(CO)O)(O)=O,4,3,0,3,29,0.000144
G5,C(C(CO)(CC(C=C)=O)O)(O)=O,2,2,0,2,33,9.7e-05
G5,C(C(CO)(CC=CC=O)O)(O)=O,4,2,0,2,33,9.7e-05
G5,C(C(C(C(CO)(CCO)O)=O)=O)=O,2,1,0,1,31,4.9e-05
G5,C(C(CO)(C)O)(C(C(C=O)=O)O)=O,4,1,0,1,1,4.9e-05
G5,C1(C(C(C(CC1(CO)O)O)O)=O)=O,8,1,0,1,43,4.9e-05
G5,C(C(CO)O)(OCC=O)=O,2,3,0,3,2,0.000144
G5,C=CC(C(C(CO)(C)O)=O)=O,2,1,0,1,7,4.9e-05
G5,C(C(C=COCC=O)(CO)O)=O,4,2,0,2,37,9.7e-05
G5,C(CC(CO)OC(C=O)(CO)O)=O,4,1,0,1,41,4.9e-05
G5,C(CC(COC(C=O)(CO)O)O)=O,4,1,0,1,30,4.9e-05
G5,C(C(CO)(OC(C(CO)=O)C)O)=O,4,1,0,1,24,4.9e-05
G5,C(C(CO)(CC(OCC=O)=O)O)=O,2,2,0,2,8,9.7e-05
G5,C1(C(CO)(CCC(C1O)=O)O)=O,4,3,0,3,32,0.000144
G5,C(C1(C(C(CO)(CC1)O)=O)O)=O,4,1,0,1,12,4.9e-05
G5,C(C(CO)(CC(CO)(CO)O)O)=O,2,1,0,1,29,4.9e-05
G5,C(C(CO)(CC(C(C)=O)O)O)=O,4,2,0,2,29,9.7e-05
G5,C(C(CO)(CC(C=O)(C)O)O)=O,4,1,0,1,16,4.9e-05
G5,C(C(C(C(CO)(C)O)=O)(C)O)=O,4,1,0,1,49,4.9e-05
G5,C(CC(C(CO)(C)O)=O)=O,2,3,0,3,29,0.000144
G5,C(C(CO)(CC(CO)(C)O)O)=O,4,1,0,1,49,4.9e-05
G5,C(C(CO)(C)O)(C(CO)(C)O)=O,3,1,0,1,49,4.9e-05
G5,C(C(CO)(CC(C)O)O)=O,4,1,0,1,11,4.9e-05
G5,C(C(CO)(C)O)(OC(C=O)CO)=O,4,1,0,1,2,4.9e-05
G5,C(OC(C(C(CO)(C)O)=O)CO)=O,4,1,0,1,2,4.9e-05
G5,C(OC(CO)CC(C=O)(CO)O)=O,4,1,0,1,2,4.9e-05
G5,C(C(CO)(C)O)(OCC(C=O)O)=O,4,1,0,1,41,4.9e-05
G5,C(OCC(C(C(CO)(C)O)=O)O)=O,4,1,0,1,2,4.9e-05
G5,C(OCC(CC(C=O)(CO)O)O)=O,4,1,0,1,19,4.9e-05
G5,C(C(CO)(OCC=O)O)(C(C)O)=O,4,1,0,1,19,4.9e-05
G5,C(COC(C(C(CO)(C)O)=O)O)=O,4,1,0,1,19,4.9e-05
G5,C(COC(C=O)O)(C(CO)(C)O)=O,4,1,0,1,2,4.9e-05
G5,C(C(CO)(CCOC(C=O)O)O)=O,4,1,0,1,30,4.9e-05
G5,C(C(C=CC=O)(CO)O)=O,4,3,0,3,29,0.000144
G5,C1(C(CO)(O)OCCC(C1O)O)=O,8,2,0,2,30,0.00010800000000000001
G5,C(C(C=O)(C(C(CO)(C)O)=O)O)=O,2,1,0,1,1,4.9e-05
G5,C(C(CO)(CC(C=O)(CO)O)O)=O,3,1,0,1,2,4.9e-05
G5,C1(C(C(CC1CO)(CO)O)=O)=O,4,2,0,2,32,9.7e-05
G5,C1(C(CC(CO)C1(CO)O)=O)=O,4,3,0,3,2,0.000144
G5,C1(C(CO)(CC(C(C)=O)O1)O)=O,4,3,0,3,29,0.000144
G5,C1(C(CO)(CC(CC=O)O1)O)=O,4,3,0,3,48,0.000144
G5,C1(CCC(C(CO1)=O)(CO)O)=O,2,2,0,2,2,9.7e-05
G5,C1(CC(C(CO)(CCO1)O)=O)=O,2,2,0,2,19,9.7e-05
G5,C1(C(COCCC1(CO)O)=O)=O,2,2,0,2,19,9.7e-05
G5,C1(C(CO)(CC(CCO1)=O)O)=O,2,3,0,3,48,0.000144
G5,C1(C(CO)(CCC(CO1)=O)O)=O,2,3,0,3,48,0.000144
G5,C1(C(CO)(O)OCCC1(CO)O)=O,4,2,0,2,2,9.7e-05
G5,C1(C(CO)(CC(OC1CO)=O)O)=O,4,1,0,1,2,4.9e-05
G5,C1(C(C(CO)(CC(CO)O1)O)=O)=O,4,1,0,1,50,4.9e-05
G5,C1(C(CO)(CC(OCC1O)=O)O)=O,4,1,0,1,2,4.9e-05
G5,C1(C(C(CO)(CC(CO1)O)O)=O)=O,4,1,0,1,27,4.9e-05
G5,C1(C(CC(C(CO1)=O)(CO)O)O)=O,4,1,0,1,2,4.9e-05
G5,C1(C(C(C(CO)(CCO1)O)=O)O)=O,4,1,0,1,2,4.9e-05
G5,C1(C(C(CO)=CC1(CO)O)O)=O,4,3,0,3,29,0.000144
G5,C1(C(C=C(CO)C1(CO)O)O)=O,4,3,0,3,2,0.000144
G5,C1(C(C=CC(CO)O1)(CO)O)=O,4,2,0,2,48,9.7e-05
G5,C1(C(CO)OC=CC1(CO)O)=O,4,2,0,2,2,9.7e-05
G5,C1(C(C=CC(CO1)O)(CO)O)=O,4,2,0,2,48,9.7e-05
G5,C1(C(COC=CC1(CO)O)O)=O,4,2,0,2,38,9.7e-05
G5,C1(C(CO)(OCC=CC1O)O)=O,4,2,0,2,41,9.7e-05
G5,C1(C(OCC=CC1(CO)O)O)=O,4,2,0,2,41,9.7e-05
G5,C1(COC(C=CC1(CO)O)O)=O,4,3,0,3,2,0.000144
G5,C(CO)(C1(C=CC(O1)O)CO)=O,4,3,0,3,29,0.000144
G5,C1(C(CO)(O)OC(CCO)C1O)=O,8,1,0,1,18,4.9e-05
G5,C(C(CO)O)(OC(C=O)C(C)=O)=O,4,3,0,3,2,0.000144
G5,C(C(CO)O)(OC(C=O)CC=O)=O,4,3,0,3,27,0.000144
G5,C(CO)(OC(C=O)(CO)CC=O)=O,2,1,0,1,27,4.9e-05
G5,C(C(CO)O)(OCCC(C=O)=O)=O,2,3,0,3,2,0.000144
G5,C(C(CO)O)(OCC(CC=O)=O)=O,2,3,0,3,2,0.000144
G5,C1(C(C)C(C(C1O)=O)(CO)O)=O,8,2,0,2,2,9.7e-05
G5,C1(CC(C=CC1(CO)O)=O)=O,2,3,0,3,29,0.000144
G5,C(C(C)C(C(CC=O)=O)(CO)O)=O,4,1,0,1,49,4.9e-05
G5,C(C)(C(CO)(C(C(CO)=O)C)O)=O,4,1,0,1,2,4.9e-05
G5,C(C(CO)(CC(C=O)CC=O)O)=O,4,3,0,3,21,0.000145
G5,C(C(C=CC(CC=O)=O)(CO)O)=O,4,1,0,1,29,4.9e-05
G5,C(C(C=CC(C(C)=O)=O)(CO)O)=O,4,1,0,1,29,4.9e-05
G5,C(C(CO)(CCC(C(C)=O)=O)O)=O,2,1,0,1,49,4.9e-05
G5,C(C)(C(C=CC=O)(CO)O)=O,4,2,0,2,45,9.7e-05
G5,C(C1(CO)CC(C(CO1)O)O)=O,8,1,0,1,29,4.9e-05
G5,C(C(C(C=C)=O)C(C=O)(CO)O)=O,4,1,0,1,7,4.9e-05
G5,C1(C(CO)(CC(C1(C)O)=O)O)=O,4,2,0,2,0,9.7e-05
G5,C(C1(CO)CC(C(CO)O1)=O)=O,4,3,0,3,29,0.000144
G5,C(C1(CO)CC(C(CO1)O)=O)=O,4,2,0,2,37,9.7e-05
G5,C(C)(C1(CO)CC(C(O1)=O)=O)=O,2,3,0,3,29,0.000144
G5,C1(C(CO)(CC=O)OC(C1)=O)=O,2,3,0,3,45,0.000144
G5,C=C1C(C(CO)(CC1=O)O)=O,2,3,0,3,47,0.000144
G5,C1(CC(C(C1(CO)O)=C)=O)=O,2,2,0,2,2,9.7e-05
G5,C1(CC=C(C=O)C1(CO)O)=O,2,3,0,3,29,0.000144
G5,C1(CC(C=O)=CC1(CO)O)=O,2,3,0,3,29,0.000144
G5,C(C)(C(C=CC(O)=O)(CO)O)=O,4,2,0,2,45,9.7e-05
G5,C(CC=O)(C(C=C)(CO)O)=O,2,3,0,3,2,0.000144
G5,C(C(CO)(CC(C=C)=O)O)=O,2,3,0,3,2,0.000144
G5,C(C1C(C(C=C1)(CO)O)=O)=O,4,2,0,2,2,9.7e-05
G5,C(C)(C1(C=CC(O1)=O)CO)=O,2,2,0,2,48,9.7e-05
G5,C(CC1(C(C=CO1)=O)CO)=O,2,3,0,3,2,0.000144
G5,C1C(C(C=O)=O)(CO)OCC=1,2,2,0,2,39,9.7e-05
G5,C(C1(C=CC(C=O)O1)CO)=O,4,4,0,4,29,0.000192
G5,C(C1(CO)CC(C(O1)=C)=O)=O,2,3,0,3,29,0.000144
G5,C(C1(CO)CC(C=CO1)=O)=O,2,3,0,3,37,0.000144
G5,C1(C(C2C(CC1(CO)O2)O)O)=O,16,1,0,1,9,4.9e-05
G5,C(C1C(C(C(CO)(O1)O)=O)O)(C)=O,8,1,0,1,1,4.9e-05
G5,C(CC1C(C(C(CO)(O)O1)=O)O)=O,8,1,0,1,5,4.9e-05
G5,C1(CC(C(CO)=O)(CO)OC1)=O,2,2,0,2,32,9.7e-05
G5,C1(CCC(C(CO)=O)(CO)O1)=O,2,2,0,2,32,9.7e-05
G5,C1(C(COC1(CO)CCO)=O)=O,2,2,0,2,2,9.7e-05
G5,C1(CC(C(CO)(CCO)O1)=O)=O,2,2,0,2,2,9.7e-05
G5,C1(C(CO)(CC(C(CO)=O)O1)O)=O,4,1,0,1,2,4.9e-05
G5,C1(C(CC(C(CO)=O)(CO)O1)O)=O,4,1,0,1,2,4.9e-05
G5,C1(C(CO)(CC(C(C)=O)(O)O1)O)=O,4,2,0,2,14,9.7e-05
G5,C1(C(CO)(CC(CC=O)(O)O1)O)=O,4,2,0,2,2,9.7e-05
G5,C1(C(C(C(CO)(CCO)O1)=O)O)=O,4,1,0,1,2,4.9e-05
G5,C1(C2(CO)CC(C(CO)O2)O1)=O,8,1,0,1,41,4.9e-05
G5,C1(C2COC1(CO)CC(O2)O)=O,8,2,0,2,9,9.7e-05
G5,C1(C(CO)(O)OC2CC1OC2)=O,8,1,0,1,39,4.9e-05
G5,C1(C(O)OC2COC1(CO)C2)=O,8,2,0,2,39,9.7e-05
G5,C1(C2(CO)CC(C(CO1)O2)O)=O,8,1,0,1,41,4.9e-05
G5,C1(COC2C(CC1(CO)O2)O)=O,8,1,0,1,4,4.9e-05
G5,C1(C2(CO)OC(CCO2)(C1)O)=O,4,2,0,2,30,9.7e-05
G5,C1(C(C2OC1(CO)CCO2)O)=O,8,1,0,1,4,4.9e-05
G5,C1(C2(CO)CC(C(CO2)O)O1)=O,8,1,0,1,30,4.9e-05
G5,C1(C(C(CO)(O)OC(CO)C1)=O)=O,4,1,0,1,0,4.9e-05
G5,C1(C(CO)OC(C(C1)=O)(CO)O)=O,4,1,0,1,2,4.9e-05
G5,C(C1CC(C(CO1)=O)(CO)O)=O,4,3,0,3,20,0.000144
G5,C(C1(CO)CC(C(CO1)=O)O)=O,4,2,0,2,37,9.7e-05
G5,C(C1(CO)CC(CC(O1)=O)O)=O,4,2,0,2,37,9.7e-05
G5,C(C1CCC(C(CO)(O1)O)=O)=O,4,3,0,3,51,0.000144
G5,C(C1(CO)CCC(C(O1)O)=O)=O,4,3,0,3,12,0.000144
G5,C1(C(CO)(C)OCC(C1O)=O)=O,4,2,0,2,24,9.7e-05
G5,C1(C(CO)(CC(OC1C)=O)O)=O,4,2,0,2,24,9.7e-05
G5,C1(CC(C(C(CO)(C)O1)=O)O)=O,4,2,0,2,24,9.7e-05
G5,C1(C(C)OC(C(C1)=O)(CO)O)=O,4,1,0,1,24,4.9e-05
G5,C1(C(CO)(C)OC(C(C1)=O)O)=O,4,3,0,3,24,0.000144
G5,C1(C(CC(OC1(CO)C)O)=O)=O,4,3,0,3,4,0.000144
G5,C1(C(C(COC1(CO)C)O)O)=O,8,1,0,1,4,4.9e-05
G5,C(C1(CO)CC(C(C(O1)=O)O)O)=O,8,1,0,1,27,4.9e-05
G5,C1(C(CO)(CC(C(C)(O)O1)=O)O)=O,4,2,0,2,14,9.7e-05
G5,C1(C(C(C(OC1(CO)C)=O)O)O)=O,8,1,0,1,2,4.9e-05
G5,C1(C2(CO)CC(C(CO2)O1)O)=O,8,1,0,1,30,4.9e-05
G5,C1(C(C(CO)(O)OCC(C1)O)=O)=O,4,1,0,1,2,4.9e-05
G5,C1(C(COC(C(C1)=O)(CO)O)O)=O,4,1,0,1,2,4.9e-05
G5,C1(CCOC(C(C1O)=O)(CO)O)=O,4,1,0,1,2,4.9e-05
G5,C1(CC(C(C(CO)(OC1)O)=O)O)=O,4,1,0,1,2,4.9e-05
G5,C1(CC(C(C(OC1)O)=O)(CO)O)=O,4,2,0,2,2,9.7e-05
G5,C1(CCOC(CC1(CO)O)O)=O,4,2,0,2,2,9.7e-05
G5,C1(C(CO)(O)OCCC(C1)O)=O,4,2,0,2,18,9.7e-05
G5,C1(CC(O)OCCC1(CO)O)=O,4,2,0,2,2,9.7e-05
G5,C1(CC(C(CO)(CC(O)O1)O)=O)=O,4,2,0,2,45,9.7e-05
G5,C1(C(CO)(CC(CC(O)O1)=O)O)=O,4,2,0,2,2,9.7e-05
G5,C1(CC(CC(C(CO)(O)O1)=O)O)=O,4,1,0,1,28,4.9e-05
G5,C1(C(CO)(CC(OC(C1)O)=O)O)=O,4,2,0,2,29,9.7e-05
G5,C1(C2(CO)OC(CC(C1)O2)O)=O,8,2,0,2,2,9.7e-05
G5,C1(CC2OC1(CO)CC(O)O2)=O,8,2,0,2,2,9.7e-05
G5,C(C1(CO)CC(CC(O1)=O)=O)=O,2,3,0,3,29,0.000144
G5,C1(C=C(C=O)CC1(CO)O)=O,2,2,0,2,22,9.7e-05
G5,C1CC(C(C=1C=O)=O)(CO)O,2,2,0,2,2,9.7e-05
G5,C(CC=O)(C(C(C=O)=C)(CO)O)=O,2,1,0,1,23,4.9e-05
G5,C(C)(C(C=CC(C=O)=O)(CO)O)=O,4,1,0,1,49,4.9e-05
G5,C(C(C(C)=CC(C=O)=O)(CO)O)=O,4,1,0,1,26,4.9e-05
G5,C(C(C(CC(C=O)=O)=C)(CO)O)=O,2,1,0,1,29,4.9e-05
G5,C(C)(C(C(C(C=O)=O)=C)(CO)O)=O,2,1,0,1,45,4.9e-05
G5,C(C)(C(C(C(CO)=O)=C)(CO)O)=O,2,1,0,1,45,4.9e-05
G5,C(C(C=CC(C=O)=O)(CO)O)=O,4,2,0,2,23,9.7e-05
G5,C(C(CO)(CC=CC(C=O)=O)O)=O,4,1,0,1,20,4.9e-05
G5,C(C(C=CCC(C=O)=O)(CO)O)=O,4,1,0,1,20,4.9e-05
G5,C(C(C(C=O)=CC(C)=O)(CO)O)=O,4,1,0,1,55,4.9e-05
G5,C(C)(C(C(C=O)=CC=O)(CO)O)=O,4,1,0,1,55,4.9e-05
G5,C(C(C(C=O)=C(C=O)C)(CO)O)=O,4,1,0,1,49,4.9e-05
G5,C(CC=O)(C(C(CO)=C)(CO)O)=O,2,1,0,1,29,4.9e-05
G5,C(C)(C(C=CC(CO)=O)(CO)O)=O,4,2,0,2,32,0.00010800000000000001
G5,C(C)(C(C(CO)=CC=O)(CO)O)=O,4,1,0,1,49,4.9e-05
G5,C(C(C(CC(CO)=O)=C)(CO)O)=O,2,1,0,1,55,4.9e-05
G5,C(C(C(C)=CC(CO)=O)(CO)O)=O,4,1,0,1,0,4.9e-05
G5,C(C(C(C(C(C)=O)O)=C)(CO)O)=O,4,1,0,1,49,4.9e-05
G5,C(C(C(C(C(C)=O)(CO)O)=C)O)=O,4,1,0,1,49,4.9e-05
G5,C(C(C(CC=O)=C)(CO)O)=O,2,3,0,3,29,0.000144
G5,C(C(C(C)=CC=O)(CO)O)=O,4,2,0,2,6,9.7e-05
G5,C(C(C(C(C=O)=O)=C)(CO)O)=O,2,3,0,3,25,0.000144
G5,C(C(C(C=O)=CC=O)(CO)O)=O,4,3,0,3,29,0.000144
G5,C(C)(C(C(C(CO)O)=C)(CO)O)=O,4,1,0,1,29,4.9e-05
G5,C(C(C(C(CO)=O)=CC)(CO)O)=O,4,1,0,1,11,4.9e-05
G5,C(C(C=C(CO)CC=O)(CO)O)=O,4,1,0,1,21,4.9e-05
G5,C(C(CO)(CC(CO)=CC=O)O)=O,4,1,0,1,21,4.9e-05
G5,C(CC(C(C(C=O)=C)=O)(CO)O)=O,2,1,0,1,9,4.9e-05
G5,C(C(C(C(C(C)=O)=O)=C)(CO)O)=O,2,1,0,1,14,4.9e-05
G5,C(C(CO)(CC(C(C=C)=O)=O)O)=O,2,1,0,1,0,4.9e-05
G5,C(C(C(C(CC=O)=O)=C)(CO)O)=O,2,1,0,1,2,4.9e-05
G5,C(C(CO)(CC(C(C=O)=C)=O)O)=O,2,1,0,1,2,4.9e-05
G5,C(C)(C(C(C=O)=CCO)(CO)O)=O,4,1,0,1,3,4.9e-05
G5,C(C)(C(C(CO)=CCO)(CO)O)=O,4,1,0,1,3,4.9e-05
G5,C(C(CO)(CC=CC(CO)=O)O)=O,4,1,0,1,21,4.9e-05
G5,C(C(C=CCC(CO)=O)(CO)O)=O,4,1,0,1,21,4.9e-05
G5,C(C(C=CC(C(C)=O)(CO)O)O)=O,8,1,0,1,49,4.9e-05
G5,C(C(C=CC(C(C)=O)O)(CO)O)=O,8,1,0,1,49,4.9e-05
G5,C(C(C(C=O)=C(CO)C)(CO)O)=O,4,1,0,1,49,4.9e-05
G5,C(C(C(C=O)=CC)(CO)O)=O,4,2,0,2,43,9.7e-05
G5,C(C(C=CCC=O)(CO)O)=O,4,2,0,2,43,9.7e-05
G5,C(C(CO)(CC=CC=O)O)=O,4,2,0,2,43,9.7e-05
G5,C(C(C=C(C(O)=O)C)(CO)O)=O,4,2,0,2,14,9.7e-05
G5,C(C(CO)(CC(C(O)=O)=C)O)=O,2,2,0,2,14,9.7e-05
G5,C1(C(C=CC1(CO)O)(CO)O)=O,3,2,0,2,2,9.7e-05
G5,C1(C(C=CC(CO1)=O)(CO)O)=O,2,2,0,2,2,9.7e-05
G5,C1(C(C(OC1(C=C)CO)O)O)=O,8,3,0,3,2,0.000144
G5,C1(C(C=C(C(CO)O)O1)(CO)O)=O,4,1,0,1,29,4.9e-05
G5,C1(COC(CO)=CC1(CO)O)=O,2,2,0,2,32,9.7e-05
G5,C(C1(C=CC(C(O1)O)O)CO)=O,8,3,0,3,29,0.000144
G5,C1(C(C=CC(CO)(O)O1)(CO)O)=O,4,1,0,1,17,4.9e-05
G5,C1(C(CO)(O)OC(CO)(CO)C1)=O,2,2,0,2,5,9.7e-05
G5,C(C1(C)CC(C(CO)(O1)O)=O)=O,4,2,0,2,25,9.7e-05
G5,C1(CC(C=O)OC1(CO)O)=O,4,3,0,3,5,0.000144
G5,C(C1(CO)CC(C(O1)O)=O)=O,4,3,0,3,1,0.000144
G5,C(C(C1CC(C(CO)(O)O1)=O)O)=O,8,2,0,2,15,9.7e-05
G5,C1(C(CO)(O)OC(CO)(C)C1)=O,4,2,0,2,25,9.7e-05
G5,C1(C(CO)(O)OC(C)C1)=O,4,2,0,2,4,9.7e-05
G5,C(C1(CO)C(C(C(O1)O)=O)CO)=O,8,2,0,2,0,9.7e-05
G5,C1(C(CO)(OC(C=O)C1CO)O)=O,8,1,0,1,0,4.9e-05
G5,C(C1C(C(OC1(C=O)CO)O)O)=O,16,2,0,2,43,9.7e-05
G5,C1(C(CO)(O)OC(C)C1CO)=O,8,1,0,1,4,4.9e-05
G5,C(C(CO)(C1C(O)OCC1O)O)=O,16,2,0,2,38,9.7e-05
G5,C1(C(CO)(CC(CCO)(O)O1)O)=O,4,2,0,2,30,9.7e-05
G5,C(C1(CO)CCC(CO)(O1)O)(O)=O,4,2,0,2,12,9.7e-05
G5,C(C1(CO)CC(C(C)(O1)O)O)(O)=O,8,2,0,2,45,9.7e-05
G5,C1(C(CO)(O)OCC1O)=O,4,2,0,2,0,9.7e-05
G5,C1(C(CO)(CC(CO)(O)O1)O)=O,4,2,0,2,33,9.7e-05
G5,C(C1(CO)CC(C(O1)O)O)=O,8,2,0,2,2,9.7e-05
G5,C1(C(C(OC1(CO)C)O)O)=O,8,2,0,2,2,9.7e-05
G5,C1(C(C(CO)(OC1(CO)C)O)O)=O,8,2,0,2,2,9.7e-05
G5,C(C1(CO)CCC(C=O)(O1)O)=O,4,2,0,2,12,9.7e-05
G5,C1(CC(C=O)(OC1(CO)C)O)=O,4,2,0,2,24,9.7e-05
G5,C(C(C1(CO)CCC(O1)O)=O)=O,4,2,0,2,27,9.7e-05
G5,C1(C(CO)(CC(O)O1)O)=O,4,2,0,2,45,9.7e-05
G5,C1(C(CO)(O)OCC(CO)(C1)O)=O,4,2,0,2,5,9.7e-05
G5,C(C1C(CC(C(CO)(O1)O)=O)O)=O,8,2,0,2,1,9.7e-05
G5,C1(C(CO)(O)OCC(C)(C1)O)=O,4,2,0,2,25,9.7e-05
G5,C(C1(CO)CC(C(C(O1)O)O)=O)=O,8,2,0,2,2,9.7e-05
G5,C(C1(CO)CC(CC(O1)O)O)=O,8,2,0,2,43,9.7e-05
G5,C1(C(CO)(CCC(CO)(O)O1)O)=O,4,2,0,2,12,9.7e-05
G5,C1(C(CO)(CC(C(C)(O)O1)O)O)=O,8,2,0,2,24,9.7e-05
G5,C(C1(CO)CC(CC(O1)O)O)(O)=O,8,2,0,2,33,9.7e-05
G5,C1(C(CO)(CC(CC(O)O1)O)O)=O,8,2,0,2,33,9.7e-05
G5,C1(C(C)(CC(C=O)(CO)O1)O)=O,4,2,0,2,14,9.7e-05
G5,C1(C(CO)(CC(C(C=O)O)O1)O)=O,8,1,0,1,29,4.9e-05
G5,C1(C(CO)(CC(C(C=O)O1)O)O)=O,8,1,0,1,29,4.9e-05
G5,C(C(CO)(CCCC(C=O)=O)O)=O,2,2,0,2,7,9.7e-05
G5,C(C(CO)(CCCC(CO)=O)O)=O,2,2,0,2,11,9.7e-05
G5,C(C(CO)(OCC(C=C)=O)O)=O,2,1,0,1,4,4.9e-05
G5,C(C(C=C)(C(C(C=O)O)O)O)(O)=O,8,1,0,1,7,4.8e-05
G5,C1(C(C(C(C=O)O)O)(CCO1)O)=O,8,1,0,1,28,4.8e-05
G5,C1(C(C(CO)(C)O)(CC(C1)=O)O)=O,4,1,0,1,26,4.8e-05
G5,C(C(C=C)(C(CO)(C)O)O)(O)=O,4,3,0,3,29,0.000143
G5,C(C(C(CO)(C)O)O)(OCC=O)=O,4,3,0,3,49,0.000143
G5,C(C(C)=O)(C(C)(C(CO)(C)O)O)=O,4,1,0,1,49,4.8e-05
G5,C1(C(CCO1)(C(CO)(C)O)O)=O,4,2,0,2,29,9.499999999999999e-05
G5,C(C(C)O)(C(C)(C(CO)(C)O)O)=O,8,1,0,1,49,4.8e-05
G5,C(C(C=CC=O)(C(CO)(C)O)O)=O,8,1,0,1,20,4.8e-05
G5,C(C(C)C(C=O)(C(CO)(C)O)O)=O,8,1,0,1,49,4.8e-05
G5,C(CO)(C(C=C)(C(CO)(C)O)O)=O,4,1,0,1,31,4.8e-05
G5,C(C(C(C=O)=C)(C(CO)(C)O)O)=O,4,1,0,1,16,4.8e-05
G5,C(C)(C(C=C)(C(CO)(C)O)O)=O,4,2,0,2,4,9.499999999999999e-05
G5,C(C(C(CO)=C)(C(CO)(C)O)O)=O,4,1,0,1,49,4.8e-05
G5,C1(C(C(CO)(C)O)(O)OC(C)C1)=O,8,1,0,1,45,4.8e-05
G5,C1(C(C(CO)(C)O)(O)OCC1O)=O,8,1,0,1,0,4.8e-05
G5,C1(C(CC(O)O1)(C(CO)(C)O)O)=O,8,2,0,2,29,9.499999999999999e-05
G5,C(C(C(C)(C)O)(CC=O)O)=O,2,1,0,1,43,4.8e-05
G5,C(C(C(COC=O)O)(CC=O)O)=O,4,1,0,1,43,4.8e-05
G5,C(C(C=C)(C(CC(C=O)O)O)O)=O,8,3,0,3,29,0.000165
G5,C(CC(C=O)(C1(C=COC1)O)O)=O,4,1,0,1,43,4.8e-05
G5,C(C(C(C=O)(CC=O)O)O)(CC)=O,4,1,0,1,43,4.8e-05
G5,C(CC(C=O)(C(C=O)(CC)O)O)=O,4,1,0,1,43,4.8e-05
G5,C(CC(C=O)(C(C=C)O)O)=O,4,3,0,3,29,0.000143
G5,C(CC(C=O)(C(C=CC)O)O)=O,8,2,0,2,43,9.499999999999999e-05
G5,C(C(C(CC=C)O)(CC=O)O)=O,4,2,0,2,43,9.499999999999999e-05
G5,C(C1CC(C(C1(C(C)O)O)=O)O)=O,16,1,0,1,32,4.9e-05
G5,C1(C=CC(CC1(C(C)O)O)=O)=O,4,3,0,3,29,0.000144
G5,C(C1C=CC(C1(C(C)O)O)=O)=O,8,2,0,2,4,9.6e-05
G5,C(C(C(C)O)(CC=O)O)(C(C)O)=O,8,1,0,1,25,4.9e-05
G5,C(C(C(C)O)(CC(C)O)O)(O)=O,8,1,0,1,27,4.9e-05
G5,C(C(C(C)O)(C(CO)CO)O)(O)=O,4,1,0,1,29,4.9e-05
G5,C(C(C(C)O)(CC(CO)O)O)(O)=O,8,1,0,1,29,4.9e-05
G5,C(C(C=CC(C)=O)(C(C)O)O)(O)=O,8,1,0,1,29,4.9e-05
G5,C(C(C=CCC=O)(C(C)O)O)(O)=O,8,1,0,1,29,4.9e-05
G5,C(C(C(C)O)(CC(C=C)=O)O)(O)=O,4,1,0,1,29,4.9e-05
G5,C(C(C(C)O)(CC=CC=O)O)(O)=O,8,1,0,1,29,4.9e-05
G5,C(C(C(C=O)=O)(C(C)O)O)=CC=O,8,1,0,1,43,4.9e-05
G5,C(C)(C(C(C)O)(OCC=O)O)=O,4,1,0,1,27,4.9e-05
G5,C(C(C(C)O)(OCC(C)=O)O)=O,4,1,0,1,27,4.9e-05
G5,C(C(C(C(C)O)(CCO)O)=O)=O,4,1,0,1,27,4.9e-05
G5,C1(COC(CC1(C(C)O)O)O)=O,8,2,0,2,4,9.6e-05
G5,C(C(C)=O)(C(C)(C(C)O)O)=O,4,1,0,1,49,4.9e-05
G5,C=CC(C(C(C)(C(C)O)O)=O)=O,4,1,0,1,7,4.9e-05
G5,C1(C(C(C)O)(O)OC(CO)C1)=O,8,1,0,1,27,4.9e-05
G5,C1(C(C(C)O)(O)OCC(C1)O)=O,8,1,0,1,27,4.9e-05
G5,C1(C(C(C)O)(CC(CO1)=O)O)=O,4,2,0,2,4,9.6e-05
G5,C(C(C(C(CO)=O)=C)(C(C)O)O)=O,4,1,0,1,47,4.9e-05
G5,C(C(C=C)(C(C)O)O)=O,4,3,0,3,29,0.000144
G5,C(C(C=COCC=O)(C(C)O)O)=O,8,1,0,1,37,4.9e-05
G5,C1(C(C(C)O)(CCO1)O)=O,4,2,0,2,29,9.6e-05
G5,C1(C(CCC(C1O)=O)(C(C)O)O)=O,8,2,0,2,32,9.6e-05
G5,C(C1(C(C(C(C)O)(CC1)O)=O)O)=O,8,1,0,1,12,4.9e-05
G5,C(C(CC(C(C)=O)O)(C(C)O)O)=O,8,1,0,1,29,4.9e-05
G5,C(C(C)(CC(C=O)(C(C)O)O)O)=O,8,1,0,1,16,4.9e-05
G5,C(C(C)(C(C)O)O)(C(C(C)=O)O)=O,8,1,0,1,25,4.9e-05
G5,C(C(C(C(C)(C(C)O)O)=O)(C)O)=O,8,1,0,1,49,4.9e-05
G5,C(CC(C(C)(C(C)O)O)=O)=O,4,1,0,1,45,4.9e-05
G5,C(C(C(C(C)O)(CC(C)O)O)=O)=O,8,1,0,1,33,4.9e-05
G5,C(CO)(C(C(C)O)(CC(C)O)O)=O,8,1,0,1,11,4.9e-05
G5,C(C(C)O)(C(C(C)O)(CCO)O)=O,8,1,0,1,3,4.9e-05
G5,C(C(CCO)O)(C(C)(C(C)O)O)=O,8,1,0,1,3,4.9e-05
G5,C(C(C(C)O)(CC(CO)(C)O)O)=O,8,1,0,1,49,4.9e-05
G5,C(C(CO)(C)O)(C(C)(C(C)O)O)=O,8,1,0,1,49,4.9e-05
G5,C(C(C(C)O)(CC(C)O)O)=O,8,1,0,1,11,4.9e-05
G5,C(C(C)O)(C(C)(C(C)O)O)=O,8,1,0,1,49,4.9e-05
G5,C(C(C=CC=O)(C(C)O)O)=O,8,3,0,3,4,0.000144
G5,C1(C(C(CC1CO)(C(C)O)O)=O)=O,8,1,0,1,47,4.9e-05
G5,C1(C(CC(CO)C1(C(C)O)O)=O)=O,8,2,0,2,55,9.6e-05
G5,C1(C(CC(C(C)=O)O1)(C(C)O)O)=O,8,1,0,1,48,4.9e-05
G5,C1(C(C(C)O)(CC(CC=O)O1)O)=O,8,1,0,1,23,4.9e-05
G5,C1(CCC(C(CO1)=O)(C(C)O)O)=O,4,1,0,1,4,4.9e-05
G5,C1(CC(C(C(C)O)(CCO1)O)=O)=O,4,1,0,1,19,4.9e-05
G5,C1(C(COCCC1(C(C)O)O)=O)=O,4,1,0,1,36,4.9e-05
G5,C1(C(C(C)O)(CC(CCO1)=O)O)=O,4,1,0,1,30,4.9e-05
G5,C1(C(CCC(CO1)=O)(C(C)O)O)=O,4,1,0,1,12,4.9e-05
G5,C1(C(C(CO)=CC1(C(C)O)O)O)=O,8,1,0,1,46,4.9e-05
G5,C1(C(C=C(CO)C1(C(C)O)O)O)=O,8,1,0,1,46,4.9e-05
G5,C1(C(C(C(C1(C(C)O)O)=C)O)O)=O,16,1,0,1,2,4.9e-05
G5,C1(C(C=CC(CO)O1)(C(C)O)O)=O,8,1,0,1,48,4.9e-05
G5,C1(C(CO)OC=CC1(C(C)O)O)=O,8,1,0,1,2,4.9e-05
G5,C1(C(C=CC(CO1)O)(C(C)O)O)=O,8,1,0,1,48,4.9e-05
G5,C1(C(COC=CC1(C(C)O)O)O)=O,8,1,0,1,38,4.9e-05
G5,C1(C(C(C)O)(OCC=CC1O)O)=O,8,1,0,1,41,4.9e-05
G5,C1(C(OCC=CC1(C(C)O)O)O)=O,8,1,0,1,41,4.9e-05
G5,C1(COC(C=CC1(C(C)O)O)O)=O,8,1,0,1,38,4.9e-05
G5,C(CO)(C1(C=CC(O1)O)C(C)O)=O,8,1,0,1,38,4.9e-05
G5,C1(C(C)C(C(C1O)=O)(C(C)O)O)=O,16,1,0,1,42,4.9e-05
G5,C1(CC(C=CC1(C(C)O)O)=O)=O,4,3,0,3,29,0.000144
G5,C(C(C)C(C(CO)=O)(C(C)O)O)=O,8,1,0,1,49,4.9e-05
G5,C(C(C)C(C(C)=O)(C(C)O)O)=O,8,2,0,2,27,9.6e-05
G5,C(C(C(C)O)(C(C(CO)=O)C)O)=O,8,1,0,1,28,4.9e-05
G5,C(C(C)C(C=O)(C(C)O)O)=O,8,2,0,2,49,9.6e-05
G5,C(C)(C(C=CC=O)(C(C)O)O)=O,8,2,0,2,4,9.6e-05
G5,C(C1(C(C)O)CC(C(CO1)O)O)=O,16,1,0,1,29,4.9e-05
G5,C1(C(C(C)O)(CC(C1(C)O)=O)O)=O,8,1,0,1,45,4.9e-05
G5,C(C(C)C(C(O)=O)(C(C)O)O)=O,8,2,0,2,49,9.6e-05
G5,C(C1(C(C)O)CC(C(CO)O1)=O)=O,8,1,0,1,2,4.9e-05
G5,C(C1(C(C)O)CC(C(CO1)O)=O)=O,8,1,0,1,37,4.9e-05
G5,C(C)(C1(C(C)O)CC(C(O1)=O)=O)=O,4,1,0,1,27,4.9e-05
G5,C1(C(C(C)O)(CC=O)OC(C1)=O)=O,4,1,0,1,27,4.9e-05
G5,C=C1C(C(C(C)O)(CC1=O)O)=O,4,3,0,3,4,0.000144
G5,C1(CC(C(C1(C(C)O)O)=C)=O)=O,4,2,0,2,30,9.6e-05
G5,C1(CC=C(C=O)C1(C(C)O)O)=O,4,3,0,3,12,0.000144
G5,C1(CC(C=O)=CC1(C(C)O)O)=O,4,3,0,3,29,0.000144
G5,C(C)(C(C=CC(O)=O)(C(C)O)O)=O,8,1,0,1,45,4.9e-05
G5,C(CC=O)(C(C=C)(C(C)O)O)=O,4,3,0,3,4,0.000144
G5,C(C(C(C)O)(CC(C=C)=O)O)=O,4,3,0,3,25,0.000144
G5,C(C1C(C(C=C1)(C(C)O)O)=O)=O,8,2,0,2,4,9.6e-05
G5,C(C)(C1(C=CC(O1)=O)C(C)O)=O,4,2,0,2,48,9.6e-05
G5,C(CC1(C(C=CO1)=O)C(C)O)=O,4,3,0,3,4,0.000144
G5,C1C(C(C=O)=O)(C(C)O)OCC=1,4,2,0,2,4,9.6e-05
G5,C(C1(C=CC(C=O)O1)C(C)O)=O,8,4,0,4,29,0.00019099999999999998
G5,C(C1(C(C)O)CC(C(O1)=C)=O)=O,4,3,0,3,14,0.000144
G5,C(C1(C(C)O)CC(C=CO1)=O)=O,4,3,0,3,25,0.000144
G5,C1(C(C2C(CC1(C(C)O)O2)O)O)=O,32,1,0,1,9,4.9e-05
G5,C1(CC(C(CO)=O)(C(C)O)OC1)=O,4,1,0,1,32,4.9e-05
G5,C1(CCC(C(CO)=O)(C(C)O)O1)=O,4,1,0,1,32,4.9e-05
G5,C1(C(COC1(C(C)O)CCO)=O)=O,4,1,0,1,4,4.9e-05
G5,C1(CC(C(CCO)(C(C)O)O1)=O)=O,4,1,0,1,2,4.9e-05
G5,C1(C2(C(C)O)CC(C(CO)O2)O1)=O,16,1,0,1,41,4.9e-05
G5,C1(C2COC1(C(C)O)CC(O2)O)=O,16,2,0,2,9,9.6e-05
G5,C1(C(C(C)O)(O)OC2CC1OC2)=O,16,1,0,1,39,4.9e-05
G5,C1(C(O)OC2COC1(C(C)O)C2)=O,16,2,0,2,4,9.6e-05
G5,C1(C2(C(C)O)CC(C(CO1)O2)O)=O,16,1,0,1,41,4.9e-05
G5,C1(COC2C(CC1(C(C)O)O2)O)=O,16,1,0,1,4,4.9e-05
G5,C1(C2(C(C)O)OCCC(C1)(O2)O)=O,8,2,0,2,30,9.6e-05
G5,C1(C(C2OC1(C(C)O)CCO2)O)=O,16,1,0,1,4,4.9e-05
G5,C1(C2(C(C)O)CC(C(CO2)O)O1)=O,16,1,0,1,30,4.9e-05
G5,C(C1CC(C(CO1)=O)(C(C)O)O)=O,8,1,0,1,4,4.9e-05
G5,C(C1(CC(C(CO1)=O)O)C(C)O)=O,8,1,0,1,4,4.9e-05
G5,C(C1(CC(CC(O1)=O)O)C(C)O)=O,8,1,0,1,48,4.9e-05
G5,C(C1CCC(C(C(C)O)(O1)O)=O)=O,8,1,0,1,12,4.9e-05
G5,C(C1(CCC(C(O1)O)=O)C(C)O)=O,8,2,0,2,12,9.6e-05
G5,C1(C(C)(C(C)O)OCC(C1O)=O)=O,8,1,0,1,24,4.9e-05
G5,C1(C(C(C)O)(CC(OC1C)=O)O)=O,8,1,0,1,24,4.9e-05
G5,C1(CC(C(C(C)(C(C)O)O1)=O)O)=O,8,1,0,1,24,4.9e-05
G5,C1(C(C)OC(C(C1)=O)(C(C)O)O)=O,8,1,0,1,24,4.9e-05
G5,C1(C(C)(C(C)O)OC(C(C1)=O)O)=O,8,2,0,2,4,9.6e-05
G5,C1(C(CC(OC1(C)C(C)O)O)=O)=O,8,2,0,2,4,9.6e-05
G5,C1(C(C(COC1(C)C(C)O)O)O)=O,16,1,0,1,4,4.9e-05
G5,C1(C2(C(C)O)CC(C(CO2)O1)O)=O,16,1,0,1,30,4.9e-05
G5,C1(CCOC(CC1(C(C)O)O)O)=O,8,2,0,2,4,9.6e-05
G5,C1(C(C(C)O)(O)OCCC(C1)O)=O,8,1,0,1,4,4.9e-05
G5,C1(CC(O)OCCC1(C(C)O)O)=O,8,2,0,2,4,9.6e-05
G5,C1(C2(C(C)O)OC(CC(O2)O)C1)=O,16,2,0,2,4,9.6e-05
G5,C1(CC2OC1(C(C)O)CC(O)O2)=O,16,2,0,2,4,9.6e-05
G5,C(C1(C(C)O)CC(CC(O1)=O)=O)=O,4,1,0,1,27,4.9e-05
G5,C1(C=C(C=O)CC1(C(C)O)O)=O,4,2,0,2,4,9.6e-05
G5,C1CC(C(C=1C=O)=O)(C(C)O)O,4,2,0,2,4,9.6e-05
G5,C(CO)(C(C(C=O)=C)(C(C)O)O)=O,4,1,0,1,2,4.9e-05
G5,C(CO)(C(C(CO)=C)(C(C)O)O)=O,4,1,0,1,49,4.9e-05
G5,C(CO)(C(C=C)(C(C)O)O)=O,4,2,0,2,4,9.6e-05
G5,C(C(C=CC(C=O)=O)(C(C)O)O)=O,8,1,0,1,12,4.9e-05
G5,C(C)(C(C(C=O)=C)(C(C)O)O)=O,4,2,0,2,45,9.6e-05
G5,C(C(C(CC=O)=C)(C(C)O)O)=O,4,2,0,2,4,9.6e-05
G5,C(C(C(C)=CC=O)(C(C)O)O)=O,8,2,0,2,4,9.6e-05
G5,C(C(C(C(C=O)=O)=C)(C(C)O)O)=O,4,1,0,1,0,4.9e-05
G5,C(C(C(C=O)=CC=O)(C(C)O)O)=O,8,1,0,1,43,4.9e-05
G5,C(C(C(C=O)=C)(C(C)O)O)=O,4,3,0,3,29,0.000144
G5,C(CCO)(C(C=C)(C(C)O)O)=O,4,2,0,2,4,9.6e-05
G5,C(C)(C(C(CO)=C)(C(C)O)O)=O,4,2,0,2,49,9.6e-05
G5,C(C)(C(C=C)(C(C)O)O)=O,4,2,0,2,4,9.6e-05
G5,C(C(C(C=O)=CC)(C(C)O)O)=O,8,2,0,2,4,9.6e-05
G5,C(C(C=CCC=O)(C(C)O)O)=O,8,2,0,2,4,9.6e-05
G5,C(C(C(C)O)(CC=CC=O)O)=O,8,2,0,2,4,9.6e-05
G5,C(C(C(CO)=CC=O)(C(C)O)O)=O,8,1,0,1,29,4.9e-05
G5,C(C(C(C(C=O)O)=C)(C(C)O)O)=O,8,1,0,1,29,4.9e-05
G5,C(C(C(C(CO)O)=C)(C(C)O)O)=O,8,1,0,1,29,4.9e-05
G5,C(C(C(C=O)=CCO)(C(C)O)O)=O,8,1,0,1,43,4.9e-05
G5,C(C(C(CO)=CCO)(C(C)O)O)=O,8,1,0,1,29,4.9e-05
G5,C(C(C(CO)=C)(C(C)O)O)=O,4,2,0,2,49,9.6e-05
G5,C(C(C=C(C(O)=O)C)(C(C)O)O)=O,8,1,0,1,14,4.9e-05
G5,C(C(C(C)O)(CC(C(O)=O)=C)O)=O,4,1,0,1,14,4.9e-05
G5,C1(C(C=CC1(CO)O)(C(C)O)O)=O,8,1,0,1,2,4.9e-05
G5,C(C(C(C=O)=C)(C(C)O)O)(O)=O,4,2,0,2,4,9.6e-05
G5,C(C(C(CO)=C)(C(C)O)O)(O)=O,4,2,0,2,49,9.6e-05
G5,C1(C(C=CC(CO1)=O)(C(C)O)O)=O,4,1,0,1,27,4.9e-05
G5,C1(C(C(OC1(C=C)C(C)O)O)O)=O,16,2,0,2,4,9.6e-05
G5,C1(COC(CO)=CC1(C(C)O)O)=O,4,1,0,1,32,4.9e-05
G5,C(C1(C=CC(C(O1)O)O)C(C)O)=O,16,1,0,1,29,4.9e-05
G5,C(C1(C)CC(C(C(C)O)(O1)O)=O)=O,8,1,0,1,4,4.9e-05
G5,C1(CC(C=O)OC1(C(C)O)O)=O,8,1,0,1,0,4.9e-05
G5,C(C1(C(C)O)CC(C(O1)O)=O)=O,8,2,0,2,4,9.6e-05
G5,C1(C(C(C)O)(O)OC(CO)(C)C1)=O,8,1,0,1,49,4.9e-05
G5,C1(C(C(C)O)(O)OC(C)C1)=O,8,1,0,1,45,4.9e-05
G5,C1(C(C(C)O)(O)OC(C)C1CO)=O,16,1,0,1,4,4.9e-05
G5,C1(C(C(C)O)(CC(CO)(O)O1)O)=O,8,2,0,2,4,9.6e-05
G5,C(C1(C(C)O)CC(C(O1)O)O)=O,16,2,0,2,27,9.6e-05
G5,C1(C(C(OC1(C)C(C)O)O)O)=O,16,2,0,2,4,9.6e-05
G5,C(C1(C(C)O)CCC(C=O)(O1)O)=O,8,2,0,2,12,9.6e-05
G5,C1(CC(C=O)(OC1(C)C(C)O)O)=O,8,2,0,2,4,9.6e-05
G5,C(C(C1(C(C)O)CCC(O1)O)=O)=O,8,2,0,2,27,9.6e-05
G5,C1(C(C(C)O)(CC(O)O1)O)=O,8,2,0,2,45,9.6e-05
G5,C1(C(C(C)O)(O)OCC(C)(C1)O)=O,8,1,0,1,49,4.9e-05
G5,C(C1(C(C)O)CC(CC(O1)O)O)=O,16,2,0,2,43,9.6e-05
G5,C1(C(C)(CC(C=O)(C(C)O)O1)O)=O,8,1,0,1,14,4.9e-05
G5,C(C(C(C)O)(OCC(C=C)=O)O)=O,4,1,0,1,4,4.9e-05
G5,C(C(C1(C(CC(C1)O)O)O)O)(O)=O,16,1,0,1,45,4.8e-05
G5,C(C(C1(C=CC(C1O)O)O)O)(O)=O,16,1,0,1,28,4.8e-05
G5,C(C(C(C=C)(C(CO)O)O)O)(O)=O,8,1,0,1,7,4.8e-05
G5,C(C(C(CC(CCO)O)O)O)(O)=O,8,1,0,1,18,4.8e-05
G5,C(C(C(CC(C(C)O)O)O)O)(O)=O,16,1,0,1,11,4.8e-05
G5,C(C(C(C)(C)O)O)(O)=O,2,1,0,1,33,4.8e-05
G5,C(OCC(C)(C(C(O)=O)O)O)=O,4,1,0,1,33,4.8e-05
G5,C(OCC(C(C(O)=O)O)O)=O,4,1,0,1,33,4.8e-05
G5,C(C(C(COC(C)=O)O)O)(O)=O,4,1,0,1,33,4.8e-05
G5,C(CCC(C=O)(C(C(O)=O)O)O)=O,4,2,0,2,33,9.499999999999999e-05
G5,C(C(C=CCO)(C(C(O)=O)O)O)=O,8,1,0,1,55,4.8e-05
G5,C(C(C(C(CO)=O)(C=C)O)O)(O)=O,4,2,0,2,31,9.6e-05
G5,C1(CCC(CO1)(C(C(O)=O)O)O)=O,4,1,0,1,7,4.8e-05
G5,C(C(C1(COCC(C1)=O)O)O)(O)=O,4,1,0,1,54,4.8e-05
G5,C1(C(CCO1)(C(C(O)=O)O)O)=O,4,3,0,3,29,0.000143
G5,C1(CC(CO1)(C(C(O)=O)O)O)=O,4,2,0,2,29,9.499999999999999e-05
G5,C(C(C1(C=COC1)O)O)(O)=O,4,2,0,2,33,9.499999999999999e-05
G5,C(C(C1(C=CC(O)OC1)O)O)(O)=O,8,1,0,1,27,4.8e-05
G5,C(C(C(C(C)O)(C(C)O)O)O)(O)=O,6,1,0,1,49,4.8e-05
G5,C(C(C(C(C)(C(C)O)O)O)O)(O)=O,16,1,0,1,18,4.8e-05
G5,C(CO)(C(CC)(C(C(O)=O)O)O)=O,4,1,0,1,42,4.8e-05
G5,C(C(CO)(C(C(O)=O)O)O)(CC)=O,4,1,0,1,42,4.8e-05
G5,C(C(C)(C(C(O)=O)O)O)(CC)=O,4,2,0,2,33,9.499999999999999e-05
G5,C(C)(C(CC)(C(C(O)=O)O)O)=O,4,1,0,1,33,4.8e-05
G5,C(CC(C)C(C(C(O)=O)O)O)=O,8,2,0,2,33,9.499999999999999e-05
G5,C(C(C)CC(C(C(O)=O)O)O)=O,8,2,0,2,49,9.499999999999999e-05
G5,C(C(C(C(O)=O)O)O)(C(CO)C)=O,8,1,0,1,28,4.8e-05
G5,C(C(C(CO)C)(C(C(O)=O)O)O)=O,8,1,0,1,28,4.8e-05
G5,C(C(C)C(C(C(C(O)=O)O)O)O)=O,16,1,0,1,49,4.8e-05
G5,C(C(C(C(C)C(C=O)O)O)O)(O)=O,16,1,0,1,49,4.8e-05
G5,C(C(C(C(O)=O)O)O)(CC)=O,4,2,0,2,29,9.499999999999999e-05
G5,C(C(CC)(C(C(O)=O)O)O)=O,4,1,0,1,33,4.8e-05
G5,C(C(CC)(C(C(O)=O)O)O)(O)=O,4,1,0,1,28,4.8e-05
G5,C(C(C(CO)(C(C=C)O)O)O)(O)=O,8,1,0,1,31,4.8e-05
G5,C(C(C(C=C(CO)CO)O)O)(O)=O,4,1,0,1,18,4.8e-05
G5,C(C(C(C=CC(CO)O)O)O)(O)=O,16,1,0,1,46,4.8e-05
G5,C(C(C=CC=O)(C(C(O)=O)O)O)=O,8,2,0,2,20,9.6e-05
G5,C(C(C=CC)(C(C(O)=O)O)O)=O,8,2,0,2,33,9.499999999999999e-05
G5,C(C(C(C=O)(CC=C)O)O)(O)=O,4,2,0,2,33,9.499999999999999e-05
G5,C(C(C(C=CC=O)(C)O)O)(O)=O,8,2,0,2,25,9.499999999999999e-05
G5,C(C(C(C=CC(C)=O)O)O)(O)=O,8,2,0,2,45,9.499999999999999e-05
G5,C(C(C(CC(C=O)=C)O)O)(O)=O,4,2,0,2,16,9.499999999999999e-05
G5,C(C(C(C=C(C=O)C)O)O)(O)=O,8,2,0,2,16,9.499999999999999e-05
G5,C(C(C(C(C=O)=C)(CO)O)O)(O)=O,4,1,0,1,9,4.8e-05
G5,C(C(C(C(CO)=C)(CO)O)O)(O)=O,4,1,0,1,49,4.8e-05
G5,C(C(C(C(CO)=CC=O)O)O)(O)=O,8,1,0,1,18,4.8e-05
G5,C(C(C(C=CC)(CO)O)O)(O)=O,8,2,0,2,33,9.499999999999999e-05
G5,C(C(C(CO)(CC=C)O)O)(O)=O,4,2,0,2,33,9.499999999999999e-05
G5,C(C(C(C)(C(C=C)O)O)O)(O)=O,8,2,0,2,33,9.499999999999999e-05
G5,C(C(C(CC(CO)=C)O)O)(O)=O,4,2,0,2,49,9.499999999999999e-05
G5,C(C(C(C=C(C)CO)O)O)(O)=O,8,2,0,2,49,9.499999999999999e-05
G5,C(C(C(C=CC)O)O)(O)=O,8,2,0,2,33,9.499999999999999e-05
G5,C(C(C(CC=C)O)O)(O)=O,4,2,0,2,33,9.499999999999999e-05
G5,C(C(C(C(C(CO)=C)O)O)O)(O)=O,8,1,0,1,49,4.8e-05
G5,C(C(C(C(C(C=C)O)O)O)O)(O)=O,16,1,0,1,27,4.8e-05
G5,C(C(C1(C(O)OC(C)C1)O)O)(O)=O,16,2,0,2,33,9.499999999999999e-05
G5,C(C(C1(COC(C1O)O)O)O)(O)=O,16,3,0,3,34,0.000154
G5,C(C(CCCO)(C(C(O)=O)O)O)=O,4,1,0,1,55,4.8e-05
G5,C(C(C(CO)(CCCO)O)O)(O)=O,4,1,0,1,55,4.8e-05
G5,C(CC=CC(C(C(O)=O)O)O)=O,8,1,0,1,33,4.8e-05
G5,C(C(C(CC=CC=O)O)O)(O)=O,8,1,0,1,33,4.8e-05
G5,C(C(C(C)(C)O)(CC(C=O)=O)O)=O,2,1,0,1,0,4.8e-05
G5,C(C(CC(C=O)=O)(C(C=C)O)O)=O,4,1,0,1,0,4.8e-05
G5,C(C)(C(C(C)(C)O)(CC=O)O)=O,2,1,0,1,45,4.8e-05
G5,C(CC(C(C)=O)(C(C=C)O)O)=O,4,3,0,3,45,0.000143
G5,C(CC(C(C)=O)(C(C=CC)O)O)=O,8,1,0,1,45,4.8e-05
G5,C(C)(C(C(CC=C)O)(CC=O)O)=O,4,1,0,1,45,4.8e-05
G5,C(C(CO)C(C=O)(C(C)(C)O)O)=O,4,1,0,1,43,4.8e-05
G5,C(C(CO)C(C=O)(C(C=C)O)O)=O,8,1,0,1,43,4.8e-05
G5,C1(C(C(CCO)O)(CC(C1)=O)O)=O,4,1,0,1,26,4.8e-05
G5,C(C(C=C)(C(CCO)O)O)(O)=O,4,3,0,3,29,0.000143
G5,C(C(C(CCO)O)O)(OCC=O)=O,4,3,0,3,40,0.000143
G5,C(C(C)=O)(C(C)(C(CCO)O)O)=O,4,1,0,1,49,4.8e-05
G5,C(C(C=C)(C(CCO)O)O)=O,4,3,0,3,29,0.000143
G5,C1(C(CCO1)(C(CCO)O)O)=O,4,2,0,2,29,9.499999999999999e-05
G5,C(CC(C(C)(C(CCO)O)O)=O)=O,4,1,0,1,45,4.8e-05
G5,C(C(C(CCO)O)(CC(C)O)O)=O,8,1,0,1,11,4.8e-05
G5,C(C(C)O)(C(C)(C(CCO)O)O)=O,8,1,0,1,49,4.8e-05
G5,C(C(C=CC=O)(C(CCO)O)O)=O,8,1,0,1,20,4.8e-05
G5,C(C(C)C(C=O)(C(CCO)O)O)=O,8,1,0,1,49,4.8e-05
G5,C(CO)(C(C=C)(C(CCO)O)O)=O,4,1,0,1,31,4.8e-05
G5,C(C(C(C=O)=C)(C(CCO)O)O)=O,4,1,0,1,16,4.8e-05
G5,C(C)(C(C=C)(C(CCO)O)O)=O,4,2,0,2,4,9.499999999999999e-05
G5,C(C(C(CO)=C)(C(CCO)O)O)=O,4,1,0,1,49,4.8e-05
G5,C1(C(C(CCO)O)(O)OC(C)C1)=O,8,1,0,1,45,4.8e-05
G5,C1(C(C(CCO)O)(O)OCC1O)=O,8,2,0,2,2,9.499999999999999e-05
G5,C1(C(CC(O)O1)(C(CCO)O)O)=O,8,2,0,2,29,9.499999999999999e-05
G5,C(C(C=C)(C(CC(C)O)O)O)(O)=O,8,1,0,1,7,4.8e-05
G5,C(C(C=C)(C(CC(C)O)O)O)=O,8,3,0,3,29,0.000143
G5,C1(C(CCO1)(C(CC(C)O)O)O)=O,8,1,0,1,28,4.8e-05
G5,C(C)(C(C=C)(C(CC(C)O)O)O)=O,8,1,0,1,28,4.8e-05
G5,C(C(C=C)(C(C(C(C)O)O)O)O)=O,16,1,0,1,28,4.8e-05
G5,C(C(C=C)(C(CC(CO)O)O)O)=O,8,1,0,1,6,4.8e-05
G5,C(C(C)(C(C(CO)CO)O)O)(O)=O,4,1,0,1,25,4.8e-05
G5,C(C(C)(C(C)(C)O)O)(O)=O,2,1,0,1,25,4.8e-05
G5,C(OCC(C)(C(C(O)=O)(C)O)O)=O,4,1,0,1,25,4.8e-05
G5,C(OCC(C(C(O)=O)(C)O)O)=O,4,1,0,1,25,4.8e-05
G5,C(C(C)(C(COC(C)=O)O)O)(O)=O,4,1,0,1,25,4.8e-05
G5,C(C(C)(C(CCC=O)O)O)(O)=O,4,3,0,3,25,0.000143
G5,C1(C(CCO1)(C(C(O)=O)(C)O)O)=O,4,2,0,2,28,9.499999999999999e-05
G5,C(C(C)(C1(COC(C1)=O)O)O)(O)=O,4,1,0,1,25,4.8e-05
G5,C(C(C)(C(C(C=C)O)O)O)(O)=O,8,3,0,3,25,0.000143
G5,C(C(C)(C1(C=COC1)O)O)(O)=O,4,2,0,2,25,9.499999999999999e-05
G5,C(C(C)(C(C(O)=O)(C)O)O)(CC)=O,4,1,0,1,25,4.8e-05
G5,C(C(C)(C(C(C)=O)(CC)O)O)(O)=O,4,1,0,1,25,4.8e-05
G5,C(C(C)(C(C)(CC(C)=O)O)O)(O)=O,4,1,0,1,25,4.8e-05
G5,C(C(C)(C(C(C)CC=O)O)O)(O)=O,8,2,0,2,25,9.499999999999999e-05
G5,C(C(C)CC(C(C(O)=O)(C)O)O)=O,8,1,0,1,25,4.8e-05
G5,C(C(C)(C(C(CC)=O)O)O)(O)=O,4,2,0,2,25,9.499999999999999e-05
G5,C(C(C)(C(C=O)(CC)O)O)(O)=O,4,1,0,1,25,4.8e-05
G5,C(C(CC)(C(C(O)=O)(C)O)O)(O)=O,4,1,0,1,25,4.8e-05
G5,C(C(C)(C(C=O)(C=CC)O)O)(O)=O,8,1,0,1,25,4.8e-05
G5,C(C(C)(C(C=O)(CC=C)O)O)(O)=O,4,1,0,1,25,4.8e-05
G5,C(C(C)(C(C=CC=O)(C)O)O)(O)=O,8,1,0,1,25,4.8e-05
G5,C(C(C)(C(C=CC(C)=O)O)O)(O)=O,8,1,0,1,25,4.8e-05
G5,C(C(C)(C(C(CC=O)=C)O)O)(O)=O,4,1,0,1,25,4.8e-05
G5,C(C(C)(C(CC(C=O)=C)O)O)(O)=O,4,1,0,1,25,4.8e-05
G5,C(C(C)(C(C(C)=CC=O)O)O)(O)=O,8,1,0,1,25,4.8e-05
G5,C(C(C)(C(C=C(C=O)C)O)O)(O)=O,8,1,0,1,25,4.8e-05
G5,C(C(C)(C(C=C)O)O)(O)=O,4,3,0,3,25,0.000143
G5,C(C(C)(C(C=CC)(CO)O)O)(O)=O,8,1,0,1,25,4.8e-05
G5,C(C(C)(C(CO)(CC=C)O)O)(O)=O,4,1,0,1,25,4.8e-05
G5,C(C(C)(C(C)(C(C=C)O)O)O)(O)=O,8,1,0,1,25,4.8e-05
G5,C(C(C)(C(CC(CO)=C)O)O)(O)=O,4,1,0,1,25,4.8e-05
G5,C(C(C)(C(C=C(CO)C)O)O)(O)=O,8,1,0,1,25,4.8e-05
G5,C(C(C)(C(C=CC)O)O)(O)=O,8,2,0,2,25,9.499999999999999e-05
G5,C(C(C)(C(CC=C)O)O)(O)=O,4,2,0,2,25,9.499999999999999e-05
G5,C(C(C)(C(C=CCC=O)O)O)(O)=O,8,1,0,1,25,4.8e-05
G5,C(C(C)(C(CC=CC=O)O)O)(O)=O,8,1,0,1,25,4.8e-05
G5,C(C(CCO)(C(C)(C)O)O)(O)=O,2,1,0,1,45,4.8e-05
G5,C(C(CCO)(C(C=C)O)O)(O)=O,4,3,0,3,11,0.000143
G5,C(C(CCO)(C(C=CC)O)O)(O)=O,8,1,0,1,45,4.8e-05
G5,C(C(C(CC=C)O)(CCO)O)(O)=O,4,1,0,1,45,4.8e-05
G5,C(C)(C(C=C)(C(C(CO)=O)O)O)=O,4,1,0,1,28,4.8e-05
G5,C(CO)(C(C(C)(C)O)(CC=O)O)=O,2,1,0,1,2,4.8e-05
G5,C(C(C(C)(C(C)(C)O)O)=O)=O,2,1,0,1,25,4.8e-05
G5,C(OCC(C(C(C=O)=O)(C)O)O)=O,4,1,0,1,25,4.8e-05
G5,C(CCC(C(C(C=O)=O)(C)O)O)=O,4,2,0,2,0,9.499999999999999e-05
G5,C=CC(C(C(C(C=O)=O)(C)O)O)O,8,1,0,1,25,4.8e-05
G5,C1OCC(C=1)(C(C(C=O)=O)(C)O)O,4,1,0,1,25,4.8e-05
G5,C(C(C(C(C=O)=O)(C)O)O)(CC)=O,4,1,0,1,25,4.8e-05
G5,C(C(CC)(C(C(C=O)=O)(C)O)O)=O,4,1,0,1,25,4.8e-05
G5,C=CC(C(C(C=O)=O)(C)O)O,4,3,0,3,29,0.000143
G5,C(C)=CC(C(C(C=O)=O)(C)O)O,8,2,0,2,25,9.499999999999999e-05
G5,C=CCC(C(C(C=O)=O)(C)O)O,4,2,0,2,25,9.499999999999999e-05
G5,C(CO)(C(C)(C(C)(C)O)O)=O,2,1,0,1,25,4.8e-05
G5,C(OCC(C(C(CO)=O)(C)O)O)=O,4,1,0,1,25,4.8e-05
G5,C(CCC(C(C(CO)=O)(C)O)O)=O,4,2,0,2,49,9.499999999999999e-05
G5,C(CO)(C(C)(C(C(C=C)O)O)O)=O,8,1,0,1,25,4.8e-05
G5,C(CO)(C(C)(C1(C=COC1)O)O)=O,4,1,0,1,25,4.8e-05
G5,C(CO)(C(C)(C(C(CC)=O)O)O)=O,4,1,0,1,25,4.8e-05
G5,C(C(CC)(C(C(CO)=O)(C)O)O)=O,4,1,0,1,25,4.8e-05
G5,C(CO)(C(C)(C(C=C)O)O)=O,4,3,0,3,29,0.000143
G5,C(CO)(C(C)(C(C=CC)O)O)=O,8,2,0,2,25,9.499999999999999e-05
G5,C(CO)(C(C)(C(CC=C)O)O)=O,4,2,0,2,25,9.499999999999999e-05
G5,C(CC(C1(C(CC(C1)=O)=O)O)O)=O,4,1,0,1,26,4.8e-05
G5,C(CC(C1(C(C=CC(C1)=O)=O)O)O)=O,4,1,0,1,45,4.8e-05
G5,C(CC(C1(C(C=CC1C=O)=O)O)O)=O,8,1,0,1,45,4.8e-05
G5,C(C(C=C)(C(CC=O)O)O)(O)=O,4,3,0,3,45,0.000143
G5,C(C(C(CC=O)O)O)(OCC=O)=O,4,3,0,3,40,0.000143
G5,C(CC(C(C(C(C)=O)=O)(C)O)O)=O,4,1,0,1,49,4.8e-05
G5,C1(C(C(CC=O)O)(CCO1)O)=O,4,2,0,2,45,9.499999999999999e-05
G5,C(C(C)(C(CC=O)O)O)(CC=O)=O,4,1,0,1,45,4.8e-05
G5,C(C(C(CC=O)O)(CC(C)O)O)=O,8,1,0,1,11,4.8e-05
G5,C(C(C=CC=O)(C(CC=O)O)O)=O,8,1,0,1,20,4.8e-05
G5,C1(CC(C=CC1(C(CC=O)O)O)=O)=O,4,1,0,1,45,4.8e-05
G5,C(CC(C1(C(C(C(C1)=O)=C)=O)O)O)=O,4,1,0,1,45,4.8e-05
G5,C1(CC(C(C1(C(CC=O)O)O)=C)=O)=O,4,1,0,1,45,4.8e-05
G5,C1(CC=C(C=O)C1(C(CC=O)O)O)=O,4,1,0,1,27,4.8e-05
G5,C1(CC(C=O)=CC1(C(CC=O)O)O)=O,4,1,0,1,45,4.8e-05
G5,C(C1C(C(C=C1)(C(CC=O)O)O)=O)=O,8,1,0,1,45,4.8e-05
G5,C(CC(C1(C(C)=O)C=CC(O1)=O)O)=O,4,1,0,1,48,4.8e-05
G5,C(CC(C1(C(C=CO1)=O)CC=O)O)=O,4,1,0,1,45,4.8e-05
G5,C(CC(C1(C=CCO1)C(C=O)=O)O)=O,4,1,0,1,39,4.8e-05
G5,C(C1(C=CC(C=O)O1)C(CC=O)O)=O,8,1,0,1,40,4.8e-05
G5,C(CC(C1(C=O)CC(C(O1)=C)=O)O)=O,4,1,0,1,14,4.8e-05
G5,C(CC(C1(C=O)CC(C=CO1)=O)O)=O,4,1,0,1,37,4.8e-05
G5,C(CC(C1(C(C=C(C=O)C1)=O)O)O)=O,4,1,0,1,45,4.8e-05
G5,C(CC(C1(C(C(C=O)=CC1)=O)O)O)=O,4,1,0,1,27,4.8e-05
G5,C(CC(C(C(CO)=O)(C=C)O)O)=O,4,2,0,2,4,0.000106
G5,C(CC(C1(C(CC(C)O1)=O)O)O)=O,8,2,0,2,4,9.499999999999999e-05
G5,C(CC(C1(C(C(CO1)O)=O)O)O)=O,8,1,0,1,0,4.8e-05
G5,C1(C(C(CC=O)O)(CC(O)O1)O)=O,8,2,0,2,33,9.499999999999999e-05
G5,C(C(CCO)(C(C)(C)O)O)=O,2,1,0,1,29,4.8e-05
G5,C(OCC(C(C=O)(CCO)O)O)=O,4,1,0,1,29,4.8e-05
G5,C(C(C=C)(C(C(CCO)O)O)O)=O,8,1,0,1,29,4.8e-05
G5,C(C(C(C(C=C)O)O)(CCO)O)=O,8,1,0,1,29,4.8e-05
G5,C(C(CCO)(C1(C=COC1)O)O)=O,4,1,0,1,29,4.8e-05
G5,C(C(CCO)(C(C(CC)=O)O)O)=O,4,1,0,1,29,4.8e-05
G5,C(C(CCO)(C(C=O)(CC)O)O)=O,4,1,0,1,29,4.8e-05
G5,C(C(CCO)(C(C=C)O)O)=O,4,3,0,3,29,0.000143
G5,C(C(CCO)(C(C=CC)O)O)=O,8,2,0,2,29,9.499999999999999e-05
G5,C(C(C(CC=C)O)(CCO)O)=O,4,2,0,2,29,9.499999999999999e-05
G5,C(C(C)(C(C(C)=O)(C=C)O)O)(O)=O,4,1,0,1,28,4.8e-05
G5,C1(C(CC(C=O)C1(C(O)=O)O)O)=O,8,1,0,1,32,4.8e-05
G5,C(C1(C(C=CC(C1)=O)=O)O)(O)=O,2,3,0,3,29,0.000143
G5,C(C1(C(C=CC1C=O)=O)O)(O)=O,4,2,0,2,17,9.6e-05
G5,C(C(C(O)=O)(C(C=O)C=O)O)(O)=O,1,1,0,1,33,4.8e-05
G5,C(C(C=O)(C(C=O)C=O)O)(O)=O,2,2,0,2,17,9.6e-05
G5,C(C(C(C)=O)C(C(O)=O)(C=O)O)=O,4,1,0,1,6,4.8e-05
G5,C(C(C(C=C)=O)(CC=O)O)(O)=O,2,3,0,3,29,0.000143
G5,C(C(C(O)=O)(CC(C)O)O)(O)=O,2,1,0,1,27,4.8e-05
G5,C(C(C(O)=O)(C(CO)CO)O)(O)=O,1,1,0,1,29,4.8e-05
G5,C(C(C(O)=O)(CC(C)=O)O)(O)=O,1,1,0,1,26,4.8e-05
G5,C(C(C(O)=O)(C=C)O)(O)=O,1,3,0,3,17,0.000143
G5,C(C(C(O)=O)(C=CC(C)=O)O)(O)=O,2,1,0,1,29,4.8e-05
G5,C(C(C(O)=O)(C=CCC=O)O)(O)=O,2,1,0,1,29,4.8e-05
G5,C(C(C(O)=O)(CC(C=C)=O)O)(O)=O,1,1,0,1,29,4.8e-05
G5,C(C(C(O)=O)(CC=CC=O)O)(O)=O,2,1,0,1,29,4.8e-05
G5,C(C(C=CC=O)(C(C=O)=O)O)(O)=O,4,1,0,1,43,4.8e-05
G5,C(C(C(C)=O)(O)OCC=O)(O)=O,2,1,0,1,27,4.8e-05
G5,C(C(C=O)(O)OCC(C)=O)(O)=O,2,1,0,1,27,4.8e-05
G5,C(C(C(O)=O)O)(OCC=O)=O,2,3,0,3,17,0.000143
G5,C(C1(C(COC(C1)O)=O)O)(O)=O,4,2,0,2,17,9.6e-05
G5,C(C(C(C(C=C)=O)=O)(C)O)(O)=O,2,1,0,1,7,4.8e-05
G5,C1(C(C(O)=O)(CC(CO1)=O)O)=O,2,2,0,2,17,9.6e-05
G5,C(C(C=O)(C(C(CO)=O)=C)O)(O)=O,2,1,0,1,47,4.8e-05
G5,C(C(C=O)(C=COCC=O)O)(O)=O,4,1,0,1,37,4.8e-05
G5,C1(C(C(O)=O)(CCO1)O)=O,2,2,0,2,17,9.6e-05
G5,C(C1(C(C(C(CC1)=O)O)=O)O)(O)=O,4,2,0,2,17,9.6e-05
G5,C(C1(C(C(C=O)(CC1)O)=O)O)(O)=O,4,1,0,1,12,4.8e-05
G5,C(C(C=O)(CC(C(C)=O)O)O)(O)=O,4,1,0,1,29,4.8e-05
G5,C(C(C=O)(CC(C=O)(C)O)O)(O)=O,4,1,0,1,16,4.8e-05
G5,C(C(C(C(C=O)(C)O)=O)(C)O)(O)=O,4,1,0,1,49,4.8e-05
G5,C(C(C(CC=O)=O)(C)O)(O)=O,2,2,0,2,25,9.6e-05
G5,C(C(C(C=O)=O)(CC(C)O)O)(O)=O,4,1,0,1,33,4.8e-05
G5,C(C(C(CO)=O)(CC(C)O)O)(O)=O,4,1,0,1,11,4.8e-05
G5,C(C(C=O)(CC(CO)(C)O)O)(O)=O,4,1,0,1,49,4.8e-05
G5,C(C(C(C(CO)(C)O)=O)(C)O)(O)=O,4,1,0,1,49,4.8e-05
G5,C(C(C=O)(CC(C)O)O)(O)=O,4,1,0,1,11,4.8e-05
G5,C(C(C=O)(C=CC=O)O)(O)=O,4,3,0,3,17,0.000143
G5,C(C1(C(C(C(CO)C1)=O)=O)O)(O)=O,4,1,0,1,47,4.8e-05
G5,C(C1(C(C(CC1CO)=O)=O)O)(O)=O,4,2,0,2,55,9.6e-05
G5,C(C1(C(OC(C(C)=O)C1)=O)O)(O)=O,4,1,0,1,48,4.8e-05
G5,C1(C(C(O)=O)(CC(CC=O)O1)O)=O,4,1,0,1,23,4.8e-05
G5,C1(CCC(C(O)=O)(C(CO1)=O)O)=O,2,1,0,1,4,4.8e-05
G5,C(C1(C(CC(OCC1)=O)=O)O)(O)=O,2,1,0,1,19,4.8e-05
G5,C(C1(C(C(COCC1)=O)=O)O)(O)=O,2,1,0,1,36,4.8e-05
G5,C1(C(C(O)=O)(CC(CCO1)=O)O)=O,2,1,0,1,30,4.8e-05
G5,C(C1(C(OCC(CC1)=O)=O)O)(O)=O,2,1,0,1,12,4.8e-05
G5,C(C1(C(C(C(CO)=C1)O)=O)O)(O)=O,4,1,0,1,46,4.8e-05
G5,C(C1(C(C(C=C1CO)O)=O)O)(O)=O,4,1,0,1,46,4.8e-05
G5,C(C1(C(C(C(C1=C)O)O)=O)O)(O)=O,8,1,0,1,2,4.8e-05
G5,C(C1(C(OC(C=C1)CO)=O)O)(O)=O,4,1,0,1,48,4.8e-05
G5,C(C1(C(C(CO)OC=C1)=O)O)(O)=O,4,1,0,1,2,4.8e-05
G5,C1(C(C(O)=O)(C=CC(CO1)O)O)=O,4,1,0,1,48,4.8e-05
G5,C(C1(C(C(COC=C1)O)=O)O)(O)=O,4,1,0,1,38,4.8e-05
G5,C1(C(C(O)=O)(O)OCC=CC1O)=O,4,1,0,1,41,4.8e-05
G5,C(C1(C(C(O)OCC=C1)=O)O)(O)=O,4,1,0,1,41,4.8e-05
G5,C(C1(C(COC(C=C1)O)=O)O)(O)=O,4,1,0,1,38,4.8e-05
G5,C(C1(C(CO)=O)C=CC(O1)O)(O)=O,4,1,0,1,38,4.8e-05
G5,C1(C(C(O)=O)(C(C(C1O)=O)C)O)=O,8,1,0,1,42,4.8e-05
G5,C(C1(C(CC(C=C1)=O)=O)O)(O)=O,2,2,0,2,17,9.6e-05
G5,C(C(C)C(C(O)=O)(C(CO)=O)O)=O,4,1,0,1,49,4.8e-05
G5,C(C(C(C)=O)(C=CC=O)O)(O)=O,4,2,0,2,45,9.6e-05
G5,C(C1(C=O)CC(C(CO1)O)O)(O)=O,8,1,0,1,29,4.8e-05
G5,C1(C(C(O)=O)(CC(C1(C)O)=O)O)=O,4,1,0,1,45,4.8e-05
G5,C(C(C(O)=O)(C(C=O)C)O)(O)=O,2,2,0,2,17,9.6e-05
G5,C(C1(C=O)CC(C(CO)O1)=O)(O)=O,4,1,0,1,2,4.8e-05
G5,C(C1(C=O)CC(C(CO1)O)=O)(O)=O,4,1,0,1,37,4.8e-05
G5,C(C1(C(C)=O)CC(C(O1)=O)=O)(O)=O,2,1,0,1,27,4.8e-05
G5,C(C1(C(CC(O1)=O)=O)CC=O)(O)=O,2,1,0,1,27,4.8e-05
G5,C(C1(C(C(C(C1)=O)=C)=O)O)(O)=O,2,3,0,3,29,0.000143
G5,C(C1(C(CC(C1=C)=O)=O)O)(O)=O,2,2,0,2,17,9.6e-05
G5,C(C1(C(CC=C1C=O)=O)O)(O)=O,2,3,0,3,29,0.000143
G5,C(C1(C(CC(C=O)=C1)=O)O)(O)=O,2,3,0,3,17,0.000143
G5,C(C(C(C)=O)(C=CC(O)=O)O)(O)=O,4,1,0,1,45,4.8e-05
G5,C(C(C(CC=O)=O)(C=C)O)(O)=O,2,3,0,3,17,0.000143
G5,C(C(C=O)(CC(C=C)=O)O)(O)=O,2,3,0,3,29,0.000143
G5,C(C1(C(C(C=O)C=C1)=O)O)(O)=O,4,2,0,2,17,9.6e-05
G5,C(C1(C(C)=O)C=CC(O1)=O)(O)=O,2,2,0,2,48,9.6e-05
G5,C(C1(C(C=CO1)=O)CC=O)(O)=O,2,3,0,3,29,0.000143
G5,C(C1(C=CCO1)C(C=O)=O)(O)=O,2,2,0,2,17,9.6e-05
G5,C(C1(C=O)C=CC(C=O)O1)(O)=O,4,4,0,4,29,0.00019099999999999998
G5,C(C1(C=O)CC(C(O1)=C)=O)(O)=O,2,3,0,3,29,0.000143
G5,C(C1(C=O)CC(C=CO1)=O)(O)=O,2,3,0,3,29,0.000143
G5,C(C12C(C(C(C(C1)O)O2)O)=O)(O)=O,16,1,0,1,9,4.8e-05
G5,C(C1(C(CO)=O)CC(CO1)=O)(O)=O,2,1,0,1,32,4.8e-05
G5,C1(CCC(C(O)=O)(C(CO)=O)O1)=O,2,1,0,1,32,4.8e-05
G5,C(C1(C(C(CO1)=O)=O)CCO)(O)=O,2,1,0,1,4,4.8e-05
G5,C(C1(C(CC(O1)=O)=O)CCO)(O)=O,2,1,0,1,2,4.8e-05
G5,C1(C2(C(O)=O)CC(C(CO)O2)O1)=O,8,1,0,1,41,4.8e-05
G5,C(C12C(C(CO1)OC(C2)O)=O)(O)=O,8,2,0,2,17,9.6e-05
G5,C(C1(C(C2CC(CO2)O1)=O)O)(O)=O,8,1,0,1,39,4.8e-05
G5,C(C12C(C(O)OC(CO1)C2)=O)(O)=O,8,2,0,2,39,9.6e-05
G5,C1(C2(C(O)=O)CC(C(CO1)O2)O)=O,8,1,0,1,41,4.8e-05
G5,C(C12C(COC(C(C1)O)O2)=O)(O)=O,8,1,0,1,4,4.8e-05
G5,C(C12C(CC(CCO1)(O2)O)=O)(O)=O,4,2,0,2,17,9.6e-05
G5,C(C12C(C(C(O1)OCC2)O)=O)(O)=O,8,1,0,1,4,4.8e-05
G5,C1(C2(C(O)=O)CC(C(CO2)O)O1)=O,8,1,0,1,30,4.8e-05
G5,C(C1CC(C(O)=O)(C(CO1)=O)O)=O,4,1,0,1,4,4.8e-05
G5,C(C1(C=O)CC(C(CO1)=O)O)(O)=O,4,1,0,1,4,4.8e-05
G5,C(C1(C=O)CC(CC(O1)=O)O)(O)=O,4,1,0,1,48,4.8e-05
G5,C1(CCC(C=O)OC1(C(O)=O)O)=O,4,1,0,1,12,4.8e-05
G5,C(C1(C=O)CCC(C(O1)O)=O)(O)=O,4,2,0,2,17,9.6e-05
G5,C(C1(C(C(C(CO1)=O)O)=O)C)(O)=O,4,1,0,1,24,4.8e-05
G5,C(C1(C(C(C)OC(C1)=O)=O)O)(O)=O,4,1,0,1,24,4.8e-05
G5,C1(CC(C(C(C(O)=O)(C)O1)=O)O)=O,4,1,0,1,24,4.8e-05
G5,C1(C(C(O)=O)(OC(C(C1)=O)C)O)=O,4,1,0,1,24,4.8e-05
G5,C(C1(C(CC(C(O1)O)=O)=O)C)(O)=O,4,2,0,2,17,9.6e-05
G5,C(C1(C(C(CC(O1)O)=O)=O)C)(O)=O,4,2,0,2,17,9.6e-05
G5,C(C1(C(C(C(CO1)O)O)=O)C)(O)=O,8,1,0,1,4,4.8e-05
G5,C1(C2(C(O)=O)CC(C(CO2)O1)O)=O,8,1,0,1,30,4.8e-05
G5,C(C1(C(CCOC(C1)O)=O)O)(O)=O,4,2,0,2,4,9.6e-05
G5,C(C1(C(CC(CCO1)O)=O)O)(O)=O,4,1,0,1,4,4.8e-05
G5,C(C1(C(CC(O)OCC1)=O)O)(O)=O,4,2,0,2,17,9.6e-05
G5,C(C12C(CC(CC(O1)O)O2)=O)(O)=O,8,2,0,2,17,9.6e-05
G5,C(C12C(CC(O1)OC(C2)O)=O)(O)=O,8,2,0,2,17,9.6e-05
G5,C(C1(C=O)CC(CC(O1)=O)=O)(O)=O,2,1,0,1,27,4.8e-05
G5,C(C1(C(C=C(C=O)C1)=O)O)(O)=O,2,2,0,2,17,9.6e-05
G5,C(C1(C(C(C=O)=CC1)=O)O)(O)=O,2,2,0,2,17,9.6e-05
G5,C(C(C(CO)=O)(C(C=O)=C)O)(O)=O,2,1,0,1,2,4.8e-05
G5,C(C(C(CO)=O)(C(CO)=C)O)(O)=O,2,1,0,1,49,4.8e-05
G5,C(C(C(CO)=O)(C=C)O)(O)=O,2,2,0,2,17,9.6e-05
G5,C(C(C=O)(C=CC(C=O)=O)O)(O)=O,4,1,0,1,12,4.8e-05
G5,C(C(C=O)(C(CC=O)=C)O)(O)=O,2,2,0,2,17,9.6e-05
G5,C(C(C=O)(C(C)=CC=O)O)(O)=O,4,2,0,2,17,9.6e-05
G5,C(C(C=O)(C(C(C=O)=O)=C)O)(O)=O,2,1,0,1,0,4.8e-05
G5,C(C(C=O)(C(C=O)=CC=O)O)(O)=O,4,1,0,1,43,4.8e-05
G5,C(C(C(CCO)=O)(C=C)O)(O)=O,2,2,0,2,4,9.6e-05
G5,C(C(C=O)(C(C=O)=CC)O)(O)=O,4,2,0,2,17,9.6e-05
G5,C(C(C=O)(C(C=O)C=C)O)(O)=O,4,3,0,3,17,0.000143
G5,C(C(C=O)(C=CCC=O)O)(O)=O,4,2,0,2,17,9.6e-05
G5,C(C(C=O)(CC=CC=O)O)(O)=O,4,2,0,2,17,9.6e-05
G5,C(C(C=O)(C=C(C(O)=O)C)O)(O)=O,4,1,0,1,14,4.8e-05
G5,C(C(C=O)(CC(C(O)=O)=C)O)(O)=O,2,1,0,1,14,4.8e-05
G5,C(C1(C(C(C=C1)(CO)O)=O)O)(O)=O,4,1,0,1,2,4.8e-05
G5,C(C(C(O)=O)(C(C=O)=C)O)(O)=O,1,2,0,2,17,9.6e-05
G5,C(C(C(O)=O)(C(CO)=C)O)(O)=O,1,2,0,2,17,9.6e-05
G5,C1(C(C(O)=O)(C=CC(CO1)=O)O)=O,2,1,0,1,27,4.8e-05
G5,C(C1(C(C(C(O1)O)O)=O)C=C)(O)=O,8,2,0,2,17,9.6e-05
G5,C(C1(C(COC(CO)=C1)=O)O)(O)=O,2,1,0,1,32,4.8e-05
G5,C(C1(C=O)C=CC(C(O1)O)O)(O)=O,8,1,0,1,29,4.8e-05
G5,C(C1(C)CC(C(C(O)=O)(O1)O)=O)=O,4,1,0,1,4,4.8e-05
G5,C(C1(C(CC(C=O)O1)=O)O)(O)=O,4,1,0,1,0,4.8e-05
G5,C(C1(C=O)CC(C(O1)O)=O)(O)=O,4,2,0,2,29,9.6e-05
G5,C(C1(C(CC(CO)(C)O1)=O)O)(O)=O,4,1,0,1,49,4.8e-05
G5,C(C1(C(CC(C)O1)=O)O)(O)=O,4,1,0,1,45,4.8e-05
G5,C(C1(C(C(CO)C(C)O1)=O)O)(O)=O,8,1,0,1,4,4.8e-05
G5,C(C1(C(C(CO1)O)=O)O)(O)=O,4,1,0,1,0,4.8e-05
G5,C1(C(C(O)=O)(CC(CO)(O)O1)O)=O,4,2,0,2,33,9.6e-05
G5,C(C1(C=O)CC(C(O1)O)O)(O)=O,8,2,0,2,17,9.6e-05
G5,C(C1(C(C(C(O1)O)O)=O)C)(O)=O,8,2,0,2,17,9.6e-05
G5,C(C1(C=O)CCC(C=O)(O1)O)(O)=O,4,2,0,2,17,9.6e-05
G5,C1(CC(C=O)(OC1(C(O)=O)C)O)=O,4,2,0,2,17,9.6e-05
G5,C(C1(C(C=O)=O)CCC(O1)O)(O)=O,4,2,0,2,17,9.6e-05
G5,C1(C(C(O)=O)(CC(O)O1)O)=O,4,2,0,2,17,9.6e-05
G5,C(C1(C(CC(CO1)(C)O)=O)O)(O)=O,4,1,0,1,49,4.8e-05
G5,C(C1(C=O)CC(CC(O1)O)O)(O)=O,8,2,0,2,17,9.6e-05
G5,C(C1(C=O)CC(C(O1)=O)(C)O)(O)=O,4,1,0,1,14,4.8e-05
G5,C(C(C=O)(O)OCC(C=C)=O)(O)=O,2,1,0,1,4,4.8e-05
G5,C(C(C(C(O)=O)O)O)(OCC=O)=O,4,3,0,3,33,0.000143
G5,C(C(C(C(C(C)=O)=O)(C)O)O)(O)=O,4,1,0,1,49,4.8e-05
G5,C(C(C1(C(CC(C)O1)=O)O)O)(O)=O,8,1,0,1,45,4.8e-05
G5,C(C(C1(C(C(CO1)O)=O)O)O)(O)=O,8,1,0,1,0,4.8e-05
G5,C1(C(CC(O)O1)(C(C(O)=O)O)O)=O,8,2,0,2,33,9.499999999999999e-05
G5,C(C(C(C)(C)O)(CC(O)=O)O)=O,2,1,0,1,29,4.8e-05
G5,C(CC(C=O)(C(C=C)O)O)(O)=O,4,3,0,3,29,0.000143
G5,C(CC(C=O)(C(C=CC)O)O)(O)=O,8,1,0,1,29,4.8e-05
G5,C(C(C(CC=C)O)(CC(O)=O)O)=O,4,1,0,1,29,4.8e-05
G5,C(C(C=C)(C(C(C)=O)(C)O)O)(O)=O,4,1,0,1,7,4.8e-05
G5,C(C(C=C)(C(C(C)=O)(C)O)O)=O,4,3,0,3,14,0.000143
G5,C1(C(CCO1)(C(C(C)=O)(C)O)O)=O,4,1,0,1,28,4.8e-05
G5,C(C)(C(C)(C(C(C)=O)(C=C)O)O)=O,4,1,0,1,28,4.8e-05
G5,C(C(C=C)(C(C)(CC=O)O)O)(O)=O,4,1,0,1,7,4.8e-05
G5,C(C(C=C)(C(CC(C)=O)O)O)(O)=O,4,1,0,1,7,4.8e-05
G5,C1(C(CCO1)(C(C)(CC=O)O)O)=O,4,1,0,1,28,4.8e-05
G5,C1(C(C(CC(C)=O)O)(CCO1)O)=O,4,1,0,1,28,4.8e-05
G5,C(CC(C)(C(C(C)=O)(C=C)O)O)=O,4,1,0,1,28,4.8e-05
G5,C(C(C=C)(C1(COC(C1)O)O)O)=O,8,1,0,1,35,4.8e-05
G5,C1(CC(C(C1)=O)(C(C(C=C)=O)O)O)=O,4,1,0,1,26,4.8e-05
G5,C(C(C=C)(C1(C(CC(C1)=O)=O)O)O)=O,4,1,0,1,26,4.8e-05
G5,C(C(C=C)(C(C=O)(C=C)O)O)=O,3,3,0,3,28,0.000143
G5,C(C(C(C=O)=C)(C(C(C=C)=O)O)O)=O,4,1,0,1,16,4.8e-05
G5,C(C(C=C)(C(C=O)(C(C=O)=C)O)O)=O,4,1,0,1,16,4.8e-05
G5,C(C)(C(C=C)(C(C(C=C)=O)O)O)=O,4,1,0,1,28,4.8e-05
G5,C(C(C=C)(C(C(C)=O)(C=C)O)O)=O,4,1,0,1,28,4.8e-05
G5,C(C(C=C)(C(C=C)(CO)O)O)(O)=O,4,1,0,1,7,4.8e-05
G5,C(C(C=C)(C(C=C)(CO)O)O)=O,4,3,0,3,7,0.000143
G5,C1(C(CCO1)(C(C=C)(CO)O)O)=O,4,1,0,1,28,4.8e-05
G5,C(C)(C(C=C)(C(C=C)(CO)O)O)=O,4,1,0,1,28,4.8e-05
G5,C1(CC(C(C1)=O)(C(C=CC=O)O)O)=O,8,1,0,1,26,4.8e-05
G5,C1(C(CCO1)(C(C=CC=O)O)O)=O,8,1,0,1,28,4.8e-05
G5,C(C(C=CC=O)(C(C=CC=O)O)O)=O,16,1,0,1,20,4.8e-05
G5,C(C(C(C=O)=C)(C(C=CC=O)O)O)=O,8,1,0,1,16,4.8e-05
G5,C(C)(C(C=C)(C(C=CC=O)O)O)=O,8,1,0,1,28,4.8e-05
G5,C(C(CC(C=O)O)(C(C)(C)O)O)=O,4,1,0,1,0,4.8e-05
G5,C(C(CC(C=O)(C(C=C)O)O)O)=O,8,1,0,1,0,4.8e-05
G5,C(C(C(C(C)(C(C)(C)O)O)=O)O)=O,4,1,0,1,0,4.8e-05
G5,C(C(C)(C(C=C)O)O)(C(C=O)O)=O,8,1,0,1,0,4.8e-05
G5,C(C(C)(C1(C(CC(C1)O)O)O)O)=O,16,1,0,1,45,4.8e-05
G5,C(C(C)(C1(CC(C(C1)=O)O)O)O)=O,8,1,0,1,26,4.8e-05
G5,C(C(C)(C1(C=CC(C1O)O)O)O)=O,16,1,0,1,28,4.8e-05
G5,C(C(CO)C(C(C=O)(C)O)O)(O)=O,8,1,0,1,18,4.8e-05
G5,C(C(C)(C(C(CO)CO)O)O)=O,4,1,0,1,18,4.8e-05
G5,C(C(C)(C(C(CO)C(C)O)O)O)=O,16,1,0,1,18,4.8e-05
G5,C(C(C)(C(CCO)(CC=O)O)O)=O,4,1,0,1,2,4.8e-05
G5,C(C(C)(C(C=C)(C(CO)O)O)O)=O,8,1,0,1,7,4.8e-05
G5,C(C(C)(C(CC(CCO)O)O)O)=O,8,1,0,1,18,4.8e-05
G5,C(C(C)(C(CC(C(C)O)O)O)O)=O,16,1,0,1,11,4.8e-05
G5,C(C(C=C)(C(C(C)O)O)O)(O)=O,8,3,0,3,11,0.000143
G5,C(C(C)(C(C)(C(C(C)=O)O)O)O)=O,8,1,0,1,49,4.8e-05
G5,C(C(C)(C(CC(CC=O)=O)O)O)=O,4,1,0,1,9,4.8e-05
G5,C(C(C)(C(CC=O)(CC=O)O)O)=O,2,1,0,1,9,4.8e-05
G5,C(C(C)(C(C)(C)O)O)=O,2,1,0,1,11,4.8e-05
G5,C(C(C)(C(CO)(CCC=O)O)O)=O,4,2,0,2,0,9.6e-05
G5,C(C(C)(C(CCC(CO)=O)O)O)=O,4,2,0,2,11,9.6e-05
G5,C(C(C)(C(C)(CC(C=O)O)O)O)=O,8,1,0,1,27,4.8e-05
G5,C(OCC(C)(C(C=O)(C)O)O)=O,4,1,0,1,35,4.8e-05
G5,C(OCC(C(C=O)(C)O)O)=O,4,1,0,1,28,4.8e-05
G5,C(C(C(C(C)O)O)O)(OCC=O)=O,8,3,0,3,40,0.000143
G5,C(C(C)(C(COC(CO)=O)O)O)=O,4,1,0,1,40,4.8e-05
G5,C(C(C)(C(COC(C)=O)O)O)=O,4,1,0,1,28,4.8e-05
G5,C(CCC(C=O)(C(C=O)(C)O)O)=O,4,2,0,2,45,9.6e-05
G5,C(C(C)(C(CCC(C=O)=O)O)O)=O,4,2,0,2,11,9.6e-05
G5,C(C(C)(C(CCC=O)O)O)=O,4,3,0,3,11,0.000143
G5,C(C(C)(C(C=O)(C=CCO)O)O)=O,8,1,0,1,55,4.8e-05
G5,C(C(C=O)(C(C(C=O)(C)O)O)O)=O,4,1,0,1,1,4.8e-05
G5,C(C(C)=O)(C(C)(C(C(C)O)O)O)=O,8,1,0,1,49,4.8e-05
G5,C(C(C)(C1(CCC(C1O)=O)O)O)=O,8,1,0,1,47,4.8e-05
G5,C(C(C)(C1(COC(CC1)=O)O)O)=O,4,1,0,1,7,4.8e-05
G5,C(C(C)(C1(COCC(C1)=O)O)O)=O,4,1,0,1,54,4.8e-05
G5,C(C(C)(C1(COC(C1)=O)O)O)=O,4,2,0,2,29,9.499999999999999e-05
G5,C(C(C=C)(C(C(C)O)O)O)=O,8,3,0,3,11,0.000143
G5,C(C(C)(C(C(C=C)O)O)O)=O,8,3,0,3,29,0.000143
G5,C(C(C)(C1(C=COC1)O)O)=O,4,2,0,2,11,9.499999999999999e-05
G5,C(C(C)(C1(C=CC(O)OC1)O)O)=O,8,1,0,1,27,4.8e-05
G5,C1(C(CCO1)(C(C(C)O)O)O)=O,8,2,0,2,11,9.499999999999999e-05
G5,C(CC(C(C)(C(C(C)O)O)O)=O)=O,8,1,0,1,45,4.8e-05
G5,C(C(C(C(C)O)O)(CC(C)O)O)=O,16,1,0,1,11,4.8e-05
G5,C(C(C)(C(C(CC(C)O)O)O)O)=O,16,1,0,1,11,4.8e-05
G5,C(C(C)(C(C(C)O)(C(C)O)O)O)=O,6,1,0,1,49,4.8e-05
G5,C(C(C=CC=O)(C(C(C)O)O)O)=O,16,1,0,1,20,4.8e-05
G5,C(C(C)(C(C(C=CC=O)O)O)O)=O,16,1,0,1,20,4.8e-05
G5,C(C(C)(C(C(CO)(C)O)O)O)=O,8,1,0,1,11,4.8e-05
G5,C(C(C)(C(C(C)(C(C)O)O)O)O)=O,16,1,0,1,18,4.8e-05
G5,C(C(C)(C(C(CO)=O)(CC)O)O)=O,4,1,0,1,42,4.8e-05
G5,C(C(CO)(C(C=O)(C)O)O)(CC)=O,4,1,0,1,42,4.8e-05
G5,C(C(C)(C(C(CO)CC=O)O)O)=O,8,3,0,3,11,0.000143
G5,C(C(CO)CC(C(C=O)(C)O)O)=O,8,1,0,1,55,4.8e-05
G5,C(C(C)(C(C=O)(C)O)O)(CC)=O,4,2,0,2,11,9.499999999999999e-05
G5,C(C(C)(C(C(C)=O)(CC)O)O)=O,4,1,0,1,28,4.8e-05
G5,C(C(C)(C(C)(CC(C)=O)O)O)=O,4,2,0,2,11,9.499999999999999e-05
G5,C(C(C)(C(C(C)CC=O)O)O)=O,8,2,0,2,11,9.6e-05
G5,C(C(C)CC(C(C=O)(C)O)O)=O,8,2,0,2,11,9.499999999999999e-05
G5,C(C(C)(C(C(C(C=O)C)=O)O)O)=O,8,1,0,1,49,4.8e-05
G5,C(C(C(C(C(C=O)=O)C)O)(C)O)=O,8,1,0,1,49,4.8e-05
G5,C(C(C)(C(C(C(CO)C)=O)O)O)=O,8,1,0,1,28,4.8e-05
G5,C(C(C(CO)C)(C(C=O)(C)O)O)=O,8,1,0,1,28,4.8e-05
G5,C(C(C)C(C=O)(C(C(C)O)O)O)=O,16,1,0,1,49,4.8e-05
G5,C(C(C)C(C(C(C=O)(C)O)O)O)=O,16,1,0,1,49,4.8e-05
G5,C(C(C)(C(C(C)C(C=O)O)O)O)=O,16,1,0,1,49,4.8e-05
G5,C(C(C)(C(C(CC)=O)O)O)=O,4,2,0,2,11,9.499999999999999e-05
G5,C(C(CC)(C(C=O)(C)O)O)=O,4,1,0,1,28,4.8e-05
G5,C(C(C)(C(C(C=O)C(C)=O)O)O)=O,8,1,0,1,6,4.8e-05
G5,C(C(C=O)C(C)(C(C=O)(C)O)O)=O,4,1,0,1,6,4.8e-05
G5,C(C(C=O)C(C(C=O)(C)O)O)=O,4,2,0,2,11,9.499999999999999e-05
G5,C(C(C)(C(C(C=O)CC=O)O)O)=O,8,2,0,2,11,9.6e-05
G5,C(C(C=O)CC(C(C=O)(C)O)O)=O,4,1,0,1,43,4.8e-05
G5,C(C(CC)(C(C=O)(C)O)O)(O)=O,4,1,0,1,28,4.8e-05
G5,C(CO)(C(C=C)(C(C(C)O)O)O)=O,8,1,0,1,31,4.8e-05
G5,C(C(C)(C(CO)(C(C=C)O)O)O)=O,8,1,0,1,31,4.8e-05
G5,C(C(C)(C(C=C(CO)CO)O)O)=O,4,1,0,1,18,4.8e-05
G5,C(C(C)(C(C=CC(CO)O)O)O)=O,16,1,0,1,46,4.8e-05
G5,C(C(C)(C(C=CC(C=O)=O)O)O)=O,8,1,0,1,20,4.8e-05
G5,C(C(C)(C(C=O)(C=CC)O)O)=O,8,2,0,2,11,9.499999999999999e-05
G5,C(C(C)(C(C=O)(CC=C)O)O)=O,4,2,0,2,11,9.499999999999999e-05
G5,C(C(C)(C(C=CC=O)(C)O)O)=O,8,2,0,2,11,9.499999999999999e-05
G5,C(C(C)(C(C=CC(C)=O)O)O)=O,8,2,0,2,11,9.499999999999999e-05
G5,C(C(C)(C(C(CC=O)=C)O)O)=O,4,2,0,2,11,9.499999999999999e-05
G5,C(C(C)(C(CC(C=O)=C)O)O)=O,4,2,0,2,11,9.499999999999999e-05
G5,C(C(C)(C(C(C)=CC=O)O)O)=O,8,2,0,2,11,9.499999999999999e-05
G5,C(C(C)(C(C=C(C=O)C)O)O)=O,8,2,0,2,11,9.499999999999999e-05
G5,C(C(C)(C(C(C(CO)=O)=C)O)O)=O,4,1,0,1,9,4.8e-05
G5,C(C(C)(C(C(C=O)=C)(CO)O)O)=O,4,1,0,1,9,4.8e-05
G5,C(C(C)(C(C(C(C=C)=O)O)O)O)=O,8,1,0,1,0,4.8e-05
G5,C(C(C(C=C)(C(C=O)(C)O)O)O)=O,8,1,0,1,0,4.8e-05
G5,C(C(C)(C(C(CO)=C)(CO)O)O)=O,4,1,0,1,49,4.8e-05
G5,C(C(C(C=O)=C)(C(C(C)O)O)O)=O,8,1,0,1,16,4.8e-05
G5,C(C(C)(C(C(C(C=O)=C)O)O)O)=O,8,1,0,1,16,4.8e-05
G5,C(C(C)(C(C(C(C=O)O)=C)O)O)=O,8,1,0,1,16,4.8e-05
G5,C(C(C)(C(C=C(C=O)CO)O)O)=O,8,1,0,1,18,4.8e-05
G5,C(C(C)(C(C(CO)=CC=O)O)O)=O,8,1,0,1,18,4.8e-05
G5,C(C(C)(C(C=C)O)O)=O,4,3,0,3,11,0.000143
G5,C(C(C)(C(C=CC)(CO)O)O)=O,8,2,0,2,11,9.499999999999999e-05
G5,C(C(C)(C(CO)(CC=C)O)O)=O,4,2,0,2,11,9.499999999999999e-05
G5,C(C)(C(C=C)(C(C(C)O)O)O)=O,8,2,0,2,11,9.499999999999999e-05
G5,C(C(C)(C(C)(C(C=C)O)O)O)=O,8,2,0,2,11,9.499999999999999e-05
G5,C(C(C)(C(CC(CO)=C)O)O)=O,4,2,0,2,11,9.499999999999999e-05
G5,C(C(C)(C(C=C(CO)C)O)O)=O,8,2,0,2,11,9.499999999999999e-05
G5,C(C(C)(C(C=CC)O)O)=O,8,2,0,2,11,9.499999999999999e-05
G5,C(C(C)(C(CC=C)O)O)=O,4,2,0,2,11,9.499999999999999e-05
G5,C(C(C(CO)=C)(C(C(C)O)O)O)=O,8,1,0,1,49,4.8e-05
G5,C(C(C)(C(C(C(CO)=C)O)O)O)=O,8,1,0,1,49,4.8e-05
G5,C(C(C)(C(C(C=C)(CO)O)O)O)=O,8,1,0,1,29,4.8e-05
G5,C(C(C=C)(C(C(C=O)(C)O)O)O)=O,8,1,0,1,28,4.8e-05
G5,C(C(C)(C(C(C(C=C)O)O)O)O)=O,16,1,0,1,27,4.8e-05
G5,C1(C(C(C(C)O)O)(O)OC(C)C1)=O,16,1,0,1,45,4.8e-05
G5,C(C(C)(C1(C(O)OC(C)C1)O)O)=O,16,2,0,2,11,9.499999999999999e-05
G5,C1(C(C(C(C)O)O)(O)OCC1O)=O,16,1,0,1,0,4.8e-05
G5,C(C(C)(C1(COC(C1O)O)O)O)=O,16,3,0,3,34,0.000154
G5,C1(C(CC(O)O1)(C(C(C)O)O)O)=O,16,2,0,2,11,9.499999999999999e-05
G5,C(C(CCCO)(C(C=O)(C)O)O)=O,4,1,0,1,55,4.8e-05
G5,C(C(C)(C(CO)(CCCO)O)O)=O,4,1,0,1,55,4.8e-05
G5,C(C(C)(C1(C=CC(C1O)=O)O)O)=O,8,1,0,1,47,4.8e-05
G5,C(C(C)(C(C=CCC=O)O)O)=O,8,1,0,1,28,4.8e-05
G5,C(C(C)(C(CC=CC=O)O)O)=O,8,1,0,1,28,4.8e-05
G5,C(C(C(C)(C)O)(CC=O)O)(O)=O,2,1,0,1,33,4.8e-05
G5,C(C(CC=O)(C(C=C)O)O)(O)=O,4,3,0,3,29,0.000143
G5,C(C(CC=O)(C(C=CC)O)O)(O)=O,8,1,0,1,33,4.8e-05
G5,C(C(C(CC=C)O)(CC=O)O)(O)=O,4,1,0,1,33,4.8e-05
G5,C(C(C=C)(C1(COCC1O)O)O)=O,8,1,0,1,10,4.8e-05
G5,C(C(C=O)(C1(C(CCO1)=O)O)O)=O,2,1,0,1,34,4.8e-05
G5,C1(C(C(C(C=O)=O)O)(O)OCC1)=O,4,1,0,1,34,4.8e-05
G5,C1(C(C(C)(C)O)(O)OCC1)=O,2,1,0,1,34,4.8e-05
G5,C(OCC(C1(C(CCO1)=O)O)O)=O,4,1,0,1,34,4.8e-05
G5,C(CCC(C1(C(CCO1)=O)O)O)=O,4,2,0,2,34,9.499999999999999e-05
G5,C(C(C=C)(C1(C(O)OCC1)O)O)=O,8,2,0,2,28,9.499999999999999e-05
G5,C1(C(C(C(C=C)O)O)(O)OCC1)=O,8,1,0,1,34,4.8e-05
G5,C1(C(C2(C=COC2)O)(O)OCC1)=O,4,1,0,1,34,4.8e-05
G5,C(C(C1(C(CCO1)=O)O)O)(CC)=O,4,1,0,1,34,4.8e-05
G5,C(C(CC)(C1(C(CCO1)=O)O)O)=O,4,1,0,1,34,4.8e-05
G5,C1(C(C(C=C)O)(O)OCC1)=O,4,3,0,3,34,0.000143
G5,C1(C(C(C=CC)O)(O)OCC1)=O,8,2,0,2,34,9.499999999999999e-05
G5,C1(C(C(CC=C)O)(O)OCC1)=O,4,2,0,2,34,9.499999999999999e-05
G5,C(CC(CCO)O)(OCC=O)=O,2,1,0,1,8,4.7e-05
G5,C(CC(CC(C)O)O)(OCC=O)=O,4,1,0,1,8,4.7e-05
G5,C(CC(C(CO)=O)O)(OCC=O)=O,2,1,0,1,8,4.7e-05
G5,C(CC(CC=O)O)(OCC=O)=O,2,1,0,1,8,4.7e-05
G5,C(C(C)(CC(OCC=O)=O)O)(O)=O,2,1,0,1,8,4.7e-05
G5,C(CC(O)=O)(OCC=O)=O,1,1,0,1,17,4.7e-05
G5,C(CC(OC(C=O)C(C)=O)=O)(O)=O,2,1,0,1,48,4.7e-05
G5,C(CC(O)=O)(OC(C=O)CC=O)=O,2,1,0,1,17,4.7e-05
G5,C(CC(O)=O)(OCCC(C=O)=O)=O,1,1,0,1,19,4.7e-05
G5,C(CC(O)=O)(OCC(CC=O)=O)=O,1,1,0,1,48,4.7e-05
G5,C(C)(C(C)(CC(OCC=O)=O)O)=O,2,1,0,1,8,4.7e-05
G5,C(C)(CC(CC(OCC=O)=O)O)=O,2,1,0,1,8,4.7e-05
G5,C(CC(C(C=C)=O)O)(OCC=O)=O,2,1,0,1,8,4.7e-05
G5,C(C(C=C)(CC(OCC=O)=O)O)=O,2,1,0,1,8,4.7e-05
G5,C(CC(C=C)(CO)O)(OCC=O)=O,2,1,0,1,8,4.7e-05
G5,C(CC(C=CC=O)O)(OCC=O)=O,4,1,0,1,8,4.7e-05
G5,C(CC(C(C)O)O)(OCC=O)=O,4,1,0,1,8,4.7e-05
G5,C(CC(CO)(CO)O)(OCC=O)=O,1,1,0,1,8,4.7e-05
G5,C(CC(C(CO)O)O)(OCC=O)=O,4,1,0,1,8,4.7e-05
G5,C(CC(C(C)=O)O)(OCC=O)=O,2,1,0,1,8,4.7e-05
G5,C(C(C)(CC(OCC=O)=O)O)=O,2,1,0,1,8,4.7e-05
G5,C(CCO)(OC(C=O)CC=O)=O,2,2,0,2,48,9.499999999999999e-05
G5,C(CCO)(OCCC(C=O)=O)=O,1,2,0,2,48,9.499999999999999e-05
G5,C(CCO)(OCC(CC=O)=O)=O,1,2,0,2,48,9.499999999999999e-05
G5,C(CCO)(OC(C=O)C(C=O)O)=O,4,2,0,2,8,9.499999999999999e-05
G5,C(CC(C(C=O)O)O)(OCC=O)=O,4,1,0,1,8,4.7e-05
G5,C(CC(C)(CO)O)(OCC=O)=O,2,1,0,1,8,4.7e-05
G5,C(CC(C)O)(OCC=O)=O,2,1,0,1,4,4.7e-05
G5,C(CC(C)O)(OC(C=O)CC=O)=O,4,1,0,1,48,4.7e-05
G5,C(CC(C)O)(OCCC(C=O)=O)=O,2,1,0,1,19,4.7e-05
G5,C(CC(C)O)(OCC(CC=O)=O)=O,2,1,0,1,48,4.7e-05
G5,C(C(C(CO)O)O)(OC(C=O)O)=O,8,2,0,2,0,9.499999999999999e-05
G5,C(C(C(C(OCC=O)O)O)O)(O)=O,8,2,0,2,15,9.499999999999999e-05
G5,C(CO)(OCCC(C(CO)=O)=O)=O,1,1,0,1,2,4.7e-05
G5,C(CO)(OC(C(C=O)=O)C)=O,2,2,0,2,14,9.499999999999999e-05
G5,C(CO)(OC(C=O)=CCO)=O,2,2,0,2,2,9.499999999999999e-05
G5,C(C(C=C)(O)OC(CO)=O)=O,2,2,0,2,2,9.499999999999999e-05
G5,C(CO)(OC(CO)=CC=O)=O,2,2,0,2,17,9.499999999999999e-05
G5,C(C(C(OC(CO)=O)=C)O)=O,2,2,0,2,14,9.499999999999999e-05
G5,C(CO)(OC(C=CC=O)O)=O,4,2,0,2,43,9.499999999999999e-05
G5,C(C(C=COC(CO)=O)O)=O,4,2,0,2,43,9.499999999999999e-05
G5,C(C(C)(O)OC(CO)=O)=O,2,1,0,1,17,4.7e-05
G5,C(CO)(OC(C=O)O)=O,2,1,0,1,0,4.7e-05
G5,C(C(C(C)O)(O)OC(CO)=O)=O,4,1,0,1,2,4.7e-05
G5,C(CO)(OC(C(C)=O)O)=O,2,1,0,1,45,4.7e-05
G5,C(CO)(OC(C(CCO)=O)O)=O,2,1,0,1,29,4.7e-05
G5,C(C(C(OCC(O)=O)O)O)=O,4,1,0,1,17,4.7e-05
G5,C(C1C(C)(OCC(O1)=O)O)=O,4,1,0,1,2,4.7e-05
G5,C1(CC(CO1)OC(CO)=O)=O,2,2,0,2,50,9.499999999999999e-05
G5,C(CC1(COC(CO1)=O)O)=O,2,1,0,1,2,4.7e-05
G5,C(C)(C(C(O)OC(CO)=O)O)=O,4,1,0,1,28,4.7e-05
G5,C(C(C(O)OC(CO)=O)O)=O,4,1,0,1,17,4.7e-05
G5,C(C(C(C(OCC(O)=O)O)O)O)=O,8,1,0,1,29,4.7e-05
G5,C(C1CC(OCC(O1)=O)O)=O,4,1,0,1,27,4.7e-05
G5,C(CC(C(O)OC(CO)=O)O)=O,4,1,0,1,43,4.7e-05
G5,C(C(C(C(O)OC(CO)=O)O)O)=O,8,1,0,1,33,4.7e-05
G5,C(C(C=O)OC(CO)=O)=O,1,1,0,1,17,4.7e-05
G5,C(CC1(CO)OCC(O1)=O)=O,2,1,0,1,2,4.7e-05
G5,C(C(C1(C)OCC(O1)=O)O)=O,4,1,0,1,2,4.7e-05
G5,C(C(COC(CO)=O)O)=O,2,1,0,1,33,4.7e-05
G5,C(CC(C=O)O)(OC(CO)=O)=O,2,1,0,1,29,4.7e-05
G5,C(C(CC1OCC(O1)=O)O)=O,4,1,0,1,2,4.7e-05
G5,C1(C(CCO)C(C(C1O)=O)O)=O,8,1,0,1,5,4.7e-05
G5,C1(C(C)C(C(C1C=O)=O)O)=O,8,1,0,1,49,4.7e-05
G5,C1(C(C=O)C(C(C1O)=O)C)=O,8,1,0,1,49,4.7e-05
G5,C(CC1C(C(C(C1)=O)O)=O)=O,4,2,0,2,51,9.6e-05
G5,C1(CC(C(C=O)=O)CC1O)=O,4,2,0,2,26,9.499999999999999e-05
G5,C(CO)(C1CC(C(C1)=O)O)=O,4,1,0,1,45,4.7e-05
G5,C1(C(CO)C(C(C1O)=O)C)=O,8,1,0,1,3,4.7e-05
G5,C1(C(CCO)CC(C1O)=O)=O,4,4,0,4,3,0.00018999999999999998
G5,C1(C(C)C(C(C1CO)=O)O)=O,8,1,0,1,45,4.7e-05
G5,C(C1C(CO)C(C(C1)=O)O)=O,8,4,0,4,45,0.00018999999999999998
G5,C1(C(C)C(C(C1)=O)O)=O,4,1,0,1,45,4.7e-05
G5,C(C1CC(C(C1)=O)O)=O,4,2,0,2,3,9.499999999999999e-05
G5,C1(C(C)CC(C1O)=O)=O,4,1,0,1,16,4.7e-05
G5,C(C1C(C(C(C1)=O)O)=O)=O,4,2,0,2,29,9.499999999999999e-05
G5,C1(C(C(CC1C(CO)O)O)=O)=O,8,2,0,2,2,9.499999999999999e-05
G5,C(C1C(C(CC1CO)=O)=O)=O,4,1,0,1,12,4.7e-05
G5,C1(C(CO)C(C=O)CC1O)=O,8,3,0,3,3,0.000143
G5,C(CC1C(C(C(C1)=O)CO)=O)=O,4,5,0,5,29,0.000239
G5,C1(CCC(C(CCC1O)=O)=O)=O,2,1,0,1,7,4.7e-05
G5,C(C1(CCC(C(CC1)=O)=O)O)=O,1,1,0,1,29,4.7e-05
G5,C1(CCC(C(C1O)=O)CC=O)=O,4,2,0,2,29,9.499999999999999e-05
G5,C(C1C(C(CC1C(C)O)=O)=O)=O,8,1,0,1,12,4.7e-05
G5,C(C1CC(C(C1)=O)O)(CC=O)=O,4,1,0,1,22,4.7e-05
G5,C1(C(CC(C(C1)=O)CC=O)O)=O,4,1,0,1,22,4.7e-05
G5,C1C(C(CCC(C(C=1)=O)=O)O)O,4,1,0,1,32,4.7e-05
G5,C(C1CC(OC1C=O)O)=O,8,2,0,2,38,9.499999999999999e-05
G5,C1(C(OC(C=O)C1C)O)=O,8,2,0,2,19,9.499999999999999e-05
G5,C(CO)(C1C(COC1)=O)=O,2,2,0,2,29,9.499999999999999e-05
G5,C1(C(C(CC1C)=O)=O)=O,2,2,0,2,29,9.499999999999999e-05
G5,C1(C(C(CCC1)=O)=O)=O,1,1,0,1,17,4.7e-05
G5,C1(CC(C(C1C)=O)=O)=O,2,4,0,4,29,0.00018999999999999998
G5,C1(C(C)CC(C1(C=O)O)=O)=O,4,1,0,1,16,4.7e-05
G5,C1(C(C=O)(C(C(C1)=O)C)O)=O,4,1,0,1,29,4.7e-05
G5,C1(C(C)CC(C1(CO)O)=O)=O,4,1,0,1,16,4.7e-05
G5,C1(C(C)C(C(C1)=O)(CO)O)=O,4,1,0,1,45,4.7e-05
G5,C(C1(C(CCC1=O)=O)O)=O,1,1,0,1,15,4.7e-05
G5,C1(C(CO)(CC(C1O)=O)O)=O,4,1,0,1,5,4.7e-05
G5,C1(C(C(C(CO)(C1C)O)O)=O)=O,8,1,0,1,5,4.7e-05
G5,C(C1(CC(C(C(C1)=O)O)=O)O)=O,1,1,0,1,51,4.7e-05
G5,C(C(C1(CC(C(C1)=O)=O)O)O)=O,2,1,0,1,51,4.7e-05
G5,C1(C(CC(C(C)O)(C1)O)=O)=O,2,1,0,1,41,4.7e-05
G5,C1C(CO)(CC(C(C=1)=O)=O)O,2,2,0,2,29,9.499999999999999e-05
G5,C1C(C(C)O)(CC(C(C=1)=O)=O)O,4,2,0,2,29,9.499999999999999e-05
G5,C1(C2COC1C(C2)=O)=O,4,1,0,1,17,4.7e-05
G5,C1(CC2C(OC1C2)=O)=O,4,1,0,1,22,4.7e-05
G5,C1(CC2C(C1CO2)=O)=O,4,2,0,2,29,9.499999999999999e-05
G5,C(C1C(CC(CC1CO)=O)=O)=O,4,2,0,2,29,9.499999999999999e-05
G5,C(C1C(CO)CC(C(C1)=O)=O)=O,4,2,0,2,29,9.499999999999999e-05
G5,C(C1CCC(C(C(C1)=O)O)=O)=O,4,2,0,2,7,9.499999999999999e-05
G5,C(CCC1C(CC(C1=O)O)=O)=O,4,3,0,3,4,0.000144
G5,C(CCC1C(C(C(C1)=O)O)=O)=O,4,3,0,3,4,0.000144
G5,C1(CC(C(C=O)O)CC(C1)=O)=O,2,2,0,2,29,9.499999999999999e-05
G5,C(C(C1CCC(C(C1)=O)=O)O)=O,4,2,0,2,32,9.499999999999999e-05
G5,C(CC1CC(C(C(C1)=O)O)=O)=O,1,4,0,4,32,0.00019099999999999998
G5,C(CC1C(C(CC(C1)=O)=O)O)=O,4,5,0,5,26,0.000239
G5,C(CC1C(C=O)CC(C1O)=O)=O,8,3,0,3,29,0.000144
G5,C(CC)(C(C(C=O)=O)C(C)O)=O,4,1,0,1,4,4.7e-05
G5,C(CC(C(C)C(C=O)CO)=O)=O,4,1,0,1,45,4.7e-05
G5,C(CC(C(C)C(C=O)C=O)=O)=O,2,1,0,1,45,4.7e-05
G5,C(CC(C(CCC(C)=O)=O)O)=O,2,1,0,1,11,4.7e-05
G5,C(CC(C(CC(CC)=O)=O)O)=O,2,1,0,1,11,4.7e-05
G5,C(C(CC(C)=O)C(C(C)=O)O)=O,4,2,0,2,45,9.499999999999999e-05
G5,C(CC)(C(C=O)C(C(C)=O)O)=O,4,1,0,1,45,4.7e-05
G5,C(C(C)CC=O)(C(C=O)CO)=O,4,1,0,1,45,4.7e-05
G5,C(C(C)CC=O)(C(C=O)C=O)=O,2,1,0,1,45,4.7e-05
G5,C(CC(C=O)C(C=O)(C)O)(C)=O,4,2,0,2,11,9.499999999999999e-05
G5,C(CC)(C(C=O)C(C=O)(C)O)=O,4,1,0,1,11,4.7e-05
G5,C(C(CC(C)O)C(C=O)CO)=O,8,1,0,1,11,4.7e-05
G5,C(C(CCCO)=O)(CC(C)O)=O,2,1,0,1,11,4.7e-05
G5,C(C(C)C(C=O)CO)(C(C)O)=O,8,1,0,1,4,4.7e-05
G5,C(C(CO)CC(C(C)O)=O)=O,4,1,0,1,28,4.7e-05
G5,C(C(C(C)=O)=O)(CCCO)=O,1,1,0,1,25,4.7e-05
G5,C(C(CO)C(C(C)=O)CO)=O,4,1,0,1,25,4.7e-05
G5,C(CCO)(CC(C(C)O)=O)=O,2,2,0,2,29,9.499999999999999e-05
G5,C(C(C(C)O)=O)(CCCO)=O,2,2,0,2,25,9.499999999999999e-05
G5,C(C(C(C(CCCO)=O)=O)O)=O,2,1,0,1,5,4.7e-05
G5,C(C(C(CCCO)=O)CO)=O,2,1,0,1,29,4.7e-05
G5,C(C(CO)C(C(C(O)=O)=O)C)=O,4,1,0,1,33,4.7e-05
G5,C(C(C(CCC(O)=O)=O)CO)=O,2,1,0,1,29,4.7e-05
G5,C(C(C=CC=O)C(C=O)CO)=O,8,1,0,1,11,4.7e-05
G5,C(C(C=CC=O)=O)(CCCO)=O,2,1,0,1,18,4.7e-05
G5,C(C(C=C)C(C=O)CO)=O,4,1,0,1,7,4.7e-05
G5,C(CCO)(CC(C=C)=O)=O,1,1,0,1,7,4.7e-05
G5,C=CC(C(CCCO)=O)=O,1,1,0,1,7,4.7e-05
G5,C(C(CO)CC(C)=O)=O,2,2,0,2,11,9.499999999999999e-05
G5,C(C(C(CC)=O)CO)=O,2,1,0,1,11,4.7e-05
G5,C(C(C(C(CO)CO)=O)CO)=O,2,1,0,1,18,4.7e-05
G5,C(C(C(C(C=O)CO)=O)CO)=O,3,1,0,1,18,4.7e-05
G5,C(C(CO)C1C(COC1)=O)=O,4,1,0,1,10,4.7e-05
G5,C1(C(CCO1)C(C=O)CO)=O,4,1,0,1,34,4.7e-05
G5,C(C(C=O)C(C=O)CC(C)O)=O,4,1,0,1,45,4.7e-05
G5,C(CC)(C(C(CO)=O)C(C)O)=O,4,1,0,1,11,4.7e-05
G5,C(CC(C)O)(CC(C(C)O)=O)=O,4,2,0,2,29,9.499999999999999e-05
G5,C(CC(C)O)(C(C(CC)=O)O)=O,4,1,0,1,11,4.7e-05
G5,C(C(C=O)C(C(C(C)O)=O)C)=O,4,1,0,1,45,4.7e-05
G5,C(CCC(C(C(C)O)O)=O)(C)=O,4,1,0,1,11,4.7e-05
G5,C(CC)(CC(C(C(C)O)O)=O)=O,4,1,0,1,11,4.7e-05
G5,C(C(C(C)(CO)O)CC(C)=O)=O,4,2,0,2,49,9.499999999999999e-05
G5,C(C(C(CC)=O)C(C)(CO)O)=O,4,1,0,1,49,4.7e-05
G5,C(C(C(C)O)CC(C(C)O)=O)=O,8,1,0,1,28,4.7e-05
G5,C(C(C(CCC(C)O)=O)=O)=O,2,1,0,1,5,4.7e-05
G5,C(C(C(C)=O)=O)(CCC(C)O)=O,2,1,0,1,25,4.7e-05
G5,C(C(C(C)O)C(C(C)=O)CO)=O,8,1,0,1,25,4.7e-05
G5,C(C(C(C)O)=O)(CCC(C)O)=O,4,2,0,2,25,9.499999999999999e-05
G5,C(C(C(CCCO)=O)C(C)O)=O,4,1,0,1,29,4.7e-05
G5,C(C(C(C)O)CC(C(O)=O)=O)=O,4,2,0,2,29,9.499999999999999e-05
G5,C(C(C=C)C(C=O)C(C)O)=O,8,1,0,1,7,4.7e-05
G5,C(CC(C)O)(CC(C=C)=O)=O,2,1,0,1,7,4.7e-05
G5,C=CC(C(CCC(C)O)=O)=O,2,1,0,1,7,4.7e-05
G5,C(C(C(C)O)CC(C)=O)=O,4,2,0,2,11,9.499999999999999e-05
G5,C(C(C(CC)=O)C(C)O)=O,4,1,0,1,11,4.7e-05
G5,C(C(C(C)O)C1C(COC1)=O)=O,8,1,0,1,10,4.7e-05
G5,C1(C(CCO1)C(C=O)C(C)O)=O,8,1,0,1,34,4.7e-05
G5,C(C(C=O)CC(C(C)O)=O)=O,2,1,0,1,28,4.7e-05
G5,C(CCC(C(O)=O)=O)(C(C)O)=O,2,1,0,1,28,4.7e-05
G5,C(CCC(C(C)=O)=O)(C(C)O)=O,2,1,0,1,14,4.7e-05
G5,C(CC(CCC(C(C)O)=O)=O)=O,2,1,0,1,6,4.7e-05
G5,C(C)(C(C=O)CC(C(C)O)=O)=O,4,1,0,1,6,4.7e-05
G5,C(CC(C(C=C)=O)O)(C(C)O)=O,4,1,0,1,7,4.7e-05
G5,C=CC(C(CC(C(C)O)O)=O)=O,4,1,0,1,7,4.7e-05
G5,C(C(C(CCC(CO)O)=O)=O)=O,2,1,0,1,6,4.7e-05
G5,C(C(C=C)C(C=O)C(CO)O)=O,8,1,0,1,7,4.7e-05
G5,C(CC(CO)O)(CC(C=C)=O)=O,2,1,0,1,7,4.7e-05
G5,C=CC(C(CCC(CO)O)=O)=O,2,1,0,1,7,4.7e-05
G5,C(C(C(CO)O)CC(C)=O)=O,4,2,0,2,6,9.499999999999999e-05
G5,C(C(C(CC)=O)C(CO)O)=O,4,1,0,1,6,4.7e-05
G5,C(C(C=O)C(C=O)C(CO)=O)=O,2,2,0,2,29,9.499999999999999e-05
G5,C(CO)(C(C(C(C=O)=O)=O)C)=O,2,1,0,1,25,4.7e-05
G5,C(C(C(C(C(C)=O)=O)=O)CO)=O,2,1,0,1,25,4.7e-05
G5,C(C(C=O)CC(C(CO)=O)=O)=O,1,2,0,2,29,9.499999999999999e-05
G5,C(C(C)O)(CC(C(C=O)=O)=O)=O,2,1,0,1,25,4.7e-05
G5,C(C(CC(C(C(C)O)=O)=O)=O)=O,2,1,0,1,25,4.7e-05
G5,C(C(C=O)C(C=O)C=O)=O,1,1,0,1,5,4.7e-05
G5,C(C(C(C(C=O)=O)=O)C)(O)=O,2,1,0,1,5,4.7e-05
G5,C(C(C=O)CC(C(O)=O)=O)=O,1,2,0,2,29,9.499999999999999e-05
G5,C(C(C=O)C(C=O)C(C=O)=O)=O,2,1,0,1,23,4.7e-05
G5,C(C)(C(C(C(C=O)=O)=O)C)=O,2,1,0,1,14,4.7e-05
G5,C(CC(C(C(C=O)=O)=O)C)=O,2,1,0,1,6,4.7e-05
G5,C(C)(CCC(C(C=O)=O)=O)=O,1,1,0,1,5,4.7e-05
G5,C(C(C=O)C(C=O)C(C)=O)=O,2,3,0,3,29,0.00014199999999999998
G5,C(C(C(C1COC(C1)O)=O)=O)=O,4,1,0,1,35,4.7e-05
G5,C(C(C=O)C1C(COC1O)=O)=O,4,1,0,1,5,4.7e-05
G5,C(C(C=O)C1C(CC(O1)O)=O)=O,4,2,0,2,5,9.499999999999999e-05
G5,C=CC(CC(C(C=O)=O)=O)=O,1,1,0,1,5,4.7e-05
G5,C(C(C=C)C(C(C=O)=O)=O)=O,2,1,0,1,1,4.7e-05
G5,C=CC(C(C(C=O)=O)=O)CO,2,1,0,1,7,4.7e-05
G5,C(CC(C(C=O)=O)=O)=CC=O,2,1,0,1,43,4.7e-05
G5,C(C(C(C1COCC1O)=O)=O)=O,4,1,0,1,10,4.7e-05
G5,C1(COCC1C(C(C=O)=O)O)=O,4,1,0,1,10,4.7e-05
G5,C(C(C=O)C1C(C(CO1)O)=O)=O,4,1,0,1,10,4.7e-05
G5,C(C(C(C1C(O)OCC1)=O)=O)=O,4,1,0,1,34,4.7e-05
G5,C1(C(CCO1)C(C(C=O)=O)O)=O,4,1,0,1,34,4.7e-05
G5,C(C(C=O)C1C(C(O)OC1)=O)=O,4,1,0,1,34,4.7e-05
G5,C(CCC(C(C(C)=O)=O)=O)=O,1,3,0,3,29,0.00014199999999999998
G5,C(C(C(C(C(C)=O)=O)=O)C)(O)=O,2,1,0,1,25,4.7e-05
G5,C(CC(C(C(C)=O)=O)=O)(O)=O,1,1,0,1,33,4.7e-05
G5,C(C)(C(C(C(C(C)=O)=O)=O)C)=O,2,1,0,1,14,4.7e-05
G5,C(CC(C(C(C(C)=O)=O)=O)C)=O,2,1,0,1,25,4.7e-05
G5,C(C)(CCC(C(C(C)=O)=O)=O)=O,1,1,0,1,25,4.7e-05
G5,C(CC(C)=O)(CC(C(C)=O)=O)=O,1,4,0,4,29,0.00018999999999999998
G5,C(C(C(C)=O)C(C=O)C(C)=O)=O,3,2,0,2,29,9.499999999999999e-05
G5,C=CC(CC(C(C(C)=O)=O)=O)=O,1,1,0,1,25,4.7e-05
G5,C=CC(C(CC(C(C)=O)=O)=O)=O,1,1,0,1,25,4.7e-05
G5,C(C(C=C)C(C(C(C)=O)=O)=O)=O,2,1,0,1,25,4.7e-05
G5,C=CC(C(C(C(C)=O)=O)=O)CO,2,1,0,1,25,4.7e-05
G5,C(C)(C(C(C(C=C)=O)=O)CO)=O,2,1,0,1,7,4.7e-05
G5,C(CO)(C(C(C(C=C)=O)=O)C)=O,2,1,0,1,25,4.7e-05
G5,C(CC(C(C(C)=O)=O)=O)=CC=O,2,1,0,1,25,4.7e-05
G5,C(C(C)=O)(CC(C=CC=O)=O)=O,2,2,0,2,29,9.499999999999999e-05
G5,C(C(C(C)=O)=O)(CC(C)O)=O,2,1,0,1,25,4.7e-05
G5,C(CC)(C(C(C(C)=O)=O)O)=O,2,1,0,1,25,4.7e-05
G5,C(C)(CCC(C(CO)=O)=O)=O,1,2,0,2,29,9.499999999999999e-05
G5,C(CC)(CC(C(CO)=O)=O)=O,1,1,0,1,11,4.7e-05
G5,C=CC(CC(C(C(C)O)=O)=O)=O,2,1,0,1,25,4.7e-05
G5,C(C(C)O)(CC(C(C=C)=O)=O)=O,2,1,0,1,25,4.7e-05
G5,C(C(C=O)C(C(C)=O)CO)=O,2,1,0,1,25,4.7e-05
G5,C(C(C(C(C(C)O)=O)=O)C)(O)=O,4,1,0,1,25,4.7e-05
G5,C(C)(C(C(C(C(C)O)=O)=O)C)=O,4,1,0,1,25,4.7e-05
G5,C(CC(C(C(C(C)O)=O)=O)C)=O,4,1,0,1,25,4.7e-05
G5,C(CCC(C(C(C)O)=O)=O)(C)=O,2,1,0,1,25,4.7e-05
G5,C(C(C)O)(CC(CC(C)=O)=O)=O,2,1,0,1,25,4.7e-05
G5,C(C(C(C)=O)C(C(C)=O)CO)=O,4,1,0,1,25,4.7e-05
G5,C=CC(C(C(C(C)O)=O)=O)CO,4,1,0,1,7,4.7e-05
G5,C(C(C)O)(CC(C(C)O)=O)=O,3,1,0,1,25,4.7e-05
G5,C(CC)(C(C(C(C)O)=O)O)=O,4,1,0,1,25,4.7e-05
G5,C(C(C=O)C(C(C=O)=O)CO)=O,2,2,0,2,29,9.499999999999999e-05
G5,C(C(C(C(CCC=O)=O)=O)O)=O,2,1,0,1,5,4.7e-05
G5,C(C(C=O)C(C(C(O)=O)=O)C)=O,2,1,0,1,45,4.7e-05
G5,C(C(C=O)C(C=O)C=CC=O)=O,4,1,0,1,11,4.7e-05
G5,C(CC(CC(C=CC=O)=O)=O)=O,2,3,0,3,29,0.00014199999999999998
G5,C(CCC(C(C=CC=O)=O)=O)=O,2,2,0,2,29,9.499999999999999e-05
G5,C(C(C=O)C(C=O)C=C)=O,2,1,0,1,7,4.7e-05
G5,C(CC(CC(C=C)=O)=O)=O,1,1,0,1,45,4.7e-05
G5,C(CCC(C(C=C)=O)=O)=O,1,1,0,1,45,4.7e-05
G5,C(C(C=O)CC(C)=O)=O,1,1,0,1,11,4.7e-05
G5,C(C(C=O)C(CC)=O)=O,1,1,0,1,11,4.7e-05
G5,C(C(C=O)C(C(CO)CO)=O)=O,1,1,0,1,45,4.7e-05
G5,C(C(C=O)C(C(C=O)CO)=O)=O,2,1,0,1,1,4.7e-05
G5,C(C(C=O)C1C(COC1)=O)=O,2,1,0,1,10,4.7e-05
G5,C(C(C=O)C1C(OCC1)=O)=O,2,1,0,1,34,4.7e-05
G5,C(C(C(CC(C(O)=O)=O)=O)O)=O,2,1,0,1,5,4.7e-05
G5,C(C(C(C(C(CC)=O)O)=O)O)=O,4,1,0,1,5,4.7e-05
G5,C(CCC(C(O)=O)=O)(CCO)=O,1,1,0,1,29,4.7e-05
G5,C(C(CCC(C(O)=O)=O)=O)(O)=O,1,1,0,1,29,4.7e-05
G5,C(C(C=C)CC(C(O)=O)=O)=O,2,1,0,1,29,4.7e-05
G5,C(C(C(C(C=C)=O)=O)C)(O)=O,2,1,0,1,7,4.7e-05
G5,C(C)(CCC(C(O)=O)=O)=O,1,3,0,3,29,0.00014199999999999998
G5,C(CC)(CC(C(O)=O)=O)=O,1,1,0,1,11,4.7e-05
G5,C1(COCC1CC(C(O)=O)=O)=O,2,1,0,1,10,4.7e-05
G5,C1(C(CCO1)CC(C(O)=O)=O)=O,2,1,0,1,29,4.7e-05
G5,C(C(C(CO)=O)CC(C)=O)(O)=O,2,1,0,1,0,4.7e-05
G5,C(CC)(C(C(O)=O)C(CO)=O)=O,2,1,0,1,0,4.7e-05
G5,C(CC(CC(C(C)O)=O)=O)(O)=O,2,1,0,1,0,4.7e-05
G5,C(CC(C(C(CC)=O)O)=O)(O)=O,2,1,0,1,0,4.7e-05
G5,C(C(C(CCC(C)=O)=O)O)(O)=O,2,1,0,1,11,4.7e-05
G5,C(C(C(O)=O)O)(CC(CC)=O)=O,2,1,0,1,11,4.7e-05
G5,C(C=CC(CC(C(O)=O)=O)=O)=O,2,1,0,1,33,4.7e-05
G5,C(C)(C(C(C=O)=O)CC(C)=O)=O,2,3,0,3,29,0.00014199999999999998
G5,C(CC)(C(C(C)=O)C(C=O)=O)=O,2,1,0,1,26,4.7e-05
G5,C(CCC(C)=O)(CC(C=O)=O)=O,1,2,0,2,29,9.499999999999999e-05
G5,C(CC(CC)=O)(CC(C=O)=O)=O,1,1,0,1,11,4.7e-05
G5,C(C(C(C=O)=O)C(C=O)C=C)=O,4,1,0,1,23,4.7e-05
G5,C(CC(C(CC(C=C)=O)=O)=O)=O,1,2,0,2,29,9.499999999999999e-05
G5,C(CC(CC(C(C=C)=O)=O)=O)=O,1,2,0,2,29,9.499999999999999e-05
G5,C(C(C(C(C=C)=O)=O)CC=O)=O,2,2,0,2,29,9.499999999999999e-05
G5,C(CC(C=O)=O)(CC(C=C)=O)=O,1,2,0,2,29,9.499999999999999e-05
G5,C=CC(C(CCC(C=O)=O)=O)=O,1,2,0,2,29,9.499999999999999e-05
G5,C(C(C(C=O)=O)CC(C)=O)=O,2,4,0,4,29,0.00018999999999999998
G5,C(C(C(CC)=O)C(C=O)=O)=O,2,1,0,1,23,4.7e-05
G5,C(C(C(C(C)=O)=O)CC(C)=O)=O,2,2,0,2,29,9.499999999999999e-05
G5,C(CC)(C(C=O)C(C(C)=O)=O)=O,2,1,0,1,14,4.7e-05
G5,C(CC(C(CCC(C)=O)=O)=O)=O,1,3,0,3,29,0.00014199999999999998
G5,C(CC(C(CC(CC)=O)=O)=O)=O,1,1,0,1,11,4.7e-05
G5,C(C(C=C)CC(C(C)=O)=O)=O,2,3,0,3,29,0.00014199999999999998
G5,C(C)(C(C(C(C=C)=O)=O)C)=O,2,1,0,1,14,4.7e-05
G5,C(C)(CCC(C(C)=O)=O)=O,1,2,0,2,29,9.499999999999999e-05
G5,C(CC)(CC(C(C)=O)=O)=O,1,1,0,1,11,4.7e-05
G5,C1(COCC1CC(C(C)=O)=O)=O,2,1,0,1,10,4.7e-05
G5,C1(C(CCO1)CC(C(C)=O)=O)=O,2,1,0,1,14,4.7e-05
G5,C(C(C=C)CC(CC=O)=O)=O,2,3,0,3,29,0.00014199999999999998
G5,C(C(C=C)C(C=O)C(C)=O)=O,4,1,0,1,7,4.7e-05
G5,C(CC(C(C(C=C)=O)=O)C)=O,2,1,0,1,7,4.7e-05
G5,C(CC(C)=O)(CC(C=C)=O)=O,1,1,0,1,7,4.7e-05
G5,C(C)(CCC(C(C=C)=O)=O)=O,1,1,0,1,7,4.7e-05
G5,C(CC(CCC(C)=O)=O)=O,1,1,0,1,11,4.7e-05
G5,C(CC(CC(CC)=O)=O)=O,1,1,0,1,11,4.7e-05
G5,C(C(C(C)=O)CC(C)=O)=O,2,1,0,1,11,4.7e-05
G5,C(CC)(C(C=O)C(C)=O)=O,2,1,0,1,11,4.7e-05
G5,C1(COCC1CC(CC=O)=O)=O,2,1,0,1,10,4.7e-05
G5,C(C)(C(C=O)C1C(COC1)=O)=O,4,1,0,1,10,4.7e-05
G5,C(CC(CC1C(OCC1)=O)=O)=O,2,1,0,1,34,4.7e-05
G5,C(C(C(C)=O)C1C(OCC1)=O)=O,4,1,0,1,34,4.7e-05
G5,C(C(C=C)C1C(COC1O)=O)=O,8,1,0,1,7,4.7e-05
G5,C(C(C=C)C1C(CC(O1)O)=O)=O,8,3,0,3,29,0.00014199999999999998
G5,C=CC(C(C1COC(C1)O)=O)=O,4,1,0,1,7,4.7e-05
G5,C1(COC(C1CC(C)=O)O)=O,4,1,0,1,35,4.7e-05
G5,C(CC)(C1C(COC1O)=O)=O,4,1,0,1,35,4.7e-05
G5,C(CC1C(CC(O1)O)=O)(C)=O,4,1,0,1,35,4.7e-05
G5,C(CC)(C1C(CC(O1)O)=O)=O,4,1,0,1,35,4.7e-05
G5,C=CC(CC(C(C=CC=O)=O)=O)=O,2,1,0,1,7,4.7e-05
G5,C=CC(C(CC(C=CC=O)=O)=O)=O,2,1,0,1,7,4.7e-05
G5,C(C(C=C)C(C(C=CC=O)=O)=O)=O,4,1,0,1,7,4.7e-05
G5,C(CC(C(C=CC=O)=O)=O)=CC=O,4,2,0,2,29,9.499999999999999e-05
G5,C(C=CC(CC(C=CC=O)=O)=O)=O,3,1,0,1,43,4.7e-05
G5,C(CC)(C(C(C=CC=O)=O)O)=O,4,1,0,1,11,4.7e-05
G5,C=CC(CC(C(C=C)=O)=O)=O,1,1,0,1,7,4.7e-05
G5,C(C(C=C)C(C(C=C)=O)=O)=O,2,3,0,3,29,0.00014199999999999998
G5,C=CC(C(C(C=C)=O)=O)CO,2,1,0,1,7,4.7e-05
G5,C=CC(C(CC=CC=O)=O)=O,2,3,0,3,29,0.00014199999999999998
G5,C=CC(CC(C=CC=O)=O)=O,2,3,0,3,29,0.00014199999999999998
G5,C=CC(C(CC(C)O)=O)=O,2,1,0,1,11,4.7e-05
G5,C(C(C)O)(CC(C=C)=O)=O,2,1,0,1,11,4.7e-05
G5,C(CC)(C(C(C=C)=O)O)=O,2,1,0,1,11,4.7e-05
G5,C=CC(C(C1COCC1O)=O)=O,4,1,0,1,10,4.7e-05
G5,C1(COCC1C(C(C=C)=O)O)=O,4,1,0,1,10,4.7e-05
G5,C(C(C=C)C1C(C(CO1)O)=O)=O,8,2,0,2,29,9.499999999999999e-05
G5,C=CC(C(C1C(O)OCC1)=O)=O,4,1,0,1,7,4.7e-05
G5,C1(C(CCO1)C(C(C=C)=O)O)=O,4,1,0,1,7,4.7e-05
G5,C(C(C=C)C1C(C(O)OC1)=O)=O,8,1,0,1,34,4.7e-05
G5,C(CC)(C(C(C(O)=O)=O)CO)=O,2,1,0,1,11,4.7e-05
G5,C(C(C(C=O)CC(C)=O)O)(O)=O,4,2,0,2,33,9.499999999999999e-05
G5,C(CC)(C(C=O)C(C(O)=O)O)=O,4,1,0,1,33,4.7e-05
G5,C(CC1C(C(CO1)O)=O)(C)=O,4,1,0,1,10,4.7e-05
G5,C(CC)(C1C(C(CO1)O)=O)=O,4,1,0,1,10,4.7e-05
G5,C(CC1C(C(O)OC1)=O)(C)=O,4,2,0,2,34,9.499999999999999e-05
G5,C(CC)(C1C(C(O)OC1)=O)=O,4,1,0,1,34,4.7e-05
G5,C(C(C(C=O)=O)CC(C)O)=O,4,1,0,1,0,4.7e-05
G5,C(C(C)C(C=O)O)(CC=O)=O,4,1,0,1,0,4.7e-05
G5,C(C(C(C=O)=O)C(CO)CO)=O,2,1,0,1,2,4.7e-05
G5,C(C(CC(C)O)C(C=O)O)=O,8,2,0,2,0,9.499999999999999e-05
G5,C(C(C)C(C=O)O)(C(C)O)=O,8,1,0,1,0,4.7e-05
G5,C(CC(C=O)O)(C(C=O)(C)O)=O,4,2,0,2,29,0.000106
G5,C(CC(C=O)O)(C(CO)(C)O)=O,4,1,0,1,49,4.7e-05
G5,C(C)(C(C(C)=O)C(C=O)=O)=O,1,2,0,2,29,9.499999999999999e-05
G5,C(CC(C(C)=O)C(C=O)=O)=O,2,2,0,2,29,9.499999999999999e-05
G5,C(CC=O)(C(C(C=O)=O)C)=O,2,3,0,3,29,0.00014199999999999998
G5,C(CC(C(CCC=O)=O)=O)=O,1,4,0,4,29,0.00018999999999999998
G5,C(C)(C(C(C=O)=O)C)=O,2,3,0,3,29,0.00014199999999999998
G5,C(C(C1COC(C1)O)=O)=O,4,2,0,2,35,9.499999999999999e-05
G5,C1(COC(C1CC=O)O)=O,4,3,0,3,29,0.00014199999999999998
G5,C(C(C1COC(C(C1)O)O)=O)=O,8,2,0,2,27,9.499999999999999e-05
G5,C(C)(C1C(COC(C1O)O)=O)=O,8,3,0,3,29,0.00014199999999999998
G5,C1(COC(C(C1CC=O)O)O)=O,8,2,0,2,0,9.499999999999999e-05
G5,C1(CC(C(OC1C(C)=O)O)O)=O,8,3,0,3,49,0.00014199999999999998
G5,C(CC1C(CC(C(O1)O)O)=O)=O,8,2,0,2,0,9.499999999999999e-05
G5,C(C)(C(C(C=CC=O)=O)O)=O,4,3,0,3,29,0.00014199999999999998
G5,C(CO)(CC(C=CC=O)=O)=O,2,4,0,4,29,0.00018999999999999998
G5,C(C(CC(C=CC(C)=O)=O)=O)=O,2,2,0,2,29,9.499999999999999e-05
G5,C(CC(C(C=CC(C)=O)=O)=O)=O,2,2,0,2,29,9.499999999999999e-05
G5,C(C(C=CC(C)=O)C(C=O)=O)=O,4,2,0,2,29,9.499999999999999e-05
G5,C(C(C(C=O)=O)C)=CC(C=O)=O,4,1,0,1,45,4.7e-05
G5,C(C)(CC(C=CC(C=O)=O)=O)=O,2,2,0,2,29,9.499999999999999e-05
G5,C(CCC(C=CC(C=O)=O)=O)=O,2,1,0,1,0,4.7e-05
G5,C(CC=CC(CC(C=O)=O)=O)=O,2,2,0,2,29,9.499999999999999e-05
G5,C(CC(C(C=CCC=O)=O)=O)=O,2,2,0,2,29,9.499999999999999e-05
G5,C(C(C=CCC=O)C(C=O)=O)=O,4,1,0,1,45,4.7e-05
G5,C(CCC(C=O)=O)=CC(C=O)=O,2,3,0,3,29,0.00014199999999999998
G5,C(CC(CC=CC(C=O)=O)=O)=O,2,2,0,2,29,9.499999999999999e-05
G5,C(C(C(C)=O)C=CC(C=O)=O)=O,4,2,0,2,29,9.499999999999999e-05
G5,C(C(C=CC(C=O)=O)CC=O)=O,4,3,0,3,29,0.00014199999999999998
G5,C(CC(C=O)=O)=CC(C(C)=O)=O,2,3,0,3,29,0.00014199999999999998
G5,C(CC(C=CC(C(C)=O)=O)=O)=O,2,2,0,2,29,9.499999999999999e-05
G5,C(C)(C(C=CC=O)C(C=O)=O)=O,4,3,0,3,29,0.00014199999999999998
G5,C(C(C(C(C=CC=O)=O)C)=O)=O,4,2,0,2,29,9.499999999999999e-05
G5,C(C)(CC(C(C=CC=O)=O)=O)=O,2,2,0,2,29,9.499999999999999e-05
G5,C(CC(C=CCC(C=O)=O)=O)=O,2,4,0,4,29,0.00018999999999999998
G5,C(CC(C=CC(CC=O)=O)=O)=O,2,2,0,2,29,9.499999999999999e-05
G5,C(CC(C=CC=O)C(C=O)=O)=O,4,2,0,2,29,9.499999999999999e-05
G5,C(C(CCC(C=CC=O)=O)=O)=O,2,1,0,1,45,4.7e-05
G5,C(C(C(C)=O)C(C=CC=O)=O)=O,4,2,0,2,29,9.499999999999999e-05
G5,C(C(C(C=CC=O)=O)CC=O)=O,4,2,0,2,29,9.499999999999999e-05
G5,C(C(C(C=O)=O)CC(C=C)=O)=O,2,1,0,1,0,4.7e-05
G5,C=CC(C(C=O)=O)CC(C=O)=O,2,1,0,1,45,4.7e-05
G5,C(C)(C(C(C=O)=O)C(C=C)=O)=O,2,1,0,1,0,4.7e-05
G5,C(CC(C(C=O)=O)C(C=C)=O)=O,2,2,0,2,29,9.499999999999999e-05
G5,C(CC(C(C=C)C(C=O)=O)=O)=O,2,1,0,1,0,4.7e-05
G5,C(C(C(C)=O)C(C(C=C)=O)=O)=O,2,2,0,2,29,9.499999999999999e-05
G5,C(CC(C=O)=O)(CC=CC=O)=O,2,3,0,3,29,0.00014199999999999998
G5,C(CC(C(CC=CC=O)=O)=O)=O,2,4,0,4,29,0.00018999999999999998
G5,C(C(C(C=O)=O)CC=CC=O)=O,4,1,0,1,27,4.7e-05
G5,C(CC(C=O)=O)=CCC(C=O)=O,2,2,0,2,29,9.499999999999999e-05
G5,C(C(C1COCC1O)=O)=O,4,1,0,1,10,4.7e-05
G5,C1(COCC1C(C=O)O)=O,4,1,0,1,10,4.7e-05
G5,C(C(C1C(O)OCC1)=O)=O,4,2,0,2,34,9.499999999999999e-05
G5,C1(C(CCO1)C(C=O)O)=O,4,1,0,1,34,4.7e-05
G5,C(CC1C(C(O)OC1)=O)=O,4,3,0,3,0,0.00014199999999999998
G5,C(C(CO)=O)(CCC(C)O)=O,2,2,0,2,5,9.499999999999999e-05
G5,C(C)(C(C(C(CO)=O)=O)C)=O,2,2,0,2,29,9.499999999999999e-05
G5,C(C(CO)C1C(COC1O)=O)=O,8,2,0,2,5,9.499999999999999e-05
G5,C(C(C=C)C(C(CO)=O)=O)=O,2,2,0,2,29,9.499999999999999e-05
G5,C=CC(C(C(CO)=O)=O)CO,2,2,0,2,29,9.499999999999999e-05
G5,C(C(CO)=O)(C1COCC1O)=O,4,1,0,1,10,4.7e-05
G5,C1(COCC1C(C(CO)=O)O)=O,4,1,0,1,10,4.7e-05
G5,C(C(CO)=O)(C1C(O)OCC1)=O,4,2,0,2,5,9.499999999999999e-05
G5,C1(C(CCO1)C(C(CO)=O)O)=O,4,1,0,1,5,4.7e-05
G5,C(C(CO)C1C(C(O)OC1)=O)=O,8,2,0,2,5,9.499999999999999e-05
G5,C(CCO)(C1C(COC1O)=O)=O,4,2,0,2,2,9.499999999999999e-05
G5,C(CC1C(COC1O)=O)(CO)=O,4,3,0,3,29,0.00014199999999999998
G5,C(CC1C(CC(O1)O)=O)(CO)=O,4,3,0,3,20,0.00014199999999999998
G5,C(CC1C(C(CO1)O)=O)(CO)=O,4,1,0,1,10,4.7e-05
G5,C(C(C)CC(C=O)=O)(CC=O)=O,2,1,0,1,4,4.7e-05
G5,C(C(CC(C)O)CC(C=O)=O)=O,4,2,0,2,45,9.499999999999999e-05
G5,C(C(C)CC(C=O)=O)(C(C)O)=O,4,1,0,1,45,4.7e-05
G5,C(C(C=O)CC(C=O)=O)=O,1,2,0,2,29,9.499999999999999e-05
G5,C(C(C(C(C=O)=O)=O)C)=O,2,1,0,1,45,4.7e-05
G5,C(C)(CC(C(C(C)=O)=O)=O)=O,1,3,0,3,29,0.00014199999999999998
G5,C(C(C(C(C(C)=O)=O)=O)C)=O,2,2,0,2,29,9.499999999999999e-05
G5,C(C(C(C(C(C)O)=O)=O)C)=O,4,1,0,1,25,4.7e-05
G5,C(C(C(C(CC(C)=O)=O)=O)O)=O,2,1,0,1,5,4.7e-05
G5,C(C(C(C(C(C=O)O)=O)=O)C)=O,4,1,0,1,5,4.7e-05
G5,C(C(C=CC=O)CC(C=O)=O)=O,4,1,0,1,45,4.7e-05
G5,C(C(C(C(C=CC=O)=O)=O)C)=O,4,1,0,1,45,4.7e-05
G5,C(C(C=C)CC(C=O)=O)=O,2,2,0,2,29,9.499999999999999e-05
G5,C=CC(CC(C(C)=O)=O)=O,1,2,0,2,29,9.499999999999999e-05
G5,C(C)(CC(C(C=C)=O)=O)=O,1,2,0,2,29,9.499999999999999e-05
G5,C(C(C(C(C=C)=O)=O)C)=O,2,2,0,2,29,9.499999999999999e-05
G5,C(CC)(CC(C=O)=O)=O,1,1,0,1,11,4.7e-05
G5,C1(COCC1CC(C=O)=O)=O,2,1,0,1,10,4.7e-05
G5,C1(C(CCO1)CC(C=O)=O)=O,2,1,0,1,29,4.7e-05
G5,C(CC(C(C(C(C)=O)C)=O)=O)=O,2,2,0,2,29,9.499999999999999e-05
G5,C(C(C=C)C(C(CC=O)=O)=O)=O,2,1,0,1,7,4.7e-05
G5,C(C(C=C)C(C=O)C(CO)=O)=O,4,1,0,1,7,4.7e-05
G5,C(CC(CO)=O)(CC(C=C)=O)=O,1,1,0,1,49,4.7e-05
G5,C(CO)(CCC(C(C=C)=O)=O)=O,1,1,0,1,49,4.7e-05
G5,C(CC(C(C(C=C)=O)=O)CO)=O,2,1,0,1,7,4.7e-05
G5,C(C(C(CO)=O)CC(C)=O)=O,2,1,0,1,49,4.7e-05
G5,C(CC)(C(C=O)C(CO)=O)=O,2,1,0,1,49,4.7e-05
G5,C(CC(C(C(CC)=O)O)=O)=O,2,1,0,1,11,4.7e-05
G5,C(C(C=O)CC(C(C=O)O)=O)=O,2,2,0,2,29,9.499999999999999e-05
G5,C(C(C(C)=O)O)(CC(C=O)=O)=O,2,2,0,2,29,9.499999999999999e-05
G5,C(C(C(C(C(C=O)=O)=O)C)O)=O,4,1,0,1,0,4.7e-05
G5,C(C(C=O)C(C(C=O)=O)C)=O,2,2,0,2,29,9.499999999999999e-05
G5,C(C(CCC(C(C)=O)=O)=O)(C)=O,1,1,0,1,14,4.7e-05
G5,C(C(CC(C(C=O)=O)C)=O)(C)=O,2,1,0,1,14,4.7e-05
G5,C(CC(CC(C(C=O)=O)C)=O)=O,2,1,0,1,27,4.7e-05
G5,C(C(C(C)=O)C(C(C=O)=O)C)=O,4,1,0,1,6,4.7e-05
G5,C(C(C(C=C)=O)O)(CC(C)=O)=O,2,2,0,2,29,9.499999999999999e-05
G5,C(C(C(C)=O)O)(CC(C=C)=O)=O,2,1,0,1,1,4.7e-05
G5,C(C)(C(CC(C(C=C)=O)=O)O)=O,2,1,0,1,1,4.7e-05
G5,C(C(C(C(C(C=C)=O)=O)C)O)=O,4,1,0,1,1,4.7e-05
G5,C(C(C(CCC(C)=O)=O)O)=O,2,1,0,1,11,4.7e-05
G5,C(C(C=O)O)(CC(CC)=O)=O,2,1,0,1,11,4.7e-05
G5,C(CO)(C(C)C(C(C=O)=O)O)=O,4,1,0,1,5,4.7e-05
G5,C(C(C(C(C)C(CO)O)=O)=O)=O,4,1,0,1,5,4.7e-05
G5,C(C(C=O)C(C(CO)=O)C)=O,2,2,0,2,29,9.499999999999999e-05
G5,C(CO)(C(C)CC(C(C)=O)=O)=O,2,1,0,1,14,4.7e-05
G5,C(CO)(C(C)CC(CC=O)=O)=O,2,1,0,1,6,4.7e-05
G5,C(C)(C(C=O)C(C(CO)=O)C)=O,4,1,0,1,6,4.7e-05
G5,C(CO)(C(C)C(C(C=C)=O)O)=O,4,1,0,1,7,4.7e-05
G5,C=CC(C(C(C)C(CO)O)=O)=O,4,1,0,1,7,4.7e-05
G5,C(CCC(C(CO)O)=O)(C)=O,2,1,0,1,11,4.7e-05
G5,C(CC)(CC(C(CO)O)=O)=O,2,1,0,1,11,4.7e-05
G5,C(OC(CO)CC(C(C)=O)=O)=O,2,1,0,1,2,4.7e-05
G5,C(C(COCC(C(C)=O)=O)O)=O,2,1,0,1,36,4.7e-05
G5,C(COC(CC(C(C)=O)=O)O)=O,2,1,0,1,38,4.7e-05
G5,C(CC(C(C=CCO)=O)=O)=O,2,4,0,4,29,0.00018999999999999998
G5,C(CO)=CC(C(C(C)=O)=O)=O,2,2,0,2,29,9.499999999999999e-05
G5,C(CC(C(C=CC=O)O)=O)=O,4,3,0,3,29,0.00014199999999999998
G5,C(CC(C1(CC(CO1)O)O)=O)=O,4,3,0,3,29,0.00014199999999999998
G5,C(C(C)=O)(C1(CC(CO1)O)O)=O,4,2,0,2,2,9.499999999999999e-05
G5,C(CC(C1C(CC(O1)O)O)=O)=O,8,2,0,2,38,9.499999999999999e-05
G5,C(C(C)=O)(C1C(CC(O1)O)O)=O,8,2,0,2,38,9.499999999999999e-05
G5,C(CC(C1CC(C(O1)O)O)=O)=O,8,2,0,2,32,9.499999999999999e-05
G5,C(C(C)=O)(C1CC(C(O1)O)O)=O,8,2,0,2,32,9.499999999999999e-05
G5,C(C(C(C(C=O)=O)=O)CCO)=O,2,1,0,1,1,4.7e-05
G5,C(C(C=C)C(C(C=O)=O)CO)=O,4,1,0,1,7,4.7e-05
G5,C=CC(CC(C(CCO)=O)=O)=O,1,1,0,1,3,4.7e-05
G5,C(CCO)(CC(C(C=C)=O)=O)=O,1,1,0,1,3,4.7e-05
G5,C(C(C(C(C=C)=O)=O)CCO)=O,2,1,0,1,7,4.7e-05
G5,C(CC)(C(C(C=O)=O)CO)=O,2,1,0,1,11,4.7e-05
G5,C(C)(C(C(C(CCO)=O)=O)C)=O,2,1,0,1,14,4.7e-05
G5,C(CCC(C(CCO)=O)=O)(C)=O,1,1,0,1,3,4.7e-05
G5,C(C(C=C)C(C(CO)=O)CO)=O,4,1,0,1,7,4.7e-05
G5,C=CC(C(C(CO)CCO)=O)=O,2,1,0,1,7,4.7e-05
G5,C(CCO)(C(C(CC)=O)O)=O,2,1,0,1,11,4.7e-05
G5,C(CC)(C(C(CO)=O)CO)=O,2,1,0,1,11,4.7e-05
G5,C(C(CC(C(C(C)=O)=O)=O)O)=O,2,1,0,1,25,4.7e-05
G5,C(C(C=O)C(CC=O)=O)=O,1,4,0,4,29,0.00018999999999999998
G5,C(C(C(CC=O)=O)C(C=O)=O)=O,2,1,0,1,23,4.7e-05
G5,C(C(C(C=O)=O)CC(C=O)=O)=O,2,2,0,2,29,9.499999999999999e-05
G5,C(CC=O)(C1C(COC1O)=O)=O,4,2,0,2,1,9.499999999999999e-05
G5,C1(COC(C1CC(C=O)=O)O)=O,4,2,0,2,35,9.499999999999999e-05
G5,C(CC(C1C(CC(O1)O)=O)=O)=O,4,3,0,3,29,0.00014199999999999998
G5,C1(C(CC(C=O)=O)OC(C1)O)=O,4,3,0,3,0,0.00014199999999999998
G5,C(CC(C1C(C(CO1)O)=O)=O)=O,4,1,0,1,10,4.7e-05
G5,C1(C(CC(C=O)=O)OCC1O)=O,4,1,0,1,10,4.7e-05
G5,C(CC=O)(C1C(C(O)OC1)=O)=O,4,2,0,2,34,9.499999999999999e-05
G5,C1(C(O)OCC1CC(C=O)=O)=O,4,2,0,2,34,9.499999999999999e-05
G5,C(C(C(C(C)=O)=O)CC(C)O)=O,4,1,0,1,4,4.7e-05
G5,C(C(C)CC(CO)=O)(CC=O)=O,2,1,0,1,4,4.7e-05
G5,C(C(C)C(C(C)=O)O)(CC=O)=O,4,1,0,1,45,4.7e-05
G5,C(C)(C(CCC(C(C)=O)=O)O)=O,2,1,0,1,45,4.7e-05
G5,C(C)(C(C(C(C)CC=O)=O)O)=O,4,1,0,1,45,4.7e-05
G5,C(C(C)(CCC(C(C)=O)=O)O)=O,2,1,0,1,45,4.7e-05
G5,C(C(CC(C)O)CC(CO)=O)=O,4,2,0,2,49,9.499999999999999e-05
G5,C(C(C)=O)(C(CO)CC(C)O)=O,4,1,0,1,11,4.7e-05
G5,C(C(CC(C)O)C(C(C)=O)O)=O,8,2,0,2,11,9.499999999999999e-05
G5,C(C(C)CC(CO)=O)(C(C)O)=O,4,1,0,1,49,4.7e-05
G5,C(C(C)C(C(C)=O)O)(C(C)O)=O,8,1,0,1,49,4.7e-05
G5,C(C(C)=O)(CCC(C)(CO)O)=O,2,1,0,1,49,4.7e-05
G5,C(C(C)=O)(CCC(C)O)=O,2,1,0,1,28,4.7e-05
G5,C(CC(C(C)=O)O)(C(C)O)=O,4,1,0,1,28,4.7e-05
G5,C(C(C)C(C(C=O)=O)O)=O,4,2,0,2,29,0.000106
G5,C(C(C(C(C)CO)=O)=O)=O,2,1,0,1,49,4.7e-05
G5,C(C(C)C(C(C(C)=O)=O)O)=O,4,2,0,2,29,9.499999999999999e-05
G5,C(C(C(C)=O)=O)(C(C)CO)=O,2,2,0,2,29,9.499999999999999e-05
G5,C(C(C)C(C(C(C)O)=O)O)=O,8,1,0,1,25,4.7e-05
G5,C(C(C(C)O)=O)(C(CO)C)=O,4,1,0,1,25,4.7e-05
G5,C(C(C=O)C(C=O)C)=O,2,2,0,2,29,9.499999999999999e-05
G5,C(C)(CC(C(CC(C)=O)=O)=O)=O,1,2,0,2,29,9.499999999999999e-05
G5,C(C(C(C)CC(C=O)=O)=O)(C)=O,2,1,0,1,49,4.7e-05
G5,C(C(C)C(C(C)=O)C(C=O)=O)=O,4,1,0,1,26,4.7e-05
G5,C(C(C)CC(CC(C=O)=O)=O)=O,2,1,0,1,49,4.7e-05
G5,C(C(C(C=O)=O)C(C=O)C)=O,4,2,0,2,29,9.499999999999999e-05
G5,C(CC(C(C)=O)C(C(C)=O)=O)=O,2,3,0,3,29,0.00014199999999999998
G5,C(CC=O)(C(C(C(C)=O)=O)C)=O,2,1,0,1,14,4.7e-05
G5,C(C(C)C(C=O)C(C(C)=O)=O)=O,4,1,0,1,14,4.7e-05
G5,C(C(C)CC(C(CC=O)=O)=O)=O,2,1,0,1,49,4.7e-05
G5,C(C)(C(C(C(C)=O)=O)C)=O,2,2,0,2,29,9.499999999999999e-05
G5,C(C(C)CC(C(C)=O)=O)=O,2,2,0,2,29,9.499999999999999e-05
G5,C(CC(C(C(C)=O)=O)C)=O,2,2,0,2,29,9.499999999999999e-05
G5,C(CC(C)=O)(CC(C)=O)=O,1,1,0,1,49,4.7e-05
G5,C(C(C)CC(CC=O)=O)=O,2,2,0,2,29,9.499999999999999e-05
G5,C(C(C)C(C=O)C(C)=O)=O,4,2,0,2,29,9.499999999999999e-05
G5,C(C(C)=O)(C1COC(C1)O)=O,4,2,0,2,49,9.499999999999999e-05
G5,C(C(C)C1C(COC1O)=O)=O,8,2,0,2,49,9.499999999999999e-05
G5,C(C(C)C1C(CC(O1)O)=O)=O,8,2,0,2,49,9.499999999999999e-05
G5,C(CC(C(C)=O)=O)=CC(CO)=O,2,2,0,2,29,9.499999999999999e-05
G5,C(C(C=CC=O)CC(CO)=O)=O,4,3,0,3,29,0.00014199999999999998
G5,C(C(C(C(C)=O)=O)CO)=CC=O,4,1,0,1,49,4.7e-05
G5,C(C(C)C(C(C=CC=O)=O)O)=O,8,1,0,1,49,4.7e-05
G5,C(C(C=CC=O)=O)(C(C)CO)=O,4,1,0,1,49,4.7e-05
G5,C(C(C=C)CC(CO)=O)=O,2,3,0,3,29,0.00014199999999999998
G5,C=CC(C(C(C)=O)=O)CO,2,2,0,2,29,9.499999999999999e-05
G5,C(C(C)C(C(C=C)=O)O)=O,4,2,0,2,29,9.499999999999999e-05
G5,C=CC(C(C(C)CO)=O)=O,2,2,0,2,29,9.499999999999999e-05
G5,C(CC)(CC(CO)=O)=O,1,1,0,1,11,4.7e-05
G5,C(CC)(C(C(C)=O)O)=O,2,1,0,1,11,4.7e-05
G5,C(CC1C(COC1)=O)(CO)=O,2,1,0,1,10,4.7e-05
G5,C(C(C)=O)(C1COCC1O)=O,4,1,0,1,10,4.7e-05
G5,C1(COCC1C(C(C)=O)O)=O,4,1,0,1,10,4.7e-05
G5,C(C(C)C1C(C(CO1)O)=O)=O,8,1,0,1,10,4.7e-05
G5,C1(C(CCO1)CC(CO)=O)=O,2,1,0,1,34,4.7e-05
G5,C(C(C)=O)(C1C(O)OCC1)=O,4,2,0,2,34,9.499999999999999e-05
G5,C1(C(CCO1)C(C(C)=O)O)=O,4,1,0,1,34,4.7e-05
G5,C(C(C)C1C(C(O)OC1)=O)=O,8,2,0,2,49,9.499999999999999e-05
G5,C(CCC(C(C(C=O)=O)O)=O)=O,2,1,0,1,43,4.7e-05
G5,C(C(CCC(C(C=O)=O)=O)O)=O,2,1,0,1,5,4.7e-05
G5,C(C(C=C)C(C=O)C(C=O)O)=O,8,1,0,1,7,4.7e-05
G5,C(C(CC(CC(C=C)=O)=O)O)=O,2,1,0,1,7,4.7e-05
G5,C(C(CCC(C(C=C)=O)=O)O)=O,2,1,0,1,7,4.7e-05
G5,C(C(C(C=O)CC(C)=O)O)=O,4,2,0,2,43,9.6e-05
G5,C(CC)(C(C=O)C(C=O)O)=O,4,1,0,1,43,4.7e-05
G5,C1(C(CCC1(C=O)O)CC=O)=O,4,1,0,1,29,4.7e-05
G5,C(C(CO)CC=O)(C(C)O)=O,4,1,0,1,4,4.7e-05
G5,C(C)(C(CC(C=O)CC=O)O)=O,4,2,0,2,29,9.499999999999999e-05
G5,C(C(C)(CC(C=O)CC=O)O)=O,4,2,0,2,4,9.499999999999999e-05
G5,C(C(C)CC=O)(C(C=O)(C)O)=O,4,1,0,1,11,4.7e-05
G5,C(C(C)CC=O)(CC=O)=O,2,1,0,1,45,4.7e-05
G5,C(CC(C(C(C)O)=O)CC=O)=O,2,1,0,1,4,4.7e-05
G5,C(CC(C(C=O)=O)CCO)=O,2,2,0,2,0,9.499999999999999e-05
G5,C(CC(C(C=O)=O)CC(C)O)=O,4,1,0,1,4,4.7e-05
G5,C(CO)(C(CC(C)O)CC=O)=O,4,1,0,1,4,4.7e-05
G5,C(C(CCO)CC=O)(C(C)O)=O,4,1,0,1,4,4.7e-05
G5,C(C(CC(C)(CO)O)CC=O)=O,4,2,0,2,4,9.499999999999999e-05
G5,C(C(C)CC=O)(C(CO)(C)O)=O,4,1,0,1,4,4.7e-05
G5,C(C(CC(C)O)CC=O)=O,4,2,0,2,11,9.499999999999999e-05
G5,C(C(C)CC=O)(C(C)O)=O,4,1,0,1,4,4.7e-05
G5,C(C(C(CCC=O)=O)(C)O)=O,2,1,0,1,45,4.7e-05
G5,C(CCC=O)(C(CO)(C)O)=O,2,1,0,1,4,4.7e-05
G5,C(C(C(CC)=O)=O)=O,1,1,0,1,0,4.7e-05
G5,C(CC(C(C(CC)=O)=O)O)=O,2,1,0,1,4,4.7e-05
G5,C(C(C(C)=O)=O)(CC)=O,1,2,0,2,29,9.499999999999999e-05
G5,C(C)(C(C(C(CC)=O)=O)O)=O,2,1,0,1,0,4.7e-05
G5,C(C(C(C)O)=O)(CC)=O,2,1,0,1,4,4.7e-05
G5,C(C(C=CC=O)CC=O)=O,4,3,0,3,29,0.00014199999999999998
G5,C(C(C=CC=O)=O)(CC)=O,2,2,0,2,29,9.499999999999999e-05
G5,C(C(C=C)CC=O)=O,2,3,0,3,29,0.00014199999999999998
G5,C=CC(C(CC)=O)=O,1,2,0,2,29,9.499999999999999e-05
G5,C(CC(C(C)=O)C(C=O)O)=O,4,2,0,2,45,9.6e-05
G5,C(CCC(C)=O)=O,1,1,0,1,11,4.7e-05
G5,C(CC(CC)=O)=O,1,1,0,1,11,4.7e-05
G5,C(CCC(CCC(C=O)=O)=O)=O,1,1,0,1,7,4.7e-05
G5,C(C(C(CC(C)=O)=O)CC=O)=O,2,3,0,3,29,0.00014199999999999998
G5,C(C)(CC(C(C(CC)=O)=O)=O)=O,1,1,0,1,26,4.7e-05
G5,C(C(C(CCC=O)=O)CC=O)=O,2,3,0,3,29,0.00014199999999999998
G5,C(CCC(C(C(CC)=O)=O)=O)=O,1,1,0,1,17,4.7e-05
G5,C(C(CC(C(C)=O)=O)=O)(CC)=O,1,1,0,1,24,4.7e-05
G5,C(C(C(C=CCO)=O)CC=O)=O,4,2,0,2,29,9.499999999999999e-05
G5,C(C)(CC(C(C=CCO)=O)=O)=O,2,1,0,1,55,4.7e-05
G5,C(CO)=CC(C(C(CC)=O)=O)=O,2,1,0,1,55,4.7e-05
G5,C(CC(C(C=CC=O)=O)CO)=O,4,1,0,1,32,4.7e-05
G5,C(C(C(C(CC)=O)=O)O)=CC=O,4,1,0,1,32,4.7e-05
G5,C=CC(C(C(C(CC)=O)=O)O)=O,2,1,0,1,32,4.7e-05
G5,C(CC(C(C=C)=O)C(C=O)O)=O,4,1,0,1,27,4.7e-05
G5,C(C(C)C(C(O)=O)O)(CC=O)=O,4,1,0,1,25,4.7e-05
G5,C(CC1C(CC(C1CO)=O)=O)=O,4,4,0,4,30,0.00019099999999999998
G5,C(CC1C(C(C(C1)CO)=O)=O)=O,4,1,0,1,47,4.7e-05
G5,C(CC1C(C(CC1CO)=O)=O)=O,4,2,0,2,29,9.499999999999999e-05
G5,C(C)(C1C(C(CO1)CC=O)=O)=O,4,1,0,1,17,4.7e-05
G5,C(CC1C(C(CO1)CC=O)=O)=O,4,1,0,1,4,4.7e-05
G5,C(C)(C1CC(C(O1)=O)CC=O)=O,4,1,0,1,22,4.7e-05
G5,C(CC1CC(C(O1)=O)CC=O)=O,4,1,0,1,13,4.7e-05
G5,C1(COC(CCC1CC=O)=O)=O,2,1,0,1,4,4.7e-05
G5,C1(C(CCOC(C1)=O)CC=O)=O,2,1,0,1,19,4.7e-05
G5,C(CC1C(COCC(C1)=O)=O)=O,2,3,0,3,32,0.000144
G5,C(CC1C(C(CCOC1)=O)=O)=O,2,1,0,1,36,4.7e-05
G5,C(CC1C(C(COCC1)=O)=O)=O,2,1,0,1,36,4.7e-05
G5,C1(COCC(C(C1)=O)CC=O)=O,2,1,0,1,36,4.7e-05
G5,C1(CC(C(OCC1)=O)CC=O)=O,2,2,0,2,23,9.6e-05
G5,C1(COC(C(CC1)CC=O)=O)=O,2,1,0,1,29,4.7e-05
G5,C1(COCC1CC=O)=O,2,1,0,1,10,4.7e-05
G5,C(CC1C(OCC1)=O)=O,2,1,0,1,34,4.7e-05
G5,C1(COC(C1CC=O)CC=O)=O,4,1,0,1,9,4.7e-05
G5,C1(C(C(C)OC1C=O)CC=O)=O,8,1,0,1,29,4.7e-05
G5,C1(CC(C(CC=O)=O)OCC1)=O,2,1,0,1,30,4.7e-05
G5,C(C1CCC(CO1)=O)(CC=O)=O,2,1,0,1,7,4.7e-05
G5,C1(C(C=C(CO)C1CC=O)O)=O,4,1,0,1,2,4.7e-05
G5,C(CC1C(C(C(C1=C)O)O)=O)=O,8,1,0,1,47,4.7e-05
G5,C(CC=O)(C1C=CC(C1O)O)=O,8,2,0,2,29,9.499999999999999e-05
G5,C1(C(C=CC(CO)O1)CC=O)=O,4,1,0,1,46,4.7e-05
G5,C1(C(CO)OC=CC1CC=O)=O,4,2,0,2,29,9.499999999999999e-05
G5,C1(C(C=CC(CO1)O)CC=O)=O,4,1,0,1,41,4.7e-05
G5,C1(C(COC=CC1CC=O)O)=O,4,2,0,2,29,9.499999999999999e-05
G5,C(CC1C(C(O)OCC=C1)=O)=O,4,1,0,1,19,4.7e-05
G5,C(CC1C(COC(C=C1)O)=O)=O,4,1,0,1,38,4.7e-05
G5,C(CC(C1C=CC(CO)O1)=O)=O,4,1,0,1,41,4.7e-05
G5,C(CC=O)(CC1OCC(C=1)O)=O,2,1,0,1,36,4.7e-05
G5,C(CCC(C1OCC(C=1)O)=O)=O,2,1,0,1,36,4.7e-05
G5,C(CC(CC1(C=CCO1)O)=O)=O,2,1,0,1,39,4.7e-05
G5,C(CCC(C1(C=CCO1)O)=O)=O,2,1,0,1,39,4.7e-05
G5,C(CC(CC1C=CC(O)O1)=O)=O,4,2,0,2,29,9.499999999999999e-05
G5,C(CCC(C1C=CC(O1)O)=O)=O,4,2,0,2,29,9.499999999999999e-05
G5,C(CC1C(C=CO1)O)(CC=O)=O,4,2,0,2,29,9.499999999999999e-05
G5,C(CCC(C1C(C=CO1)O)=O)=O,4,2,0,2,29,9.499999999999999e-05
G5,C(CC(C1C=CC(CO1)O)=O)=O,4,1,0,1,30,4.7e-05
G5,C(CC)(C(C(C(CO)O)=O)O)=O,4,1,0,1,2,4.7e-05
G5,C(C(C(O)=O)C)=O,2,1,0,1,25,4.7e-05
G5,C(C(C(CCO)=O)CO)(O)=O,2,1,0,1,33,4.7e-05
G5,C(CC=O)(C(C(O)=O)C)=O,2,1,0,1,25,4.7e-05
G5,C(C(C(O)=O)CC(C)=O)=O,2,2,0,2,29,9.499999999999999e-05
G5,C(C(C(O)=O)CCC=O)=O,2,3,0,3,29,0.000143
G5,C(C(C=O)C=CCO)(O)=O,4,2,0,2,29,9.499999999999999e-05
G5,C(C(C(C(CO)O)=O)C)(O)=O,4,1,0,1,29,4.7e-05
G5,C(C(C(CC=O)=O)(C)O)=O,2,2,0,2,29,9.499999999999999e-05
G5,C(C(C(CC(CO)=O)=O)(C)O)=O,2,3,0,3,29,0.000153
G5,C1(C(CCC(CO)O1)=O)=O,2,2,0,2,29,9.499999999999999e-05
G5,C1(C(CCC(CO1)O)=O)=O,2,2,0,2,29,9.499999999999999e-05
G5,C1(C(C(O)OCCC1)=O)=O,2,2,0,2,18,9.499999999999999e-05
G5,C=CC(C(C(C)=O)=O)=O,1,2,0,2,29,9.499999999999999e-05
G5,C=CCC(C(C=O)=O)=O,1,2,0,2,29,9.499999999999999e-05
G5,C1(C(COC1C(CO)O)=O)=O,4,1,0,1,5,4.7e-05
G5,C1(C(COC(CO)C1O)=O)=O,4,1,0,1,5,4.7e-05
G5,C1(C(COCC(C1O)O)=O)=O,4,1,0,1,5,4.7e-05
G5,C(C)(C(CO)OCC=O)=O,2,1,0,1,2,4.7e-05
G5,C(C)(C(COCC=O)O)=O,2,1,0,1,29,4.7e-05
G5,C(CO)(CCOCC=O)=O,1,1,0,1,2,4.7e-05
G5,C(CC(C)(OCC=O)O)=O,2,1,0,1,29,4.7e-05
G5,C(CCC(OCC=O)O)=O,2,1,0,1,29,4.7e-05
G5,C1(CC(C=O)OCC1)=O,2,2,0,2,29,9.499999999999999e-05
G5,C(C1CCC(CO1)=O)=O,2,2,0,2,29,9.499999999999999e-05
G5,C(CC1OCC(C=1)O)=O,2,2,0,2,29,9.499999999999999e-05
G5,C1C(COC=1C(C)=O)O,2,2,0,2,29,9.499999999999999e-05
G5,C(CC1(C=CCO1)O)=O,2,3,0,3,29,0.00014199999999999998
G5,C(C)(C1(C=CCO1)O)=O,2,2,0,2,29,9.499999999999999e-05
G5,C(CC1C=CC(O)O1)=O,4,3,0,3,29,0.00014199999999999998
G5,C(C)(C1C=CC(O1)O)=O,4,2,0,2,29,9.499999999999999e-05
G5,C(CC1C(C=CO1)O)=O,4,2,0,2,29,9.499999999999999e-05
G5,C(C)(C1C(C=CO1)O)=O,4,2,0,2,29,9.499999999999999e-05
G5,C(C1C=CC(CO1)O)=O,4,2,0,2,29,9.499999999999999e-05
G5,C(C)(C1(C(CCO1)O)O)=O,4,2,0,2,29,9.499999999999999e-05
G5,C(C)(C1CC(C(O1)O)O)=O,8,2,0,2,29,9.499999999999999e-05
G5,C(C1C(CC(CO1)O)O)=O,8,1,0,1,29,4.7e-05
G5,C(CCCC(C(C(C)=O)O)=O)=O,2,3,0,3,27,0.000144
G5,C(CC(C(C(C)=O)O)CC=O)=O,2,3,0,3,4,0.000144
G5,C(C1(CO)CC(C(C1)=O)=O)=O,1,2,0,2,2,9.499999999999999e-05
G5,C(C1(C(C)O)CC(C(C1)=O)=O)=O,2,2,0,2,29,9.499999999999999e-05
G5,C1(CC(C(C1CO)=O)=O)=O,2,1,0,1,2,4.7e-05
G5,C(C1COCC1(C=O)O)=O,4,1,0,1,36,4.7e-05
G5,C1(C(C)C(C=O)(CO1)O)=O,4,1,0,1,41,4.7e-05
G5,C(C1C(COC1(C)O)=O)=O,4,2,0,2,1,9.499999999999999e-05
G5,C1(C2C(C(C(C2)=O)O1)O)=O,8,4,0,4,29,0.00018999999999999998
G5,C(C1C(CC(CO)CC1=O)=O)=O,1,2,0,2,29,9.499999999999999e-05
G5,C1(CC(C=O)CC(C1CO)=O)=O,1,2,0,2,43,9.499999999999999e-05
G5,C1(CCCC(C1C(C=O)O)=O)=O,2,2,0,2,7,9.499999999999999e-05
G5,C(C1(C(O)=O)CC(C(C1)=O)=O)=O,1,1,0,1,17,4.7e-05
G5,C1(C(C(CCO)=O)C(CO1)O)=O,4,2,0,2,29,9.499999999999999e-05
G5,C(C(C(CCO)=O)C(C)O)(O)=O,4,1,0,1,4,4.7e-05
G5,C(CCO)(C1C(COC1)=O)=O,2,1,0,1,10,4.7e-05
G5,C(C(C)O)(C(C(C)=O)C(C)O)=O,8,1,0,1,11,4.7e-05
G5,C(CC)(C(C(C)=O)(C(C)O)O)=O,4,1,0,1,11,4.7e-05
G5,C(C(C(CC(C)O)=O)CO)(O)=O,4,1,0,1,33,4.7e-05
G5,C(CC(C)O)(C1C(COC1)=O)=O,4,1,0,1,10,4.7e-05
G5,C(C(C(CC)=O)(C(C)O)O)=O,4,1,0,1,11,4.7e-05
G5,C(CC)(C(C(C=O)=O)(CO)O)=O,2,1,0,1,11,4.7e-05
G5,C(C(C=O)C1C(OCC1O)=O)=O,4,1,0,1,8,4.7e-05
G5,C(C(C=O)C1(C(COC1)=O)O)=O,2,1,0,1,10,4.7e-05
G5,C1(COCC1C(C(CO)=O)=O)=O,2,1,0,1,10,4.7e-05
G5,C1(C(C(CC=O)=O)C(CO1)O)=O,4,3,0,3,29,0.00014199999999999998
G5,C(CC=O)(C1C(COC1)=O)=O,2,2,0,2,29,9.499999999999999e-05
G5,C(C(C(CO)=O)C(C(O)=O)=O)=O,2,1,0,1,33,4.7e-05
G5,C(CC)(C(C=O)(C(CO)=O)O)=O,2,1,0,1,11,4.7e-05
G5,C(C(C(C)=O)(CC(C)=O)O)(O)=O,2,1,0,1,11,4.7e-05
G5,C(C(C)O)(C(C(O)=O)C(C)=O)=O,4,1,0,1,11,4.7e-05
G5,C(CC)(C(C(O)=O)(C(C)=O)O)=O,2,1,0,1,11,4.7e-05
G5,C1(C(C(C(O)=O)=O)C(CO1)O)=O,4,1,0,1,33,4.7e-05
G5,C1(COCC1C(C(O)=O)=O)=O,2,1,0,1,10,4.7e-05
G5,C(C(C=O)(C(CC)=O)O)(O)=O,2,1,0,1,11,4.7e-05
G5,C(C(CC(C)=O)C(C=O)O)(O)=O,4,1,0,1,11,4.7e-05
G5,C(CC)(C(C(O)=O)C(C=O)O)=O,4,1,0,1,11,4.7e-05
G5,C(C)(CC(C1C(COC1)=O)=O)=O,2,1,0,1,10,4.7e-05
G5,C1(COCC1C(C(C=C)=O)=O)=O,2,1,0,1,10,4.7e-05
G5,C(C(C=C)C1C(OCC1O)=O)=O,8,1,0,1,8,4.7e-05
G5,C(C(C=C)C1(C(COC1)=O)O)=O,4,1,0,1,10,4.7e-05
G5,C1(COCC1C(C=CC=O)=O)=O,4,1,0,1,10,4.7e-05
G5,C1(C(C(CO1)O)(CC(C)=O)O)=O,4,1,0,1,40,4.7e-05
G5,C1(C(C(CC)=O)(C(CO1)O)O)=O,4,1,0,1,40,4.7e-05
G5,C1(C(C(CO1)O)CC(C)=O)=O,4,1,0,1,8,4.7e-05
G5,C1(C(C(CC)=O)C(CO1)O)=O,4,1,0,1,8,4.7e-05
G5,C(C(C(CC)=O)(CO)O)(O)=O,2,1,0,1,11,4.7e-05
G5,C(C(C(C(C)O)=O)CO)(O)=O,4,1,0,1,11,4.7e-05
G5,C(C(C(CC)=O)(C(C)O)O)(O)=O,4,1,0,1,4,4.7e-05
G5,C(C(C(C(C)O)=O)C(C)O)(O)=O,8,1,0,1,4,4.7e-05
G5,C(CC1(C(COC1)=O)O)(C)=O,2,1,0,1,10,4.7e-05
G5,C(CC)(C1(C(COC1)=O)O)=O,2,1,0,1,10,4.7e-05
G5,C(C(C)O)(C1C(COC1)=O)=O,4,1,0,1,10,4.7e-05
G5,C1(C(C(CO1)O)(CC=O)O)=O,4,2,0,2,29,9.499999999999999e-05
G5,C1(C(C(CO1)O)CC=O)=O,4,2,0,2,29,9.499999999999999e-05
G5,C1(COCC1(CC=O)O)=O,2,2,0,2,29,9.499999999999999e-05
G5,C(C(C(CC)=O)(C(CO)O)O)=O,4,1,0,1,11,4.7e-05
G5,C1(C(C(CO1)O)C(C=O)CO)=O,8,1,0,1,8,4.7e-05
G5,C(C(CO)C1(C(COC1)=O)O)=O,4,1,0,1,10,4.7e-05
G5,C(C(CO)(CC(C(C)O)=O)O)=O,4,1,0,1,28,4.7e-05
G5,C1(C(C(CO1)O)CC(CO)=O)=O,4,2,0,2,29,9.499999999999999e-05
G5,C(C(C(CC)=O)(CO)O)=O,2,1,0,1,11,4.7e-05
G5,C(CCO)(C1(C(COC1)=O)O)=O,2,2,0,2,29,9.499999999999999e-05
G5,C(C(CO)O)(C1C(COC1)=O)=O,4,2,0,2,29,9.499999999999999e-05
G5,C(CC1(C(COC1)=O)O)(CO)=O,2,1,0,1,10,4.7e-05
G5,C(C(CO)(C1C(COC1)=O)O)=O,4,1,0,1,10,4.7e-05
G5,C1(C(CCO1)C(C=O)(CO)O)=O,4,1,0,1,34,4.7e-05
G5,C1(COCC1C(C(C)=O)=O)=O,2,2,0,2,29,9.499999999999999e-05
G5,C(CC)(C(C=O)(C(C)=O)O)=O,2,1,0,1,11,4.7e-05
G5,C1(COCC1C(C=O)=O)=O,2,2,0,2,29,9.499999999999999e-05
G5,C(C(C)O)(C(C(C)=O)CO)=O,4,1,0,1,11,4.7e-05
G5,C(CC)(C(C(C)=O)(CO)O)=O,2,1,0,1,11,4.7e-05
G5,C(C(C=O)C(OCC(C)=O)O)=O,2,1,0,1,35,4.7e-05
G5,C(C(C=O)COCC(CO)=O)=O,1,1,0,1,36,4.7e-05
G5,C(C(C=O)C(C)(OCC=O)O)=O,2,1,0,1,1,4.7e-05
G5,C(C1C(C(C(CO)O)OC1)=O)=O,8,2,0,2,29,9.499999999999999e-05
G5,C(C1C(C(C(CO)OC1)O)=O)=O,8,1,0,1,2,4.7e-05
G5,C(C1C(C(COC1CO)O)=O)=O,8,1,0,1,2,4.7e-05
G5,C(C1C(C(C(COC1)O)O)=O)=O,8,1,0,1,36,4.7e-05
G5,C(C1C(C(COCC1O)O)=O)=O,8,1,0,1,36,4.7e-05
G5,C(C1C(C(CCOC1O)O)=O)=O,8,2,0,2,2,9.499999999999999e-05
G5,C(C1C(COC1C(C)=O)=O)=O,4,3,0,3,29,0.00014199999999999998
G5,C(CC1C(C=O)C(CO1)=O)=O,4,2,0,2,29,9.499999999999999e-05
G5,C(C1C(CCC(OC1)=O)=O)=O,2,2,0,2,29,9.499999999999999e-05
G5,C(C1C(CC(COC1)=O)=O)=O,2,2,0,2,29,9.499999999999999e-05
G5,C1(CCOCC(C1C=O)=O)=O,2,3,0,3,29,0.00014199999999999998
G5,C(C1C(COC1)=O)=O,2,2,0,2,29,9.499999999999999e-05
G5,C(C1C(C(CO)OC1CO)=O)=O,8,1,0,1,2,4.7e-05
G5,C(CC1C(C(C=O)CO1)=O)=O,4,2,0,2,29,9.499999999999999e-05
G5,C1(C(C)OC(C=O)C1C=O)=O,8,2,0,2,29,9.499999999999999e-05
G5,C(C1C(C(CO)OCC1O)=O)=O,8,1,0,1,2,4.7e-05
G5,C(C1C(CCOC1(CO)O)=O)=O,4,3,0,3,29,0.00014199999999999998
G5,C1(C(C=O)C(C(C(C)=O)O1)O)=O,8,3,0,3,29,0.00014199999999999998
G5,C1(C(C=O)C(C(CC=O)O1)O)=O,8,3,0,3,29,0.00014199999999999998
G5,C(C1C(CC(OC1CO)=O)=O)=O,4,1,0,1,2,4.7e-05
G5,C1(C(C=O)C(CC(CO)O1)=O)=O,4,2,0,2,29,9.499999999999999e-05
G5,C(C1C(CC(OCC1O)=O)=O)=O,4,1,0,1,2,4.7e-05
G5,C1(C(C=O)C(CC(CO1)O)=O)=O,4,2,0,2,29,9.499999999999999e-05
G5,C1(CC(C(OCC1C=O)=O)O)=O,4,2,0,2,29,9.499999999999999e-05
G5,C1(C(C=O)C(C(CCO1)=O)O)=O,4,3,0,3,29,0.00014199999999999998
G5,C1(CCOC(C(C1C=O)O)=O)=O,4,1,0,1,2,4.7e-05
G5,C1(C(C=O)C(CC(CO1)=O)O)=O,4,3,0,3,29,0.00014199999999999998
G5,C(C1C(C=COC1CO)=O)=O,4,2,0,2,29,9.499999999999999e-05
G5,C(C1C(C=COCC1O)=O)=O,4,2,0,2,29,9.499999999999999e-05
G5,C(C1C(C=CCOC1O)=O)=O,4,2,0,2,29,9.499999999999999e-05
G5,C(C1C(C=CC(O)OC1)=O)=O,4,3,0,3,29,0.00014199999999999998
G5,C(C(C=O)C1OCC(C=1)O)=O,2,2,0,2,29,9.499999999999999e-05
G5,C(C(C=O)C1(C=CCO1)O)=O,2,2,0,2,29,9.499999999999999e-05
G5,C(C(C=O)C1C=CC(O)O1)=O,4,2,0,2,29,9.499999999999999e-05
G5,C(C(C=O)C1C(C=CO1)O)=O,4,2,0,2,29,9.499999999999999e-05
G5,C(C1C(COC1(CCO)O)=O)=O,4,2,0,2,2,9.499999999999999e-05
G5,C(C1C(C(CCO)OC1O)=O)=O,8,2,0,2,2,9.499999999999999e-05
G5,C(C(C=O)C1(C(CCO1)O)O)=O,4,2,0,2,2,9.499999999999999e-05
G5,C(C(C=O)C1CC(C(O)O1)O)=O,8,2,0,2,43,9.499999999999999e-05
G5,C(C1C(C(C)OC(C1O)O)=O)=O,16,2,0,2,24,9.499999999999999e-05
G5,C(C1C(COC(CC1O)O)=O)=O,8,2,0,2,38,9.499999999999999e-05
G5,C(C(C=O)C1C(CC(O1)=O)O)=O,4,2,0,2,29,9.499999999999999e-05
G5,C1(C(CO)CC(C(C=O)O1)=O)=O,4,2,0,2,29,9.499999999999999e-05
G5,C(C(C=O)(CC(C(C)O)=O)O)=O,2,1,0,1,1,4.7e-05
G5,C(C(C=O)C(C(CC=O)=O)=O)=O,1,1,0,1,23,4.7e-05
G5,C(C(C=O)C(CC(C=O)=O)=O)=O,1,1,0,1,1,4.7e-05
G5,C1(C(C(CO1)O)CC(C=O)=O)=O,4,1,0,1,8,4.7e-05
G5,C(C(C=O)(C(CC)=O)O)=O,1,1,0,1,11,4.7e-05
G5,C(CC=O)(C1(C(COC1)=O)O)=O,2,1,0,1,10,4.7e-05
G5,C(C(C=O)O)(C1C(COC1)=O)=O,4,1,0,1,10,4.7e-05
G5,C1(COCC1(CC(C=O)=O)O)=O,2,1,0,1,10,4.7e-05
G5,C(C(C=O)(C1C(COC1)=O)O)=O,2,1,0,1,10,4.7e-05
G5,C(C(C=O)(C1C(OCC1)=O)O)=O,2,1,0,1,34,4.7e-05
G5,C(C(C)C(C(C=O)=O)(CO)O)=O,4,2,0,2,29,0.000106
G5,C(C(C)C1(C(OCC1O)=O)O)=O,8,1,0,1,49,4.7e-05
G5,C1(C(C(CO1)O)C(C=O)C)=O,8,1,0,1,8,4.7e-05
G5,C(C(C)C1(C(COC1)=O)O)=O,4,1,0,1,10,4.7e-05
G5,C(CC)(C(C=O)(C(C=O)O)O)=O,4,1,0,1,11,4.7e-05
G5,C(C)(C1C(C(CO)CC1=O)=O)=O,4,1,0,1,47,4.7e-05
G5,C(C)(C1C(COC1C(C)=O)=O)=O,4,1,0,1,17,4.7e-05
G5,C(CC1C(C(C)=O)C(CO1)=O)=O,4,1,0,1,9,4.7e-05
G5,C(C)(C1C(CCC(OC1)=O)=O)=O,2,1,0,1,4,4.7e-05
G5,C(C)(C1C(CC(COC1)=O)=O)=O,2,1,0,1,36,4.7e-05
G5,C(C)(C1C(CCOCC1=O)=O)=O,2,1,0,1,36,4.7e-05
G5,C(C)(C1C(COC1)=O)=O,2,1,0,1,4,4.7e-05
G5,C(CC1C(C(C(C)=O)CO1)=O)=O,4,1,0,1,9,4.7e-05
G5,C(C)(C1C(C(C)OC1C=O)=O)=O,8,1,0,1,29,4.7e-05
G5,C(C)(C1C(C(CO)=CC1O)=O)=O,4,1,0,1,4,4.7e-05
G5,C(C)(C1C(C(C(C1O)O)=C)=O)=O,8,1,0,1,4,4.7e-05
G5,C(C)(C1C(C=COC1CO)=O)=O,4,1,0,1,9,4.7e-05
G5,C(C)(C1C(C=COCC1O)=O)=O,4,1,0,1,38,4.7e-05
G5,C(C)(C1C(C=CCOC1O)=O)=O,4,1,0,1,19,4.7e-05
G5,C(C)(C1C(C=CC(O)OC1)=O)=O,4,1,0,1,38,4.7e-05
G5,C(C(C(C)=O)C1OCC(C=1)O)=O,4,1,0,1,36,4.7e-05
G5,C(C(C(C)=O)C1(C=CCO1)O)=O,4,1,0,1,39,4.7e-05
G5,C(C(C(C)=O)C1C=CC(O)O1)=O,8,1,0,1,43,4.7e-05
G5,C(C(C(C)=O)C1C(C=CO1)O)=O,8,1,0,1,36,4.7e-05
G5,C(CC)(C(C(CO)=O)(CO)O)=O,2,1,0,1,11,4.7e-05
G5,C1(C(C(CC1C(C)=O)=O)O)=O,4,1,0,1,25,4.7e-05
G5,C1(CC(CC1(C(C)=O)O)=O)=O,2,1,0,1,25,4.7e-05
G5,C(C)(C1(CC(C(C1)=O)=O)O)=O,1,1,0,1,25,4.7e-05
G5,C(C1CC(CC1(C=O)O)O)=O,8,1,0,1,21,4.7e-05
G5,C1(C(C)C(C=O)(CC1O)O)=O,8,1,0,1,49,4.7e-05
G5,C(CC1(C(CC(C1C)=O)=O)O)=O,4,1,0,1,45,4.7e-05
G5,C(C1C(CC(C1)O)=O)(O)=O,4,1,0,1,9,4.7e-05
G5,C1(COC(C=O)(C1C)O)=O,4,1,0,1,2,4.7e-05
G5,C(C1CCOC1(C=O)O)=O,4,2,0,2,30,9.499999999999999e-05
G5,C(C1C(COC(C1)O)=O)=O,4,2,0,2,37,9.499999999999999e-05
G5,C1(CC2CC(C1O2)=O)=O,1,1,0,1,23,4.7e-05
G5,C(CC(C(C)=O)C(C(O)=O)=O)=O,2,1,0,1,45,4.7e-05
G5,C(C(C)C(C=O)(C)O)(CC=O)=O,4,1,0,1,11,4.7e-05
G5,C(CC(C(C)=O)O)(C(C=O)C)=O,4,1,0,1,11,4.7e-05
G5,C(C)(C(C(C(C)O)=O)CC=O)=O,4,1,0,1,45,4.7e-05
G5,C(C)(C(C(CC)=O)(CC=O)O)=O,2,1,0,1,45,4.7e-05
G5,C(C(C)(CC(C(C=O)C)=O)O)=O,4,1,0,1,11,4.7e-05
G5,C(C(C(CCO)=O)C)(O)=O,2,1,0,1,25,4.7e-05
G5,C(C(C(CCO)=O)CCO)(O)=O,2,1,0,1,29,4.7e-05
G5,C(CCO)(C(C(C=O)=O)C)=O,2,1,0,1,18,4.7e-05
G5,C(CCO)(C(C(CO)=O)C)=O,2,1,0,1,18,4.7e-05
G5,C(C(C(CCO)=O)CCO)=O,2,1,0,1,29,4.7e-05
G5,C(CCO)(C(C=O)CC(O)=O)=O,2,1,0,1,29,4.7e-05
G5,C(C(C(CCO)=O)C)=O,2,1,0,1,11,4.7e-05
G5,C(CCO)(C(C(O)=O)CC=O)=O,2,1,0,1,29,4.7e-05
G5,C(CCO)(C1C(CCO1)=O)=O,2,1,0,1,34,4.7e-05
G5,C(C(CC(C)O)C(C=O)(C)O)=O,8,1,0,1,11,4.7e-05
G5,C(C(C)C(C=O)(C)O)(C(C)O)=O,8,1,0,1,11,4.7e-05
G5,C(C(C(CC(C)(CO)O)=O)C)=O,4,1,0,1,11,4.7e-05
G5,C(C(C(CC(C)O)=O)C)(O)=O,4,1,0,1,25,4.7e-05
G5,C(CC(C)O)(C(C(C=O)=O)C)=O,4,1,0,1,25,4.7e-05
G5,C(CC(C)O)(C(C(CO)=O)C)=O,4,1,0,1,25,4.7e-05
G5,C(C(C(CC(C)O)=O)CCO)=O,4,1,0,1,29,4.7e-05
G5,C(C(C(CC(C)O)=O)C)=O,4,1,0,1,11,4.7e-05
G5,C(CC(C)O)(C1C(CCO1)=O)=O,4,1,0,1,34,4.7e-05
G5,C(C(C(CC(C)O)=O)(C)O)(O)=O,4,1,0,1,25,4.7e-05
G5,C(C(C(C(C(C)O)O)=O)C)(O)=O,8,1,0,1,25,4.7e-05
G5,C(C(C)(CC(C(C)O)=O)O)(O)=O,4,1,0,1,25,4.7e-05
G5,C(C(C(CC(C)O)=O)(C)O)=O,4,1,0,1,11,4.7e-05
G5,C(C(C(C(C(C)O)O)=O)C)=O,8,1,0,1,11,4.7e-05
G5,C(C(C)(CC(C(C)O)=O)O)=O,4,1,0,1,11,4.7e-05
G5,C(C(C(CC(CO)O)=O)C)(O)=O,4,1,0,1,25,4.7e-05
G5,C(C(C(CC(CO)O)=O)C)=O,4,1,0,1,11,4.7e-05
G5,C(C(C(C(CCO)O)=O)C)(O)=O,4,1,0,1,25,4.7e-05
G5,C(C(C(CCCO)=O)(C)O)(O)=O,2,1,0,1,25,4.7e-05
G5,C(C(C(C(C(O)=O)O)=O)C)(O)=O,4,1,0,1,29,4.7e-05
G5,C(C(C(CC(O)=O)=O)(C)O)(O)=O,2,1,0,1,29,4.7e-05
G5,C(CC(C=O)=O)(C(C(O)=O)C)=O,2,1,0,1,25,4.7e-05
G5,C(CC(C)=O)(C(C(O)=O)C)=O,2,1,0,1,25,4.7e-05
G5,C(C(C(C=CC=O)=O)C)(O)=O,4,1,0,1,29,4.7e-05
G5,C(C(C(C(C)O)=O)C)(O)=O,4,1,0,1,29,4.7e-05
G5,C(C(C(CC)=O)(C)O)(O)=O,2,1,0,1,29,4.7e-05
G5,C(C(C)(C1C(COC1)=O)O)(O)=O,4,1,0,1,25,4.7e-05
G5,C1(C(CCO1)C(C(O)=O)(C)O)=O,4,1,0,1,25,4.7e-05
G5,C(C(C(CC=O)=O)CCO)(O)=O,2,1,0,1,45,4.7e-05
G5,C(C(C(C(C)O)=O)CCO)(O)=O,4,1,0,1,11,4.7e-05
G5,C(C(C(CC)=O)(CCO)O)(O)=O,2,1,0,1,11,4.7e-05
G5,C(C(C(C(C(CO)=O)=O)C)=O)=O,2,1,0,1,5,4.7e-05
G5,C(C(C=O)C1(C(CCO1)=O)O)=O,2,2,0,2,7,9.499999999999999e-05
G5,C1(CCOC1C(C(CO)=O)=O)=O,2,1,0,1,5,4.7e-05
G5,C(C(C(C(C(O)=O)=O)C)=O)=O,2,1,0,1,33,4.7e-05
G5,C(CC(C)=O)(C(C(C=O)=O)C)=O,2,1,0,1,25,4.7e-05
G5,C=CC(C(C(C(C=O)=O)C)=O)=O,2,1,0,1,25,4.7e-05
G5,C(CC)(C(C(C=O)=O)(C)O)=O,2,1,0,1,11,4.7e-05
G5,C(CC=O)(C(C(CO)=O)C)=O,2,1,0,1,25,4.7e-05
G5,C(C)(CC(C(C(CO)=O)C)=O)=O,2,1,0,1,25,4.7e-05
G5,C(CO)(C(C(C=CC=O)=O)C)=O,4,1,0,1,25,4.7e-05
G5,C(CC)(C(C(CO)=O)(C)O)=O,2,1,0,1,11,4.7e-05
G5,C(C(C(CC=O)=O)C)=O,2,1,0,1,11,4.7e-05
G5,C(CC(C1C(CCO1)=O)=O)=O,2,1,0,1,34,4.7e-05
G5,C(C(C(CC(C)=O)=O)CCO)=O,2,1,0,1,29,4.7e-05
G5,C(C(C(C=CC=O)=O)CCO)=O,4,1,0,1,43,4.7e-05
G5,C(C(C(CCCO)=O)(C)O)=O,2,1,0,1,29,4.7e-05
G5,C(C(C(CC)=O)(CCO)O)=O,2,1,0,1,11,4.7e-05
G5,C(C(C(C(O)=O)=O)CC(O)=O)=O,2,1,0,1,33,4.7e-05
G5,C(C(C(C(O)=O)=O)CC=O)(O)=O,2,1,0,1,33,4.7e-05
G5,C1(CCOC1C(C(O)=O)=O)=O,2,1,0,1,34,4.7e-05
G5,C(C(C(CC(O)=O)=O)(C)O)=O,2,1,0,1,29,4.7e-05
G5,C(C(C(C(C(O)=O)O)=O)C)=O,4,1,0,1,29,4.7e-05
G5,C(C(C(CCC(O)=O)=O)(C)O)=O,2,1,0,1,29,4.7e-05
G5,C(CC(C(C(C=O)C)=O)O)(O)=O,4,1,0,1,29,4.7e-05
G5,C(C(C)O)(C(C=O)CC(O)=O)=O,4,1,0,1,29,4.7e-05
G5,C(CC)(C(C=O)(CC(O)=O)O)=O,2,1,0,1,29,4.7e-05
G5,C(C(C(C(CC(C)=O)=O)=O)C)=O,2,1,0,1,26,4.7e-05
G5,C(C(C(CC(C=O)=O)=O)C)=O,2,3,0,3,29,0.00014199999999999998
G5,C(C(C(CC(C(C)=O)=O)=O)C)=O,2,1,0,1,14,4.7e-05
G5,C(C(C(CC(C)=O)=O)C)=O,2,1,0,1,11,4.7e-05
G5,C(C1C(CCO1)=O)(CC(C)=O)=O,2,1,0,1,34,4.7e-05
G5,C(C(C(C=CC(CO)=O)=O)C)=O,4,1,0,1,11,4.7e-05
G5,C1(CCOC1C(C(C=C)=O)=O)=O,2,1,0,1,7,4.7e-05
G5,C(C(C=C)C1(C(CCO1)=O)O)=O,4,3,0,3,29,0.00014199999999999998
G5,C(C(C(C=CC=O)=O)C)=O,4,1,0,1,11,4.7e-05
G5,C1(CCOC1C(C=CC=O)=O)=O,4,1,0,1,34,4.7e-05
G5,C(C(C(CC)=O)(C)O)=O,2,1,0,1,11,4.7e-05
G5,C(CC)(C(C(O)=O)(CC=O)O)=O,2,1,0,1,11,4.7e-05
G5,C(C(C)O)(C(C(O)=O)CC=O)=O,4,1,0,1,11,4.7e-05
G5,C(CC(C(O)=O)O)(C(C=O)C)=O,4,1,0,1,11,4.7e-05
G5,C(C(C(C(CO)(CO)O)=O)C)=O,2,1,0,1,11,4.7e-05
G5,C(C(C(C(CO)CO)=O)(C)O)=O,2,1,0,1,11,4.7e-05
G5,C(C(C(C(C=O)(CO)O)=O)C)=O,4,1,0,1,11,4.7e-05
G5,C(C(C(C(C=O)(C)O)=O)CO)=O,4,1,0,1,11,4.7e-05
G5,C(C(C)(C1C(COC1)=O)O)=O,4,1,0,1,10,4.7e-05
G5,C(CC1(C(CCO1)=O)O)(C)=O,2,2,0,2,34,9.499999999999999e-05
G5,C1(CCOC1(C(CC)=O)O)=O,2,1,0,1,34,4.7e-05
G5,C1(CCOC1C(C(C)O)=O)=O,4,1,0,1,34,4.7e-05
G5,C1(C(CCO1)C(C=O)(C)O)=O,4,1,0,1,29,4.7e-05
G5,C(CC(C(C)=O)(C(C)=O)O)=O,1,1,0,1,0,4.7e-05
G5,C(CC(C(C)=O)C(CO)=O)=O,2,3,0,3,29,0.00014199999999999998
G5,C(C(C(CO)=O)C)(O)=O,2,1,0,1,0,4.7e-05
G5,C(C(C(CC(CO)O)=O)(C)O)=O,4,1,0,1,45,4.7e-05
G5,C(CCO)(C(C(C=O)=O)(C)O)=O,2,2,0,2,29,0.000106
G5,C(CCO)(C(C(CO)=O)(C)O)=O,2,1,0,1,25,4.7e-05
G5,C(C(C(CCO)=O)(C)O)=O,2,1,0,1,11,4.7e-05
G5,C(CCO)(C1(C(CCO1)=O)O)=O,2,1,0,1,34,4.7e-05
G5,C1(CCOC1C(C(CO)O)=O)=O,4,1,0,1,34,4.7e-05
G5,C(C(C(C(C(C)=O)=O)C)=O)=O,2,1,0,1,49,4.7e-05
G5,C1(CCOC1C(C(C)=O)=O)=O,2,1,0,1,34,4.7e-05
G5,C(C(C(CC(CO)=O)=O)C)(O)=O,2,1,0,1,25,4.7e-05
G5,C(C(C(CC(CO)=O)=O)C)=O,2,1,0,1,11,4.7e-05
G5,C(C(C(CC(C)=O)=O)(C)O)(O)=O,2,1,0,1,25,4.7e-05
G5,C(C(C(C(C(C)=O)O)=O)C)(O)=O,4,1,0,1,25,4.7e-05
G5,C(C(C(CC(C)=O)=O)(C)O)=O,2,1,0,1,11,4.7e-05
G5,C(C(C(C(C(C)=O)O)=O)C)=O,4,1,0,1,11,4.7e-05
G5,C(C(C=O)O)(C(C(C=O)=O)C)=O,4,2,0,2,29,9.499999999999999e-05
G5,C1(CCOC1C(C=O)=O)=O,2,1,0,1,34,4.7e-05
G5,C(C(C)(C(C(CO)=O)C)O)(O)=O,4,1,0,1,25,4.7e-05
G5,C(C(C)(C(C(CO)=O)C)O)=O,4,1,0,1,11,4.7e-05
G5,C(C(C=O)CCO)(O)=O,2,1,0,1,29,4.7e-05
G5,C(C(C=O)CC(CCO)=O)(O)=O,2,1,0,1,33,4.7e-05
G5,C(C(C=O)CC(C(C)=O)O)(O)=O,4,1,0,1,5,4.7e-05
G5,C(C(C=O)CC(CC=O)O)(O)=O,4,1,0,1,33,4.7e-05
G5,C(C(C=O)C=CC(CO)O)(O)=O,8,1,0,1,29,4.7e-05
G5,C(C(C=O)OC(C(C)=O)CO)=O,2,1,0,1,2,4.7e-05
G5,C(C(C=O)OCC(C(C)=O)O)=O,2,1,0,1,2,4.7e-05
G5,C(C(C=O)OCCC(CO)=O)=O,1,1,0,1,30,4.7e-05
G5,C(C(C=O)CC(OCC=O)O)=O,2,1,0,1,37,4.7e-05
G5,C(C(C=O)C)=O,1,2,0,2,27,9.499999999999999e-05
G5,C(C(C(C=O)=O)CCC=O)=O,2,3,0,3,29,0.000143
G5,C1(C(C=O)CC(C(CO)O)O1)=O,8,1,0,1,48,4.7e-05
G5,C1(C(C=O)CC(C(CO)O1)O)=O,8,1,0,1,48,4.7e-05
G5,C(C1C(C(CO)OC(C1)O)=O)=O,8,3,0,3,2,0.00014199999999999998
G5,C(C1C(C(CC(CO)O1)O)=O)=O,8,1,0,1,2,4.7e-05
G5,C(C1C(C(O)OC(CO)C1)=O)=O,8,2,0,2,2,9.499999999999999e-05
G5,C1(C(C=O)CC(C(CO1)O)O)=O,8,1,0,1,48,4.7e-05
G5,C(C1C(C(COC(C1)O)O)=O)=O,8,3,0,3,38,0.00014199999999999998
G5,C(C1C(C(CC(CO1)O)O)=O)=O,8,1,0,1,41,4.7e-05
G5,C(C1C(C(O)OCC(C1)O)=O)=O,8,2,0,2,41,9.499999999999999e-05
G5,C(C1C(COC(C(C1)O)O)=O)=O,8,2,0,2,2,9.499999999999999e-05
G5,C(C1C(C(C(O)OCC1)O)=O)=O,8,2,0,2,19,9.499999999999999e-05
G5,C(C(C=CCO)C(C=O)=O)=O,4,3,0,3,29,0.00014199999999999998
G5,C(C(C(CO)=O)C=CC=O)=O,4,3,0,3,29,0.00014199999999999998
G5,C(C(C(C(C=O)O)=O)C=C)=O,4,2,0,2,29,9.499999999999999e-05
G5,C(C1C(CC(C(C)=O)O1)=O)=O,4,2,0,2,29,9.499999999999999e-05
G5,C(C1C(CC(CC=O)O1)=O)=O,4,2,0,2,29,9.499999999999999e-05
G5,C1(CCOC(CC1C=O)=O)=O,2,2,0,2,29,9.499999999999999e-05
G5,C(C1C(COCC(C1)=O)=O)=O,2,2,0,2,29,9.499999999999999e-05
G5,C1(C(C=O)OCCC(C1)=O)=O,2,2,0,2,29,9.499999999999999e-05
G5,C(C1C(CCC(CO1)=O)=O)=O,2,2,0,2,29,9.499999999999999e-05
G5,C(C1C(CCO1)=O)=O,2,1,0,1,34,4.7e-05
G5,C1(C(C=O)CC(C(CO)O1)=O)=O,4,2,0,2,29,9.499999999999999e-05
G5,C1(C(C=O)CC(C(CO1)O)=O)=O,4,2,0,2,29,9.499999999999999e-05
G5,C(C1C(C=CC(CO)O1)=O)=O,4,2,0,2,29,9.499999999999999e-05
G5,C(C1C(C=CC(CO1)O)=O)=O,4,2,0,2,29,9.499999999999999e-05
G5,C(C1C(COC(CO)(C1)O)=O)=O,4,3,0,3,29,0.00014199999999999998
G5,C(C(C(C(C=O)O)=O)C)(O)=O,4,1,0,1,25,4.7e-05
G5,C(CC(C1(C(CCO1)=O)O)=O)=O,2,1,0,1,34,4.7e-05
G5,C(C(C(C1C(CCO1)=O)=O)O)=O,4,1,0,1,34,4.7e-05
G5,C1(C(CC(C=O)=O)(O)OCC1)=O,2,1,0,1,34,4.7e-05
G5,C(C(C)C(C(C=O)=O)(C)O)=O,4,1,0,1,49,4.7e-05
G5,C(C(C)C(C(CO)=O)(C)O)=O,4,1,0,1,25,4.7e-05
G5,C(C(C)C(C=O)(C)O)=O,4,1,0,1,11,4.7e-05
G5,C(C(C)C1(C(CCO1)=O)O)=O,4,2,0,2,49,9.499999999999999e-05
G5,C(C(C(CCC=O)=O)(C)O)(O)=O,2,1,0,1,25,4.7e-05
G5,C(CC(C(C(C(O)=O)C)=O)O)=O,4,1,0,1,25,4.7e-05
G5,C(CC(C=O)O)(C(C(O)=O)C)=O,4,1,0,1,25,4.7e-05
G5,C(CC(C=O)O)(C(C=O)C)=O,4,1,0,1,11,4.7e-05
G5,C(CC)(C(C=O)(CC=O)O)=O,2,1,0,1,11,4.7e-05
G5,C1(C(CO)C(C(C1)=O)C(C)=O)=O,4,1,0,1,30,4.7e-05
G5,C(CC(C(C)=O)C(C)=O)=O,1,1,0,1,4,4.7e-05
G5,C(C)(C(C(O)=O)C)=O,2,1,0,1,27,4.7e-05
G5,C(C(C(C)=O)CCO)(O)=O,2,1,0,1,29,4.7e-05
G5,C(C)(C(C(CO)=O)C)=O,2,1,0,1,4,4.7e-05
G5,C(C(C=O)O)(C(C(C)=O)C)=O,4,1,0,1,4,4.7e-05
G5,C(C(C(C)=O)C)=O,2,1,0,1,18,4.7e-05
G5,C(CC(C=O)=O)(C(C(C)=O)C)=O,2,1,0,1,4,4.7e-05
G5,C(CCC(C(C)=O)C(C=O)=O)=O,2,2,0,2,27,9.499999999999999e-05
G5,C(C)(C(C=CCO)C(C=O)=O)=O,4,2,0,2,29,9.499999999999999e-05
G5,C(C)(C(C(CO)=O)C=CC=O)=O,4,1,0,1,32,4.7e-05
G5,C(C)(C1C(C(C(C1)=O)CO)=O)=O,4,1,0,1,4,4.7e-05
G5,C(C)(C1C(CC(C(C)=O)O1)=O)=O,4,1,0,1,22,4.7e-05
G5,C(CC1CC(C(C(C)=O)O1)=O)=O,4,1,0,1,4,4.7e-05
G5,C(C)(C1C(CCOC(C1)=O)=O)=O,2,1,0,1,19,4.7e-05
G5,C(C)(C1C(COCC(C1)=O)=O)=O,2,1,0,1,17,4.7e-05
G5,C1(CCOC(C(C1)=O)C(C)=O)=O,2,1,0,1,30,4.7e-05
G5,C(C)(C1C(CCC(CO1)=O)=O)=O,2,1,0,1,12,4.7e-05
G5,C1(CCOC1C(C)=O)=O,2,1,0,1,4,4.7e-05
G5,C(C)(C1C(C=CC(CO)O1)=O)=O,4,1,0,1,46,4.7e-05
G5,C(C)(C1C(C=CC(CO1)O)=O)=O,4,1,0,1,41,4.7e-05
G5,C(C(C(C(O)=O)=O)CC(C)O)=O,4,1,0,1,33,4.7e-05
G5,C(C(C(CO)CC(C)O)=O)(O)=O,4,1,0,1,33,4.7e-05
G5,C(C(CC(C)O)C(C(O)=O)O)=O,8,2,0,2,33,9.499999999999999e-05
G5,C(C(C)C(C(O)=O)O)(C(C)O)=O,8,1,0,1,33,4.7e-05
G5,C(C(CCC(C)(CO)O)=O)(O)=O,2,2,0,2,49,9.499999999999999e-05
G5,C(C(C(C(O)=O)=O)CC(C)=O)=O,2,1,0,1,27,4.7e-05
G5,C(CC=O)(C(C(C(O)=O)=O)C)=O,2,1,0,1,14,4.7e-05
G5,C(C)(C(C(C(O)=O)=O)C)=O,2,2,0,2,29,9.499999999999999e-05
G5,C(C(C1COC(C1)O)=O)(O)=O,4,2,0,2,33,9.499999999999999e-05
G5,C(C(C=C)C(C(O)=O)=O)=O,2,2,0,2,29,9.499999999999999e-05
G5,C(C(C(CC)=O)O)(O)=O,2,1,0,1,11,4.7e-05
G5,C(C(C1COCC1O)=O)(O)=O,4,1,0,1,33,4.7e-05
G5,C1(COCC1C(C(O)=O)O)=O,4,1,0,1,33,4.7e-05
G5,C(C(C1C(O)OCC1)=O)(O)=O,4,2,0,2,29,9.499999999999999e-05
G5,C1(C(CCO1)C(C(O)=O)O)=O,4,1,0,1,29,4.7e-05
G5,C(C1C(C(CCO1)=O)=O)=O,2,2,0,2,29,9.499999999999999e-05
G5,C1(C(C=O)OCC(C1)=O)=O,2,3,0,3,29,0.00014199999999999998
G5,C1(C(C)OCC(C1)=O)=O,2,2,0,2,29,9.499999999999999e-05
G5,C1(C(C(C)OCC1)=O)=O,2,2,0,2,29,9.499999999999999e-05
G5,C(C1CCC(C(O1)=O)=O)=O,2,3,0,3,29,0.00014199999999999998
G5,C1(C(C)OC(C(C1)=O)=O)=O,2,3,0,3,29,0.00014199999999999998
G5,C1(CC(C(C(C)O1)=O)=O)=O,2,3,0,3,29,0.00014199999999999998
G5,C1(CCCOC(C1)=O)=O,1,2,0,2,29,9.499999999999999e-05
G5,C1(CCC(OCC1)=O)=O,1,2,0,2,29,9.499999999999999e-05
G5,C1(C(COCCC1)=O)=O,1,2,0,2,29,9.499999999999999e-05
G5,C1(CCOCC(C1)=O)=O,1,2,0,2,29,9.499999999999999e-05
G5,C1(CC(CCC(O1)=O)=O)=O,1,3,0,3,29,0.00014199999999999998
G5,C1(CCC(C(CO1)=O)=O)=O,1,3,0,3,29,0.00014199999999999998
G5,C1(CO)CC(C(C=1)=O)=O,1,3,0,3,29,0.00014199999999999998
G5,C1(C(C(C(CO)=CC1)=O)O)=O,2,2,0,2,29,9.499999999999999e-05
G5,C1(C(C=C(C(C1)=O)CO)O)=O,2,2,0,2,29,9.499999999999999e-05
G5,C(CO)(C(C(C(C)=O)=C)O)=O,2,2,0,2,29,9.499999999999999e-05
G5,C(C(C(C(C=O)=O)=C)CO)=O,2,2,0,2,29,9.499999999999999e-05
G5,C(C(C(C(CO)=O)=C)CO)=O,2,3,0,3,29,0.00014199999999999998
G5,C(C(C(C=O)=CC=O)CO)=O,4,3,0,3,29,0.00014199999999999998
G5,C(CC=C(C=O)C(CO)=O)=O,2,2,0,2,29,9.499999999999999e-05
G5,C(CC=C(C=O)C(C=O)O)=O,4,2,0,2,29,9.499999999999999e-05
G5,C(C(C(CCO)=O)=CC=O)=O,2,3,0,3,29,0.00014199999999999998
G5,C(CO)(CC(C=O)=CC=O)=O,2,4,0,4,29,0.00018999999999999998
G5,C(CC(C(C=O)=CC=O)O)=O,4,3,0,3,29,0.00014199999999999998
G5,C(C(C=C(C(C)=O)C)=O)=O,2,2,0,2,29,9.499999999999999e-05
G5,C(CC(C)=CC(C=O)=O)=O,2,2,0,2,29,9.499999999999999e-05
G5,C=C(C(C)=O)CC(C=O)=O,1,4,0,4,29,0.00018999999999999998
G5,C(CC(CC(C=O)=O)=C)=O,1,4,0,4,29,0.00018999999999999998
G5,C(C(C=CC(C)=O)=O)(C)=O,2,2,0,2,29,9.499999999999999e-05
G5,C(CC(C=CC(C)=O)=O)=O,2,2,0,2,29,9.499999999999999e-05
G5,C=C(C=O)CC(C(C)=O)=O,1,4,0,4,29,0.00018999999999999998
G5,C(CC(CC(C=O)=C)=O)=O,1,4,0,4,29,0.00018999999999999998
G5,C(C(C)=CC(C(C)=O)=O)=O,2,2,0,2,29,9.499999999999999e-05
G5,C(CC(C=C(C=O)C)=O)=O,2,3,0,3,29,0.00014199999999999998
G5,C(CC(C=O)=O)=CC(C=O)=O,2,4,0,4,29,0.00018999999999999998
G5,C(C)(CO)=CC(C(C)=O)=O,2,2,0,2,29,9.499999999999999e-05
G5,C(CC(C=C(C)CO)=O)=O,2,2,0,2,29,9.499999999999999e-05
G5,C=C(CO)CC(C(C)=O)=O,1,2,0,2,29,9.499999999999999e-05
G5,C(CC(CC(CO)=C)=O)=O,1,2,0,2,29,9.499999999999999e-05
G5,C(CO)(CC(C(C)=O)=C)=O,1,2,0,2,29,9.499999999999999e-05
G5,C(CC(CC(CO)=O)=C)=O,1,2,0,2,29,9.499999999999999e-05
G5,C(C(C)=CC(CO)=O)(C)=O,2,2,0,2,29,9.499999999999999e-05
G5,C(CC(C)=CC(CO)=O)=O,2,2,0,2,29,9.499999999999999e-05
G5,C(C)(C(C(C(C)=O)=C)O)=O,2,2,0,2,29,9.499999999999999e-05
G5,C(CC(C(C(C)=O)O)=C)=O,2,2,0,2,29,9.499999999999999e-05
G5,C(CC(CC=O)=C)=O,1,2,0,2,29,9.499999999999999e-05
G5,C(CC(C)=CC=O)=O,2,2,0,2,29,9.499999999999999e-05
G5,C(C)(C(C(C(C=O)=C)O)O)=O,4,3,0,3,29,0.00014199999999999998
G5,C(C)(C(C=C(C=O)CO)O)=O,4,2,0,2,29,9.499999999999999e-05
G5,C(C)(C1C(C(C(O1)O)=O)=C)=O,4,3,0,3,29,0.00014199999999999998
G5,C(CC1C(C(C(O)O1)=O)=C)=O,4,3,0,3,29,0.00014199999999999998
G5,C(C)(C1C(C(C(O1)O)=C)=O)=O,4,3,0,3,29,0.00014199999999999998
G5,C(CC1C(C(C(O)O1)=C)=O)=O,4,3,0,3,29,0.00014199999999999998
G5,C(C)(C1C(C(CO)=CO1)=O)=O,2,2,0,2,29,9.499999999999999e-05
G5,C(CC1C(C(CO)=CO1)=O)=O,2,2,0,2,29,9.499999999999999e-05
G5,C1(CC(C(C(C=C)=O)O1)O)=O,4,2,0,2,29,9.499999999999999e-05
G5,C1(COC(C(C=C)=O)C1O)=O,4,2,0,2,29,9.499999999999999e-05
G5,C1(C(O)OC(C(C=C)=O)C1)=O,4,3,0,3,0,0.00014199999999999998
G5,C1(CC(OC1C(C=C)=O)O)=O,4,3,0,3,2,0.00014199999999999998
G5,C1(CC(C(C(C=O)=C)O1)O)=O,4,2,0,2,29,9.499999999999999e-05
G5,C1(COC(C(C=O)=C)C1O)=O,4,2,0,2,29,9.499999999999999e-05
G5,C1(C(O)OC(C(C=O)=C)C1)=O,4,3,0,3,29,0.00014199999999999998
G5,C1(CC(OC1C(C=O)=C)O)=O,4,4,0,4,29,0.00018999999999999998
G5,C1(CC(C(C(CO)O1)=C)=O)=O,2,2,0,2,29,9.499999999999999e-05
G5,C=C1C(C(COC1CO)=O)=O,2,2,0,2,29,9.499999999999999e-05
G5,C1(CC(C(C(CO)O1)=O)=C)=O,2,2,0,2,29,9.499999999999999e-05
G5,C=C1C(C(CO)OCC1=O)=O,2,2,0,2,29,9.499999999999999e-05
G5,C=C1C(CCOC(C1=O)O)=O,2,3,0,3,29,0.00014199999999999998
G5,C1(COC(C(C(C1)=C)=O)O)=O,2,3,0,3,29,0.00014199999999999998
G5,C=C1C(C(CCOC1O)=O)=O,2,3,0,3,29,0.00014199999999999998
G5,C1(COC(C(C(C1)=O)=C)O)=O,2,3,0,3,29,0.00014199999999999998
G5,C1OCCC(C(C=1CO)=O)=O,1,2,0,2,29,9.499999999999999e-05
G5,C1(COC=C(C(C1)=O)CO)=O,1,2,0,2,29,9.499999999999999e-05
G5,C1(CC(C(C(CO1)O)=C)=O)=O,2,2,0,2,29,9.499999999999999e-05
G5,C=C1C(C(COCC1O)=O)=O,2,2,0,2,29,9.499999999999999e-05
G5,C1(CC(C(CO)=CCO1)=O)=O,1,2,0,2,29,9.499999999999999e-05
G5,C1COCC(C(C=1CO)=O)=O,1,2,0,2,29,9.499999999999999e-05
G5,C1(CC(C(C(CO1)O)=O)=C)=O,2,2,0,2,29,9.499999999999999e-05
G5,C=C1C(C(COCC1=O)O)=O,2,2,0,2,29,9.499999999999999e-05
G5,C1(CC(C(C(CO1)=C)=O)O)=O,2,2,0,2,29,9.499999999999999e-05
G5,C1(COCC(C(C1O)=O)=C)=O,2,2,0,2,29,9.499999999999999e-05
G5,C1(C(O)OCC(C(C1)=O)=C)=O,2,3,0,3,30,0.00014199999999999998
G5,C=C1C(C(CC(OC1)O)=O)=O,2,3,0,3,29,0.00014199999999999998
G5,C1(CC(C(C(CO1)=O)=C)O)=O,2,2,0,2,29,9.499999999999999e-05
G5,C1(COCC(C(C1O)=C)=O)=O,2,2,0,2,29,9.499999999999999e-05
G5,C1(C(O)OCC(C(C1)=C)=O)=O,2,3,0,3,29,0.00014199999999999998
G5,C=C1C(CC(OCC1=O)O)=O,2,3,0,3,29,0.00014199999999999998
G5,C1(CC=C(C(CO1)=O)CO)=O,1,2,0,2,29,9.499999999999999e-05
G5,C1(C(CO)=CC(COC1)=O)=O,1,3,0,3,29,0.00014199999999999998
G5,C1(C(COC1C(C=O)=C)O)=O,4,3,0,3,29,0.00014199999999999998
G5,C1(CCOC1(C(C=O)=C)O)=O,2,4,0,4,29,0.00018999999999999998
G5,C1(COC(C(C=O)=C)(C1)O)=O,2,3,0,3,29,0.00014199999999999998
G5,C1(C(OCC1)=C(C=O)CO)=O,2,2,0,2,29,9.499999999999999e-05
G5,C1(COC(C1)=C(C=O)CO)=O,2,2,0,2,29,9.499999999999999e-05
G5,C(CC(C(C(C=O)=O)=C)=O)=O,1,2,0,2,29,9.499999999999999e-05
G5,C=C(C(C=O)=O)CC(C=O)=O,1,2,0,2,29,9.499999999999999e-05
G5,C(C(C(C(C=O)=O)=C)C)=O,2,2,0,2,29,9.499999999999999e-05
G5,C(C(C(C(CO)=O)=C)C)=O,2,2,0,2,29,9.499999999999999e-05
G5,C(CC(C(CC=O)=O)=C)=O,1,4,0,4,29,0.00018999999999999998
G5,C(C)(CC(C=O)=O)=CC=O,2,2,0,2,29,9.499999999999999e-05
G5,C(CC(C(C)=CC=O)=O)=O,2,2,0,2,29,9.499999999999999e-05
G5,C(CC(C(C=O)=CC=O)=O)=O,2,3,0,3,29,0.00014199999999999998
G5,C(C(CC(C=O)=O)=CC=O)=O,2,3,0,3,29,0.00014199999999999998
G5,C(C(C(C=O)=CC=O)C)=O,4,3,0,3,29,0.00014199999999999998
G5,C=C(CO)C(C(C(C)=O)=O)O,2,2,0,2,29,9.499999999999999e-05
G5,C(C=C(C(C)=O)CO)=O,2,2,0,2,29,9.499999999999999e-05
G5,C(C=CC(C=CC(C)=O)=O)=O,4,3,0,3,29,0.00014199999999999998
G5,C(CC=CC(C=CC=O)=O)=O,4,4,0,4,29,0.00018999999999999998
G5,C(C(C=CC(C)=O)=CC=O)=O,4,3,0,3,29,0.00014199999999999998
G5,C(CC=CC(C=O)=CC=O)=O,4,3,0,3,29,0.00014199999999999998
G5,C(C=CC=CC(C(C)=O)=O)=O,4,3,0,3,29,0.00014199999999999998
G5,C(CC(C=CC=CC=O)=O)=O,4,5,0,5,29,0.00023700000000000001
G5,C(C=CC(C(C)=O)=CC=O)=O,4,3,0,3,29,0.00014199999999999998
G5,C(CC(C=CC=O)=CC=O)=O,4,4,0,4,29,0.00018999999999999998
G5,C=CC(CC(C=O)=O)=CC=O,2,3,0,3,29,0.00014199999999999998
G5,C(CC(C(C=C)=CC=O)=O)=O,2,5,0,5,29,0.00023700000000000001
G5,C(CC(C=CC=O)=O)=CC=O,4,4,0,4,29,0.00018999999999999998
G5,C(CC(C=O)=O)=CC=CC=O,4,3,0,3,29,0.00014199999999999998
G5,C(C(C(C(C)=O)=C)O)=O,2,2,0,2,29,9.499999999999999e-05
G5,C(C=C(C(C)=O)C(CO)=O)=O,2,2,0,2,29,9.499999999999999e-05
G5,C(CC(C(CO)=O)=CC=O)=O,2,3,0,3,29,0.00014199999999999998
G5,C(CC(C(C=O)=O)=C)=O,1,3,0,3,29,0.00014199999999999998
G5,C=C(C(C)=O)C(CO)=O,1,2,0,2,29,9.499999999999999e-05
G5,C(CO)=CC(CC(C=O)=O)=O,2,3,0,3,29,0.00014199999999999998
G5,C(C(CO)=CC(C)=O)(O)=O,2,2,0,2,29,9.499999999999999e-05
G5,C(CC=C(C(O)=O)CO)=O,2,2,0,2,29,9.499999999999999e-05
G5,C=C1C(CC(C1O)O)=O,4,2,0,2,29,9.499999999999999e-05
G5,C1(CC(C(C=C)O1)O)=O,4,2,0,2,29,9.499999999999999e-05
G5,C1(COC(C=C)C1O)=O,4,2,0,2,29,9.499999999999999e-05
G5,C1(C(O)OC(C=C)C1)=O,4,3,0,3,4,0.00014199999999999998
G5,C1(CC(OC1C=C)O)=O,4,4,0,4,29,0.00018999999999999998
G5,C1(C(COC1C=C)O)=O,4,3,0,3,29,0.00014199999999999998
G5,C1(CCOC1(C=C)O)=O,2,4,0,4,29,0.00018999999999999998
G5,C1(COC(C=C)(C1)O)=O,2,3,0,3,29,0.00014199999999999998
G5,C(C(C=O)C(C=O)=C)=O,1,2,0,2,29,9.499999999999999e-05
G5,C(C(C=O)C(CO)=CC=O)=O,2,2,0,2,29,9.499999999999999e-05
G5,C(C(C=O)C(C(C=O)O)=C)=O,2,2,0,2,29,9.499999999999999e-05
G5,C(C(C=O)C(C(CO)O)=C)=O,2,2,0,2,29,9.499999999999999e-05
G5,C(C(C(C(C)=O)=C)(CO)O)=O,2,2,0,2,29,9.499999999999999e-05
G5,C(C(C=O)C(C=O)=CCO)=O,2,2,0,2,29,9.499999999999999e-05
G5,C(C(C=O)C(CO)=CCO)=O,2,2,0,2,29,9.499999999999999e-05
G5,C(C(C=O)C(CO)=C)=O,1,2,0,2,29,9.499999999999999e-05
G5,C(C(C(C)=O)C(C=O)=C)=O,2,2,0,2,29,9.499999999999999e-05
G5,C(C(C(C=O)=O)C(C=O)=C)=O,2,2,0,2,29,9.499999999999999e-05
G5,C(C(C=O)(C(C(C)=O)=C)O)=O,1,2,0,2,29,9.499999999999999e-05
G5,C(C(C=O)(C(CC=O)=C)O)=O,1,2,0,2,29,9.499999999999999e-05
G5,C(C(C(C)=O)C(CO)=C)=O,2,2,0,2,29,9.499999999999999e-05
G5,C(C)(C1C(C(C(O1)=O)=C)O)=O,4,2,0,2,29,9.499999999999999e-05
G5,C(CC1C(C(C(O1)=O)=C)O)=O,4,2,0,2,29,9.499999999999999e-05
G5,C(C)(C1C=C(C(O1)=O)CO)=O,2,2,0,2,29,9.499999999999999e-05
G5,C(CC1C=C(C(O1)=O)CO)=O,2,2,0,2,29,9.499999999999999e-05
G5,C=C1C(OC(CO)CC1=O)=O,2,2,0,2,29,9.499999999999999e-05
G5,C1(C(CO)OC(C(C1)=C)=O)=O,2,2,0,2,29,9.499999999999999e-05
G5,C=C1C(OCC(CC1=O)O)=O,2,2,0,2,29,9.499999999999999e-05
G5,C1(C(COC(C(C1)=C)=O)O)=O,2,2,0,2,29,9.499999999999999e-05
G5,C1(CCOC(C(C1O)=C)=O)=O,2,2,0,2,29,9.499999999999999e-05
G5,C1(COC(C(C(C1)O)=C)=O)=O,2,2,0,2,29,9.499999999999999e-05
G5,C1(C=C(C(OCC1)=O)CO)=O,1,2,0,2,29,9.499999999999999e-05
G5,C1(COC(C(CO)=CC1)=O)=O,1,2,0,2,29,9.499999999999999e-05
G5,C(C(C(CO)=C)C(C=O)=O)=O,2,2,0,2,29,9.499999999999999e-05
G5,C(C(C=C)C(C=CC=O)=O)=O,4,5,0,5,29,0.00023700000000000001
G5,C=CC(C(C=C)=O)C(C=O)=O,2,3,0,3,29,0.00014199999999999998
G5,C(C(C(C(C)=O)=C)O)(O)=O,2,2,0,2,29,9.499999999999999e-05
G5,C(C(C(C)=O)=CC(CO)=O)=O,2,3,0,3,29,0.00014199999999999998
G5,C(CC(C=O)=CC(CO)=O)=O,2,4,0,4,29,0.00018999999999999998
G5,C(C1C(C=CCO1)=O)=O,2,3,0,3,29,0.00014199999999999998
G5,C(C1C=CC(CO1)=O)=O,2,4,0,4,29,0.00018999999999999998
G5,C1(CC2(C=CC1O2)O)=O,4,3,0,3,29,0.00014199999999999998
G5,C1(CC2C=CC1(O)O2)=O,4,4,0,4,29,0.00018999999999999998
G5,C1(C(C2C=CC1O2)O)=O,8,3,0,3,29,0.00014199999999999998
G5,C(C1OCC(C=1)=O)(C)=O,1,2,0,2,29,9.499999999999999e-05
G5,C=CC1C(C(CO1)=O)=O,2,3,0,3,29,0.00014199999999999998
G5,C1(CC(C(C=C)O1)=O)=O,2,2,0,2,29,9.499999999999999e-05
G5,C(C)(C1(C=CC(O1)=O)O)=O,2,2,0,2,29,9.499999999999999e-05
G5,C(CC1(C=CC(O1)=O)O)=O,2,3,0,3,29,0.00014199999999999998
G5,C1(C(C=C(C(C)=O)O1)O)=O,2,2,0,2,29,9.499999999999999e-05
G5,C1(C(C=C(CC=O)O1)O)=O,2,2,0,2,29,9.499999999999999e-05
G5,C1(CC(C(O1)=O)=O)=CCO,2,2,0,2,29,9.499999999999999e-05
G5,C1(CC(C(O1)=CCO)=O)=O,2,2,0,2,29,9.499999999999999e-05
G5,C=CC1(CC(C(O1)=O)=O)O,2,3,0,3,2,0.00014199999999999998
G5,C1(CC(C(C=C)(O)O1)=O)=O,2,3,0,3,29,0.00014199999999999998
G5,C1(C(C(C(C=C)O1)=O)O)=O,4,3,0,3,29,0.00014199999999999998
G5,C1(C2C=CC(C2O)O1)=O,8,2,0,2,29,9.499999999999999e-05
G5,C1(C2C=CC1C(O2)O)=O,8,3,0,3,43,0.00014199999999999998
G5,C1(CC2C(C=CO2)O1)=O,4,2,0,2,29,9.499999999999999e-05
G5,C1(COC2C=COC12)=O,4,2,0,2,29,9.499999999999999e-05
G5,C1(C2COC1C=CO2)=O,4,2,0,2,29,9.499999999999999e-05
G5,C1(C2C=CC(CO1)O2)=O,4,2,0,2,29,9.499999999999999e-05
G5,C1(COC2C=CC1O2)=O,4,4,0,4,29,0.00018999999999999998
G5,C(C1C=CCC(O1)=O)=O,2,3,0,3,29,0.00014199999999999998
G5,C=C1CC(C(CO1)=O)=O,1,2,0,2,29,9.499999999999999e-05
G5,C1(COC(C(C1)=O)=C)=O,1,2,0,2,29,9.499999999999999e-05
G5,C1(COC(C(C1)O)=C)=O,2,2,0,2,29,9.499999999999999e-05
G5,C1(CCOC(C1O)=C)=O,2,2,0,2,29,9.499999999999999e-05
G5,C1(C(COC(C1)=C)O)=O,2,2,0,2,29,9.499999999999999e-05
G5,C=C1C(CC(CO1)O)=O,2,2,0,2,29,9.499999999999999e-05
G5,C1(C(C=CC(C=O)O1)O)=O,4,3,0,3,29,0.00014199999999999998
G5,C1CC(C(OC=1CO)=O)=O,1,2,0,2,29,9.499999999999999e-05
G5,C1(CC(C=C(CO)O1)=O)=O,1,2,0,2,29,9.499999999999999e-05
G5,C=C1C(CC(C(O1)=O)=O)O,2,2,0,2,29,9.499999999999999e-05
G5,C1(CC(C(C(O1)=C)O)=O)=O,2,2,0,2,29,9.499999999999999e-05
G5,C1(C(C(CC(O1)=C)=O)O)=O,2,2,0,2,29,9.499999999999999e-05
G5,C1(C(CC(C(O1)=C)=O)O)=O,2,2,0,2,29,9.499999999999999e-05
G5,C1(C2C=CC(CO2)O1)=O,4,2,0,2,29,9.499999999999999e-05
G5,C1CC(C(COC=1)=O)=O,1,2,0,2,29,9.499999999999999e-05
G5,C1(COC(C=CC1)O)=O,2,2,0,2,29,9.499999999999999e-05
G5,C1C(O)OCCC(C=1)=O,2,3,0,3,29,0.00014199999999999998
G5,C1(COC=CC(C1)O)=O,2,2,0,2,29,9.499999999999999e-05
G5,C1(CCOC=CC1O)=O,2,2,0,2,29,9.499999999999999e-05
G5,C1(C(COC=CC1)O)=O,2,2,0,2,29,9.499999999999999e-05
G5,C1OCC(CC(C=1)=O)O,2,2,0,2,29,9.499999999999999e-05
G5,C1(CC(C=CCO1)O)=O,2,2,0,2,29,9.499999999999999e-05
G5,C1(COCC=CC1O)=O,2,2,0,2,29,9.499999999999999e-05
G5,C1(C(O)OCC=CC1)=O,2,2,0,2,29,9.499999999999999e-05
G5,C1COC(CC(C=1)=O)O,2,3,0,3,29,0.00014199999999999998
G5,C1CC(C(OC(C=1)O)=O)=O,2,2,0,2,29,9.499999999999999e-05
G5,C1(CC(C=CC(O)O1)=O)=O,2,3,0,3,29,0.00014199999999999998
G5,C1OC(C(CC(C=1)O)=O)=O,2,2,0,2,29,9.499999999999999e-05
G5,C1(CC(C(C=CO1)O)=O)=O,2,2,0,2,29,9.499999999999999e-05
G5,C1(C(C(CC=CO1)=O)O)=O,2,2,0,2,29,9.499999999999999e-05
G5,C1(C(CC(C=CO1)=O)O)=O,2,2,0,2,29,9.499999999999999e-05
G5,C1(CC(C=CC(O1)=O)O)=O,2,2,0,2,29,9.499999999999999e-05
G5,C1(C(O)OC(C=CC1)=O)=O,2,2,0,2,29,9.499999999999999e-05
G5,C1(C=CC(CC(O)O1)=O)=O,2,3,0,3,29,0.00014199999999999998
G5,C1(C2OC(C=CO2)C1)=O,4,2,0,2,29,9.499999999999999e-05
G5,C1(CC2OC1C=CO2)=O,4,2,0,2,29,9.499999999999999e-05
G5,C1(CC2C=CC(O2)O1)=O,4,2,0,2,29,9.499999999999999e-05
G5,C(CC(CO)O)(C(CO)(C)O)=O,4,1,0,1,29,4.7e-05
G5,C(C(C(CO)O)O)(C(CO)C)=O,8,2,0,2,29,0.000106
G5,C(C(C)C(C(C(CO)O)O)O)=O,16,3,0,3,29,0.000164
G5,C(CO)(C(C)C(C(CO)O)O)=O,8,3,0,3,29,0.000164
G5,C(C)(C(C)(C(C(CO)O)O)O)=O,8,3,0,3,29,0.000164
G5,C(C(CO)O)(C(C)C(CO)O)=O,8,2,0,2,29,0.000106
G5,C(CCO)(C(C)(C(CO)O)O)=O,4,1,0,1,29,4.7e-05
G5,C(C(C)O)(CC(CO)O)=O,4,1,0,1,29,4.7e-05
G5,C(C(C(CO)O)O)(CC)=O,4,2,0,2,29,0.000106
G5,C(C(C(C(C=O)O)O)O)(CC)=O,8,2,0,2,29,0.000106
G5,C(CCO)(C(CO)(C)O)=O,2,1,0,1,29,4.7e-05
G5,C(C(CO)O)(C(CO)C)=O,4,2,0,2,29,0.000106
G5,C(C(C)C(C(CO)O)O)=O,8,3,0,3,29,0.000164
G5,C(C(CO)O)(CC)=O,2,2,0,2,29,0.000106
G5,C(OC(C(CO)O)CC=O)=O,4,2,0,2,29,0.000106
G5,C(CC=O)(OCC(CO)O)=O,2,2,0,2,29,0.000106
G5,C(C(COCC(CO)O)=O)=O,2,2,0,2,29,0.000106
G5,C(CCOC(C(C=O)O)O)=O,4,1,0,1,29,4.7e-05
G5,C(CCO)(OC(C=O)CO)=O,2,1,0,1,2,4.7e-05
G5,C(CC(OC(C=O)CO)O)=O,4,1,0,1,2,4.7e-05
G5,C(OC(CO)C(CC=O)O)=O,4,1,0,1,9,4.7e-05
G5,C(OC(C(CCO)=O)CO)=O,2,1,0,1,9,4.7e-05
G5,C(OCC(C(CC=O)O)O)=O,4,1,0,1,29,4.7e-05
G5,C(OCC(C(CCO)=O)O)=O,2,1,0,1,29,4.7e-05
G5,C(C(C(CO)O)OCC=O)=O,4,2,0,2,29,0.000106
G5,C(C1(C(CCCO1)=O)O)=O,2,2,0,2,30,9.499999999999999e-05
G5,C=CC(CCO)=O,1,2,0,2,27,9.499999999999999e-05
G5,C1(C2CC(C(C1)(O2)O)O)=O,8,2,0,2,32,9.499999999999999e-05
G5,C1(C2C(CC1(CO2)O)O)=O,8,1,0,1,32,4.7e-05
G5,C1(C2(C(CC1CO2)O)O)=O,8,3,0,3,47,0.00014199999999999998
G5,C1(C2(C(CO)C(C(C1)O2)O)O)=O,16,2,0,2,9,9.499999999999999e-05
G5,C1(C2C(CO)C(C(C1O)O2)O)=O,32,1,0,1,9,4.7e-05
G5,C(C1C(C(CO)(CO1)O)O)=O,8,1,0,1,5,4.7e-05
G5,C(C1COC(CO)(C1O)O)=O,8,2,0,2,5,9.499999999999999e-05
G5,C(C1COC(C=O)(C1)O)=O,4,2,0,2,5,9.499999999999999e-05
G5,C(C1CC(C(C(CO)=O)O1)O)=O,8,2,0,2,29,9.499999999999999e-05
G5,C(C1CC(OC1C(CO)=O)O)=O,8,2,0,2,5,9.499999999999999e-05
G5,C1(C(COC1CO)(CC=O)O)=O,4,1,0,1,5,4.7e-05
G5,C1(C(CO)(O)OCC1CC=O)=O,4,3,0,3,5,0.00014199999999999998
G5,C(CC1(C(C(C=O)OC1)O)O)=O,8,1,0,1,5,4.7e-05
G5,C(C1COC(C1C(CO)=O)O)=O,8,2,0,2,5,9.499999999999999e-05
G5,C(C1C(CO)(O)OCC1C=O)=O,8,2,0,2,20,9.499999999999999e-05
G5,C(C1C(CO)(COC1C=O)O)=O,8,1,0,1,20,4.7e-05
G5,C1(CC(C)(OC1C(CO)=O)O)=O,4,2,0,2,5,9.499999999999999e-05
G5,C1(CC(C(CO)=O)OC1(C)O)=O,4,2,0,2,5,9.499999999999999e-05
G5,C(C1C(C(C(C)O1)=O)O)(CO)=O,8,1,0,1,5,4.7e-05
G5,C(C1C(C(C(C(C)=O)O1)O)O)=O,16,1,0,1,5,4.7e-05
G5,C1(CC(CO)(OC1C(C)=O)O)=O,4,2,0,2,5,9.499999999999999e-05
G5,C1(CC(C)(C(C(CO)=O)O1)O)=O,4,1,0,1,5,4.7e-05
G5,C1(COC(C(CO)=O)C1(C)O)=O,4,1,0,1,5,4.7e-05
G5,C(C1C(C(C(O1)O)=O)C)(CO)=O,8,2,0,2,5,9.499999999999999e-05
G5,C1(C(C)(C(C=O)OC1CO)O)=O,8,1,0,1,5,4.7e-05
G5,C1(C(CO)(OC(C=O)C1C)O)=O,8,2,0,2,5,9.499999999999999e-05
G5,C(C1C(C(C)(C(C=O)O1)O)O)=O,16,1,0,1,5,4.7e-05
G5,C(C(C1CC(CO)(CO1)O)=O)=O,4,1,0,1,5,4.7e-05
G5,C1(C(CO)OC(CO)C1(C)O)=O,8,1,0,1,5,4.7e-05
G5,C1(C(CO)(O)OC(CO)C1C)=O,8,2,0,2,5,9.499999999999999e-05
G5,C(C1C(C(C)(C(CO)O1)O)O)=O,16,1,0,1,5,4.7e-05
G5,C(CO)(C1CC(CO)(CO1)O)=O,4,1,0,1,5,4.7e-05
G5,C(C1COC(C=O)(C1CO)O)=O,8,2,0,2,5,9.499999999999999e-05
G5,C1(C(CO)OCC1(CCO)O)=O,4,1,0,1,3,4.7e-05
G5,C1(C(CO)(O)OCC1CCO)=O,4,2,0,2,3,9.499999999999999e-05
G5,C(C1C(C(CO1)(CCO)O)O)=O,8,1,0,1,3,4.7e-05
G5,C(C1COC(CO)(C1CO)O)=O,8,2,0,2,5,9.499999999999999e-05
G5,C(C1C(CO)C(CO)(CO1)O)=O,8,1,0,1,5,4.7e-05
G5,C1(COC(C(CO)=O)C1O)=O,4,1,0,1,15,4.7e-05
G5,C(C1C(C(C(C=O)O1)O)O)=O,10,1,0,1,5,4.7e-05
G5,C(C1C(CC(CO)(O1)O)=O)=O,4,2,0,2,5,9.499999999999999e-05
G5,C1(C(CO)OCC1(C)O)=O,4,1,0,1,49,4.7e-05
G5,C1(C(CO)(O)OCC1C)=O,4,2,0,2,49,9.499999999999999e-05
G5,C(C1C(C(C)(CO1)O)O)=O,8,1,0,1,49,4.7e-05
G5,C(C1COC(C1)(CO)O)=O,4,2,0,2,5,9.499999999999999e-05
G5,C(C1CC(CO)(CO1)O)=O,4,1,0,1,5,4.7e-05
G5,C(C1COC(C)(C1O)O)=O,8,2,0,2,5,9.499999999999999e-05
G5,C1(C(C)(O)OCC1CO)=O,4,2,0,2,5,9.499999999999999e-05
G5,C1(C(C)OCC1(CO)O)=O,4,1,0,1,5,4.7e-05
G5,C(CC1C(C(C(C=O)O1)O)O)=O,16,1,0,1,51,4.7e-05
G5,C(CC1C(CC(CO)(O1)O)=O)=O,4,2,0,2,51,9.499999999999999e-05
G5,C1(CCC(C(C(CO)=O)O)O1)=O,4,1,0,1,51,4.7e-05
G5,C(CO)(C(C1CC(CO1)=O)O)=O,4,1,0,1,51,4.7e-05
G5,C(C1COC(C1C(C=O)O)O)=O,16,2,0,2,5,9.499999999999999e-05
G5,C(C1C(CO)(CO)OC(C1)=O)=O,2,1,0,1,5,4.7e-05
G5,C(C1C(COC1(CO)CO)=O)=O,2,1,0,1,5,4.7e-05
G5,C(C1COC(C1)O)=O,4,2,0,2,27,9.499999999999999e-05
G5,C(C1C(C(CO)OC1C=O)O)=O,16,1,0,1,40,4.7e-05
G5,C(CC1(C(CC(CO)O1)=O)O)=O,4,3,0,3,29,0.00014199999999999998
G5,C(C(C1CC(C(CO)O1)O)=O)=O,8,1,0,1,29,4.7e-05
G5,C(CO)(C1CC(C(CO)O1)O)=O,8,1,0,1,41,4.7e-05
G5,C(C)(C1(CC(C(CO)O1)O)O)=O,8,2,0,2,41,9.499999999999999e-05
G5,C(CC1(CC(C(CO)O1)O)O)=O,8,2,0,2,41,9.499999999999999e-05
G5,C1(C(CCO)OC(CO)C1O)=O,8,1,0,1,3,4.7e-05
G5,C(C1C(CO)C(C(CO)O1)O)=O,16,1,0,1,41,4.7e-05
G5,C(C1C(CC=O)OC(C1O)O)=O,16,2,0,2,41,9.499999999999999e-05
G5,C(C1C(C(CO)O)OC(C1)=O)=O,8,1,0,1,41,4.7e-05
G5,C(C)(C1(C)CC(C(O1)O)=O)=O,4,2,0,2,16,9.499999999999999e-05
G5,C(CC1(C)CC(C(O)O1)=O)=O,4,3,0,3,16,0.00014199999999999998
G5,C1(C(C)OCC1C(C=O)=O)=O,4,1,0,1,45,4.7e-05
G5,C1(C(C)C(C(C=O)=O)CO1)=O,4,1,0,1,42,4.7e-05
G5,C1(C(C)OCC1C(CO)=O)=O,4,1,0,1,45,4.7e-05
G5,C1(C(C)C(C(CO)=O)CO1)=O,4,1,0,1,42,4.7e-05
G5,C1(CCC(CC(C=O)=O)O1)=O,2,1,0,1,20,4.7e-05
G5,C1(COC(CC(C=O)=O)C1)=O,2,1,0,1,20,4.7e-05
G5,C(C1C(C(C)=O)OC(C1)=O)=O,4,1,0,1,45,4.7e-05
G5,C(C1C(C=O)C(C(O1)=O)C)=O,8,1,0,1,45,4.7e-05
G5,C(C1(C)C(C=O)CC(O1)=O)=O,4,1,0,1,45,4.7e-05
G5,C(C1(C)C(C=O)C(CO1)=O)=O,4,1,0,1,45,4.7e-05
G5,C(CC(C1CC(C(O)O1)=O)=O)=O,4,3,0,3,29,0.00014199999999999998
G5,C1(C(O)OC(CC(C=O)=O)C1)=O,4,3,0,3,29,0.00014199999999999998
G5,C1(COC(C1O)CC(C=O)=O)=O,4,1,0,1,0,4.7e-05
G5,C1(CC(C(CC(C=O)=O)O1)O)=O,4,2,0,2,29,9.499999999999999e-05
G5,C(C1CC(C=O)(O)OC1CO)=O,8,2,0,2,51,9.499999999999999e-05
G5,C(C1C(C(C=O)C(C=O)O1)O)=O,16,1,0,1,40,4.7e-05
G5,C(CC(C1C(C(CO1)=O)O)=O)=O,4,1,0,1,1,4.7e-05
G5,C1(CC(C(C(CC=O)=O)O1)O)=O,4,1,0,1,1,4.7e-05
G5,C(C1C(C(C(CC=O)O1)=O)O)=O,8,1,0,1,1,4.7e-05
G5,C(C1CC(C(CC=O)(O)O1)=O)=O,4,2,0,2,0,9.499999999999999e-05
G5,C(C1C(CC(CC=O)(O1)O)=O)=O,4,2,0,2,1,9.499999999999999e-05
G5,C(C1C(C)(COC1C=O)O)=O,8,1,0,1,49,4.7e-05
G5,C(CC1C(C(CO1)(C)O)=O)=O,4,1,0,1,49,4.7e-05
G5,C(CC1(C(C(CO1)C)=O)O)=O,4,2,0,2,49,9.499999999999999e-05
G5,C(CC1(CC(C=O)OC1)O)=O,4,1,0,1,51,4.7e-05
G5,C(C1CC(C(C(C)=O)O1)O)=O,8,1,0,1,49,4.7e-05
G5,C1(C(C)(O)OCC1CC=O)=O,4,2,0,2,0,9.499999999999999e-05
G5,C1(C(COC1C)(CC=O)O)=O,4,1,0,1,0,4.7e-05
G5,C(C1CC(OC1C(C)=O)O)=O,8,2,0,2,49,9.499999999999999e-05
G5,C(C1C(CC(C(C=O)=O)O1)O)=O,8,1,0,1,1,4.7e-05
G5,C(C(C1CC(C)(CO1)O)=O)=O,4,1,0,1,49,4.7e-05
G5,C(C1CC(C)(C(C=O)O1)O)=O,8,1,0,1,55,4.7e-05
G5,C1(CC(C)(OC1C(C)=O)O)=O,4,2,0,2,49,9.499999999999999e-05
G5,C1(CC(C(C)=O)OC1(C)O)=O,4,2,0,2,49,9.499999999999999e-05
G5,C(C1C(C(C(C)O1)=O)O)(C)=O,8,1,0,1,49,4.7e-05
G5,C1(C(C)(OC(C=O)C1C)O)=O,8,2,0,2,49,9.499999999999999e-05
G5,C1(C(C)(C(C=O)OC1C)O)=O,8,1,0,1,49,4.7e-05
G5,C1(CC(C)(C(C(C)=O)O1)O)=O,4,1,0,1,49,4.7e-05
G5,C1(COC(C(C)=O)C1(C)O)=O,4,1,0,1,49,4.7e-05
G5,C(C1C(C(C(O1)O)=O)C)(C)=O,8,2,0,2,49,9.499999999999999e-05
G5,C(C1C(C(CO1)=O)C(CO)=O)=O,4,1,0,1,0,4.7e-05
G5,C1(CC(C(CO)=O)C(C=O)O1)=O,4,1,0,1,0,4.7e-05
G5,C1(CC(C(C=O)=O)CO1)=O,2,1,0,1,0,4.7e-05
G5,C(C1C(COC1C=O)=O)=O,4,1,0,1,43,4.7e-05
G5,C(C1C(C=O)CC(O1)=O)=O,4,1,0,1,43,4.7e-05
G5,C(C1C(CC(C(CO)=O)O1)O)=O,8,1,0,1,41,4.7e-05
G5,C(C1C(CC(C(C)=O)(O1)O)O)=O,8,2,0,2,41,9.499999999999999e-05
G5,C(CC1(CC(C(C=O)O1)O)O)=O,8,2,0,2,41,9.499999999999999e-05
G5,C(CO)(C1CC(CO1)(C)O)=O,4,1,0,1,49,4.7e-05
G5,C(C)(C1(CC(CO1)(C)O)O)=O,4,2,0,2,49,9.499999999999999e-05
G5,C(CC1(CC(CO1)(C)O)O)=O,4,2,0,2,49,9.499999999999999e-05
G5,C(C1CC(C)(C(CO)O1)O)=O,8,1,0,1,52,4.7e-05
G5,C1(C(C)(O)OC(CO)C1C)=O,8,2,0,2,28,9.499999999999999e-05
G5,C1(C(C)OC(CO)C1(C)O)=O,8,1,0,1,28,4.7e-05
G5,C(CO)(C1C(C)OC(C1)=O)=O,4,1,0,1,11,4.7e-05
G5,C(CO)(C1C(COC1C)=O)=O,4,1,0,1,11,4.7e-05
G5,C(CC1C(CC(C=O)O1)O)=O,8,1,0,1,21,4.7e-05
G5,C1(CCC(CO)(CC=O)O1)=O,2,1,0,1,21,4.7e-05
G5,C(CC1(CO)CC(CO1)=O)=O,2,1,0,1,21,4.7e-05
G5,C(C1COC(C(CO)=O)C1O)=O,8,1,0,1,2,4.7e-05
G5,C(C1COC(C(C)=O)(C1O)O)=O,8,2,0,2,2,9.499999999999999e-05
G5,C(CC1(C(C(CO1)O)=O)O)(C)=O,4,2,0,2,0,9.499999999999999e-05
G5,C(CCC1(C(C(CO1)O)=O)O)=O,4,3,0,3,0,0.000143
G5,C1(CC(CO)OC1(C(C)=O)O)=O,4,2,0,2,0,9.499999999999999e-05
G5,C1(CC(CO)OC1C(CO)=O)=O,4,1,0,1,0,4.7e-05
G5,C(C1C(C(CO1)C(CO)O)=O)=O,8,1,0,1,0,4.7e-05
G5,C1(C(CO)(O)OCC1C(C)=O)=O,4,3,0,3,29,0.00014199999999999998
G5,C(CC1(C(CC(C=O)O1)O)O)=O,8,2,0,2,32,9.499999999999999e-05
G5,C1(CC(C=O)OC1C(CO)O)=O,8,1,0,1,32,4.7e-05
G5,C(C1CC(C(C(C)=O)(O1)O)O)=O,8,2,0,2,32,9.499999999999999e-05
G5,C1(C(COC1C(CO)CO)=O)=O,2,1,0,1,2,4.7e-05
G5,C(C1C(C(C(CO)=O)CO1)O)=O,8,1,0,1,30,4.7e-05
G5,C1(C(CO)OCC1C(CO)=O)=O,4,1,0,1,30,4.7e-05
G5,C(CC1(C(CO)C(CO1)O)O)=O,8,2,0,2,54,9.499999999999999e-05
G5,C(C)(C1(C(CO)C(CO1)O)O)=O,8,2,0,2,54,9.499999999999999e-05
G5,C(CO)(C1C(CO)C(CO1)O)=O,8,1,0,1,54,4.7e-05
G5,C(CC1C(C(C(O)O1)CO)O)=O,16,2,0,2,43,9.499999999999999e-05
G5,C(C)(C1C(C(CO)C(O1)O)O)=O,16,2,0,2,43,9.499999999999999e-05
G5,C(C1CC(C(C=O)=O)CO1)=O,4,1,0,1,12,4.7e-05
G5,C(C1CC(C(C=O)=O)OC1)=O,4,1,0,1,55,4.7e-05
G5,C1(CC(C(C(C)=O)=O)CO1)=O,2,1,0,1,30,4.7e-05
G5,C(C1COC(C1)=O)(CC=O)=O,2,1,0,1,30,4.7e-05
G5,C1(C2C(CO)OC1C(CO)O2)=O,10,1,0,1,2,4.7e-05
G5,C1(C2C(CO)C(C(CO)O2)O1)=O,16,1,0,1,41,4.7e-05
G5,C1(CC2C(C(C(O)O2)CO)O1)=O,16,2,0,2,43,9.499999999999999e-05
G5,C1(COC2C(CO)C(OC12)O)=O,16,2,0,2,43,9.499999999999999e-05
G5,C1(C2C(CO)C(OC1CO2)O)=O,16,2,0,2,9,9.499999999999999e-05
G5,C1(CC2(C(CO)C(CO2)O1)O)=O,8,2,0,2,54,9.499999999999999e-05
G5,C1(COC2COC1(C2CO)O)=O,8,2,0,2,54,9.499999999999999e-05
G5,C1(C(O)OC2COC1C2CO)=O,16,1,0,1,54,4.7e-05
G5,C1(C2C(CO)OCC(C1O)O2)=O,16,1,0,1,36,4.7e-05
G5,C1(C2(C(CO)OCC(C1)O2)O)=O,8,2,0,2,36,9.499999999999999e-05
G5,C1(C2COC(CO)C(C1)(O2)O)=O,8,2,0,2,36,9.499999999999999e-05
G5,C1(C2C(CO)C(C(CO1)O2)O)=O,16,1,0,1,41,4.7e-05
G5,C1(COC2C(C(CO)C1O2)O)=O,16,1,0,1,47,4.7e-05
G5,C1(C2OCC(CO)C(C1)(O2)O)=O,8,2,0,2,30,9.499999999999999e-05
G5,C1(C2(C(CO)COC(C1)O2)O)=O,8,2,0,2,30,9.499999999999999e-05
G5,C1(C2C(CO)COC(C1O)O2)=O,16,1,0,1,30,4.7e-05
G5,C(C1C(C(C(CCO)O1)=O)O)=O,8,1,0,1,30,4.7e-05
G5,C(C1C(C(CO)C(C=O)O1)O)=O,16,1,0,1,40,4.7e-05
G5,C1(C(CCO)OCC1(C)O)=O,4,1,0,1,3,4.7e-05
G5,C1(C(CCO)(O)OCC1C)=O,4,2,0,2,3,9.499999999999999e-05
G5,C(C1C(CO)C(C)(CO1)O)=O,8,1,0,1,49,4.7e-05
G5,C(C1CC(CO1)(CCO)O)=O,4,1,0,1,29,4.7e-05
G5,C1(C(C)(O)OCC1CCO)=O,4,2,0,2,3,9.499999999999999e-05
G5,C1(C(C)OCC1(CCO)O)=O,4,1,0,1,3,4.7e-05
G5,C(CC1C(CC(C)(O1)O)=O)=O,4,2,0,2,49,9.499999999999999e-05
G5,C(CC1CC(C(C)(O)O1)=O)=O,4,2,0,2,49,9.499999999999999e-05
G5,C(CC1C(C(C(C)O1)=O)O)=O,8,1,0,1,49,4.7e-05
G5,C1(CC(C(C)(CC=O)O1)O)=O,4,1,0,1,16,4.7e-05
G5,C(CC1(C)C(C(CO1)=O)O)=O,4,1,0,1,16,4.7e-05
G5,C1(C(C)(CC=O)OC(C1)O)=O,4,2,0,2,16,9.499999999999999e-05
G5,C(C(C1C(C=O)CC(O1)=O)O)=O,8,1,0,1,43,4.7e-05
G5,C(C(C1C(C=O)C(CO1)=O)O)=O,8,1,0,1,43,4.7e-05
G5,C(C1CC(C)(CO1)O)=O,4,1,0,1,49,4.7e-05
G5,C1(C(C)OCC1(C)O)=O,4,1,0,1,49,4.7e-05
G5,C1(C(C)(O)OCC1C)=O,4,2,0,2,49,9.499999999999999e-05
G5,C1(CCC(CC(CO)=O)O1)=O,2,1,0,1,21,4.7e-05
G5,C(CO)(CC1CC(CO1)=O)=O,2,1,0,1,21,4.7e-05
G5,C1(CCC(C(C(C)=O)O)O1)=O,4,1,0,1,49,4.7e-05
G5,C(C)(C(C1CC(CO1)=O)O)=O,4,1,0,1,49,4.7e-05
G5,C(C1C(C)(CO)OC(C1)=O)=O,4,1,0,1,49,4.7e-05
G5,C(C1C(COC1(CO)C)=O)=O,4,1,0,1,49,4.7e-05
G5,C(CO)(CC1C(C(CO1)=O)O)=O,4,1,0,1,20,4.7e-05
G5,C1(CC(C(CC(CO)=O)O1)O)=O,4,2,0,2,29,9.499999999999999e-05
G5,C(C(C1C(CC(C=O)O1)O)O)=O,16,1,0,1,20,4.7e-05
G5,C1(CC(C(C(C(C)=O)O)O1)O)=O,8,2,0,2,29,9.499999999999999e-05
G5,C(C(C1C(C(C(C)O1)=O)O)O)=O,16,1,0,1,5,4.7e-05
G5,C(C(C1CC(C(C)(O)O1)=O)O)=O,8,2,0,2,5,9.499999999999999e-05
G5,C(C(C1C(CC(C)(O1)O)=O)O)=O,8,2,0,2,5,9.499999999999999e-05
G5,C(C1CC(CO1)(C(CO)O)O)=O,8,1,0,1,51,4.7e-05
G5,C(C1CC(CO)(C(CO)O1)O)=O,8,1,0,1,29,4.7e-05
G5,C(C1C(CO)OC(C1)(CO)O)=O,8,2,0,2,29,9.499999999999999e-05
G5,C1(C(C)OCC1(C(CO)O)O)=O,8,1,0,1,0,4.7e-05
G5,C1(C(C(CO)O)(O)OCC1C)=O,8,2,0,2,49,9.499999999999999e-05
G5,C1(C(C(CO)O)OCC1(C)O)=O,8,1,0,1,49,4.7e-05
G5,C(CO)(C1C(C(CO1)(C)O)O)=O,8,1,0,1,49,4.7e-05
G5,C(C)(C1(C(C(CO1)(C)O)O)O)=O,8,2,0,2,49,9.499999999999999e-05
G5,C(C1C(COC1C)=O)=O,4,1,0,1,4,4.7e-05
G5,C(CC1CC(CO1)=O)=O,2,1,0,1,43,4.7e-05
G5,C(CO)(C1COC(C1)O)=O,4,2,0,2,35,9.499999999999999e-05
G5,C(C)(C1(COC(C1)O)O)=O,4,2,0,2,35,9.499999999999999e-05
G5,C(C1C(CO)OC(C1)O)=O,8,2,0,2,29,9.499999999999999e-05
G5,C(C1CCC(C=O)(CC=O)O1)=O,4,1,0,1,29,4.7e-05
G5,C(C1CC(C(C=O)=O)C(C)O1)=O,8,1,0,1,12,4.7e-05
G5,C1(CC(C=O)(CC=O)OC1C)=O,4,1,0,1,22,4.7e-05
G5,C1(C(C)OC(C)C1C(C=O)=O)=O,8,1,0,1,45,4.7e-05
G5,C(CC1C(CC(CC=O)O1)=O)=O,4,1,0,1,13,4.7e-05
G5,C(CC1C(C(C=O)C(C)O1)=O)=O,8,1,0,1,4,4.7e-05
G5,C(CC1CCC(C(C=O)=O)O1)=O,4,1,0,1,44,4.7e-05
G5,C(C1CC(C(C=O)=O)OC1C)=O,8,1,0,1,46,4.7e-05
G5,C(C)(C1(CCC(O1)=O)CC=O)=O,2,1,0,1,21,4.7e-05
G5,C(CC1(C(C)=O)CC(CO1)=O)=O,2,1,0,1,21,4.7e-05
G5,C1(CC(C(C(C)=O)=O)C(C)O1)=O,4,1,0,1,14,4.7e-05
G5,C1(COC(C)C1C(C(C)=O)=O)=O,4,1,0,1,14,4.7e-05
G5,C(CC1(CCC(O1)=O)CC=O)=O,1,1,0,1,4,4.7e-05
G5,C(CC1(CC=O)CC(CO1)=O)=O,1,1,0,1,4,4.7e-05
G5,C(C1C(C)OC(C1)=O)(CC=O)=O,4,1,0,1,37,4.7e-05
G5,C(CC=O)(C1C(COC1C)=O)=O,4,1,0,1,37,4.7e-05
G5,C(CC1C(CC(C=C)(O)O1)=O)=O,4,3,0,3,7,0.00014199999999999998
G5,C(CC1CC(C(C=C)(O)O1)=O)=O,4,4,0,4,29,0.00018999999999999998
G5,C(CC1C(C(C(C=C)O1)=O)O)=O,8,2,0,2,29,9.499999999999999e-05
G5,C1(CC(C(C=C)(CC=O)O1)O)=O,4,1,0,1,7,4.7e-05
G5,C(CC1(C=C)C(C(CO1)=O)O)=O,4,1,0,1,7,4.7e-05
G5,C(CC1(C=C)CC(C(O)O1)=O)=O,4,3,0,3,30,0.00014199999999999998
G5,C1(CC(OC1(C=C)CC=O)O)=O,4,4,0,4,53,0.00018999999999999998
G5,C(C1C(C(CO1)O)O)=O,8,1,0,1,27,4.7e-05
G5,C1(CC(C)(C(CO)O1)O)=O,4,2,0,2,29,9.499999999999999e-05
G5,C1(COC(CO)C1(C)O)=O,4,1,0,1,28,4.7e-05
G5,C1(C(O)OC(CO)C1C)=O,8,2,0,2,28,9.499999999999999e-05
G5,C1(CCC(CO)(C(C=O)O)O1)=O,4,1,0,1,20,4.7e-05
G5,C(C(C1(CO)CC(CO1)=O)O)=O,4,1,0,1,20,4.7e-05
G5,C1(CC(CO1)(CC(C=O)O)O)=O,4,2,0,2,29,9.499999999999999e-05
G5,C(C(CC1(C(COC1)=O)O)O)=O,4,1,0,1,12,4.7e-05
G5,C(C(C1C(COC1C=O)O)O)=O,16,1,0,1,0,4.7e-05
G5,C(CO)(C1C(CO)OC(C1)=O)=O,4,1,0,1,0,4.7e-05
G5,C(CO)(C1C(COC1CO)=O)=O,4,1,0,1,0,4.7e-05
G5,C(C(CC1(CC(CO1)=O)O)O)=O,4,2,0,2,0,9.499999999999999e-05
G5,C(C(CC1C(C(CO1)O)=O)O)=O,8,1,0,1,0,4.7e-05
G5,C1(CC(CO1)(CCO)O)=O,2,2,0,2,29,9.499999999999999e-05
G5,C1(COCC1(CCO)O)=O,2,1,0,1,3,4.7e-05
G5,C1(C(O)OCC1CCO)=O,4,2,0,2,3,9.499999999999999e-05
G5,C(C1C(CO)C(CO1)O)=O,8,1,0,1,40,4.7e-05
G5,C1(CC(C(C)(C(C=O)O)O1)O)=O,8,1,0,1,26,4.7e-05
G5,C(C(C1(C)C(C(CO1)=O)O)O)=O,8,1,0,1,26,4.7e-05
G5,C1(C(C)(C(C=O)O)OC(C1)O)=O,8,2,0,2,26,9.499999999999999e-05
G5,C1(CC(C)(C(C(C=O)O)O1)O)=O,8,2,0,2,29,9.499999999999999e-05
G5,C(C(C1C(C(CO1)=O)(C)O)O)=O,8,1,0,1,5,4.7e-05
G5,C(C(C1C(C(C(O)O1)=O)C)O)=O,16,2,0,2,5,9.499999999999999e-05
G5,C(C(CC1(CC(CO1)O)O)=O)=O,4,2,0,2,0,9.499999999999999e-05
G5,C(C(C(C1CC(CO1)O)=O)O)=O,8,1,0,1,0,4.7e-05
G5,C(C1C(C(CO1)=O)O)=O,4,1,0,1,1,4.7e-05
G5,C1(COCC1(C)O)=O,2,1,0,1,27,4.7e-05
G5,C1(C(O)OCC1C)=O,4,2,0,2,27,9.499999999999999e-05
G5,C(C1CC(CO1)O)=O,4,2,0,2,27,9.499999999999999e-05
G5,C1(C(C)OCC1O)=O,4,1,0,1,27,4.7e-05
G5,C(C1C(CO)OC(C1)=O)=O,4,1,0,1,41,4.7e-05
G5,C(C1C(COC1CO)=O)=O,4,1,0,1,41,4.7e-05
G5,C1(CC(CO1)(C(CO)O)O)=O,4,2,0,2,29,9.499999999999999e-05
G5,C1(CC(CO)(C(CO)O1)O)=O,4,2,0,2,29,9.499999999999999e-05
G5,C(C1CC(C(C(CO)O)O1)O)=O,16,1,0,1,49,4.7e-05
G5,C1(C(C(CO)O)OC(C)(C1)O)=O,8,2,0,2,49,9.499999999999999e-05
G5,C1(C(C)(O)OC(C(CO)O)C1)=O,8,2,0,2,49,9.499999999999999e-05
G5,C1(C(C)OC(C(CO)O)C1O)=O,16,1,0,1,49,4.7e-05
G5,C(C(C1C(CO)C(CO1)O)=O)=O,8,1,0,1,54,4.7e-05
G5,C(C1COC(C1)=O)(C(CO)O)=O,4,4,0,4,2,0.00018999999999999998
G5,C(C1CCC(C=O)O1)(O)=O,4,1,0,1,12,4.7e-05
G5,C1(CC(C(O)=O)OC1C)=O,4,1,0,1,45,4.7e-05
G5,C(C1(C)CCC(O1)=O)(O)=O,2,1,0,1,14,4.7e-05
G5,C(C1(C)CC(CO1)=O)(O)=O,2,1,0,1,14,4.7e-05
G5,C1(C(COC1C)=O)=O,2,2,0,2,29,9.499999999999999e-05
G5,C1(C(CC(C)(O)O1)=O)=O,2,2,0,2,17,9.499999999999999e-05
G5,C1(CC(C(C)(O)O1)=O)=O,2,2,0,2,17,9.499999999999999e-05
G5,C1(C(C(C(C)O1)=O)O)=O,4,2,0,2,29,9.499999999999999e-05
G5,C1(C(CC(O)O1)=O)=O,2,2,0,2,0,9.499999999999999e-05
G5,C1(CC(C(O)O1)=O)=O,2,2,0,2,0,9.499999999999999e-05
G5,C(OC1C(C(C)OC1)=O)=O,4,1,0,1,9,4.7e-05
G5,C(OC1CC(C=O)OC1)=O,4,1,0,1,2,4.7e-05
G5,C1(CCC(OCC=O)O1)=O,2,1,0,1,37,4.7e-05
G5,C1(COC(C1)OCC=O)=O,2,1,0,1,37,4.7e-05
G5,C1(C2(C(C(CO2)C1)O)O)=O,8,4,0,4,55,0.00018999999999999998
G5,C1(C2C(C(CO2)C1O)O)=O,16,1,0,1,2,4.7e-05
G5,C(C(C1C(C(CO1)O)O)=O)=O,8,1,0,1,34,4.7e-05
G5,C(C(C1(CC(CO1)=O)O)O)=O,4,2,0,2,34,9.499999999999999e-05
G5,C(C1CCC(O1)=O)=O,2,1,0,1,27,4.7e-05
G5,C1(C(C)OC(C1)=O)=O,2,1,0,1,0,4.7e-05
G5,C1(C(C(C)OC1CO)=O)=O,4,2,0,2,29,9.499999999999999e-05
G5,C1(C(COC1C(C)O)=O)=O,4,2,0,2,29,9.499999999999999e-05
G5,C1(COC(C(C)O)(C1)O)=O,4,2,0,2,4,9.499999999999999e-05
G5,C(C)(C1C(C(CO1)O)O)=O,8,1,0,1,4,4.7e-05
G5,C1(CC(C(C(C)=O)(O)O1)O)=O,4,2,0,2,29,9.499999999999999e-05
G5,C1(C(CC(C(C)O)(O)O1)=O)=O,4,2,0,2,2,9.499999999999999e-05
G5,C1(CC(C(C(C)O)(O)O1)=O)=O,4,2,0,2,2,9.499999999999999e-05
G5,C1(C(C(C(C(C)O)O1)=O)O)=O,8,2,0,2,29,9.499999999999999e-05
G5,C1(COC2C(COC12)O)=O,8,1,0,1,10,4.7e-05
G5,C1(COC2C(C1OC2)O)=O,8,1,0,1,2,4.7e-05
G5,C1(C2C(COC(C1)O2)O)=O,8,1,0,1,38,4.7e-05
G5,C1(C2C(CC(CO1)O2)O)=O,8,1,0,1,41,4.7e-05
G5,C1(C2C(O)OCC(C1)O2)=O,8,3,0,3,26,0.00014199999999999998
G5,C1(C2COC(C(C1)O2)O)=O,8,3,0,3,29,0.00014199999999999998
G5,C(C1C2(CC(CO2)O1)O)=O,8,2,0,2,0,9.499999999999999e-05
G5,C(CC1C(CCO1)=O)=O,2,1,0,1,4,4.7e-05
G5,C(C(C1CCCO1)=O)=O,2,1,0,1,29,4.7e-05
G5,C1(CCC(C(C=O)=O)O1)=O,2,2,0,2,29,9.499999999999999e-05
G5,C(C1C(C2C(CC1(O)O2)O)O)=O,32,2,0,2,2,9.499999999999999e-05
G5,C1(C2C(C(CO)(C(O2)O)C1)O)=O,16,3,0,3,2,0.00014199999999999998
G5,C(C1COC(C1(CO)O)O)=O,8,2,0,2,5,9.499999999999999e-05
G5,C(C1COC(C1(C(C)=O)O)O)=O,8,2,0,2,5,9.499999999999999e-05
G5,C1(C(C(C)=O)C(CO1)(CO)O)=O,4,1,0,1,5,4.7e-05
G5,C(C1COC(C)(C1(C=O)O)O)=O,8,2,0,2,5,9.499999999999999e-05
G5,C(C1COC(C)(C1(CO)O)O)=O,8,2,0,2,5,9.499999999999999e-05
G5,C(C1C(C)(O)OCC1(CO)O)=O,8,2,0,2,5,9.499999999999999e-05
G5,C(C1COC(C1(C=O)O)O)=O,8,2,0,2,5,9.499999999999999e-05
G5,C1(C(C=O)C(CO1)(CO)O)=O,4,2,0,2,29,9.499999999999999e-05
G5,C1(C(CO)C(C(CO)O1)O)=O,8,1,0,1,41,4.7e-05
G5,C(C1C(O)OC(CO)C1O)=O,16,2,0,2,41,9.499999999999999e-05
G5,C(C1C(C(C)(O)OC1)=O)=O,4,2,0,2,24,9.499999999999999e-05
G5,C(C1(C(C(C)OC1)=O)O)=O,4,1,0,1,24,4.7e-05
G5,C(C1CC(OC1(C=O)CO)O)=O,8,2,0,2,38,9.499999999999999e-05
G5,C1(C(CO)C(CO1)(CC=O)O)=O,4,1,0,1,29,4.7e-05
G5,C(C1C(O)OCC1(CC=O)O)=O,8,2,0,2,29,9.499999999999999e-05
G5,C1(C(CO)OC(C1C(C)=O)O)=O,8,2,0,2,19,9.499999999999999e-05
G5,C1(C(C(C)=O)C(C(CO)O1)O)=O,8,1,0,1,19,4.7e-05
G5,C(C1C(C(CO)OC1(C)O)=O)=O,8,2,0,2,1,9.499999999999999e-05
G5,C(C1C(C(C(C)=O)OC1O)O)=O,16,2,0,2,35,9.499999999999999e-05
G5,C(C1(CO)C(C)(CC(O1)=O)O)=O,4,1,0,1,19,4.7e-05
G5,C(C1(CO)C(C(CO1)=O)(C)O)=O,4,1,0,1,19,4.7e-05
G5,C(C1(CO)C(C(C(O1)O)=O)C)=O,8,2,0,2,19,9.499999999999999e-05
G5,C1(C(CO)C(C)(C(C=O)O1)O)=O,8,1,0,1,19,4.7e-05
G5,C(C1C(OC(C=O)C1(C)O)O)=O,16,2,0,2,19,9.499999999999999e-05
G5,C(C1C(C)(O)OC(CO)C1O)=O,16,2,0,2,41,9.499999999999999e-05
G5,C1(C(CO)C(C)(C(CO)O1)O)=O,8,1,0,1,28,4.7e-05
G5,C(C1C(O)OC(CO)C1(C)O)=O,16,2,0,2,28,9.499999999999999e-05
G5,C(C1(C(C(CCO)OC1)=O)O)=O,4,1,0,1,7,4.7e-05
G5,C1(C(CCO)C(C=O)(CO1)O)=O,4,1,0,1,41,4.7e-05
G5,C1(C(CO)C(CO1)(CCO)O)=O,4,1,0,1,3,4.7e-05
G5,C(C1C(O)OCC1(CCO)O)=O,8,2,0,2,3,9.499999999999999e-05
G5,C(C1C(C(CO)OC1O)=O)=O,8,2,0,2,1,9.499999999999999e-05
G5,C1(C(C=O)C(C(CO)O1)O)=O,8,2,0,2,29,9.499999999999999e-05
G5,C(C1(C(CC(O1)O)=O)CO)=O,4,2,0,2,1,9.499999999999999e-05
G5,C(C1(CO)C(C(CO1)=O)O)=O,4,1,0,1,1,4.7e-05
G5,C(C1(CO)C(CC(O1)=O)O)=O,4,1,0,1,1,4.7e-05
G5,C1(C(CO)C(C(C=O)O1)O)=O,8,1,0,1,1,4.7e-05
G5,C(C1C(C(C=O)OC1O)O)=O,16,2,0,2,1,9.499999999999999e-05
G5,C(C1C(C(CO)C(O1)O)=O)=O,8,2,0,2,1,9.499999999999999e-05
G5,C1(C(CO)C(C)(CO1)O)=O,4,1,0,1,49,4.7e-05
G5,C(C1C(O)OCC1(C)O)=O,8,2,0,2,49,9.499999999999999e-05
G5,C(C1C(O)OC(C1O)CC=O)=O,16,2,0,2,43,9.499999999999999e-05
G5,C1(C(C)OCC1(C(C)=O)O)=O,4,1,0,1,0,4.7e-05
G5,C1(C(C)(O)OCC1C(C)=O)=O,4,2,0,2,0,9.499999999999999e-05
G5,C1(C(C)C(C(C)=O)(CO1)O)=O,4,1,0,1,45,4.7e-05
G5,C(C1C(C(O)OC1C(C)=O)=O)=O,8,2,0,2,0,9.499999999999999e-05
G5,C(C1(C(COC1C(C)=O)=O)O)=O,4,1,0,1,0,4.7e-05
G5,C1(CC(C=O)(C(C(C)=O)O1)O)=O,4,2,0,2,29,9.499999999999999e-05
G5,C1(C(C)OC(C=O)C1(C=O)O)=O,8,1,0,1,0,4.7e-05
G5,C1(C(C)(OC(C=O)C1C=O)O)=O,8,2,0,2,0,9.499999999999999e-05
G5,C(C1(C)C(C=O)C(C(O1)O)=O)=O,8,2,0,2,45,9.499999999999999e-05
G5,C(C1(C)C(C=O)(C(CO1)=O)O)=O,4,1,0,1,45,4.7e-05
G5,C1(CC(C=O)(C(C=O)(C)O1)O)=O,4,2,0,2,29,9.499999999999999e-05
G5,C1(C(C)C(C=O)(C(C=O)O1)O)=O,8,1,0,1,45,4.7e-05
G5,C1(C(C)OCC1(C(CO)=O)O)=O,4,1,0,1,0,4.7e-05
G5,C1(C(C)C(C(CO)=O)(CO1)O)=O,4,1,0,1,42,4.7e-05
G5,C(C1(C=O)C(CC(C=O)O1)O)=O,4,1,0,1,40,4.7e-05
G5,C1(C(C=O)C(CO1)(CC=O)O)=O,4,2,0,2,29,9.499999999999999e-05
G5,C(C1(C=O)C(C=O)CC(O1)O)=O,4,2,0,2,1,9.499999999999999e-05
G5,C(C1C(C(C(C)=O)OC1O)=O)=O,8,2,0,2,1,9.499999999999999e-05
G5,C(C1(C=O)C(CC(C)(O1)O)=O)=O,2,2,0,2,1,9.499999999999999e-05
G5,C(C1(C=O)CC(C(C)(O1)O)=O)=O,2,2,0,2,1,9.499999999999999e-05
G5,C(C1(C=O)C(C(C(C)O1)=O)O)=O,4,1,0,1,1,4.7e-05
G5,C1(C(C=O)C(C)(C(C=O)O1)O)=O,8,2,0,2,29,9.499999999999999e-05
G5,C(C1(C=O)C(C)(CC(O1)=O)O)=O,2,1,0,1,1,4.7e-05
G5,C(C1(C=O)C(C(CO1)=O)(C)O)=O,2,1,0,1,1,4.7e-05
G5,C(C1(C=O)C(C(C(O1)O)=O)C)=O,4,2,0,2,1,9.499999999999999e-05
G5,C1(CC(OC1(C=O)C(C)=O)O)=O,4,2,0,2,1,9.499999999999999e-05
G5,C(C1(C(C)=O)CC(C(O1)O)=O)=O,4,2,0,2,1,9.499999999999999e-05
G5,C(C1(C(C)=O)C(C(CO1)=O)O)=O,4,1,0,1,1,4.7e-05
G5,C1(CC(C(C=O)(C(C)=O)O1)O)=O,4,1,0,1,1,4.7e-05
G5,C(C1C(C(C(O1)=O)C(C)=O)O)=O,8,1,0,1,1,4.7e-05
G5,C1(C(C=O)OC(C1C(C)=O)O)=O,8,2,0,2,1,9.499999999999999e-05
G5,C(C1C(C(C=O)OC1(C)O)=O)=O,8,2,0,2,1,9.499999999999999e-05
G5,C1(C(C(C)=O)C(C)(CO1)O)=O,4,1,0,1,49,4.7e-05
G5,C(C1C(C(CO1)=O)(C(C)=O)O)=O,4,1,0,1,0,4.7e-05
G5,C(C1C(C(C)=O)C(C(O)O1)=O)=O,8,2,0,2,0,9.499999999999999e-05
G5,C1(CC(C(C)=O)(C(C=O)O1)O)=O,4,1,0,1,0,4.7e-05
G5,C(C1C(C(O)OC1C=O)=O)=O,8,2,0,2,0,9.499999999999999e-05
G5,C(C1(C(COC1C=O)=O)O)=O,4,1,0,1,0,4.7e-05
G5,C1(CC(C=O)(C(C=O)O1)O)=O,4,2,0,2,29,9.499999999999999e-05
G5,C(CO)(C1(COC(C1)=O)O)=O,2,1,0,1,5,4.7e-05
G5,C1(C(C(CO1)=O)(C(CO)O)O)=O,4,2,0,2,29,9.499999999999999e-05
G5,C1(C(C(C(O)O1)=O)C(CO)O)=O,8,2,0,2,0,9.499999999999999e-05
G5,C1(C(C(CO)O)(CC(O1)=O)O)=O,4,1,0,1,0,4.7e-05
G5,C1(C(C(CO)=O)C(C(O)O1)O)=O,8,2,0,2,0,9.499999999999999e-05
G5,C1(C(C(C)=O)(C(C(O)O1)O)O)=O,8,2,0,2,0,9.499999999999999e-05
G5,C1(C(C(C(O)O1)O)(CC=O)O)=O,8,2,0,2,0,9.499999999999999e-05
G5,C(C1(C(CO)OC(C1)=O)O)(O)=O,4,1,0,1,0,4.7e-05
G5,C1(C(C=O)C(C)(C(CO)O1)O)=O,8,2,0,2,29,9.499999999999999e-05
G5,C(C1C(C(C=O)OC1(C)O)O)=O,16,2,0,2,1,9.499999999999999e-05
G5,C(C1C(C)(O)OCC1(C)O)=O,8,2,0,2,49,9.499999999999999e-05
G5,C(C1C(C(C(C)=O)(CO1)O)O)=O,8,1,0,1,2,4.7e-05
G5,C1(C(CO)OCC1(C(C)=O)O)=O,4,1,0,1,2,4.7e-05
G5,C(C1C(C(C(C)O)(O)OC1)=O)=O,8,2,0,2,4,9.499999999999999e-05
G5,C(C1(C(C(C(C)O)OC1)=O)O)=O,8,1,0,1,25,4.7e-05
G5,C(C1(COC(C(C)=O)C1O)O)=O,8,1,0,1,25,4.7e-05
G5,C(C1(COC(C1)=O)O)(C(C)O)=O,4,1,0,1,12,4.7e-05
G5,C(C1C(COC1(CCO)O)O)=O,8,2,0,2,9,9.499999999999999e-05
G5,C(C1C(O)OC(C1O)CCO)=O,16,2,0,2,29,9.499999999999999e-05
G5,C(C1C2C(CO)OC1(CO2)O)=O,16,2,0,2,2,9.499999999999999e-05
G5,C(C1C2COC1(CC(O)O2)O)=O,16,2,0,2,9,9.499999999999999e-05
G5,C(C1C(O)OC2COC1(C2)O)=O,16,3,0,3,2,0.00014199999999999998
G5,C(C1C2(COCC(C1O)O2)O)=O,16,2,0,2,36,9.499999999999999e-05
G5,C(C1COC2C(CC1(O)O2)O)=O,16,2,0,2,2,9.499999999999999e-05
G5,C(C1C(C2OC1(CCO2)O)O)=O,16,2,0,2,30,9.499999999999999e-05
G5,C(C1C(C(C=C)(O)OC1)=O)=O,4,3,0,3,2,0.00014199999999999998
G5,C(C1(C(C(C=C)OC1)=O)O)=O,4,1,0,1,7,4.7e-05
G5,C1(CC(C(C=C)=O)(CO1)O)=O,2,1,0,1,12,4.7e-05
G5,C1(COCC1(C(C=C)=O)O)=O,2,1,0,1,12,4.7e-05
G5,C1(C(O)OCC1C(C=C)=O)=O,4,3,0,3,29,0.00014199999999999998
G5,C(C1C(O)OC2C1OC(C2)O)=O,32,2,0,2,43,9.499999999999999e-05
G5,C1(C(C=O)C(CO1)(CCO)O)=O,4,2,0,2,29,9.499999999999999e-05
G5,C(C1C(C(C)(O)OC1C)=O)=O,8,2,0,2,4,9.499999999999999e-05
G5,C(C1(C(C(C)OC1C)=O)O)=O,8,1,0,1,0,4.7e-05
G5,C(C)(C1(C(C)OC(C1)=O)O)=O,4,1,0,1,11,4.7e-05
G5,C(C)(C1(C(COC1C)=O)O)=O,4,1,0,1,11,4.7e-05
G5,C(C1C(C(C=O)OC1O)=O)=O,8,2,0,2,1,9.499999999999999e-05
G5,C1(C(C=O)C(C(C=O)O1)O)=O,8,2,0,2,29,9.499999999999999e-05
G5,C(C1(C=O)C(CC(O1)O)=O)=O,2,2,0,2,1,9.499999999999999e-05
G5,C(C1(C=O)CC(C(O1)O)=O)=O,2,2,0,2,1,9.499999999999999e-05
G5,C(C1(C=O)C(C(CO1)=O)O)=O,2,1,0,1,1,4.7e-05
G5,C(C1(C=O)C(CC(O1)=O)O)=O,2,1,0,1,1,4.7e-05
G5,C(CC1C(C(C=O)C(O1)O)=O)=O,8,2,0,2,43,9.499999999999999e-05
G5,C(C(C=O)(C1CCC(O1)=O)O)=O,2,1,0,1,1,4.7e-05
G5,C(C(C=O)(C1CC(CO1)=O)O)=O,2,1,0,1,1,4.7e-05
G5,C1(C(C(C)(CO1)O)C(C=O)O)=O,8,2,0,2,29,9.499999999999999e-05
G5,C(C(C1C(O)OCC1(C)O)=O)=O,8,2,0,2,49,9.499999999999999e-05
G5,C(C1C(C(O)OC1(CO)C)=O)=O,8,2,0,2,49,9.499999999999999e-05
G5,C(C1(C(COC1(CO)C)=O)O)=O,4,1,0,1,49,4.7e-05
G5,C(C1(C(CO)(C)OC(C1)=O)O)=O,4,2,0,2,29,9.499999999999999e-05
G5,C(C1C(CO)(C(C)(CO1)O)O)=O,8,1,0,1,49,4.7e-05
G5,C(C1(C(COC1C)=O)O)=O,4,1,0,1,25,4.7e-05
G5,C(C1C(C(C=C)(O)OC1C)=O)=O,8,3,0,3,7,0.00014199999999999998
G5,C(C1(C(C(C=C)OC1C)=O)O)=O,8,1,0,1,7,4.7e-05
G5,C1(CC(C(C=C)=O)(C(C)O1)O)=O,4,1,0,1,12,4.7e-05
G5,C1(COC(C)C1(C(C=C)=O)O)=O,4,1,0,1,12,4.7e-05
G5,C1(C(O)OC(C)C1C(C=C)=O)=O,8,3,0,3,30,0.00014199999999999998
G5,C(C1C(O)OCC1O)=O,8,2,0,2,27,9.499999999999999e-05
G5,C1(COC(C)(C1CO)O)=O,4,2,0,2,0,9.499999999999999e-05
G5,C(C1C(C)(O)OCC1O)=O,8,2,0,2,0,9.499999999999999e-05
G5,C(C(C)=O)(C1C(O)OCC1O)=O,8,2,0,2,0,9.499999999999999e-05
G5,C(C1C(C(C)(O)OC1CO)=O)=O,8,2,0,2,0,9.499999999999999e-05
G5,C(C1(C(C(C)OC1CO)=O)O)=O,8,1,0,1,0,4.7e-05
G5,C1(COC(C)(C1C(C=O)O)O)=O,8,2,0,2,0,9.499999999999999e-05
G5,C(C(C1C(C)(O)OCC1O)=O)=O,8,2,0,2,0,9.499999999999999e-05
G5,C(C)(C1(C(CO)OC(C1)=O)O)=O,4,1,0,1,0,4.7e-05
G5,C(C)(C1(C(COC1CO)=O)O)=O,4,1,0,1,0,4.7e-05
G5,C(C)(C1C(C(O)OC1CO)=O)=O,8,2,0,2,0,9.499999999999999e-05
G5,C(C(C1C(O)OCC1O)=O)=O,8,2,0,2,0,9.499999999999999e-05
G5,C(C1C(C(O)OC1CO)=O)=O,8,2,0,2,0,9.499999999999999e-05
G5,C(C1(C(COC1CO)=O)O)=O,4,1,0,1,0,4.7e-05
G5,C(C1(C(CO)OC(C1)=O)O)=O,4,2,0,2,29,9.499999999999999e-05
G5,C1(C(C)C(C=O)(C(CO)O1)O)=O,8,1,0,1,45,4.7e-05
G5,C(C(C)C1(C(O)OCC1O)O)=O,16,2,0,2,49,9.499999999999999e-05
G5,C1(C(C(CO)O)C(C)(CO1)O)=O,8,2,0,2,49,9.499999999999999e-05
G5,C(C)(C1C(O)OCC1O)=O,8,2,0,2,4,9.499999999999999e-05
G5,C(C1C(CC=O)(O)OCC1O)=O,8,2,0,2,9,9.499999999999999e-05
G5,C(C1(COC(C1)=O)O)(CCO)=O,2,2,0,2,19,9.499999999999999e-05
G5,C1(C2C(CC1C(O2)O)O)=O,16,3,0,3,41,0.00014199999999999998
G5,C1(C2CC(C(C2O)O1)O)=O,16,1,0,1,43,4.7e-05
G5,C1(CC2CC1(C(O)O2)O)=O,8,3,0,3,43,0.00014199999999999998
G5,C1(C(C2CC1C(O)O2)O)=O,16,3,0,3,41,0.00014199999999999998
G5,C1(C2CC(C(C2O)O)O1)=O,16,1,0,1,43,4.7e-05
G5,C(C1COC(C1(CC=O)O)O)=O,8,2,0,2,43,9.499999999999999e-05
G5,C1(C(C(CO1)(CO)O)CC=O)=O,4,1,0,1,43,4.7e-05
G5,C1(C(C(OC1CO)O)CC=O)=O,8,2,0,2,41,9.499999999999999e-05
G5,C1(C(C(C(CO)O1)O)CC=O)=O,8,1,0,1,41,4.7e-05
G5,C(C1(C(CC=O)OC(C1)O)O)=O,8,2,0,2,41,9.499999999999999e-05
G5,C1(C(C)C(C(O1)=O)O)=O,4,1,0,1,45,4.7e-05
G5,C1(C(C(C)C(O)O1)=O)=O,4,2,0,2,45,9.499999999999999e-05
G5,C(C1CC(OC1C(O)=O)O)=O,8,2,0,2,29,9.499999999999999e-05
G5,C1(CC(C)(C(C(O)=O)O1)O)=O,4,1,0,1,29,4.7e-05
G5,C1(COC(C(O)=O)C1(C)O)=O,4,1,0,1,29,4.7e-05
G5,C1(C(OC(C(O)=O)C1C)O)=O,8,2,0,2,29,9.499999999999999e-05
G5,C(C1CC(C=O)(C(C=O)O1)O)=O,8,1,0,1,51,4.7e-05
G5,C(C1(COC(C=O)C1)O)=O,4,1,0,1,2,4.7e-05
G5,C(C1(CC(C=O)OC1C)O)=O,8,1,0,1,41,4.7e-05
G5,C(CC1(C(C(O)OC1)=O)O)(C)=O,4,2,0,2,20,9.499999999999999e-05
G5,C(CCC1(C(C(O)OC1)=O)O)=O,4,3,0,3,20,0.000143
G5,C(C1CC(CO)OC1(C=O)O)=O,8,2,0,2,0,9.499999999999999e-05
G5,C(C1C(OC(C(CO)=O)C1)O)=O,8,2,0,2,43,9.499999999999999e-05
G5,C1(C(CO)CC(C(CO)=O)O1)=O,4,1,0,1,43,4.7e-05
G5,C(C1CC(C=O)OC1(CO)O)=O,8,2,0,2,32,9.499999999999999e-05
G5,C(C1CC(CO)(C(C=O)O1)O)=O,8,1,0,1,32,4.7e-05
G5,C(C1C(C(C=O)O)(O)OCC1)=O,8,2,0,2,2,9.499999999999999e-05
G5,C(C(C1C(CO)(CCO1)O)=O)=O,4,1,0,1,2,4.7e-05
G5,C(C1CC(C(CO)=O)(CO1)O)=O,4,1,0,1,32,4.7e-05
G5,C(C1C(O)OC(C1)C(C=O)O)=O,16,2,0,2,43,9.499999999999999e-05
G5,C1(C(CO)CC(C(C=O)O)O1)=O,8,1,0,1,43,4.7e-05
G5,C(C1C2(CC(C(CO)O2)O1)O)=O,16,2,0,2,2,9.499999999999999e-05
G5,C(C1C2(CC(C(CO1)O2)O)O)=O,16,2,0,2,41,9.499999999999999e-05
G5,C1(C(CCO)C(C(O1)=O)O)=O,4,1,0,1,29,4.7e-05
G5,C1(C(C(C(O)O1)CCO)=O)=O,4,2,0,2,29,9.499999999999999e-05
G5,C1(C(C(OC1C=O)O)CC=O)=O,8,2,0,2,1,9.499999999999999e-05
G5,C1(C(C(C(C=O)O1)O)CC=O)=O,8,1,0,1,1,4.7e-05
G5,C1(CC(OC1(C=O)CC=O)O)=O,4,2,0,2,29,9.499999999999999e-05
G5,C(CC1(C=O)CC(C(O)O1)=O)=O,4,2,0,2,1,9.499999999999999e-05
G5,C(CC1(C=O)C(C(CO1)=O)O)=O,4,1,0,1,1,4.7e-05
G5,C1(CC(C(C=O)(CC=O)O1)O)=O,4,1,0,1,1,4.7e-05
G5,C1(CC(C(C(O)=O)O1)O)=O,4,1,0,1,17,4.7e-05
G5,C1(C(C(C)(CO1)O)CC=O)=O,4,1,0,1,49,4.7e-05
G5,C(C1(CC(C=O)OC1CO)O)=O,8,1,0,1,51,4.7e-05
G5,C(C1(COC(C(CO)=O)C1)O)=O,4,1,0,1,14,4.7e-05
G5,C(CO)(OC1C(COC1)=O)=O,2,1,0,1,50,4.7e-05
G5,C1(C(C2CC1CO2)=O)=O,4,1,0,1,47,4.7e-05
G5,C1(COC2(CC1OC2)O)=O,4,2,0,2,2,9.499999999999999e-05
G5,C1(C2(CCOC1CO2)O)=O,4,2,0,2,2,9.499999999999999e-05
G5,C1(C2(COC1CCO2)O)=O,4,2,0,2,2,9.499999999999999e-05
G5,C1(CC2C(C(CO2)O1)=O)=O,4,2,0,2,29,9.499999999999999e-05
G5,C1(C(C2CC(CO2)O1)=O)=O,4,2,0,2,29,9.499999999999999e-05
G5,C1(C2C(C(C(CO)O2)O1)O)=O,16,2,0,2,29,9.499999999999999e-05
G5,C1(C2C(CO)OC1C(O2)O)=O,16,2,0,2,5,9.499999999999999e-05
G5,C1(CC2(C(CCO2)O1)O)=O,4,2,0,2,2,9.499999999999999e-05
G5,C1(COC2CCOC12O)=O,4,2,0,2,2,9.499999999999999e-05
G5,C1(C(O)OC2CCOC12)=O,8,2,0,2,2,9.499999999999999e-05
G5,C1(C2C(C(C(CO2)O)O1)O)=O,16,2,0,2,29,9.499999999999999e-05
G5,C1(C2C(COC1C(O2)O)O)=O,16,2,0,2,5,9.499999999999999e-05
G5,C1(CC2CC(C(O)O2)O1)=O,8,2,0,2,37,9.499999999999999e-05
G5,C1(COC2CC1OC2O)=O,8,2,0,2,37,9.499999999999999e-05
G5,C1(C2C(C(C(CO1)O2)O)O)=O,16,2,0,2,29,9.499999999999999e-05
G5,C1(C2C(O)OCC(C1O)O2)=O,16,2,0,2,2,9.499999999999999e-05
G5,C1(C2(C(O)OCC(C1)O2)O)=O,8,3,0,3,2,0.00014199999999999998
G5,C1(C2COC(C(C1)(O2)O)O)=O,8,3,0,3,2,0.00014199999999999998
G5,C1(CC2C(CC(O2)=O)O1)=O,3,2,0,2,29,9.499999999999999e-05
G5,C1(CC2C(C(CO2)=O)O1)=O,4,2,0,2,29,9.499999999999999e-05
G5,C(CC1CC(C(C=O)=O)OC1)=O,4,1,0,1,55,4.7e-05
G5,C(CC1CC(C=O)OC1C=O)=O,8,1,0,1,32,4.7e-05
G5,C1(C(COC(C1C)O)=O)=O,4,2,0,2,2,9.499999999999999e-05
G5,C1(C(C)C(C(CO1)=O)O)=O,4,1,0,1,2,4.7e-05
G5,C(C1COC(C(C1)=O)O)=O,4,2,0,2,5,9.499999999999999e-05
G5,C1(CC(CC(CO)(CO)O1)=O)=O,1,1,0,1,5,4.7e-05
G5,C1(C(COC(CO)(CO)C1)=O)=O,1,1,0,1,5,4.7e-05
G5,C1(COCC(C1O)=O)=O,1,1,0,1,5,4.7e-05
G5,C1(C(CO)OCC(C1(C)O)O)=O,8,1,0,1,5,4.7e-05
G5,C1(C(CO)(O)OCC(C1C)O)=O,8,2,0,2,5,9.499999999999999e-05
G5,C(C1C(C(C)(C(CO1)O)O)O)=O,16,1,0,1,5,4.7e-05
G5,C1(COC(CO)(C(C1C)O)O)=O,8,2,0,2,5,9.499999999999999e-05
G5,C1(C(COC(CCO)(C1)O)=O)=O,2,2,0,2,5,9.499999999999999e-05
G5,C1(C(CCO)(OCC(C1)=O)O)=O,2,2,0,2,5,9.499999999999999e-05
G5,C1(C(CCO)OCC(C1O)=O)=O,4,1,0,1,5,4.7e-05
G5,C1(C(COC(C1CCO)O)=O)=O,4,2,0,2,5,9.499999999999999e-05
G5,C1(C(CCO)C(C(CO1)=O)O)=O,4,1,0,1,5,4.7e-05
G5,C(C1(C(C(CO)OCC1)=O)O)=O,4,1,0,1,5,4.7e-05
G5,C(C1C(C(CO)(O)OCC1)=O)=O,4,2,0,2,5,9.499999999999999e-05
G5,C(C1(C(C(C=O)OCC1)O)O)=O,8,1,0,1,5,4.7e-05
G5,C(C1COC(C(C1CO)=O)O)=O,8,2,0,2,5,9.499999999999999e-05
G5,C1(C(CO)OCCC1(CO)O)=O,4,1,0,1,55,4.7e-05
G5,C1(C(CO)(O)OCCC1CO)=O,4,2,0,2,55,9.499999999999999e-05
G5,C(C1C(C(CO)(CCO1)O)O)=O,8,1,0,1,55,4.7e-05
G5,C(C1CCOC(CO)(C1O)O)=O,8,2,0,2,55,9.499999999999999e-05
G5,C1(CCC(OC1C(CO)=O)O)=O,4,2,0,2,51,9.499999999999999e-05
G5,C1(CC(C(CO)=O)OC(C1)O)=O,4,2,0,2,51,9.499999999999999e-05
G5,C1(CCC(C(C(CO)=O)O1)O)=O,4,1,0,1,51,4.7e-05
G5,C1(COC(C(CO)=O)C(C1)O)=O,4,2,0,2,29,9.499999999999999e-05
G5,C(C1C(C(CC(C=O)O1)O)O)=O,16,2,0,2,29,9.499999999999999e-05
G5,C1(CC(C=O)OC(CO)(C1)O)=O,4,3,0,3,29,0.00014199999999999998
G5,C(C1C(C(O)OCC1C=O)O)=O,16,2,0,2,51,9.499999999999999e-05
G5,C(C1C(COC(C1)=O)(CO)O)=O,4,1,0,1,51,4.7e-05
G5,C(C1C(COCC1(CO)O)=O)=O,4,1,0,1,51,4.7e-05
G5,C1(CCOC(C1C(CO)=O)O)=O,4,2,0,2,41,9.499999999999999e-05
G5,C(CO)(C1C(OCC(C1)=O)O)=O,4,3,0,3,51,0.00014199999999999998
G5,C(C1C(CO)(OCC(C1)=O)O)=O,4,3,0,3,32,0.00014199999999999998
G5,C(C1C(C(COC1C=O)O)O)=O,16,1,0,1,30,4.7e-05
G5,C(CC1(C(CC(CO1)=O)O)O)=O,4,3,0,3,29,0.00014199999999999998
G5,C(CC1(C(CC(CO1)O)=O)O)=O,4,3,0,3,29,0.00014199999999999998
G5,C(CC1C(C(C(CO1)O)O)=O)=O,8,1,0,1,3,4.7e-05
G5,C(CC1C(C(CC(O)O1)=O)O)=O,8,2,0,2,49,9.499999999999999e-05
G5,C(C(C1(CCC(CO1)=O)O)O)=O,4,2,0,2,41,9.499999999999999e-05
G5,C(C(C1CC(C(CO1)O)O)=O)=O,8,1,0,1,41,4.7e-05
G5,C(CC1CC(C(C(O)O1)O)=O)=O,8,2,0,2,29,9.499999999999999e-05
G5,C1(CC(CC(C(CO)O)O1)=O)=O,4,1,0,1,29,4.7e-05
G5,C1(C(COC(C(CO)O)C1)=O)=O,4,1,0,1,29,4.7e-05
G5,C1(COC(CC1)(C(CO)O)O)=O,4,2,0,2,29,9.499999999999999e-05
G5,C(CO)(C1CC(C(CO1)O)O)=O,8,1,0,1,41,4.7e-05
G5,C(C)(C1(CC(C(CO1)O)O)O)=O,8,2,0,2,41,9.499999999999999e-05
G5,C(CC1(CC(C(CO1)O)O)O)=O,8,2,0,2,41,9.499999999999999e-05
G5,C1(C(CCO)(O)OCC(C1)O)=O,4,2,0,2,3,9.499999999999999e-05
G5,C1(C(CCO)OCC(C1O)O)=O,8,1,0,1,3,4.7e-05
G5,C(C1C(CO)C(C(CO1)O)O)=O,16,1,0,1,41,4.7e-05
G5,C(C1C(C(CO)OC(C1)=O)O)=O,8,1,0,1,37,4.7e-05
G5,C1(C(C(O)OCC1)C(C=O)O)=O,8,2,0,2,41,9.499999999999999e-05
G5,C(C(C1C(OCC(C1)=O)O)O)=O,8,3,0,3,12,0.000143
G5,C1(C(C)OCC(C1C=O)=O)=O,4,1,0,1,24,4.7e-05
G5,C(C1C(COC(C1C)=O)=O)=O,4,1,0,1,16,4.7e-05
G5,C1(C(C=O)OC(C(C1)=O)C)=O,4,1,0,1,29,4.7e-05
G5,C1(CC(CC(C(C)=O)O1)=O)=O,2,1,0,1,29,4.7e-05
G5,C(C)(C1CC(C(CO1)=O)=O)=O,2,1,0,1,29,4.7e-05
G5,C(C1C(CC(C(O1)=O)C)=O)=O,4,1,0,1,16,4.7e-05
G5,C(C1(C)CC(CC(O1)=O)=O)=O,2,1,0,1,16,4.7e-05
G5,C(C1(C)CC(C(CO1)=O)=O)=O,2,1,0,1,16,4.7e-05
G5,C(C1(CC(C(CO1)=O)C)O)=O,4,2,0,2,29,9.499999999999999e-05
G5,C1(C(CO)OC(C(C1)=O)C)=O,4,1,0,1,45,4.7e-05
G5,C1(C(C)CC(C(CO)O1)=O)=O,4,1,0,1,16,4.7e-05
G5,C(C1CC(C=O)(O)OCC1)=O,4,2,0,2,29,9.499999999999999e-05
G5,C1(C(C)OCC(C1CO)=O)=O,4,1,0,1,45,4.7e-05
G5,C1(C(C)C(C(CO1)=O)CO)=O,4,1,0,1,16,4.7e-05
G5,C1(CC(C(OC1)=O)C)=O,2,1,0,1,16,4.7e-05
G5,C(C1CC(CC(C=O)(O)O1)=O)=O,4,2,0,2,0,9.499999999999999e-05
G5,C1(CCC(C=O)(OC1C=O)O)=O,4,2,0,2,0,9.499999999999999e-05
G5,C(C1C(CO)OC(C(C1)=O)O)=O,8,2,0,2,51,9.499999999999999e-05
G5,C(C1CC(C=O)(O)OCC1O)=O,8,2,0,2,51,9.499999999999999e-05
G5,C1(C(C)C(C(C(CO)O1)=O)O)=O,8,1,0,1,2,4.7e-05
G5,C1(C(C(CO)OC(C1C)O)=O)=O,8,2,0,2,2,9.499999999999999e-05
G5,C(C1C(COCC1=O)=O)=O,1,1,0,1,15,4.7e-05
G5,C(C1C(COC(C1)=O)=O)=O,2,1,0,1,15,4.7e-05
G5,C(C1CC(C(CO1)=O)=O)=O,2,1,0,1,15,4.7e-05
G5,C1(CC(C(C=O)O)OC(C1)=O)=O,4,1,0,1,1,4.7e-05
G5,C(C(C1CC(C(CO1)=O)=O)O)=O,4,1,0,1,1,4.7e-05
G5,C1(CC(CC(C)(CO)O1)=O)=O,2,1,0,1,49,4.7e-05
G5,C1(C(COC(CO)(C)C1)=O)=O,2,1,0,1,49,4.7e-05
G5,C1(C(COC(C)C1)=O)=O,2,1,0,1,4,4.7e-05
G5,C1(C(CO)OCC(C1O)=O)=O,4,1,0,1,5,4.7e-05
G5,C1(C(C(CO)OC(C1)O)=O)=O,4,2,0,2,5,9.499999999999999e-05
G5,C1(COC(CO)(CC1C)O)=O,4,2,0,2,52,9.499999999999999e-05
G5,C(C1CC(C)(C(CO1)O)O)=O,8,1,0,1,52,4.7e-05
G5,C1(COC(C)(C(C1C)O)O)=O,8,2,0,2,28,9.499999999999999e-05
G5,C1(C(C)(O)OCC(C1C)O)=O,8,2,0,2,28,9.499999999999999e-05
G5,C1(C(C)OCC(C1(C)O)O)=O,8,1,0,1,28,4.7e-05
G5,C1(COC(CC1C)O)=O,4,2,0,2,17,9.499999999999999e-05
G5,C(C1CC(C=O)OC(C1)O)=O,8,2,0,2,21,9.499999999999999e-05
G5,C1(CC(COC1(C(C)=O)O)O)=O,4,2,0,2,29,9.499999999999999e-05
G5,C1(CC(COC1C(CO)=O)O)=O,4,1,0,1,0,4.7e-05
G5,C1(CC(C(CO)=O)OCC1O)=O,4,1,0,1,2,4.7e-05
G5,C1(CC(C(C)=O)(O)OCC1O)=O,4,2,0,2,2,9.499999999999999e-05
G5,C1(C(C(CCO)OCC1O)=O)=O,4,1,0,1,5,4.7e-05
G5,C1(C(C(C(C)=O)(O)OCC1)O)=O,4,2,0,2,3,9.499999999999999e-05
G5,C1(C(C(C(CO)=O)OCC1)O)=O,4,1,0,1,9,4.7e-05
G5,C1(C(C(C(CO)O)OCC1)=O)=O,4,1,0,1,9,4.7e-05
G5,C(C)(C1(C(CC(CO1)=O)O)O)=O,4,2,0,2,32,9.499999999999999e-05
G5,C(C1C(CO)C(C(CO1)=O)O)=O,8,1,0,1,2,4.7e-05
G5,C(C)(C1(CC(C(CO1)=O)O)O)=O,4,2,0,2,2,9.499999999999999e-05
G5,C1(COC(C(CO)=O)CC1O)=O,4,1,0,1,2,4.7e-05
G5,C(C1COC(C=O)C(C1O)O)=O,16,1,0,1,5,4.7e-05
G5,C(C1COC(C(C1O)=O)CO)=O,8,1,0,1,5,4.7e-05
G5,C(C1COC(C(C1)=O)(CO)O)=O,4,2,0,2,5,9.499999999999999e-05
G5,C1(CC(C=O)OCC1C=O)=O,4,1,0,1,30,4.7e-05
G5,C(C1C(C(C(C)OC1)=O)=O)=O,4,1,0,1,26,4.7e-05
G5,C(CC1C(C(CCO1)=O)=O)=O,2,1,0,1,9,4.7e-05
G5,C1(CC(OCC1C(C)=O)=O)=O,2,1,0,1,12,4.7e-05
G5,C(C)(C1C(C(COC1)=O)=O)=O,2,1,0,1,12,4.7e-05
G5,C1(CC(C(C=O)=O)OCC1)=O,2,1,0,1,41,4.7e-05
G5,C1(C(COC(C1)=O)CC=O)=O,2,1,0,1,43,4.7e-05
G5,C(CC1C(C(COC1)=O)=O)=O,2,1,0,1,43,4.7e-05
G5,C1(C2C(CO)OC1C(CO2)O)=O,16,1,0,1,2,4.7e-05
G5,C1(C2C(CO)C(C(CO2)O)O1)=O,16,1,0,1,41,4.7e-05
G5,C1(C2C(CO)OC(CO2)C1O)=O,16,1,0,1,2,4.7e-05
G5,C1(C2(C(CO)OC(CO2)C1)O)=O,8,2,0,2,2,9.499999999999999e-05
G5,C1(C2COC(C(CO)O2)(C1)O)=O,8,2,0,2,2,9.499999999999999e-05
G5,C1(C2C(CO)C(C(CO2)O1)O)=O,16,1,0,1,41,4.7e-05
G5,C1(CC(O)OCC1C(C=O)=O)=O,4,2,0,2,15,9.499999999999999e-05
G5,C1(C(O)OCC(C(C=O)=O)C1)=O,4,2,0,2,15,9.499999999999999e-05
G5,C1(C(C(C(C=O)=O)COC1)O)=O,4,1,0,1,15,4.7e-05
G5,C1(CC(C(C(C=O)=O)CO1)O)=O,4,2,0,2,29,9.499999999999999e-05
G5,C1(C(CCO)OCC(C1)=O)=O,2,1,0,1,3,4.7e-05
G5,C(C1(CC(C=O)OCC1)O)=O,4,1,0,1,3,4.7e-05
G5,C1(C(CCO)CC(CO1)=O)=O,2,1,0,1,3,4.7e-05
G5,C(C1C(C(C)(O)OCC1)=O)=O,4,2,0,2,3,9.499999999999999e-05
G5,C(C1(C(C(C)OCC1)=O)O)=O,4,1,0,1,3,4.7e-05
G5,C(CO)(C1COCC(C1O)=O)=O,4,1,0,1,12,4.7e-05
G5,C1(CC(C(C(CO)=O)CO1)O)=O,4,2,0,2,2,9.499999999999999e-05
G5,C(C1CCOC(C1)(CO)O)=O,4,2,0,2,29,9.499999999999999e-05
G5,C(C1CC(CO)(CCO1)O)=O,4,1,0,1,29,4.7e-05
G5,C(C1CCOC(C)(C1O)O)=O,8,2,0,2,3,9.499999999999999e-05
G5,C1(C(C)(O)OCCC1CO)=O,4,2,0,2,3,9.499999999999999e-05
G5,C1(C(C)OCCC1(CO)O)=O,4,1,0,1,3,4.7e-05
G5,C(C1CCOC(C1)O)=O,4,2,0,2,3,9.499999999999999e-05
G5,C1(CC(C(C)=O)OC(C1)O)=O,4,2,0,2,43,9.499999999999999e-05
G5,C1(CCC(OC1C(C)=O)O)=O,4,2,0,2,43,9.499999999999999e-05
G5,C(C1C(C(C)CC(O1)O)=O)=O,8,2,0,2,16,9.499999999999999e-05
G5,C(C1C(C(C=O)OC(C1)=O)O)=O,8,1,0,1,43,4.7e-05
G5,C(C1C(C(C=O)C(CO1)=O)O)=O,8,1,0,1,43,4.7e-05
G5,C1(CC(OC(C=O)C1C=O)O)=O,8,2,0,2,43,9.499999999999999e-05
G5,C(C1C(C=O)CC(C(O)O1)=O)=O,8,2,0,2,43,9.499999999999999e-05
G5,C(C1C(C=O)C(C(CO1)=O)O)=O,8,1,0,1,43,4.7e-05
G5,C1(CC(C(C=O)C(C=O)O1)O)=O,8,1,0,1,43,4.7e-05
G5,C(C1CC(CC(C=O)O1)O)=O,3,1,0,1,21,4.7e-05
G5,C1(CCC(C(C(C)=O)O1)O)=O,4,1,0,1,49,4.7e-05
G5,C(C)(C1C(CC(CO1)=O)O)=O,4,1,0,1,49,4.7e-05
G5,C(C1CC(C(C(C)O1)=O)O)=O,8,1,0,1,49,4.7e-05
G5,C(C1CCC(C(C)(O1)O)=O)=O,4,2,0,2,49,9.499999999999999e-05
G5,C1(CC(C=O)OC(C)(C1)O)=O,4,2,0,2,49,9.499999999999999e-05
G5,C(C1C(C)(COC(C1)=O)O)=O,4,1,0,1,49,4.7e-05
G5,C(C1C(COCC1(C)O)=O)=O,4,1,0,1,49,4.7e-05
G5,C(C1C(CCC(CO)(O1)O)=O)=O,4,2,0,2,20,9.499999999999999e-05
G5,C(C)(C1C(C(C(CO1)=O)O)O)=O,8,1,0,1,49,4.7e-05
G5,C1(CC(C(C(C(C)=O)O1)O)O)=O,8,2,0,2,29,9.499999999999999e-05
G5,C(C1C(C(C(C(C)O1)=O)O)O)=O,16,1,0,1,24,4.7e-05
G5,C(C1C(CC(C(C)(O1)O)=O)O)=O,8,2,0,2,24,9.499999999999999e-05
G5,C1(C(C(C=O)OC(C)(C1)O)O)=O,8,2,0,2,24,9.499999999999999e-05
G5,C1(CC(C=O)OC(C)(C1O)O)=O,8,2,0,2,24,9.499999999999999e-05
G5,C(C1CC(CO)(C(CO1)O)O)=O,8,1,0,1,29,4.7e-05
G5,C(C1CC(CO)(O)OCC1O)=O,8,2,0,2,29,9.499999999999999e-05
G5,C(C1C(COC(C)(C1O)O)O)=O,16,2,0,2,45,9.499999999999999e-05
G5,C(C1CC(O)OCC1O)=O,8,2,0,2,37,9.499999999999999e-05
G5,C1(COC(CC1CO)O)=O,4,2,0,2,37,9.499999999999999e-05
G5,C(CC1C(CCC(C=O)O1)=O)=O,4,1,0,1,7,4.7e-05
G5,C(CC1C(CC(C(C)O1)=O)=O)=O,4,1,0,1,45,4.7e-05
G5,C1(CC(C=O)OC(C1)CC=O)=O,4,1,0,1,26,4.7e-05
G5,C1(CC(C=O)OC(C)C1C=O)=O,8,1,0,1,4,4.7e-05
G5,C(CC1CC(C(C(C)O1)=O)=O)=O,4,1,0,1,9,4.7e-05
G5,C(C1C(C(C(C)OC1C)=O)=O)=O,8,1,0,1,9,4.7e-05
G5,C(CC1C(C(CC(C)O1)=O)=O)=O,4,1,0,1,9,4.7e-05
G5,C(CC1(C)CC(CC(O1)=O)=O)=O,2,1,0,1,6,4.7e-05
G5,C(CC1(C)CC(C(CO1)=O)=O)=O,2,1,0,1,6,4.7e-05
G5,C1(CC(OC(C)C1C(C)=O)=O)=O,4,1,0,1,2,4.7e-05
G5,C(C)(C1C(C(COC1C)=O)=O)=O,4,1,0,1,2,4.7e-05
G5,C1(CC(C(C=O)=O)OC(C)C1)=O,4,1,0,1,4,4.7e-05
G5,C1(C(C(C)OC(C1)=O)CC=O)=O,4,1,0,1,4,4.7e-05
G5,C(CC1C(C(COC1C)=O)=O)=O,4,1,0,1,4,4.7e-05
G5,C1(CCC(OC1(C)CC=O)=O)=O,2,1,0,1,21,4.7e-05
G5,C1(COC(C(C1)=O)(C)CC=O)=O,2,1,0,1,21,4.7e-05
G5,C1(COC(CC1C=CC=O)O)=O,8,2,0,2,21,9.499999999999999e-05
G5,C1(CC(C(C=C)=O)OC(C1)O)=O,4,2,0,2,7,9.499999999999999e-05
G5,C1(CCC(OC1C(C=C)=O)O)=O,4,2,0,2,7,9.499999999999999e-05
G5,C1(C(C=O)OC(CC1C=C)O)=O,8,3,0,3,7,0.00014199999999999998
G5,C1(CC(C=CC=O)OC(C1)O)=O,8,3,0,3,29,0.00014199999999999998
G5,C1(CCC(OC1C=CC=O)O)=O,8,3,0,3,29,0.00014199999999999998
G5,C1(CC(C)(C(CO1)O)O)=O,4,2,0,2,29,9.499999999999999e-05
G5,C1(COCC(C1(C)O)O)=O,4,1,0,1,28,4.7e-05
G5,C1(C(O)OCC(C1C)O)=O,8,2,0,2,28,9.499999999999999e-05
G5,C1(COC(C(C1C)O)O)=O,8,2,0,2,28,9.499999999999999e-05
G5,C1(CCC(CO)(C(C=O)O1)O)=O,4,1,0,1,20,4.7e-05
G5,C(C1C(CO)(CC(CO1)=O)O)=O,4,2,0,2,29,9.499999999999999e-05
G5,C(C1CC(C(OC1C=O)O)O)=O,16,2,0,2,20,9.499999999999999e-05
G5,C1(CC(CC(C=O)O1)(CO)O)=O,4,2,0,2,29,9.499999999999999e-05
G5,C(C1CC(C=O)OC(C1O)O)=O,16,2,0,2,20,9.499999999999999e-05
G5,C(CO)(C1C(COC(C1)=O)O)=O,4,1,0,1,20,4.7e-05
G5,C(CO)(C1C(COCC1O)=O)=O,4,1,0,1,20,4.7e-05
G5,C(C1(CCOC(C1)=O)O)=O,2,2,0,2,29,9.499999999999999e-05
G5,C(C1(C(COCC1)=O)O)=O,2,1,0,1,30,4.7e-05
G5,C(C1C(C(O)OCC1)=O)=O,4,2,0,2,30,9.499999999999999e-05
G5,C1(CC(CO)(CCO1)O)=O,2,2,0,2,29,9.499999999999999e-05
G5,C1(COCCC1(CO)O)=O,2,1,0,1,3,4.7e-05
G5,C1(C(O)OCCC1CO)=O,4,2,0,2,3,9.499999999999999e-05
G5,C(C1CCOC(C1O)O)=O,8,2,0,2,3,9.499999999999999e-05
G5,C1(CC(C(C)(C(C=O)O1)O)O)=O,8,1,0,1,26,4.7e-05
G5,C(C1C(C)(C(C(CO1)=O)O)O)=O,8,1,0,1,26,4.7e-05
G5,C1(C(C)(C(C=O)OC(C1)O)O)=O,8,2,0,2,26,9.499999999999999e-05
G5,C1(C(C)C(C=O)OC(C1O)O)=O,16,2,0,2,26,9.499999999999999e-05
G5,C1(CC(C)(C(C(C=O)O1)O)O)=O,8,2,0,2,29,9.499999999999999e-05
G5,C(C1C(C(C(CO1)=O)(C)O)O)=O,8,1,0,1,0,4.7e-05
G5,C(C1C(C(C(C(O1)O)=O)C)O)=O,16,2,0,2,0,9.499999999999999e-05
G5,C(C1C(C(C)C(C(O1)O)O)=O)=O,16,2,0,2,0,9.499999999999999e-05
G5,C(C1C(COC(C1)=O)O)=O,4,1,0,1,30,4.7e-05
G5,C(C1C(COCC1O)=O)=O,4,1,0,1,30,4.7e-05
G5,C(C1C(C(C(CO1)=O)O)O)=O,8,1,0,1,15,4.7e-05
G5,C1(CC(CO)(C(CO1)O)O)=O,4,2,0,2,29,9.499999999999999e-05
G5,C1(CC(C=O)(O)OC(CO)C1)=O,4,2,0,2,20,9.499999999999999e-05
G5,C1(CC(CO)(O)OC(CO)C1)=O,4,2,0,2,49,9.499999999999999e-05
G5,C(C1CC(C(C(CO)O1)O)O)=O,16,1,0,1,49,4.7e-05
G5,C1(C(C(C)(O)OC(CO)C1)O)=O,8,2,0,2,45,9.499999999999999e-05
G5,C1(C(C(CO)OC(C)(C1)O)O)=O,8,2,0,2,45,9.499999999999999e-05
G5,C1(C(C)(O)OC(C(C1)O)CO)=O,8,2,0,2,45,9.499999999999999e-05
G5,C1(C(C)OC(C(C1O)O)CO)=O,16,1,0,1,45,4.7e-05
G5,C1(CC(C(CO1)C(CO)O)=O)=O,4,3,0,3,19,0.00014199999999999998
G5,C1(C(COCC1C(CO)O)=O)=O,4,1,0,1,27,4.7e-05
G5,C1(C(C)(CCC(O1)=O)O)=O,2,1,0,1,14,4.7e-05
G5,C1(C(C)(CC(CO1)=O)O)=O,2,2,0,2,29,9.499999999999999e-05
G5,C(C1C(C(CCO1)O)O)=O,8,1,0,1,30,4.7e-05
G5,C1(C(CO)OCCC1O)=O,4,1,0,1,30,4.7e-05
G5,C1(C(CO)(O)OCCC1)=O,2,2,0,2,30,9.499999999999999e-05
G5,C1(CCC(OC1(CO)O)=O)=O,2,2,0,2,17,9.499999999999999e-05
G5,C1(C2C(CC(CO2)O1)O)=O,8,1,0,1,30,4.7e-05
G5,C1(C2C(O)OC(CO2)C1)=O,8,3,0,3,37,0.00014199999999999998
G5,C1(C(CO)C(C(CO1)O)O)=O,8,1,0,1,2,4.7e-05
G5,C(C1C(O)OCC(C1O)O)=O,16,2,0,2,2,9.499999999999999e-05
G5,C(C1(COC(C=O)CC1O)O)=O,8,1,0,1,30,4.7e-05
G5,C(C1CC(O)OCC1(C=O)O)=O,8,2,0,2,41,9.499999999999999e-05
G5,C1(CCOC(C1(C(C)=O)O)O)=O,4,2,0,2,1,9.499999999999999e-05
G5,C1(C(COC(C1C(C)=O)O)O)=O,8,2,0,2,1,9.499999999999999e-05
G5,C(C)(C1(C(OCC(C1)=O)O)O)=O,4,3,0,3,29,0.00014199999999999998
G5,C1(C(C(C)=O)C(C(CO1)O)O)=O,8,1,0,1,1,4.7e-05
G5,C(C1(C(CCOC1(C)O)=O)O)=O,4,2,0,2,1,9.499999999999999e-05
G5,C(C1C(C(COC1(C)O)O)=O)=O,8,2,0,2,26,9.499999999999999e-05
G5,C(C1(C(C)(OCC(C1)=O)O)O)=O,4,2,0,2,25,9.499999999999999e-05
G5,C(C1(COC(C(C1O)=O)C)O)=O,8,1,0,1,26,4.7e-05
G5,C(C1(COC(CC1(C)O)=O)O)=O,4,1,0,1,1,4.7e-05
G5,C(C1(COCC(C1(C)O)=O)O)=O,4,1,0,1,1,4.7e-05
G5,C(C1(COC(C(C1C)=O)O)O)=O,8,2,0,2,1,9.499999999999999e-05
G5,C1(COC(C)(C(CO)(C1)O)O)=O,4,2,0,2,41,9.499999999999999e-05
G5,C(C1C(C)(O)OCC(C1O)O)=O,16,2,0,2,41,9.499999999999999e-05
G5,C1(C(CO)C(C)(C(CO1)O)O)=O,8,1,0,1,28,4.7e-05
G5,C(C1C(O)OCC(C1(C)O)O)=O,16,2,0,2,28,9.499999999999999e-05
G5,C1(COC(C(CO)(C1C)O)O)=O,8,2,0,2,28,9.499999999999999e-05
G5,C1(C(CO)C(C=O)(CCO1)O)=O,4,1,0,1,3,4.7e-05
G5,C(C1C(O)OCCC1(C=O)O)=O,8,2,0,2,3,9.499999999999999e-05
G5,C1(C(CO)C(CO)(CCO1)O)=O,4,1,0,1,3,4.7e-05
G5,C(C1C(O)OCCC1(CO)O)=O,8,2,0,2,3,9.499999999999999e-05
G5,C(C1CCOC(C1(CO)O)O)=O,8,2,0,2,3,9.499999999999999e-05
G5,C(C1(C(CCOC1O)=O)O)=O,4,2,0,2,1,9.499999999999999e-05
G5,C(C1C(C(COC1O)O)=O)=O,8,2,0,2,1,9.499999999999999e-05
G5,C(C1(C(OCC(C1)=O)O)O)=O,4,2,0,2,1,9.499999999999999e-05
G5,C1(C(C=O)C(C(CO1)O)O)=O,8,2,0,2,29,9.499999999999999e-05
G5,C(C1C(C(C(O)OC1)O)=O)=O,8,2,0,2,2,9.499999999999999e-05
G5,C(C1(C(CC(O)OC1)=O)O)=O,4,2,0,2,1,9.499999999999999e-05
G5,C(C1(COC(C(C1)=O)O)O)=O,4,2,0,2,1,9.499999999999999e-05
G5,C(C1(COCC(C1O)=O)O)=O,4,1,0,1,1,4.7e-05
G5,C(C1(COC(CC1O)=O)O)=O,4,1,0,1,1,4.7e-05
G5,C(C1C(OC(C=O)CC1O)O)=O,16,2,0,2,43,9.499999999999999e-05
G5,C1(C(C)C(C(CO1)=O)(CO)O)=O,4,1,0,1,2,4.7e-05
G5,C1(COCC(C1(CO)O)=O)=O,1,1,0,1,5,4.7e-05
G5,C1(COC(C(C1CO)=O)O)=O,4,2,0,2,5,9.499999999999999e-05
G5,C1(COC(CC1(CO)O)=O)=O,2,1,0,1,5,4.7e-05
G5,C(C1(C(COC(C1)=O)O)O)(O)=O,4,1,0,1,15,4.7e-05
G5,C(C1(C(OCC(C1C)=O)O)O)=O,8,2,0,2,12,9.499999999999999e-05
G5,C1(C(C=O)C(C)(C(CO1)O)O)=O,8,2,0,2,29,9.499999999999999e-05
G5,C(C)(C1(COCC(C1O)=O)O)=O,4,1,0,1,12,4.7e-05
G5,C1(CC(C(C(C)=O)(CO1)O)O)=O,4,1,0,1,12,4.7e-05
G5,C(C1C(C)(OCC(C1O)=O)O)=O,8,2,0,2,5,9.499999999999999e-05
G5,C(C1C(OC(C(C1O)=O)C)O)=O,16,2,0,2,25,9.499999999999999e-05
G5,C(C1C2C(COC1(CO2)O)O)=O,16,2,0,2,2,9.499999999999999e-05
G5,C(C1C2(COC(CO2)C1O)O)=O,16,2,0,2,54,9.499999999999999e-05
G5,C1(C(C=O)C(C=O)(CCO1)O)=O,4,2,0,2,29,9.499999999999999e-05
G5,C(C1CCOC(C1(C=O)O)O)=O,8,2,0,2,12,9.499999999999999e-05
G5,C1(C(C=O)C(CO)(CCO1)O)=O,4,2,0,2,29,9.499999999999999e-05
G5,C(C1(C=O)C(CCC(O1)O)=O)=O,2,2,0,2,29,9.499999999999999e-05
G5,C(C1(C=O)CC(CC(O1)O)=O)=O,2,2,0,2,1,9.499999999999999e-05
G5,C(C1(C=O)C(CCC(O1)=O)O)=O,2,1,0,1,43,4.7e-05
G5,C(C1(C=O)C(CC(CO1)=O)O)=O,2,1,0,1,43,4.7e-05
G5,C1(C(C=O)C(CC(C=O)O1)O)=O,8,2,0,2,29,9.499999999999999e-05
G5,C1(CC(C=O)OC(C1C=O)O)=O,8,2,0,2,29,9.499999999999999e-05
G5,C(C1C(C(O)OCC1(C)O)=O)=O,8,2,0,2,27,9.499999999999999e-05
G5,C(C1(C(COCC1(C)O)=O)O)=O,4,1,0,1,27,4.7e-05
G5,C(C1(C(C)(COC(C1)=O)O)O)=O,4,2,0,2,29,9.499999999999999e-05
G5,C(C1C(C(C)(O)OCC1O)=O)=O,8,2,0,2,14,9.499999999999999e-05
G5,C(C1(C(C(C)OCC1O)=O)O)=O,8,1,0,1,24,4.7e-05
G5,C(C)(C1(C(COC(C1)=O)O)O)=O,4,1,0,1,26,4.7e-05
G5,C(C)(C1(C(COCC1O)=O)O)=O,4,1,0,1,26,4.7e-05
G5,C(C)(C1C(C(O)OCC1O)=O)=O,8,2,0,2,26,9.499999999999999e-05
G5,C(C1C(C(O)OCC1O)=O)=O,8,2,0,2,15,9.499999999999999e-05
G5,C(C1(C(COCC1O)=O)O)=O,4,1,0,1,15,4.7e-05
G5,C1(C(C)C(C=O)(C(CO1)O)O)=O,8,1,0,1,16,4.7e-05
G5,C(C1COC(CC1(C=O)O)O)=O,8,2,0,2,43,9.499999999999999e-05
G5,C1(C(C(O)OCC1)(CC=O)O)=O,4,2,0,2,29,9.499999999999999e-05
G5,C1(C(C(O)OCC1O)CC=O)=O,8,2,0,2,41,9.499999999999999e-05
G5,C(CC1(C(OCC(C1)=O)O)O)=O,4,3,0,3,41,0.00014199999999999998
G5,C1(C(C(C(CO1)O)O)CC=O)=O,8,1,0,1,41,4.7e-05
G5,C(C1CC(O)OC(C1O)=O)=O,8,2,0,2,43,9.499999999999999e-05
G5,C1(C(C(CO)CC(O)O1)=O)=O,4,2,0,2,43,9.499999999999999e-05
G5,C1(CC(C)(C(C(O1)=O)O)O)=O,4,1,0,1,28,4.7e-05
G5,C1(COC(C(C1(C)O)O)=O)=O,4,2,0,2,29,9.499999999999999e-05
G5,C1(C(O)OC(C(C1C)O)=O)=O,8,2,0,2,28,9.499999999999999e-05
G5,C1(C(C(C)C(C(O)O1)O)=O)=O,8,2,0,2,28,9.499999999999999e-05
G5,C1(CC(C(C=O)=O)C(OC1)O)=O,4,2,0,2,51,9.499999999999999e-05
G5,C1(C(CC(CO1)=O)C(C=O)O)=O,4,1,0,1,51,4.7e-05
G5,C1(C(C(C)O)CC(CO1)=O)=O,4,1,0,1,41,4.7e-05
G5,C(C)(C1C(OCC(C1)=O)O)=O,4,2,0,2,41,9.499999999999999e-05
G5,C(C1CC(COC1(C=O)O)O)=O,8,2,0,2,20,9.499999999999999e-05
G5,C(C1(COC(C(C1)=O)CO)O)=O,4,1,0,1,43,4.7e-05
G5,C(C1(COC(C=O)C(C1)O)O)=O,8,1,0,1,43,4.7e-05
G5,C1(CCC(C(CO)=O)(CO1)O)=O,2,1,0,1,32,4.7e-05
G5,C(CO)(C1(COCC(C1)=O)O)=O,2,1,0,1,32,4.7e-05
G5,C1(CC(C(CO1)(CCO)O)=O)=O,2,1,0,1,2,4.7e-05
G5,C1(C(COCC1(CCO)O)=O)=O,2,1,0,1,2,4.7e-05
G5,C(C1C(OC(C=O)C(C1)O)O)=O,16,2,0,2,43,9.499999999999999e-05
G5,C1(C(CO)CC(C(C=O)O1)O)=O,8,1,0,1,43,4.7e-05
G5,C(C1C2(CC(C(CO2)O)O1)O)=O,16,2,0,2,2,9.499999999999999e-05
G5,C(C1C2(CC(C(CO2)O1)O)O)=O,16,2,0,2,2,9.499999999999999e-05
G5,C(C1C(C(C=O)OC(C1)O)=O)=O,8,2,0,2,1,9.499999999999999e-05
G5,C1(C(C(CC(O)O1)=O)O)=O,4,2,0,2,17,9.499999999999999e-05
G5,C1(CC(C(C(O)O1)O)=O)=O,4,2,0,2,17,9.499999999999999e-05
G5,C1(C(CC(C(O)O1)=O)O)=O,4,2,0,2,17,9.499999999999999e-05
G5,C1(C(C(C(CO1)=O)O)O)=O,4,2,0,2,29,9.499999999999999e-05
G5,C1(CC(C(C(O1)=O)O)O)=O,4,1,0,1,17,4.7e-05
G5,C1(C(CC(C(O)O1)O)=O)=O,4,2,0,2,17,9.499999999999999e-05
G5,C(C1C(C(C(CO1)=O)O)O)(O)=O,8,1,0,1,29,4.7e-05
G5,C(C1(CC(C=O)OCC1O)O)=O,8,1,0,1,51,4.7e-05
G5,C1(C(C(CO)O)CC(CO1)=O)=O,4,1,0,1,51,4.7e-05
G5,C(C1C(OC(C(C1)=O)CO)O)=O,8,2,0,2,2,9.499999999999999e-05
G5,C1(C(C(C)(O)OCC1)=O)=O,2,2,0,2,2,9.499999999999999e-05
G5,C1(C2COC(C(O2)O)C1)=O,8,2,0,2,37,9.499999999999999e-05
G5,C1(C2C(C(C(CO2)O1)O)O)=O,16,2,0,2,29,9.499999999999999e-05
G5,C1(C2C(O)OC(CO2)C1O)=O,16,2,0,2,15,9.499999999999999e-05
G5,C1(C2(C(O)OC(CO2)C1)O)=O,8,3,0,3,15,0.00014199999999999998
G5,C1(C2COC(C(O2)O)(C1)O)=O,8,3,0,3,15,0.00014199999999999998
G5,C1(C(COC(CO)(CC1)O)=O)=O,2,2,0,2,32,9.499999999999999e-05
G5,C1(CC(CO)(OCC(C1)=O)O)=O,2,3,0,3,29,0.00014199999999999998
G5,C(C1CC(C(C(CO1)=O)O)O)=O,8,1,0,1,32,4.7e-05
G5,C(C1C(C(CC(CO1)=O)O)O)=O,8,1,0,1,12,4.7e-05
G5,C(C1CC(OCC(C1O)=O)O)=O,8,2,0,2,5,9.499999999999999e-05
G5,C1(C(COC(C)(C(C1)O)O)=O)=O,4,2,0,2,5,9.499999999999999e-05
G5,C1(C(C(C)(OCC(C1)=O)O)O)=O,4,2,0,2,5,9.499999999999999e-05
G5,C1(CC(C)(OCC(C1O)=O)O)=O,4,2,0,2,5,9.499999999999999e-05
G5,C1(CC(C(COC1(C)O)=O)O)=O,4,2,0,2,5,9.499999999999999e-05
G5,C1(C(C(C(C(C)OC1)=O)O)O)=O,8,1,0,1,5,4.7e-05
G5,C1(C(COC(C(C1C)O)O)=O)=O,8,2,0,2,5,9.499999999999999e-05
G5,C1(CC(C)(C(C(CO1)=O)O)O)=O,4,1,0,1,5,4.7e-05
G5,C1(COCC(C(C1(C)O)O)=O)=O,4,1,0,1,5,4.7e-05
G5,C1(C(OCC(C(C1C)O)=O)O)=O,8,2,0,2,5,9.499999999999999e-05
G5,C1(CC(CC(CO1)(CO)O)=O)=O,2,1,0,1,5,4.7e-05
G5,C1(C(COCC(CO)(C1)O)=O)=O,2,1,0,1,5,4.7e-05
G5,C1(C(C(C(C=O)OCC1)O)O)=O,8,1,0,1,30,4.7e-05
G5,C1(C(CCOC(CO)(C1)O)=O)=O,2,2,0,2,30,9.499999999999999e-05
G5,C1(C(COC(C(C1)O)O)=O)=O,4,2,0,2,5,9.499999999999999e-05
G5,C1(CC(OCC(C1O)=O)O)=O,4,2,0,2,5,9.499999999999999e-05
G5,C1(COCC(C(C1O)O)=O)=O,3,1,0,1,5,4.7e-05
G5,C1(C(CC(O)OC(CO)C1)=O)=O,4,3,0,3,0,0.00014199999999999998
G5,C1(CC(CC(C(CO)O1)O)=O)=O,4,1,0,1,19,4.7e-05
G5,C1(C(COC(CO)C(C1)O)=O)=O,4,1,0,1,19,4.7e-05
G5,C(C1C(C(OCC(C1)=O)O)O)=O,8,2,0,2,30,9.499999999999999e-05
G5,C(C1C(C(COC(C1)=O)O)O)=O,8,1,0,1,30,4.7e-05
G5,C1(COC(C(CC1C)=O)O)=O,4,2,0,2,29,9.499999999999999e-05
G5,C1(C(COC(C(C1)=O)C)O)=O,4,1,0,1,45,4.7e-05
G5,C1(C(C)CC(C(CO1)O)=O)=O,4,1,0,1,16,4.7e-05
G5,C(C1CCOC(C(C1)=O)O)=O,4,2,0,2,29,9.499999999999999e-05
G5,C1(CCOC(C(C1O)=O)C)=O,4,1,0,1,45,4.7e-05
G5,C1(CCOC(C(C1)=O)(C)O)=O,2,2,0,2,45,9.499999999999999e-05
G5,C1(C(CCOC(C)(C1)O)=O)=O,2,2,0,2,2,9.499999999999999e-05
G5,C1(C(C)C(C(CCO1)=O)O)=O,4,1,0,1,45,4.7e-05
G5,C1(C(CCOC(C1C)O)=O)=O,4,2,0,2,45,9.499999999999999e-05
G5,C(C1CC(CC(C(O)O1)=O)=O)=O,4,3,0,3,0,0.00014199999999999998
G5,C(C1C(CCC(C(O1)O)=O)=O)=O,4,3,0,3,29,0.00014199999999999998
G5,C(C1C(COC(C(C1)=O)O)O)=O,8,2,0,2,51,9.499999999999999e-05
G5,C1(C(COC(C(C1O)=O)C)O)=O,8,1,0,1,0,4.7e-05
G5,C1(C(COC(C(C1)=O)(C)O)O)=O,4,2,0,2,0,9.499999999999999e-05
G5,C1(C(C(COC(C)(C1)O)O)=O)=O,4,2,0,2,0,9.499999999999999e-05
G5,C1(C(C)C(C(C(CO1)O)=O)O)=O,8,1,0,1,42,4.7e-05
G5,C1(C(C(COC(C1C)O)O)=O)=O,8,2,0,2,42,9.499999999999999e-05
G5,C1(CC(OCC(C1C=O)=O)O)=O,4,2,0,2,1,9.499999999999999e-05
G5,C(C1C(COC(C(C1)=O)O)=O)=O,4,2,0,2,1,9.499999999999999e-05
G5,C(C1C(COCC(C1O)=O)=O)=O,4,1,0,1,1,4.7e-05
G5,C1(CC(C(C=O)C(CO1)=O)O)=O,4,1,0,1,1,4.7e-05
G5,C(C1CC(C(CC(O1)O)=O)=O)=O,4,3,0,3,29,0.00014199999999999998
G5,C1(C(C=O)OC(CC(C1)=O)O)=O,4,3,0,3,1,0.00014199999999999998
G5,C1(C(CC(O)OCC1C)=O)=O,4,2,0,2,49,9.499999999999999e-05
G5,C(C1CC(CC(CO1)=O)O)=O,4,1,0,1,49,4.7e-05
G5,C1(CC(C)(OCC(C1)=O)O)=O,2,2,0,2,49,9.499999999999999e-05
G5,C1(CCC(C(C)(OC1)O)=O)=O,2,2,0,2,49,9.499999999999999e-05
G5,C1(CC(C(C(C)OC1)=O)O)=O,4,1,0,1,49,4.7e-05
G5,C(C1C(CC(C(CO1)=O)O)=O)=O,4,1,0,1,1,4.7e-05
G5,C(C1C(CC(CC(O1)=O)O)=O)=O,4,1,0,1,1,4.7e-05
G5,C1(CC(C(C=O)OC(C1)=O)O)=O,4,1,0,1,1,4.7e-05
G5,C(C1C(CC(C(CO1)=O)=O)O)=O,4,1,0,1,1,4.7e-05
G5,C1(CC(CC(C)(CO1)O)=O)=O,2,1,0,1,49,4.7e-05
G5,C1(C(COCC(C)(C1)O)=O)=O,2,1,0,1,49,4.7e-05
G5,C1(CC(C)(CC(CO1)=O)O)=O,2,1,0,1,55,4.7e-05
G5,C1(COCC(CC1(C)O)=O)=O,2,1,0,1,55,4.7e-05
G5,C1(CC(C(C(OC1)O)=O)C)=O,4,2,0,2,55,9.499999999999999e-05
G5,C(C1CC(C(C(CO1)=O)O)=O)=O,4,1,0,1,0,4.7e-05
G5,C1(CC(C(CC(C=O)O1)=O)O)=O,4,1,0,1,0,4.7e-05
G5,C1(CCC(C(C(C=O)O1)O)=O)=O,4,1,0,1,0,4.7e-05
G5,C(C1C(C(CC(CO1)=O)=O)O)=O,4,1,0,1,0,4.7e-05
G5,C1(C(COCC(C1O)=O)O)=O,4,1,0,1,5,4.7e-05
G5,C1(C(C(COC(C1)O)O)=O)=O,4,2,0,2,5,9.499999999999999e-05
G5,C1(CCC(OC(C)C1O)=O)=O,4,1,0,1,11,4.7e-05
G5,C1(C(C(C)OCC(C1)=O)O)=O,4,1,0,1,11,4.7e-05
G5,C1(C(COC(C=O)CC1O)O)=O,8,1,0,1,32,4.7e-05
G5,C1(C(COC(C=O)C(C1)O)O)=O,8,1,0,1,2,4.7e-05
G5,C1(C(COC(C(CO)C1)O)=O)=O,4,2,0,2,5,9.499999999999999e-05
G5,C1(COC(C(CO)C(C1)O)O)=O,8,2,0,2,38,9.499999999999999e-05
G5,C1(C(C(C(O)OCC1)CO)O)=O,8,2,0,2,38,9.499999999999999e-05
G5,C(C1COC(CC(C1)=O)=O)=O,2,1,0,1,55,4.7e-05
G5,C(C1COCC(C(C1)=O)=O)=O,2,1,0,1,55,4.7e-05
G5,C1(C2OC(C(CO)C(C1)O2)O)=O,16,2,0,2,23,9.499999999999999e-05
G5,C1(C2C(C(O)OC(C1)O2)CO)=O,16,2,0,2,23,9.499999999999999e-05
G5,C1(C(CC(C=O)OCC1)O)=O,4,1,0,1,20,4.7e-05
G5,C1(CC(C(CC(C)O1)=O)O)=O,4,1,0,1,11,4.7e-05
G5,C1(CC(C)OCC(C1O)=O)=O,4,1,0,1,11,4.7e-05
G5,C(CC1CCC(CC(O1)=O)=O)=O,2,1,0,1,44,4.7e-05
G5,C(CC1CCC(C(CO1)=O)=O)=O,2,1,0,1,44,4.7e-05
G5,C(C1C(C)OC(CC(C1)=O)=O)=O,4,1,0,1,46,4.7e-05
G5,C(C1C(C)OCC(C(C1)=O)=O)=O,4,1,0,1,46,4.7e-05
G5,C(CC1CC(CCC(O1)=O)=O)=O,2,1,0,1,26,4.7e-05
G5,C(CC1CC(CC(CO1)=O)=O)=O,2,1,0,1,26,4.7e-05
G5,C(C1C(CCC(OC1C)=O)=O)=O,4,1,0,1,37,4.7e-05
G5,C(C1C(CC(COC1C)=O)=O)=O,4,1,0,1,37,4.7e-05
G5,C1(CCC(OC(CO)C1O)=O)=O,4,1,0,1,0,4.7e-05
G5,C1(CC(C(CC(CO)O1)=O)O)=O,4,1,0,1,0,4.7e-05
G5,C1(CC(CO)OCC(C1O)=O)=O,4,1,0,1,0,4.7e-05
G5,C1(CC(CO)OC(C(C1)=O)O)=O,4,3,0,3,29,0.00014199999999999998
G5,C1(CC(C=O)(O)OCC(C1)O)=O,4,2,0,2,20,9.499999999999999e-05
G5,C1(CC(CO)(O)OCC(C1)O)=O,4,2,0,2,20,9.499999999999999e-05
G5,C(C1CC(C(C(CO1)O)O)O)=O,16,1,0,1,20,4.7e-05
G5,C1(C(C(C)(O)OCC(C1)O)O)=O,8,2,0,2,45,9.499999999999999e-05
G5,C1(C(C(COC(C)(C1)O)O)O)=O,8,2,0,2,45,9.499999999999999e-05
G5,C1(C(C)(O)OCC(C(C1)O)O)=O,8,2,0,2,45,9.499999999999999e-05
G5,C1(C(C)OCC(C(C1O)O)O)=O,16,1,0,1,45,4.7e-05
G5,C(C1COC(CC(C1O)O)=O)=O,8,2,0,2,29,9.499999999999999e-05
G5,C(C1COCC(C(C1O)O)=O)=O,8,1,0,1,23,4.7e-05
G5,C1(CCC(C(CO1)O)O)=O,4,1,0,1,29,4.7e-05
G5,C1(COCC(C(C1)O)O)=O,4,1,0,1,29,4.7e-05
G5,C1(COC(C(CC1)O)O)=O,4,2,0,2,29,9.499999999999999e-05
G5,C1(C(CCC(C(O)O1)O)=O)=O,4,2,0,2,43,9.499999999999999e-05
G5,C1(CCC(C(C(O1)=O)O)O)=O,4,1,0,1,43,4.7e-05
G5,C1(CC(CC(CO1)O)O)=O,4,1,0,1,44,4.7e-05
G5,C1(COCC(CC1O)O)=O,4,1,0,1,44,4.7e-05
G5,C1(C(O)OCC(CC1)O)=O,4,2,0,2,44,9.499999999999999e-05
G5,C1(C(CCC(C(O)O1)=O)O)=O,4,2,0,2,29,9.499999999999999e-05
G5,C(C1C(CC(COC1O)=O)O)=O,8,2,0,2,35,9.499999999999999e-05
G5,C(C1C(O)OCCC(C1O)=O)=O,8,2,0,2,2,9.499999999999999e-05
G5,C(C1(COC(CCC1O)=O)O)=O,4,1,0,1,43,4.7e-05
G5,C(C1(COCC(CC1O)=O)O)=O,4,1,0,1,43,4.7e-05
G5,C(C1C(CC(COC1O)=O)=O)=O,4,2,0,2,1,9.499999999999999e-05
G5,C(C1C(O)OCCC(C1O)O)=O,16,2,0,2,29,9.499999999999999e-05
G5,C1(CC(C(O)OCC1)(CO)O)=O,4,2,0,2,29,9.499999999999999e-05
G5,C(C1C(O)OC2CC(C1O2)O)=O,32,2,0,2,2,9.499999999999999e-05
G5,C(C1C(C(CCOC1O)=O)=O)=O,4,2,0,2,3,9.499999999999999e-05
G5,C(C1(C(CCOC(C1)O)=O)O)=O,4,2,0,2,41,9.499999999999999e-05
G5,C(C1(CC(OCC(C1)=O)O)O)=O,4,2,0,2,41,9.499999999999999e-05
G5,C(C1(C(COCC(C1)=O)=O)O)=O,2,1,0,1,51,4.7e-05
G5,C(C1C(C(O)OCC(C1)=O)=O)=O,4,2,0,2,51,9.499999999999999e-05
G5,C1(CC(C=O)(CC(CO1)=O)O)=O,2,1,0,1,51,4.7e-05
G5,C(C1C(OCC(C(C1)O)=O)O)=O,8,2,0,2,43,9.499999999999999e-05
G5,C(C1(COC(CC(C1)O)=O)O)=O,4,1,0,1,43,4.7e-05
G5,C(C1(COCC(C(C1)O)=O)O)=O,4,1,0,1,43,4.7e-05
G5,C(C1(COC(C(CC1)=O)O)O)=O,4,2,0,2,43,9.499999999999999e-05
G5,C1(CC(C(C(C)(CO1)O)=O)O)=O,4,1,0,1,30,4.7e-05
G5,C1(C(COCC(C1O)=O)(C)O)=O,4,1,0,1,30,4.7e-05
G5,C1(C(COC(C(C1)=O)O)(C)O)=O,4,2,0,2,30,9.499999999999999e-05
G5,C1(C(CC(O)OCC1(C)O)=O)=O,4,2,0,2,30,9.499999999999999e-05
G5,C1(C(C(CC(C(O)O1)O)=O)O)=O,8,2,0,2,33,9.499999999999999e-05
G5,C1(CC(C(C(C(O)O1)O)O)=O)=O,8,2,0,2,33,9.499999999999999e-05
G5,C1(CC(C(OC(C1O)O)=O)O)=O,8,2,0,2,33,9.499999999999999e-05
G5,C1(C(C(C(OC(C1)O)=O)O)O)=O,8,2,0,2,33,9.499999999999999e-05
G5,C1(C(C(CC(C(O)O1)=O)O)O)=O,8,2,0,2,33,9.499999999999999e-05
G5,C1(C(C(C(C(CO1)=O)O)O)O)=O,8,2,0,2,29,9.499999999999999e-05
G5,C1(C(CC(C(C(O)O1)O)O)=O)=O,8,2,0,2,33,9.499999999999999e-05
G5,C(C1C(O)OCC(C(C1)=O)O)=O,8,2,0,2,43,9.499999999999999e-05
G5,C1(CC2CC(C(O2)O1)O)=O,8,1,0,1,43,4.7e-05
G5,C(CC1COC(CC(C1)=O)=O)=O,2,2,0,2,55,9.6e-05
G5,C(CC1COCC(C(C1)=O)=O)=O,2,2,0,2,55,9.6e-05
G5,C(CC1CC(COC(C1)=O)=O)=O,2,4,0,4,4,0.000192
G5,C1(C(C=O)CC(CO)O1)=O,4,2,0,2,29,9.499999999999999e-05
G5,C(C)(C1C(C(C(O1)=O)=O)O)=O,4,2,0,2,29,9.499999999999999e-05
G5,C(CC1C(C(C(O1)=O)=O)O)=O,4,2,0,2,29,9.499999999999999e-05
G5,C1(C(CC(CO)O1)=O)=O,2,2,0,2,29,9.499999999999999e-05
G5,C(CC1C(C(OC1)=O)=O)=O,2,2,0,2,29,9.499999999999999e-05
G5,C(C1C(C(C(O1)=O)=O)C)=O,4,2,0,2,29,9.499999999999999e-05
G5,C1(C(C(C)C(CO)O1)=O)=O,4,2,0,2,29,9.499999999999999e-05
G5,C1(C(C(CO1)CCO)=O)=O,2,2,0,2,29,9.499999999999999e-05
G5,C(C1C(CC(O1)=O)=O)=O,2,2,0,2,29,9.499999999999999e-05
G5,C(C1CC(C(O1)=O)=O)=O,2,2,0,2,29,9.499999999999999e-05
G5,C1(C(OCC1C)=O)=O,2,2,0,2,29,9.499999999999999e-05
G5,C(C(C1CC(C(O1)=O)=O)O)=O,4,2,0,2,29,9.499999999999999e-05
G5,C(C1C(CO)OC(C1O)=O)=O,8,2,0,2,29,9.499999999999999e-05
G5,C1(C(C(CO)C(CO)O1)=O)=O,4,2,0,2,29,9.499999999999999e-05
G5,C1(C(C=O)CC(CO1)O)=O,4,2,0,2,29,9.499999999999999e-05
G5,C1(C(C(CC(CO)O1)=O)=O)=O,2,2,0,2,29,9.499999999999999e-05
G5,C1(C(CO)OC(C(C1)=O)=O)=O,2,2,0,2,29,9.499999999999999e-05
G5,C1(C2C(CC(C)(O2)O1)=O)=O,4,2,0,2,29,9.499999999999999e-05
G5,C1(CC2C(OC1(C)O2)=O)=O,4,2,0,2,29,9.499999999999999e-05
G5,C1(C(CC(CO1)O)=O)=O,2,2,0,2,29,9.499999999999999e-05
G5,C1(COC(C(C1C)O)=O)=O,4,2,0,2,29,9.499999999999999e-05
G5,C1(C(C(C)C(CO1)O)=O)=O,4,2,0,2,29,9.499999999999999e-05
G5,C(C1C(C(OCC1)=O)=O)=O,2,2,0,2,29,9.499999999999999e-05
G5,C(C1CCOC(C1O)=O)=O,4,2,0,2,29,9.499999999999999e-05
G5,C1(C(C(CO)CCO1)=O)=O,2,2,0,2,29,9.499999999999999e-05
G5,C1(C(C(CC(C=O)O1)=O)O)=O,4,2,0,2,29,9.499999999999999e-05
G5,C1(CC(C(C(C=O)O1)O)=O)=O,4,2,0,2,29,9.499999999999999e-05
G5,C(C1C(CC(C(O1)=O)O)=O)=O,4,2,0,2,29,9.499999999999999e-05
G5,C(C1C(CC(C(O1)=O)=O)O)=O,4,2,0,2,29,9.499999999999999e-05
G5,C(C1C(COC(C1O)=O)O)=O,8,2,0,2,29,9.499999999999999e-05
G5,C1(C(C(CO)C(CO1)O)=O)=O,4,2,0,2,29,9.499999999999999e-05
G5,C1(C(CC(CCO1)O)=O)=O,2,2,0,2,29,9.499999999999999e-05
G5,C1(C(C(CCCO1)=O)O)=O,2,2,0,2,29,9.499999999999999e-05
G5,C1(C(C(CC(CO1)O)=O)=O)=O,2,2,0,2,29,9.499999999999999e-05
G5,C1(C(COC(C(C1)=O)=O)O)=O,2,2,0,2,29,9.499999999999999e-05
G5,C1(CCOC(C(C1O)=O)=O)=O,2,2,0,2,29,9.499999999999999e-05
G5,C1(COC(C(C(C1)O)=O)=O)=O,2,2,0,2,29,9.499999999999999e-05
G5,C1(CC(CC(C(O1)=O)=O)O)=O,2,2,0,2,29,9.499999999999999e-05
G5,C1(CC(C(CC(O1)=O)O)=O)=O,2,2,0,2,29,9.499999999999999e-05
G5,C1(C(C(CCC(O1)=O)=O)O)=O,2,2,0,2,29,9.499999999999999e-05
G5,C1(CC(CC(C(O1)=O)O)=O)=O,2,2,0,2,29,9.499999999999999e-05
G5,C1(CC2CC(C(O2)O1)=O)=O,4,2,0,2,29,9.499999999999999e-05
G5,C1(CC2C(CC(O2)O1)=O)=O,4,2,0,2,29,9.499999999999999e-05
G5,C1(C2C(CCC(O2)O1)=O)=O,4,2,0,2,29,9.499999999999999e-05
G5,C1(CC2C(OC(C1)O2)=O)=O,4,2,0,2,29,9.499999999999999e-05
G5,C(C(C1C(CC(C1)=O)=O)O)=O,4,1,0,1,12,4.7e-05
G5,C(C(C1CC(C(C1)=O)=O)O)=O,2,2,0,2,29,9.499999999999999e-05
G5,C(C(C1CC(C(C1C)=O)=O)O)=O,8,2,0,2,32,9.499999999999999e-05
G5,C1(CCC(C(C1)O)=O)=O,2,1,0,1,7,4.7e-05
G5,C1(CCCC(C1O)=O)=O,1,2,0,2,7,9.499999999999999e-05
G5,C1(CCC(C(C1)=O)O)=O,2,2,0,2,7,9.499999999999999e-05
G5,C(C1C(C(CCC1O)=O)=O)=O,4,2,0,2,2,9.499999999999999e-05
G5,C(C(C1C(CCC1=O)=O)O)=O,2,1,0,1,20,4.7e-05
G5,C(C1C(C(CCC1(C)O)=O)=O)=O,4,2,0,2,45,9.499999999999999e-05
G5,C1(CCC(C)(C1C(C=O)=O)O)=O,4,2,0,2,4,9.499999999999999e-05
G5,C1(CC(CO)CC(C1O)=O)=O,1,2,0,2,55,9.499999999999999e-05
G5,C1(CC(CO)C(C(C1)=O)O)=O,4,2,0,2,55,9.499999999999999e-05
G5,C1(CC(CCO)CC(C1O)=O)=O,1,2,0,2,46,9.499999999999999e-05
G5,C1(CC(CCO)C(C(C1)=O)O)=O,4,2,0,2,46,9.499999999999999e-05
G5,C1(CC(C(C)O)CC(C1O)=O)=O,2,2,0,2,46,9.499999999999999e-05
G5,C1(CC(C(C)O)C(C(C1)=O)O)=O,8,2,0,2,46,9.499999999999999e-05
G5,C(C(CCCCC(C=O)=O)=O)=O,1,2,0,2,7,9.499999999999999e-05
G5,C(C=O)(C(C)CCC(C=O)=O)=O,2,2,0,2,7,9.499999999999999e-05
G5,C(CO)(CCCCC(C=O)=O)=O,1,2,0,2,27,9.499999999999999e-05
G5,C(CO)(CCC(C(C=O)=O)C)=O,2,2,0,2,7,9.499999999999999e-05
G5,C(CC(C=O)C(C(C=O)=O)C)=O,4,2,0,2,45,9.499999999999999e-05
G5,C(CCC(CCC(CO)=O)=O)=O,1,1,0,1,7,4.7e-05
G5,C(CC(C=O)C(C=O)CC=O)=O,3,3,0,3,29,0.000143
G5,C1(C(CO)CC(C1CO)=O)=O,4,2,0,2,55,9.499999999999999e-05
G5,C1(C(CO)C(C(C1)=O)CO)=O,3,2,0,2,55,9.499999999999999e-05
G5,C1(C(CC(CO)C1CO)=O)=O,4,3,0,3,55,0.000143
G5,C1(CC(C(C1CCO)=O)O)=O,4,2,0,2,55,9.499999999999999e-05
G5,C(C1C(CC(C1CO)O)=O)=O,8,2,0,2,55,9.499999999999999e-05
G5,C(C(CO)CC(O)=O)(CCO)=O,2,2,0,2,55,9.499999999999999e-05
G5,C(CC(CO)C(C(C)=O)O)(O)=O,4,3,0,3,55,0.000143
G5,C(CC(CO)C(CC=O)O)(O)=O,4,3,0,3,55,0.000143
G5,C1(CC(CO)C(C(C)=O)O1)=O,4,2,0,2,55,9.499999999999999e-05
G5,C1(CC(C(CC=O)O1)CO)=O,4,2,0,2,55,9.499999999999999e-05
G5,C1(C(CO)CC(OCC1)=O)=O,2,2,0,2,55,9.499999999999999e-05
G5,C1(CC(CO)CC(CO1)=O)=O,2,4,0,4,55,0.00018999999999999998
G5,C1(CC(CC(CO1)CO)=O)=O,2,2,0,2,55,9.499999999999999e-05
G5,C1(C(COCC(CO)C1)=O)=O,2,2,0,2,55,9.499999999999999e-05
G5,C1(COCC(CC1CO)=O)=O,2,2,0,2,55,9.499999999999999e-05
G5,C(CCCCO)(C(C(C)=O)O)=O,2,2,0,2,46,9.499999999999999e-05
G5,C(CCC(C)O)(C(C(C)=O)O)=O,4,2,0,2,27,9.499999999999999e-05
G5,C(CC(CCO)C(C(C)=O)O)=O,4,2,0,2,46,9.499999999999999e-05
G5,C(CC(C(C)O)C(C(C)=O)O)=O,8,2,0,2,46,9.499999999999999e-05
G5,C1(C(CCO)CC(C1CO)=O)=O,4,2,0,2,46,9.499999999999999e-05
G5,C1(C(C(C)O)CC(C1CO)=O)=O,8,2,0,2,46,9.499999999999999e-05
G5,C1(C(CCO)C(C(C1)=O)CO)=O,4,2,0,2,46,9.499999999999999e-05
G5,C1(C(CC(CCO)C1CO)=O)=O,4,3,0,3,46,0.000143
G5,C1(C(C(C)O)C(C(C1)=O)CO)=O,8,2,0,2,46,9.499999999999999e-05
G5,C1(C(CC(C(C)O)C1CO)=O)=O,8,3,0,3,46,0.000143
G5,C1(CC(C(C1CCCO)=O)O)=O,4,2,0,2,46,9.499999999999999e-05
G5,C1(C(CCCO)CC(C1O)=O)=O,4,2,0,2,46,9.499999999999999e-05
G5,C1(CC(C(C1CC(C)O)=O)O)=O,8,2,0,2,46,9.499999999999999e-05
G5,C1(C(CC(C)O)CC(C1O)=O)=O,8,2,0,2,46,9.499999999999999e-05
G5,C(C1C(CCO)C(C(C1)=O)O)=O,8,2,0,2,46,9.499999999999999e-05
G5,C(C1C(CC(C1CCO)O)=O)=O,8,2,0,2,46,9.499999999999999e-05
G5,C(C1C(C(C)O)C(C(C1)=O)O)=O,16,2,0,2,46,9.499999999999999e-05
G5,C(C1C(CC(C1C(C)O)O)=O)=O,16,2,0,2,46,9.499999999999999e-05
G5,C1(CC(CCO)C(C(C)=O)O1)=O,4,2,0,2,46,9.499999999999999e-05
G5,C1(CC(C(CC=O)O1)CCO)=O,4,2,0,2,46,9.499999999999999e-05
G5,C1(CC(C(C)O)C(C(C)=O)O1)=O,8,2,0,2,46,9.499999999999999e-05
G5,C1(CC(C(CC=O)O1)C(C)O)=O,8,2,0,2,46,9.499999999999999e-05
G5,C1(C(CCO)CC(OCC1)=O)=O,2,2,0,2,46,9.499999999999999e-05
G5,C1(CC(CCO)CC(CO1)=O)=O,2,4,0,4,46,0.00018999999999999998
G5,C1(C(C(C)O)CC(OCC1)=O)=O,4,2,0,2,46,9.499999999999999e-05
G5,C1(CC(C(C)O)CC(CO1)=O)=O,4,4,0,4,46,0.00018999999999999998
G5,C1(CC(CC(CO1)CCO)=O)=O,2,2,0,2,46,9.499999999999999e-05
G5,C1(C(COCC(CCO)C1)=O)=O,2,2,0,2,46,9.499999999999999e-05
G5,C1(CC(CC(CO1)C(C)O)=O)=O,4,2,0,2,46,9.499999999999999e-05
G5,C1(C(COCC(C(C)O)C1)=O)=O,4,2,0,2,46,9.499999999999999e-05
G5,C1(COCC(CC1CCO)=O)=O,2,2,0,2,46,9.499999999999999e-05
G5,C1(COCC(CC1C(C)O)=O)=O,4,2,0,2,46,9.499999999999999e-05
G5,C(CC1CC(C(C1CO)=O)=O)=O,4,5,0,5,4,0.00023999999999999998
G5,C(CC1C(C(C)=O)OC(C1)=O)=O,4,2,0,2,4,9.6e-05
G5,C(CC1C(CC=O)OC(C1)=O)=O,4,2,0,2,4,9.6e-05
G5,C(CC1C(CCOC(C1)=O)=O)=O,2,2,0,2,4,9.6e-05
G5,C1(CO)C(C(C(C(C=1)=O)O)O)O,8,2,0,2,29,9.499999999999999e-05
G5,C1(CO)C(C(C(C=1CO)=O)O)O,4,2,0,2,29,9.499999999999999e-05
G5,C=C1C(C(C(C1(CO)O)O)O)=O,8,1,0,1,2,4.7e-05
G5,C1(CO)C(C(C(C=1C=O)O)O)O,8,1,0,1,51,4.7e-05
G5,C1C(C(C(C=1C=O)(CO)O)O)O,8,2,0,2,29,9.499999999999999e-05
G5,C1(C(C(C(CO)=O)=CC1)O)=O,2,1,0,1,20,4.7e-05
G5,C1(C(C(C=O)=C(CO)C1)O)=O,2,2,0,2,29,9.499999999999999e-05
G5,C(CC1C(C(C(C=1)=O)O)O)=O,4,1,0,1,51,4.7e-05
G5,C1(C(C(C(C1)=CC=O)O)O)=O,8,2,0,2,29,9.499999999999999e-05
G5,C1(C(C(C=C(C=O)C1)O)O)=O,4,1,0,1,51,4.7e-05
G5,C(C1CC(C(C(C=1)=O)O)O)=O,4,1,0,1,51,4.7e-05
G5,C(C(C1CC(C(C=1)=O)O)O)=O,4,1,0,1,26,4.7e-05
G5,C(C(C1CC(C(C=1)O)=O)O)=O,4,2,0,2,29,9.499999999999999e-05
G5,C1(CC(C(C=1)=O)O)C(CO)O,4,1,0,1,45,4.7e-05
G5,C1(C(C=C(C(CO)O)C1)O)=O,4,1,0,1,45,4.7e-05
G5,C(C1CC(C(C=1CO)=O)O)=O,2,1,0,1,2,4.7e-05
G5,C(C1(C(C(C(C1)O)=O)=C)O)=O,4,1,0,1,2,4.7e-05
G5,C(C1C(CO)C(C(C=1)=O)O)=O,4,1,0,1,45,4.7e-05
G5,C1(C(C(CO)=C(C=O)C1)O)=O,2,1,0,1,45,4.7e-05
G5,C1(CO)C(CO)C(C(C=1)=O)O,4,1,0,1,45,4.7e-05
G5,C1(C(C(CO)=C(CO)C1)O)=O,2,1,0,1,45,4.7e-05
G5,C(C1C(C=O)=CC(C1O)O)=O,8,1,0,1,20,4.7e-05
G5,C(C1CC(C(C=1C=O)O)O)=O,4,1,0,1,20,4.7e-05
G5,C(C1(C(C=O)=CC(C1)O)O)=O,4,2,0,2,29,9.499999999999999e-05
G5,C1C(CC(C=1C(C=O)=O)O)O,4,1,0,1,20,4.7e-05
G5,C1CC(C(C=1C(C=O)=O)O)O,4,1,0,1,20,4.7e-05
G5,C(C(C1C=CC(C1O)=O)O)=O,8,1,0,1,20,4.7e-05
G5,C(C(C1C(C(CC=1)=O)O)O)=O,4,1,0,1,20,4.7e-05
G5,C1C(C(C(C=1C(C=O)=O)O)O)O,8,1,0,1,0,4.7e-05
G5,C1CC(C(C=1)=O)O,2,1,0,1,45,4.7e-05
G5,C1(CC=CC1O)=O,2,1,0,1,45,4.7e-05
G5,C1C(CC(C=1C=O)(CO)O)O,4,2,0,2,29,9.499999999999999e-05
G5,C1(CO)CC(C(C=1C=O)O)O,4,1,0,1,21,4.7e-05
G5,C1C(CC(C=1C(CO)=O)O)O,4,1,0,1,21,4.7e-05
G5,C1CC(C(C=1C(CO)=O)O)O,4,1,0,1,21,4.7e-05
G5,C1(C(C(CO)=C(CO)C1O)O)=O,3,1,0,1,2,4.7e-05
G5,C1(C(C=C(C(CO)O)C1O)O)=O,8,1,0,1,2,4.7e-05
G5,C1C(CO)C(C(C=1C=O)=O)O,4,1,0,1,23,4.7e-05
G5,C(C1C(C(C(CO)=C1)O)=O)=O,4,1,0,1,23,4.7e-05
G5,C=C1C(C(CC1(CO)O)O)=O,4,1,0,1,3,4.7e-05
G5,C1(CO)CC(C(C=1CO)=O)O,2,1,0,1,3,4.7e-05
G5,C1(C(C=C(CO)C1CO)O)=O,4,2,0,2,29,9.499999999999999e-05
G5,C=C1C(C(CC1O)O)=O,4,1,0,1,4,4.7e-05
G5,C1C(C(C(C=1C=O)(C)O)O)O,8,2,0,2,29,9.499999999999999e-05
G5,C1(C)C(C(C(C=1C=O)O)O)O,8,1,0,1,16,4.7e-05
G5,C1C(C(C(C=1C(CO)=O)O)O)O,8,1,0,1,20,4.7e-05
G5,C1C(CC(C=1C=O)O)O,4,2,0,2,29,9.499999999999999e-05
G5,C1CC(C(C=1C=O)O)O,4,1,0,1,43,4.7e-05
G5,C1(C(C=CC1C(CCO)=O)O)=O,4,1,0,1,30,4.7e-05
G5,C1CC(C(C=1C(CCO)=O)=O)O,2,1,0,1,30,4.7e-05
G5,C1(CC(C(C=CC1CO)O)=O)=O,4,1,0,1,30,4.7e-05
G5,C1(C(CC=C(C(C1)=O)CO)O)=O,2,1,0,1,30,4.7e-05
G5,C1(C(CC(C(C(C1)=O)=C)O)O)=O,4,1,0,1,30,4.7e-05
G5,C(C1C(CCO)(CC(C=1)=O)O)=O,2,1,0,1,30,4.7e-05
G5,C1(C(C(C=O)=C(CCO)C1)O)=O,2,1,0,1,30,4.7e-05
G5,C(C1(C=CC(C(C1)=O)CO)O)=O,4,1,0,1,23,4.7e-05
G5,C(C1(CC(C(CO)=CC1)=O)O)=O,2,1,0,1,23,4.7e-05
G5,C(C1(CC(C(C(C1)=O)=C)O)O)=O,4,1,0,1,23,4.7e-05
G5,C1(C(C=CC1CC(CO)=O)O)=O,4,1,0,1,7,4.7e-05
G5,C(CO)(CC1C(C(CC=1)O)=O)=O,2,1,0,1,7,4.7e-05
G5,C(CO)(C1C=CC(C(C1)=O)O)=O,4,1,0,1,7,4.7e-05
G5,C1(C(CC=C(C(CO)=O)C1)O)=O,2,1,0,1,7,4.7e-05
G5,C1(CCC(C(C=CC1O)O)=O)=O,3,1,0,1,7,4.7e-05
G5,C(C1C(CO)(CCC(C=1)=O)O)=O,2,1,0,1,7,4.7e-05
G5,C1(CCC(CO)=C(C=O)C1O)=O,2,1,0,1,7,4.7e-05
G5,C(C1(C=CC(C(CO)=O)C1)O)=O,4,1,0,1,29,4.7e-05
G5,C(C1(CC(C(CO)=O)=CC1)O)=O,2,1,0,1,29,4.7e-05
G5,C(C1(C=CC(C(CC1)=O)O)O)=O,4,1,0,1,29,4.7e-05
G5,C(C1C(CO)(CCC=1C=O)O)=O,2,1,0,1,29,4.7e-05
G5,C(C1(C(C=O)=C(CO)CC1)O)=O,2,1,0,1,29,4.7e-05
G5,C1C(C(C=O)=O)CC(C=1)(CO)O,4,1,0,1,29,4.7e-05
G5,C1CC(CO)(CC=1C(C=O)=O)O,2,1,0,1,29,4.7e-05
G5,C1(C(C(C=O)=C(C(C)O)C1)O)=O,4,1,0,1,12,4.7e-05
G5,C1(C(C=CC1C(C(C)=O)O)O)=O,8,1,0,1,45,4.7e-05
G5,C(C)(C(C1C(C(CC=1)O)=O)O)=O,4,1,0,1,45,4.7e-05
G5,C1(C(C(CC1O)O)=CC(C)=O)=O,8,1,0,1,45,4.7e-05
G5,C1(C(CC(C(C=CC1)O)=O)O)=O,4,1,0,1,22,4.7e-05
G5,C1(CC(C(C=CCC1O)=O)O)=O,4,1,0,1,22,4.7e-05
G5,C(C1C(C)(C(CC(C=1)=O)O)O)=O,4,1,0,1,22,4.7e-05
G5,C1(CC(C(C)=C(C=O)C1O)O)=O,4,1,0,1,22,4.7e-05
G5,C(C1(C=CCC(C(C1)O)=O)O)=O,4,1,0,1,22,4.7e-05
G5,C(C1(CC(C(C=CC1)=O)O)O)=O,4,1,0,1,22,4.7e-05
G5,C(C1C(C)(C(CC=1C=O)O)O)=O,4,1,0,1,22,4.7e-05
G5,C(C1(C(C=O)=C(C)C(C1)O)O)=O,4,1,0,1,22,4.7e-05
G5,C1C(C(C=O)=O)C(C(C=1)(C)O)O,8,1,0,1,22,4.7e-05
G5,C1CC(C)(C(C=1C(C=O)=O)O)O,4,1,0,1,22,4.7e-05
G5,C1C(C)(CC(C=1C(C=O)=O)O)O,4,1,0,1,22,4.7e-05
G5,C1(C(C(C(C)O)=C(C=O)C1)O)=O,4,1,0,1,22,4.7e-05
G5,C(C1C(C(C)O)C(C(C=1)=O)O)=O,8,1,0,1,22,4.7e-05
G5,C(C1(C(C(C(C1)O)=O)=CC)O)=O,8,1,0,1,22,4.7e-05
G5,C(C1CC(C(C=1C(C)O)=O)O)=O,4,1,0,1,22,4.7e-05
G5,C(CC=C1C(C(CC1O)O)=O)=O,8,1,0,1,13,4.7e-05
G5,C1(CC(C(C=O)=CCC1O)O)=O,4,1,0,1,13,4.7e-05
G5,C1(C(CC(C(C=O)=CC1)O)O)=O,4,1,0,1,13,4.7e-05
G5,C1(C=C(C=O)C(CC(C1)O)O)=O,4,2,0,2,29,9.499999999999999e-05
G5,C1(CC(CC=C(C=O)C1O)O)=O,4,1,0,1,13,4.7e-05
G5,C(C1(CC(C(C=O)=CC1)O)O)=O,4,1,0,1,13,4.7e-05
G5,C(C1CC(CC(C=1C=O)O)O)=O,4,1,0,1,13,4.7e-05
G5,C(C1(C(C=O)=CCC(C1)O)O)=O,4,1,0,1,13,4.7e-05
G5,C1CC(CC(C=1C(C=O)=O)O)O,4,1,0,1,13,4.7e-05
G5,C1C(C(C(CC(C=1)O)=O)=O)CO,4,1,0,1,53,4.7e-05
G5,C1CC(CC(C(C=1CO)=O)=O)O,2,1,0,1,53,4.7e-05
G5,C=C1C(C(CC(CC1O)O)=O)=O,4,1,0,1,53,4.7e-05
G5,C1(CC=C(C=O)C1(CCO)O)=O,2,1,0,1,53,4.7e-05
G5,C1(C(CCO)=C(C=O)C(C1)O)=O,2,1,0,1,53,4.7e-05
G5,C(C1C(C(C=C1)(CCO)O)=O)=O,4,1,0,1,53,4.7e-05
G5,C1CC(C(C=1C=O)=O)(CCO)O,2,1,0,1,53,4.7e-05
G5,C1C(C(C(C=1C(C)O)=O)=O)CO,4,1,0,1,4,4.7e-05
G5,C1(CC(C=CC1C(CO)=O)O)=O,4,1,0,1,26,4.7e-05
G5,C1CC(CC(C=1C(CO)=O)=O)O,2,1,0,1,26,4.7e-05
G5,C1(CC(C(C=O)=CC1)(CO)O)=O,2,1,0,1,26,4.7e-05
G5,C1(CC(C(C=O)=C(CO)C1)O)=O,2,1,0,1,26,4.7e-05
G5,C1CC(CO)(CC(C=1C=O)=O)O,2,1,0,1,26,4.7e-05
G5,C1(C(C=C(C(C1)=O)C(C)O)O)=O,4,1,0,1,4,4.7e-05
G5,C1(C(C(C(C=O)=CC1)(C)O)O)=O,4,1,0,1,6,4.7e-05
G5,C1(CC(C(C=O)=C(C)C1O)O)=O,4,1,0,1,6,4.7e-05
G5,C(C1C(C(C(C=C1)(C)O)O)=O)=O,8,1,0,1,6,4.7e-05
G5,C1CC(C)(C(C(C=1C=O)=O)O)O,4,1,0,1,6,4.7e-05
G5,C1(C(C(C(C(C)O)=CC1)=O)O)=O,4,1,0,1,9,4.7e-05
G5,C(CC1C(CC(C=1C=O)O)O)=O,4,1,0,1,13,4.7e-05
G5,C(C1C(C(CC(C=C1)O)O)=O)=O,8,1,0,1,13,4.7e-05
G5,C1CC(CC(C(C=1C=O)=O)O)O,4,1,0,1,13,4.7e-05
G5,C1C(C(C)O)C(C(C=1C=O)=O)O,8,1,0,1,4,4.7e-05
G5,C(C1C(C(C(C(C)O)=C1)O)=O)=O,8,1,0,1,4,4.7e-05
G5,C1(C(C(C=CC1C(C)=O)O)O)=O,8,1,0,1,26,4.7e-05
G5,C1CC(C(C(C=1C(C)=O)=O)O)O,4,1,0,1,26,4.7e-05
G5,C1(CC(C(C=O)=CC1O)(C)O)=O,4,1,0,1,26,4.7e-05
G5,C1(C(C(C(C=O)=C(C)C1)O)O)=O,4,1,0,1,26,4.7e-05
G5,C(C(C1(C=CCC(C1)=O)O)O)=O,4,1,0,1,27,4.7e-05
G5,C(C(C1(CC(C=CC1)=O)O)O)=O,4,1,0,1,27,4.7e-05
G5,C(CC1C(C(C(CC=1)O)O)=O)=O,4,1,0,1,18,4.7e-05
G5,C(C1C=CC(C(C(C1)=O)O)O)=O,8,1,0,1,18,4.7e-05
G5,C1(C(C(CC=C(C=O)C1)O)O)=O,4,1,0,1,18,4.7e-05
G5,C1(CCC(C(C=O)=CC1O)O)=O,4,1,0,1,44,4.7e-05
G5,C1(CCC=C(C=O)C(C1O)O)=O,4,1,0,1,44,4.7e-05
G5,C(C1C=CC(C1)(C(C=O)O)O)=O,8,1,0,1,44,4.7e-05
G5,C(C(C1(CC(C=O)=CC1)O)O)=O,4,1,0,1,44,4.7e-05
G5,C(C(C1CCC(C=1C=O)O)O)=O,4,1,0,1,44,4.7e-05
G5,C(C(C1(C(C=O)=CCC1)O)O)=O,4,1,0,1,44,4.7e-05
G5,C(C(C=O)O)(C1C=CC(C1)O)=O,8,1,0,1,44,4.7e-05
G5,C(C(C(C1CC(CC=1)O)=O)O)=O,4,1,0,1,44,4.7e-05
G5,C1C(C(C(C=1)C(C(C)=O)=O)O)O,8,1,0,1,21,4.7e-05
G5,C1CC(C(C=1C(C(C)=O)=O)O)O,4,1,0,1,21,4.7e-05
G5,C1C(CC(C=1C(C(C)=O)=O)O)O,4,1,0,1,21,4.7e-05
G5,C1CC(C(CC(C(C=1)O)O)=O)=O,4,1,0,1,21,4.7e-05
G5,C1CC(C(CC(C(C=1)=O)=O)O)O,4,1,0,1,21,4.7e-05
G5,C(C)(C1(C(C=O)=CC(C1)O)O)=O,4,1,0,1,21,4.7e-05
G5,C(C1C(C(CC=1C(C)=O)O)O)=O,4,1,0,1,21,4.7e-05
G5,C1(CC(C=C(C=O)C1(C)O)O)=O,4,1,0,1,21,4.7e-05
G5,C1(C(C)=C(C=O)C(C(C1)O)O)=O,4,1,0,1,21,4.7e-05
G5,C1(CC=CC1(CC(C=O)O)O)=O,4,1,0,1,21,4.7e-05
G5,C(C(CC1(C(C=CC1)=O)O)O)=O,4,1,0,1,21,4.7e-05
G5,C1(C(C=CC1(C)O)C(C=O)O)=O,8,1,0,1,21,4.7e-05
G5,C(C(C1C(C(C)(CC=1)O)=O)O)=O,4,1,0,1,21,4.7e-05
G5,C1(C(C(CC1(C)O)O)=CC=O)=O,8,1,0,1,21,4.7e-05
G5,C(CC(C1C(C(CC=1)O)O)=O)=O,4,1,0,1,6,4.7e-05
G5,C(CC(C1C(CC(C=1)O)O)=O)=O,4,2,0,2,29,9.499999999999999e-05
G5,C1(CC(C(C=CC1C=O)O)O)=O,8,1,0,1,6,4.7e-05
G5,C1CC(C(CC(C=1C=O)=O)O)O,4,1,0,1,6,4.7e-05
G5,C(CC1CC(C(C=1C=O)O)O)=O,4,1,0,1,4,4.7e-05
G5,C1(CC(C=C(C=O)C(C1)O)O)=O,4,1,0,1,6,4.7e-05
G5,C1(CC(C(C(C=O)=CC1)O)O)=O,4,1,0,1,6,4.7e-05
G5,C(C(C1C(CC(C=C1)O)=O)O)=O,8,1,0,1,26,4.7e-05
G5,C(C(C1C(CC(CC=1)O)=O)O)=O,4,1,0,1,26,4.7e-05
G5,C1(C(C(CC(C1)O)O)=CC=O)=O,8,2,0,2,29,9.499999999999999e-05
G5,C(CC=C1C(CC(C1O)O)=O)=O,8,1,0,1,26,4.7e-05
G5,C1C(C(C=O)=CC=1)(C(CO)O)O,4,1,0,1,21,4.7e-05
G5,C1C(C(C=O)=C(C=1)C(CO)O)O,4,1,0,1,21,4.7e-05
G5,C=CC1(C(C=O)=CC(C1O)O)O,8,1,0,1,7,4.7e-05
G5,C=CC1C(C(C(C=1C=O)O)O)O,8,1,0,1,7,4.7e-05
G5,C1C(C(C=CC(C(C=1)O)O)=O)O,8,1,0,1,32,4.7e-05
G5,C1C(C(C=O)=CC(C=1)O)(CO)O,4,1,0,1,32,4.7e-05
G5,C1C(C(C(C=O)=C(C=1)CO)O)O,4,1,0,1,32,4.7e-05
G5,C1C(C(C=O)=CC(C(C=1)O)O)O,8,1,0,1,43,4.7e-05
G5,C1C(C(C(C(C=O)=CC=1)O)O)O,8,1,0,1,43,4.7e-05
G5,C1(C(CO)=CC(C1O)=O)=O,2,5,0,5,46,0.00023700000000000001
G5,C1(C(C(C(C1O)=O)=C)O)=O,4,1,0,1,2,4.7e-05
G5,C(C1C(C(C(C=1)=O)O)O)=O,4,6,0,6,55,0.000285
G5,C1(C(C(C=O)=CC1O)O)=O,4,1,0,1,5,4.7e-05
G5,C(C1C(CO)=CC(O1)O)=O,4,1,0,1,38,4.7e-05
G5,C1OCC(C=1C(CO)=O)O,2,1,0,1,38,4.7e-05
G5,C1COC(C=1C(CO)=O)O,2,1,0,1,38,4.7e-05
G5,C(C1C(C(C(O1)O)O)=C)=O,8,2,0,2,29,9.499999999999999e-05
G5,C1C(O)OCC=1C(CO)=O,2,1,0,1,30,4.7e-05
G5,C1COC(C=1C=O)(CO)O,2,1,0,1,40,4.7e-05
G5,C1(CO)OCC(C=1C=O)O,2,1,0,1,40,4.7e-05
G5,C1(C)C(C(C(C=1)=O)=O)O,2,1,0,1,26,4.7e-05
G5,C1C(CO)(C(C(C=1C=O)O)O)O,8,2,0,2,29,9.499999999999999e-05
G5,C1C(C(CO)(C(C=1C=O)O)O)O,8,2,0,2,29,9.499999999999999e-05
G5,C1(C)C(CO)(C(C(C=1)=O)O)O,4,1,0,1,25,4.7e-05
G5,C1(C(C(C(C1)=C)(CO)O)O)=O,4,1,0,1,25,4.7e-05
G5,C1C(C(C)O)(C(C(C=1)=O)O)O,8,1,0,1,49,4.7e-05
G5,C(C1C(CC(C=1CO)=O)O)=O,2,2,0,2,29,9.499999999999999e-05
G5,C1C(CO)(CC(C=1C=O)=O)O,2,1,0,1,2,4.7e-05
G5,C(C1C(C(C(C=1C=O)O)O)O)=O,3,1,0,1,43,4.7e-05
G5,C1(C(C(C)O)=C(C=O)C(C1)O)=O,4,2,0,2,29,9.499999999999999e-05
G5,C1C(C(C)O)(CC(C=1C=O)=O)O,4,1,0,1,25,4.7e-05
G5,C1C(C=CC(C=1)=O)=O,1,1,0,1,45,4.7e-05
G5,C(C1C=CC(C=1)=O)=O,1,4,0,4,29,0.00018999999999999998
G5,C1C=CC(C(C=1)=O)=O,1,1,0,1,27,4.7e-05
G5,C(C1C(C=CC=1)=O)=O,1,3,0,3,29,0.00014199999999999998
G5,C1(C2(C=CC1CO2)O)=O,4,2,0,2,2,9.499999999999999e-05
G5,C(C1C(C(CO)O)CC(C=1)=O)=O,4,1,0,1,46,4.7e-05
G5,C1(CC(C(C=O)=CC1O)CO)=O,4,1,0,1,11,4.7e-05
G5,C(CCC1C(C(C(C=1)O)O)=O)=O,4,1,0,1,4,4.7e-05
G5,C(C(C1C=CC(C(C1)=O)O)O)=O,8,1,0,1,32,4.7e-05
G5,C(CC1C(C=O)=CC(C1O)O)=O,8,1,0,1,4,4.7e-05
G5,C1C(C(C(C=1C(O)=O)=O)O)O,4,1,0,1,0,4.7e-05
G5,C(C1C(C(CC(C=1)=O)O)=O)(O)=O,2,1,0,1,17,4.7e-05
G5,C(C1C(C(CC=1C=O)O)=O)(O)=O,2,1,0,1,17,4.7e-05
G5,C(C1C=C(C(O)=O)C(C1O)=O)=O,4,1,0,1,17,4.7e-05
G5,C1C(C(C(C=1C(O)=O)=O)=O)CO,2,1,0,1,17,4.7e-05
G5,C1(CC(C(C(O)=O)=CC1O)=O)=O,2,1,0,1,17,4.7e-05
G5,C1(CC=C(C(O)=O)C(C1O)=O)=O,2,1,0,1,17,4.7e-05
G5,C1C(CC(C(C=1C(O)=O)=O)=O)O,2,1,0,1,17,4.7e-05
G5,C(C1C(C(C(O)=O)=CC1O)=O)=O,4,2,0,2,29,9.499999999999999e-05
G5,C(CO)(CO)=C(C(O)=O)C=O,1,1,0,1,5,4.7e-05
G5,C(C(CO)O)=C(C(O)=O)C=O,4,2,0,2,29,9.499999999999999e-05
G5,C(C(C(C(O)=O)=C(C=O)C)=O)=O,2,1,0,1,17,4.7e-05
G5,C(C(C(C(O)=O)=CC=O)=O)=O,2,1,0,1,0,4.7e-05
G5,C(C)(CO)=C(C(O)=O)C(C=O)=O,2,1,0,1,49,4.7e-05
G5,C(C=C(C=O)CO)(CC(C)O)=O,4,1,0,1,4,4.7e-05
G5,C(C(C(C=O)=CC(C)O)CO)=O,8,1,0,1,4,4.7e-05
G5,C(C(CC(C)O)=C(C=O)CO)=O,4,1,0,1,4,4.7e-05
G5,C(C(C(C=O)=C)(CC(C)O)O)=O,4,2,0,2,29,9.499999999999999e-05
G5,C(C(C=O)=CC(CC(C)O)=O)=O,2,1,0,1,4,4.7e-05
G5,C(C(C=O)C(C=O)=CC(C)O)=O,4,1,0,1,45,4.7e-05
G5,C(C(C=O)=C(C=O)CC(C)O)=O,2,1,0,1,45,4.7e-05
G5,C(C)=C(C(O)=O)C(C=O)=O,2,1,0,1,4,4.7e-05
G5,C(C(C(C(C=O)=O)=CC)O)(O)=O,4,1,0,1,4,4.7e-05
G5,C(C(C(C(C)O)=CC(O)=O)=O)=O,4,1,0,1,4,4.7e-05
G5,C(C)=C(C(C=O)=O)C(C(C)O)O,8,1,0,1,4,4.7e-05
G5,C(C(C)O)=C(C(C=O)=O)C(C)O,8,1,0,1,4,4.7e-05
G5,C(C(C(CCO)O)=CC(C)=O)=O,4,1,0,1,45,4.7e-05
G5,C(C)(C(C(C=O)=CCCO)O)=O,4,1,0,1,45,4.7e-05
G5,C(C(C=CCO)C(C(C)=O)O)=O,8,1,0,1,45,4.7e-05
G5,C(CC(C(C(C=O)CO)=C)O)=O,4,1,0,1,45,4.7e-05
G5,C(CC(C(C)=C(C=O)CO)O)=O,4,1,0,1,45,4.7e-05
G5,C(CC(C(C(C=O)=C)(C)O)O)=O,4,2,0,2,29,9.499999999999999e-05
G5,C(C(C=CC(C(C)=O)O)CO)=O,8,1,0,1,45,4.7e-05
G5,C(C)(C(CC=C(C=O)CO)O)=O,4,1,0,1,45,4.7e-05
G5,C(C)(C(CC(C(C=O)=C)O)O)=O,4,2,0,2,29,9.499999999999999e-05
G5,C(CC(C(C=O)=CC(C)=O)O)=O,4,1,0,1,45,4.7e-05
G5,C(CC=C(C=O)C(C(C)=O)O)=O,4,1,0,1,45,4.7e-05
G5,C(C(C=O)C(C(CC=O)O)=C)=O,2,1,0,1,45,4.7e-05
G5,C(CC(C(C)=C(C=O)C=O)O)=O,2,1,0,1,45,4.7e-05
G5,C(C(C=O)C=CC(C(C)=O)O)=O,4,1,0,1,45,4.7e-05
G5,C(C)(C(CC=C(C=O)C=O)O)=O,2,1,0,1,45,4.7e-05
G5,C(C(C(O)=O)=CC(C)=O)=O,2,1,0,1,17,4.7e-05
G5,C(CC(C(C=CC(O)=O)=O)O)=O,4,1,0,1,33,4.7e-05
G5,C(CC(C(C=CC(C)O)=O)O)=O,8,1,0,1,11,4.7e-05
G5,C(C(C(C(C)O)O)=CC(C)=O)=O,8,1,0,1,45,4.7e-05
G5,C(C)(C(C(C=O)=CC(C)O)O)=O,8,2,0,2,29,9.499999999999999e-05
G5,C(C(C(CCO)O)=C(C=O)C)=O,4,1,0,1,45,4.7e-05
G5,C(C(C(C=O)=CCCO)(C)O)=O,4,1,0,1,45,4.7e-05
G5,C(C(C)(C(C=O)C=CCO)O)=O,8,1,0,1,45,4.7e-05
G5,C(CC(C=C(C=O)CO)(C)O)=O,4,1,0,1,45,4.7e-05
G5,C(C(C=CC(C=O)(C)O)CO)=O,8,1,0,1,18,4.7e-05
G5,C(C(C)(CC=C(C=O)CO)O)=O,4,1,0,1,18,4.7e-05
G5,C(C(C)(CC(C(C=O)=C)O)O)=O,4,2,0,2,29,9.499999999999999e-05
G5,C(CC(C(C=O)=C(C=O)C)O)=O,4,1,0,1,45,4.7e-05
G5,C(C(C(C=O)=CCC=O)(C)O)=O,4,1,0,1,45,4.7e-05
G5,C(CC(C=C(C=O)C=O)(C)O)=O,2,1,0,1,45,4.7e-05
G5,C(C(C=O)C=CC(C=O)(C)O)=O,4,1,0,1,45,4.7e-05
G5,C(C(C)(CC=C(C=O)C=O)O)=O,2,1,0,1,45,4.7e-05
G5,C(C(C(O)=O)=C(C=O)C)=O,2,1,0,1,17,4.7e-05
G5,C(C(C(C(C)O)O)=C(C=O)C)=O,8,1,0,1,11,4.7e-05
G5,C(C(C(C=O)=CC(C)O)(C)O)=O,8,2,0,2,29,9.499999999999999e-05
G5,C(CC=C(C(O)=O)C(CO)=O)=O,2,1,0,1,17,4.7e-05
G5,C(CO)(CC=C(C(O)=O)C=O)=O,2,2,0,2,29,9.499999999999999e-05
G5,C(CC(CO)=C(C(O)=O)C=O)=O,2,1,0,1,49,4.7e-05
G5,C(C(C(C(C(O)=O)=C)=O)O)=O,2,3,0,3,29,0.00014199999999999998
G5,C(C(C(C(C(O)=O)=CC)=O)O)=O,4,1,0,1,4,4.7e-05
G5,C(C)(C(C=C(C(O)=O)C=O)O)=O,4,1,0,1,17,4.7e-05
G5,C(C(C(C)=C(C(O)=O)C=O)O)=O,4,1,0,1,17,4.7e-05
G5,C=C(C(O)=O)C(C(CO)O)=O,2,1,0,1,2,4.7e-05
G5,C(C)=C(C(C(CO)O)=O)C(O)=O,4,1,0,1,4,4.7e-05
G5,C(C)(C(CO)O)=C(C(O)=O)C=O,4,1,0,1,17,4.7e-05
G5,C=C(C=O)C(CCO)O,2,2,0,2,29,9.499999999999999e-05
G5,C(CCO)=C(C=O)CO,2,1,0,1,18,4.7e-05
G5,C(C(C=CCO)CO)=O,4,1,0,1,18,4.7e-05
G5,C=C(C=O)C(CO)(CC(C)O)O,4,2,0,2,29,9.499999999999999e-05
G5,C(CO)(CC(C)O)=C(C=O)CO,4,1,0,1,11,4.7e-05
G5,C(C(C(CO)=CC(C)O)CO)=O,8,1,0,1,11,4.7e-05
G5,C(CO)(C(C=CCO)C(C)O)=O,8,1,0,1,11,4.7e-05
G5,C(CCO)=C(C(CO)=O)C(C)O,4,1,0,1,11,4.7e-05
G5,C(C)=C(C(CO)=O)C(CCO)O,4,1,0,1,11,4.7e-05
G5,C(CC(C)O)(C(C=CCO)O)=O,8,1,0,1,11,4.7e-05
G5,C=C(C=O)C(C)(C(C(C)O)O)O,8,2,0,2,29,9.499999999999999e-05
G5,C(C)(C(C(C)O)O)=C(C=O)CO,8,1,0,1,4,4.7e-05
G5,C(C(C(C(C(C)O)O)=C)CO)=O,8,1,0,1,4,4.7e-05
G5,C(C(C(C)O)O)(CC=CCO)=O,8,1,0,1,18,4.7e-05
G5,C(CCO)=CC(C(C(C)O)O)=O,8,1,0,1,18,4.7e-05
G5,C=C(C=O)C(CC(CO)(C)O)O,4,2,0,2,29,9.499999999999999e-05
G5,C(CC(CO)(C)O)=C(C=O)CO,4,1,0,1,18,4.7e-05
G5,C(C(C=CC(CO)(C)O)CO)=O,8,1,0,1,18,4.7e-05
G5,C(C(C=CCO)C(CO)(C)O)=O,8,1,0,1,49,4.7e-05
G5,C(CCO)=C(C=O)C(CO)(C)O,4,1,0,1,49,4.7e-05
G5,C(CO)(C)=C(C=O)C(CCO)O,4,1,0,1,49,4.7e-05
G5,C=C(C=O)C(CC(C)O)O,4,2,0,2,29,9.499999999999999e-05
G5,C(CC(C)O)=C(C=O)CO,4,1,0,1,28,4.7e-05
G5,C(C(C=CC(C)O)CO)=O,8,1,0,1,28,4.7e-05
G5,C(C(C=CCO)C(C)O)=O,8,1,0,1,18,4.7e-05
G5,C(CCO)=C(C=O)C(C)O,4,1,0,1,18,4.7e-05
G5,C(C)=C(C=O)C(CCO)O,4,1,0,1,18,4.7e-05
G5,C=C(C=O)C(C(C(C)O)O)O,8,2,0,2,29,9.499999999999999e-05
G5,C(C(C(C)O)O)=C(C=O)CO,8,1,0,1,28,4.7e-05
G5,C=C(C=O)C(CC(CO)O)O,4,2,0,2,29,9.499999999999999e-05
G5,C(CC(CO)O)=C(C=O)CO,4,1,0,1,6,4.7e-05
G5,C(C(C=CC(CO)O)CO)=O,8,1,0,1,6,4.7e-05
G5,C(C(C=CCO)C(CO)O)=O,8,1,0,1,18,4.7e-05
G5,C(CCO)=C(C=O)C(CO)O,4,1,0,1,18,4.7e-05
G5,C(CO)=C(C=O)C(CCO)O,4,2,0,2,29,9.499999999999999e-05
G5,C(C(C(CO)O)=C(C=O)CO)=O,4,2,0,2,29,9.499999999999999e-05
G5,C(C(CO)=C(C=O)CO)=O,2,1,0,1,2,4.7e-05
G5,C(C(CO)=C(C(C)=O)CO)=O,2,1,0,1,25,4.7e-05
G5,C(CO)(C(C(C=O)=C)(C)O)=O,2,2,0,2,29,9.499999999999999e-05
G5,C(C(CO)=C(C(CO)=O)C)=O,2,2,0,2,29,9.499999999999999e-05
G5,C(C(C(C(C)=O)=O)O)=CCO,4,1,0,1,25,4.7e-05
G5,C(CC(C(CO)=O)=O)=CCO,2,1,0,1,18,4.7e-05
G5,C(CCO)=CC(C(CO)=O)=O,2,2,0,2,46,9.499999999999999e-05
G5,C(C(C)O)(C(C(C=O)=C)O)=O,4,2,0,2,29,9.499999999999999e-05
G5,C(C=C(C=O)CO)(C(C)O)=O,4,1,0,1,25,4.7e-05
G5,C(C(C(C)O)=C(C=O)CO)=O,4,2,0,2,29,9.499999999999999e-05
G5,C=C(C=O)C(CO)(C(C)O)O,4,2,0,2,29,9.499999999999999e-05
G5,C(CO)(C(C)O)=C(C=O)CO,4,1,0,1,25,4.7e-05
G5,C(C(C)O)(C(C=CCO)O)=O,8,1,0,1,25,4.7e-05
G5,C(CC(C(C=O)=C)O)=O,2,2,0,2,29,9.499999999999999e-05
G5,C(CC=C(C=O)CO)=O,2,1,0,1,18,4.7e-05
G5,C(C(C=O)C=CCO)=O,2,1,0,1,18,4.7e-05
G5,C(CCO)=C(C=O)C=O,1,1,0,1,18,4.7e-05
G5,C(C(C(CO)=C(C=O)CO)O)=O,4,1,0,1,2,4.7e-05
G5,C=C(C=O)C(C(CCO)O)O,4,2,0,2,29,9.499999999999999e-05
G5,C(C(CCO)O)=C(C=O)CO,4,1,0,1,29,4.7e-05
G5,C(C(C(C=O)=C)(C)O)(O)=O,2,2,0,2,29,9.499999999999999e-05
G5,C(C(C)=C(C=O)CO)(O)=O,2,1,0,1,28,4.7e-05
G5,C(C(C(C(O)=O)=C)CO)=O,2,1,0,1,28,4.7e-05
G5,C=C(C=O)C(O)=O,1,4,0,4,17,0.00018999999999999998
G5,C(CC(C(C=O)=C)(CO)O)(O)=O,2,2,0,2,29,9.499999999999999e-05
G5,C(CC(CO)=C(C=O)CO)(O)=O,2,1,0,1,29,4.7e-05
G5,C(C(C(CO)=CC(O)=O)CO)=O,4,1,0,1,29,4.7e-05
G5,C(C(C(CO)=O)C=CCO)(O)=O,4,1,0,1,0,4.7e-05
G5,C(CCO)=C(C(O)=O)C(CO)=O,2,1,0,1,0,4.7e-05
G5,C(CC(C(C=CCO)O)=O)(O)=O,4,1,0,1,17,4.7e-05
G5,C(C(C(C(C=O)=C)(C)O)O)(O)=O,4,2,0,2,29,9.499999999999999e-05
G5,C(C(C(C)=C(C=O)CO)O)(O)=O,4,1,0,1,33,4.7e-05
G5,C(C(C(C(C(O)=O)O)=C)CO)=O,4,1,0,1,33,4.7e-05
G5,C(C(C(O)=O)O)(CC=CCO)=O,4,1,0,1,18,4.7e-05
G5,C(C(C(C=CCCO)=O)O)(O)=O,4,1,0,1,18,4.7e-05
G5,C(C(C(C(C=O)=C)O)O)(O)=O,4,2,0,2,29,9.499999999999999e-05
G5,C(C(C=C(C=O)CO)O)(O)=O,4,1,0,1,18,4.7e-05
G5,C(CC(C(C(C=O)=C)O)O)(O)=O,4,2,0,2,29,9.499999999999999e-05
G5,C(CC(C=C(C=O)CO)O)(O)=O,4,1,0,1,29,4.7e-05
G5,C(C(C(C=O)=C)O)(CC(C)=O)=O,2,2,0,2,29,9.499999999999999e-05
G5,C(C)(CC(C=C(C=O)CO)=O)=O,2,1,0,1,26,4.7e-05
G5,C(C(C(C=O)=C)(CC(C)=O)O)=O,2,2,0,2,29,9.499999999999999e-05
G5,C(C)(CC(C=O)=C(C=O)CO)=O,2,1,0,1,23,4.7e-05
G5,C(C(C(C=O)=CC(C)=O)CO)=O,4,1,0,1,23,4.7e-05
G5,C=C(C=O)C(C)(CC(C=O)=O)O,2,2,0,2,29,9.499999999999999e-05
G5,C(C)(CC(C=O)=O)=C(C=O)CO,2,1,0,1,6,4.7e-05
G5,C(C(C(C)=CC(C=O)=O)CO)=O,4,1,0,1,6,4.7e-05
G5,C(C(C(CC(C=O)=O)=C)CO)=O,2,1,0,1,6,4.7e-05
G5,C(CCO)=C(C(C)=O)C(C=O)=O,2,1,0,1,26,4.7e-05
G5,C(CC=CCO)(CC(C=O)=O)=O,2,2,0,2,29,9.499999999999999e-05
G5,C(CCO)=CC(CC(C=O)=O)=O,2,1,0,1,18,4.7e-05
G5,C(CC(C=O)=C(C=O)CO)=O,2,2,0,2,29,9.499999999999999e-05
G5,C(CCO)=C(C=O)C(C=O)=O,2,1,0,1,23,4.7e-05
G5,C=C(C=O)C(CC(C(C)=O)=O)O,2,2,0,2,29,9.499999999999999e-05
G5,C(CC(C(C)=O)=O)=C(C=O)CO,2,1,0,1,14,4.7e-05
G5,C(C(C=CC(C(C)=O)=O)CO)=O,4,1,0,1,14,4.7e-05
G5,C(CC(C(C)=O)(C(C=O)=C)O)=O,2,2,0,2,29,9.499999999999999e-05
G5,C(CC(C(C)=O)=C(C=O)CO)=O,2,1,0,1,4,4.7e-05
G5,C(C(C(C(C)=O)=CC=O)CO)=O,4,1,0,1,4,4.7e-05
G5,C(CC=O)(C(C(C=O)=C)(C)O)=O,2,2,0,2,29,9.499999999999999e-05
G5,C(CC(C(C)=C(C=O)CO)=O)=O,2,1,0,1,14,4.7e-05
G5,C(C(C(C(CC=O)=O)=C)CO)=O,2,1,0,1,14,4.7e-05
G5,C(C(C=CCO)C(C(C)=O)=O)=O,4,1,0,1,14,4.7e-05
G5,C(CCO)=C(C=O)C(C(C)=O)=O,2,1,0,1,14,4.7e-05
G5,C(CC(C(CC=CCO)=O)=O)=O,2,2,0,2,29,9.499999999999999e-05
G5,C(CC(C(C=CCCO)=O)=O)=O,2,1,0,1,18,4.7e-05
G5,C(C)(C(C(C=O)=C)(C)O)=O,2,2,0,2,29,9.499999999999999e-05
G5,C(C(CO)=C(C(C)=O)C)=O,2,1,0,1,14,4.7e-05
G5,C(C(C(C(C)=O)=C)CO)=O,2,1,0,1,14,4.7e-05
G5,C(CC(C(C)=O)=O)=CCO,2,1,0,1,18,4.7e-05
G5,C(CCO)=CC(C(C)=O)=O,2,1,0,1,18,4.7e-05
G5,C(CC(C(C=O)=C)(C)O)=O,2,2,0,2,29,9.499999999999999e-05
G5,C(CC(C)=C(C=O)CO)=O,2,1,0,1,6,4.7e-05
G5,C(C(C(CC=O)=C)CO)=O,2,1,0,1,6,4.7e-05
G5,C(C(C(C)=CC=O)CO)=O,4,1,0,1,6,4.7e-05
G5,C(C)(CC(C(C=O)=C)O)=O,2,2,0,2,29,9.499999999999999e-05
G5,C(C)(CC=C(C=O)CO)=O,2,1,0,1,18,4.7e-05
G5,C(C(C=CC(C)=O)CO)=O,4,1,0,1,18,4.7e-05
G5,C(CC=O)(CC=CCO)=O,2,1,0,1,18,4.7e-05
G5,C(CC(C=CCCO)=O)=O,2,1,0,1,18,4.7e-05
G5,C(C(C(C)=O)C=CCO)=O,4,1,0,1,18,4.7e-05
G5,C(CCO)=C(C=O)C(C)=O,2,1,0,1,18,4.7e-05
G5,C=C(C=O)C1(COC(C1)O)O,4,2,0,2,29,9.499999999999999e-05
G5,C1(COC(C1)O)=C(C=O)CO,4,1,0,1,35,4.7e-05
G5,C(C(C1COC(C=1)O)CO)=O,4,1,0,1,35,4.7e-05
G5,C1(COC(C1C=CCO)O)=O,8,1,0,1,35,4.7e-05
G5,C(CCO)=C1C(COC1O)=O,4,1,0,1,35,4.7e-05
G5,C1OCC(C=1C(CCO)O)=O,2,1,0,1,35,4.7e-05
G5,C1(CC(OC1C=CCO)O)=O,8,1,0,1,35,4.7e-05
G5,C=C(C=O)C(C=CC(CO)=O)O,4,2,0,2,29,9.499999999999999e-05
G5,C(C(CO)=CC=CC(CO)=O)=O,4,1,0,1,21,4.7e-05
G5,C=C(C=O)C(C=CC=O)(CO)O,4,2,0,2,29,9.499999999999999e-05
G5,C(C(CO)=C(C=CC=O)CO)=O,4,1,0,1,11,4.7e-05
G5,C=C(C=O)C(C(C=C)=O)O,2,3,0,3,29,0.00014199999999999998
G5,C=CC(C=C(C=O)CO)=O,2,1,0,1,7,4.7e-05
G5,C(C(C=C)(C(C=O)=C)O)=O,2,2,0,2,29,9.499999999999999e-05
G5,C=CC(C=O)=C(C=O)CO,2,1,0,1,7,4.7e-05
G5,C=CC(C(C=O)=C)(CO)O,2,2,0,2,29,9.499999999999999e-05
G5,C=CC(CO)=C(C=O)CO,2,1,0,1,7,4.7e-05
G5,C(C(C(C=C)=O)O)=CCO,4,1,0,1,7,4.7e-05
G5,C=C(C=O)C(C=CC=O)O,4,2,0,2,29,9.499999999999999e-05
G5,C(C=CC=C(C=O)CO)=O,4,1,0,1,43,4.7e-05
G5,C=C(C=O)C(C(C)O)O,4,2,0,2,29,9.499999999999999e-05
G5,C(C(C)O)=C(C=O)CO,4,1,0,1,11,4.7e-05
G5,C(C(CCO)=C(C=O)CO)(O)=O,2,1,0,1,7,4.7e-05
G5,C(C(C(C(O)=O)=O)CO)=CCO,4,1,0,1,18,4.7e-05
G5,C(CCO)=C(C(C(O)=O)=O)CO,2,1,0,1,18,4.7e-05
G5,C=C(C(C(O)=O)=O)C(CCO)O,2,1,0,1,18,4.7e-05
G5,C(C(C=CCO)C(C(O)=O)O)=O,8,1,0,1,33,4.7e-05
G5,C(C(C(C=O)=CCCO)O)(O)=O,4,1,0,1,33,4.7e-05
G5,C(C=C(C=O)C(CCO)O)(O)=O,4,2,0,2,29,9.499999999999999e-05
G5,C=C(C=O)C(C(CO)(CO)O)O,2,2,0,2,29,9.499999999999999e-05
G5,C(C(CO)(CO)O)=C(C=O)CO,2,1,0,1,18,4.7e-05
G5,C(C(CO)(C(C(C=O)=C)O)O)=O,4,2,0,2,29,9.499999999999999e-05
G5,C(C(C=C(C=O)CO)(CO)O)=O,4,1,0,1,18,4.7e-05
G5,C=C(C=O)C1(COCC1O)O,4,2,0,2,29,9.499999999999999e-05
G5,C1(COCC1O)=C(C=O)CO,4,1,0,1,10,4.7e-05
G5,C1(C(COC1C=CCO)O)=O,8,1,0,1,10,4.7e-05
G5,C=C(C=O)C1(C(O)OCC1)O,4,2,0,2,29,9.499999999999999e-05
G5,C1(C(O)OCC1)=C(C=O)CO,4,1,0,1,34,4.7e-05
G5,C(C(C1C(OCC=1)O)CO)=O,4,1,0,1,34,4.7e-05
G5,C1(C(O)OCC1C=CCO)=O,8,1,0,1,34,4.7e-05
G5,C(CCO)=C1C(C(OC1)O)=O,4,1,0,1,34,4.7e-05
G5,C(C(C=O)=CC(CCO)=O)(O)=O,2,2,0,2,29,9.499999999999999e-05
G5,C(C(C=O)=C(C=O)CCO)(O)=O,2,1,0,1,3,4.7e-05
G5,C=C(C(O)=O)C(C(C(C)O)O)=O,4,1,0,1,2,4.7e-05
G5,C(CO)(CCO)=C(C(O)=O)C=O,2,1,0,1,3,4.7e-05
G5,C(C(C=C(C(O)=O)C=O)O)=O,4,2,0,2,29,9.499999999999999e-05
G5,C(C(C=O)C(CO)=CC(C)O)=O,4,1,0,1,45,4.7e-05
G5,C(CO)(CC(C)O)=C(C=O)C=O,2,1,0,1,45,4.7e-05
G5,C(C)=C(C(CO)=O)C(C(C)O)O,8,1,0,1,11,4.7e-05
G5,C(C(C)O)=C(C(CO)=O)C(C)O,8,1,0,1,11,4.7e-05
G5,C(C(C=O)C(C(C(C)O)O)=C)=O,4,1,0,1,45,4.7e-05
G5,C(C)(C(C(C)O)O)=C(C=O)C=O,4,1,0,1,45,4.7e-05
G5,C(C(C)O)=CC(C(C(C)O)O)=O,16,1,0,1,11,4.7e-05
G5,C(CC(C(C=O)=C(C)CO)O)=O,4,1,0,1,49,4.7e-05
G5,C(CC=C(C=O)C(CO)(C)O)=O,4,1,0,1,49,4.7e-05
G5,C(C(C=O)C=CC(CO)(C)O)=O,4,1,0,1,45,4.7e-05
G5,C(CC(C)(CO)O)=C(C=O)C=O,2,1,0,1,45,4.7e-05
G5,C(C)(CO)=C(C(O)=O)C=O,2,1,0,1,49,4.7e-05
G5,C(CO)(C)=C(C=O)C(C(C)O)O,8,1,0,1,49,4.7e-05
G5,C(C(C)O)=C(C=O)C(CO)(C)O,8,1,0,1,49,4.7e-05
G5,C(CC(C=C(C(O)=O)C=O)O)=O,4,2,0,2,29,9.499999999999999e-05
G5,C(C(CC=C(C(O)=O)C=O)O)=O,4,1,0,1,43,4.7e-05
G5,C(C)=C(C=O)C(CC(C)O)O,8,1,0,1,28,4.7e-05
G5,C(CC(C)O)=C(C=O)C(C)O,8,1,0,1,28,4.7e-05
G5,C(C(C=CC(C)O)C(C)O)=O,16,1,0,1,28,4.7e-05
G5,C(C)=C(C=O)C(C(C(C)O)O)O,16,1,0,1,28,4.7e-05
G5,C(C(C(C)O)O)=C(C=O)C(C)O,16,1,0,1,28,4.7e-05
G5,C(C)=C(C=O)C(CC(CO)O)O,8,1,0,1,6,4.7e-05
G5,C(CC(CO)O)=C(C=O)C(C)O,8,1,0,1,6,4.7e-05
G5,C(C(C=CC(CO)O)C(C)O)=O,16,1,0,1,6,4.7e-05
G5,C(C(C=CC(C)O)C(CO)O)=O,16,1,0,1,6,4.7e-05
G5,C(CC(C)O)=C(C=O)C(CO)O,8,1,0,1,6,4.7e-05
G5,C(CO)=C(C=O)C(CC(C)O)O,8,2,0,2,29,9.499999999999999e-05
G5,C(CO)(C(C(C=O)=CC)O)=O,4,1,0,1,28,4.7e-05
G5,C(C(C(C=O)=O)O)=CC(C)O,8,1,0,1,5,4.7e-05
G5,C(C)(C(C(C=O)=CC)(CO)O)=O,4,1,0,1,25,4.7e-05
G5,C(C(CO)=C(C=O)C(C)O)(C)=O,4,1,0,1,25,4.7e-05
G5,C(CO)(C(C(C=O)=CC)(C)O)=O,4,1,0,1,25,4.7e-05
G5,C(C(C(C)O)=C(C(CO)=O)C)=O,4,1,0,1,25,4.7e-05
G5,C(C(C(C(CO)=O)=C)C(C)O)=O,4,1,0,1,25,4.7e-05
G5,C(C(C)O)=CC(C(C(C)=O)=O)O,8,1,0,1,25,4.7e-05
G5,C(C(C)O)=CCC(C(CO)=O)=O,4,1,0,1,25,4.7e-05
G5,C(CC(C)O)=CC(C(CO)=O)=O,4,1,0,1,25,4.7e-05
G5,C(C(C)O)(C(C(C=O)=CC)O)=O,8,1,0,1,25,4.7e-05
G5,C(C(C(C)O)=CC(C(C)O)=O)=O,8,1,0,1,25,4.7e-05
G5,C(C(C(C)O)=C(C=O)C(C)O)=O,6,1,0,1,4,4.7e-05
G5,C(C)=C(C=O)C(CO)(C(C)O)O,8,1,0,1,25,4.7e-05
G5,C(CO)(C(C)O)=C(C=O)C(C)O,8,1,0,1,25,4.7e-05
G5,C(C(C)O)(C(C=CC(C)O)O)=O,16,1,0,1,25,4.7e-05
G5,C(CC(C(C=O)=CC)O)=O,4,1,0,1,4,4.7e-05
G5,C(CC=C(C=O)C(C)O)=O,4,1,0,1,4,4.7e-05
G5,C(C(C=O)C=CC(C)O)=O,4,1,0,1,28,4.7e-05
G5,C(CC(C)O)=C(C=O)C=O,2,1,0,1,28,4.7e-05
G5,C(C)=C(C=O)C(C(CCO)O)O,8,1,0,1,29,4.7e-05
G5,C(C(CCO)O)=C(C=O)C(C)O,8,1,0,1,29,4.7e-05
G5,C(C(C(C=O)=CC)(C)O)(O)=O,4,1,0,1,28,4.7e-05
G5,C(C(C)=C(C=O)C(C)O)(O)=O,4,1,0,1,28,4.7e-05
G5,C(C(C(C(O)=O)=C)C(C)O)=O,4,1,0,1,28,4.7e-05
G5,C(CC(C(O)=O)=O)=CC(C)O,4,1,0,1,28,4.7e-05
G5,C(CC(C)O)=CC(C(O)=O)=O,4,1,0,1,28,4.7e-05
G5,C(C)=C(C=O)C(O)=O,2,1,0,1,4,4.7e-05
G5,C(C(C(C(C=O)=CC)O)O)(O)=O,8,1,0,1,17,4.7e-05
G5,C(C(C=C(C=O)C(C)O)O)(O)=O,8,1,0,1,17,4.7e-05
G5,C(C(C(C=O)=CC)(CC=O)O)=O,4,1,0,1,23,4.7e-05
G5,C(CC(C=O)=C(C=O)C(C)O)=O,4,2,0,2,29,9.499999999999999e-05
G5,C(C(C(C=O)=CC=O)C(C)O)=O,8,1,0,1,23,4.7e-05
G5,C(C(C=CC(C)O)C(C=O)=O)=O,8,1,0,1,23,4.7e-05
G5,C(CC(C)O)=C(C=O)C(C=O)=O,4,1,0,1,23,4.7e-05
G5,C(C)(C(C(C=O)=CC)(C)O)=O,4,1,0,1,14,4.7e-05
G5,C(C(C(C)O)=C(C(C)=O)C)=O,4,1,0,1,14,4.7e-05
G5,C(C(C(C(C)=O)=C)C(C)O)=O,4,1,0,1,14,4.7e-05
G5,C(C(C)O)=CCC(C(C)=O)=O,4,1,0,1,14,4.7e-05
G5,C(CC(C)O)=CC(C(C)=O)=O,4,1,0,1,14,4.7e-05
G5,C(CC(C(C=O)=CC)(C)O)=O,4,1,0,1,6,4.7e-05
G5,C(CC(C)=C(C=O)C(C)O)=O,4,1,0,1,6,4.7e-05
G5,C(C(C(CC=O)=C)C(C)O)=O,4,1,0,1,6,4.7e-05
G5,C(C(C(C)=CC=O)C(C)O)=O,8,1,0,1,6,4.7e-05
G5,C(C)(CC(C(C=O)=CC)O)=O,4,1,0,1,6,4.7e-05
G5,C(C)(CC=C(C=O)C(C)O)=O,4,1,0,1,6,4.7e-05
G5,C(C(C=CC(C)=O)C(C)O)=O,8,1,0,1,6,4.7e-05
G5,C(CC=O)(CC=CC(C)O)=O,4,1,0,1,28,4.7e-05
G5,C(CC(C=CCC(C)O)=O)=O,4,1,0,1,28,4.7e-05
G5,C(C(C(C)=O)C=CC(C)O)=O,8,1,0,1,6,4.7e-05
G5,C(CC(C)O)=C(C=O)C(C)=O,4,1,0,1,6,4.7e-05
G5,C(C)=C(C=O)C1(COC(C1)O)O,8,1,0,1,35,4.7e-05
G5,C1(COC(C1)O)=C(C=O)C(C)O,8,1,0,1,35,4.7e-05
G5,C(C(C1COC(C=1)O)C(C)O)=O,8,1,0,1,35,4.7e-05
G5,C1(COC(C1C=CC(C)O)O)=O,16,1,0,1,35,4.7e-05
G5,C(CC(C)O)=C1C(COC1O)=O,8,1,0,1,35,4.7e-05
G5,C1OCC(C=1C(CC(C)O)O)=O,4,1,0,1,35,4.7e-05
G5,C1(CC(OC1C=CC(C)O)O)=O,16,1,0,1,35,4.7e-05
G5,C=CC(C(C(C=O)=CC)O)=O,4,1,0,1,7,4.7e-05
G5,C=CC(C=C(C=O)C(C)O)=O,4,1,0,1,7,4.7e-05
G5,C(C(C=C)(C(C=O)=CC)O)=O,4,1,0,1,7,4.7e-05
G5,C=CC(C=O)=C(C=O)C(C)O,4,1,0,1,7,4.7e-05
G5,C=CC(C(C=O)=CC)(CO)O,4,1,0,1,7,4.7e-05
G5,C=CC(CO)=C(C=O)C(C)O,4,1,0,1,7,4.7e-05
G5,C(C(C(C=C)=O)O)=CC(C)O,8,1,0,1,7,4.7e-05
G5,C(C(C(C=O)=CC)O)=CC=O,8,1,0,1,43,4.7e-05
G5,C(C(C(C)O)=CC=CC=O)=O,8,1,0,1,43,4.7e-05
G5,C(C)=C(C=O)C(C(C)O)O,8,1,0,1,11,4.7e-05
G5,C(C(C)O)=C(C=O)C(C)O,8,1,0,1,11,4.7e-05
G5,C(C)=C(C=O)C1(COCC1O)O,8,1,0,1,10,4.7e-05
G5,C1(COCC1O)=C(C=O)C(C)O,8,1,0,1,10,4.7e-05
G5,C1(C(COC1C=CC(C)O)O)=O,16,1,0,1,10,4.7e-05
G5,C(C)=C(C=O)C1(C(O)OCC1)O,8,1,0,1,34,4.7e-05
G5,C1(C(O)OCC1)=C(C=O)C(C)O,8,1,0,1,34,4.7e-05
G5,C(C(C1C(OCC=1)O)C(C)O)=O,8,1,0,1,34,4.7e-05
G5,C1(C(O)OCC1C=CC(C)O)=O,16,1,0,1,34,4.7e-05
G5,C(CC(C)O)=C1C(C(OC1)O)=O,8,1,0,1,34,4.7e-05
G5,C(CO)=C(C(O)=O)C(C=O)=O,2,1,0,1,0,4.7e-05
G5,C(C(C(C)O)O)=C(C=O)C=O,4,1,0,1,28,4.7e-05
G5,C(C(C(C)O)O)=CC(C(O)=O)=O,8,1,0,1,28,4.7e-05
G5,C(C(C(C)O)O)=CC(C(C)=O)=O,8,1,0,1,14,4.7e-05
G5,C(CC(C=CC(C(C)O)O)=O)=O,8,1,0,1,6,4.7e-05
G5,C(C(C(C)O)O)=C(C=O)C(C)=O,8,1,0,1,6,4.7e-05
G5,C(CC(C(C=O)=CCO)O)=O,4,2,0,2,29,9.499999999999999e-05
G5,C(CC=C(C=O)C(CO)O)=O,4,1,0,1,6,4.7e-05
G5,C(C(C=O)C=CC(CO)O)=O,4,1,0,1,6,4.7e-05
G5,C(CC(CO)O)=C(C=O)C=O,2,1,0,1,6,4.7e-05
G5,C(C(C(C=O)=CCO)(C)O)(O)=O,4,2,0,2,29,9.499999999999999e-05
G5,C(C(C)=C(C=O)C(CO)O)(O)=O,4,1,0,1,28,4.7e-05
G5,C(C(C(C(O)=O)=C)C(CO)O)=O,4,1,0,1,28,4.7e-05
G5,C(CC(C(O)=O)=O)=CC(CO)O,4,1,0,1,29,4.7e-05
G5,C(CC(CO)O)=CC(C(O)=O)=O,4,1,0,1,29,4.7e-05
G5,C(CO)=C(C(O)=O)C=O,2,2,0,2,29,9.499999999999999e-05
G5,C(C)(C(C(C=O)=CCO)(C)O)=O,4,2,0,2,29,9.499999999999999e-05
G5,C(C(C(CO)O)=C(C(C)=O)C)=O,4,1,0,1,14,4.7e-05
G5,C(C(C(C(C)=O)=C)C(CO)O)=O,4,1,0,1,14,4.7e-05
G5,C(C(CO)O)=CCC(C(C)=O)=O,4,1,0,1,14,4.7e-05
G5,C(CC(CO)O)=CC(C(C)=O)=O,4,1,0,1,14,4.7e-05
G5,C(CC(C(C=O)=CCO)(C)O)=O,4,2,0,2,29,9.499999999999999e-05
G5,C(CC(C)=C(C=O)C(CO)O)=O,4,1,0,1,6,4.7e-05
G5,C(C(C(CC=O)=C)C(CO)O)=O,4,1,0,1,6,4.7e-05
G5,C(C(C(C)=CC=O)C(CO)O)=O,8,1,0,1,6,4.7e-05
G5,C(C)(CC(C(C=O)=CCO)O)=O,4,2,0,2,29,9.499999999999999e-05
G5,C(C)(CC=C(C=O)C(CO)O)=O,4,1,0,1,6,4.7e-05
G5,C(C(C=CC(C)=O)C(CO)O)=O,8,1,0,1,6,4.7e-05
G5,C(CC=O)(CC=CC(CO)O)=O,4,1,0,1,6,4.7e-05
G5,C(CC(C=CCC(CO)O)=O)=O,4,1,0,1,6,4.7e-05
G5,C(C(C(C)=O)C=CC(CO)O)=O,8,1,0,1,6,4.7e-05
G5,C(CC(CO)O)=C(C=O)C(C)=O,4,1,0,1,6,4.7e-05
G5,C=CC(C(C(C=O)=CCO)O)=O,4,2,0,2,29,9.499999999999999e-05
G5,C=CC(C=C(C=O)C(CO)O)=O,4,1,0,1,7,4.7e-05
G5,C(C(C=C)(C(C=O)=CCO)O)=O,4,2,0,2,29,9.499999999999999e-05
G5,C=CC(C=O)=C(C=O)C(CO)O,4,1,0,1,7,4.7e-05
G5,C=CC(C(C=O)=CCO)(CO)O,4,2,0,2,29,9.499999999999999e-05
G5,C=CC(CO)=C(C=O)C(CO)O,4,1,0,1,7,4.7e-05
G5,C(C(C(C=C)=O)O)=CC(CO)O,8,1,0,1,7,4.7e-05
G5,C(C(C(C=O)=CCO)O)=CC=O,8,2,0,2,29,9.499999999999999e-05
G5,C(C(C(CO)O)=CC=CC=O)=O,8,1,0,1,43,4.7e-05
G5,C(CO)=C(C=O)C(C(C)O)O,8,2,0,2,29,9.499999999999999e-05
G5,C(C(C)O)=C(C=O)C(CO)O,8,1,0,1,6,4.7e-05
G5,C(C(C=O)=C(C=O)C(CO)O)=O,2,1,0,1,0,4.7e-05
G5,C(C(C=O)=CC(C(CO)O)=O)=O,2,1,0,1,5,4.7e-05
G5,C=C(C(CO)=O)C(C(C=O)=O)O,2,2,0,2,29,9.499999999999999e-05
G5,C(C(CO)=CC(C(CO)=O)=O)=O,2,1,0,1,5,4.7e-05
G5,C(C(C=O)=C(C=O)CO)=O,1,2,0,2,29,9.499999999999999e-05
G5,C(C(C=O)=CC(CO)=O)=O,1,3,0,3,45,0.00014199999999999998
G5,C=C(C(O)=O)C(C(C=O)=O)O,2,1,0,1,5,4.7e-05
G5,C(C(CO)=CC(C(O)=O)=O)=O,2,1,0,1,17,4.7e-05
G5,C(C(C(C(C=O)=O)O)=CC=O)=O,4,1,0,1,23,4.7e-05
G5,C(C(C(C=O)=O)O)=CC(C=O)=O,4,1,0,1,23,4.7e-05
G5,C(C(C(C=O)=O)=C(C=O)CO)=O,2,1,0,1,23,4.7e-05
G5,C(C(C(C=O)=O)=CC(CO)=O)=O,2,1,0,1,23,4.7e-05
G5,C(C)(C(C(C=O)=O)O)=CC=O,4,1,0,1,6,4.7e-05
G5,C(C(C(C)=O)=C(C=O)CO)=O,2,2,0,2,29,9.499999999999999e-05
G5,C1C(O)OCC=1C(C(C=O)=O)O,4,1,0,1,35,4.7e-05
G5,C(C(CO)=C1C(COC1O)=O)=O,4,1,0,1,5,4.7e-05
G5,C(C(C1C(COC=1)=O)(CO)O)=O,2,1,0,1,5,4.7e-05
G5,C1(C(C(O)OC1)=CC(CO)=O)=O,4,1,0,1,5,4.7e-05
G5,C(CO)(C(C1C(COC=1)=O)O)=O,2,1,0,1,5,4.7e-05
G5,C1COC(C=1C(C(C=O)=O)O)O,4,1,0,1,34,4.7e-05
G5,C(C(CO)=C1C(C(O)OC1)=O)=O,4,1,0,1,34,4.7e-05
G5,C1(C(COC1O)=CC(CO)=O)=O,4,1,0,1,34,4.7e-05
G5,C(C(C=O)=CC(CO)=O)(O)=O,2,2,0,2,29,9.499999999999999e-05
G5,C(C(C=O)=C(C(C)=O)CO)=O,1,1,0,1,45,4.7e-05
G5,C(C(C=O)C(C(CO)=O)=C)=O,1,1,0,1,25,4.7e-05
G5,C(C(C=O)=C(C(CO)=O)C)=O,1,2,0,2,29,9.499999999999999e-05
G5,C=C(C(O)=O)C(C(C(C)=O)=O)O,2,1,0,1,25,4.7e-05
G5,C(C(C)=CC(C(CO)=O)=O)(O)=O,2,1,0,1,25,4.7e-05
G5,C=C(C(O)=O)CC(C(CO)=O)=O,1,1,0,1,25,4.7e-05
G5,C(C(C=C(C(CO)=O)C)=O)(O)=O,2,1,0,1,0,4.7e-05
G5,C(C=CC(C(CO)=O)=O)(O)=O,2,1,0,1,33,4.7e-05
G5,C=C(C(C)=O)C(C(C(C)=O)=O)O,2,1,0,1,14,4.7e-05
G5,C(C(C)=CC(C(CO)=O)=O)(C)=O,2,1,0,1,14,4.7e-05
G5,C=C(C(C)=O)CC(C(CO)=O)=O,1,1,0,1,14,4.7e-05
G5,C(C(CO)=CC(C(C)=O)=O)(C)=O,2,1,0,1,14,4.7e-05
G5,C=C(C(CO)=O)CC(C(C)=O)=O,1,1,0,1,14,4.7e-05
G5,C(C(C)=CC(C(C)=O)=O)(CO)=O,2,1,0,1,14,4.7e-05
G5,C(CC(C(C(C(C)=O)=O)O)=C)=O,2,1,0,1,25,4.7e-05
G5,C(C)(C(C(C(C)=O)=O)O)=CC=O,4,1,0,1,25,4.7e-05
G5,C(C(C(C(C)=O)=O)O)=CC(C)=O,4,1,0,1,25,4.7e-05
G5,C(C)(CC=CC(C(CO)=O)=O)=O,2,1,0,1,25,4.7e-05
G5,C(CC(C(CO)=O)=O)=CC(C)=O,2,1,0,1,25,4.7e-05
G5,C(CC(C=C(C(C)=O)CO)=O)=O,2,1,0,1,25,4.7e-05
G5,C(CC=O)(CC(C(CO)=O)=C)=O,1,1,0,1,25,4.7e-05
G5,C(CC(C=C(C(CO)=O)C)=O)=O,2,1,0,1,25,4.7e-05
G5,C(C(C(C)=O)=C(C(C)=O)CO)=O,2,1,0,1,25,4.7e-05
G5,C(C(C(C)=O)C(C(CO)=O)=C)=O,2,1,0,1,25,4.7e-05
G5,C(C(C(C)=O)=C(C(CO)=O)C)=O,2,1,0,1,25,4.7e-05
G5,C=CC(C=CC(C(CO)=O)=O)=O,2,1,0,1,25,4.7e-05
G5,C=CC(C=O)=CC(C(CO)=O)=O,2,1,0,1,25,4.7e-05
G5,C=CC(CO)=CC(C(CO)=O)=O,2,1,0,1,25,4.7e-05
G5,C=CC(C(C(C(CO)=O)=C)O)=O,2,2,0,2,29,9.499999999999999e-05
G5,C(C=CC=CC(C(CO)=O)=O)=O,4,1,0,1,25,4.7e-05
G5,C(C(C)O)=CC(C(CO)=O)=O,4,2,0,2,46,9.499999999999999e-05
G5,C(C(C=O)=CC(C(C)O)=O)=O,2,1,0,1,25,4.7e-05
G5,C(C(C=O)=C(C=O)C(C)O)=O,2,1,0,1,25,4.7e-05
G5,C(C(C=CC(C(C)O)=O)=O)(O)=O,4,1,0,1,49,4.7e-05
G5,C(C(C=C(C=O)C(C)O)=O)(O)=O,4,1,0,1,17,4.7e-05
G5,C(C(C=CC(C(C)O)=O)=O)(C)=O,4,1,0,1,14,4.7e-05
G5,C(CC(C=CC(C(C)O)=O)=O)=O,4,1,0,1,9,4.7e-05
G5,C(C(C(C)=O)=CC(C(C)O)=O)=O,4,1,0,1,25,4.7e-05
G5,C(C(C(C)=O)=C(C=O)C(C)O)=O,4,1,0,1,25,4.7e-05
G5,C(CO)(C(C)O)=C(C=O)C=O,2,1,0,1,25,4.7e-05
G5,C(C(C)O)(C(C(C(O)=O)=C)O)=O,4,1,0,1,25,4.7e-05
G5,C(CO)(C(C)O)=CC(C(O)=O)=O,4,1,0,1,29,4.7e-05
G5,C(C(C)O)(C(C(C(C)=O)=C)O)=O,4,1,0,1,25,4.7e-05
G5,C(CC(C(C(C(C)O)=O)O)=C)=O,4,1,0,1,25,4.7e-05
G5,C(C(C)O)(C(C(C)=CC=O)O)=O,8,1,0,1,25,4.7e-05
G5,C(C(C)O)(C(C=CC(C)=O)O)=O,8,1,0,1,25,4.7e-05
G5,C(CO)(C(C)O)=C(C(C)=O)C=O,4,1,0,1,25,4.7e-05
G5,C(CC=C(C=O)C=O)=O,1,2,0,2,45,9.499999999999999e-05
G5,C(C(C=O)C=CC=O)=O,2,2,0,2,45,9.499999999999999e-05
G5,C(C(C(CO)=C(C=O)C=O)O)=O,2,1,0,1,1,4.7e-05
G5,C(CO)(C(C=C(C=O)C=O)O)=O,2,1,0,1,5,4.7e-05
G5,C(C(CCO)O)=C(C=O)C=O,2,1,0,1,29,4.7e-05
G5,C(C(C=O)=C(C(O)=O)C)=O,1,1,0,1,28,4.7e-05
G5,C(C(C=O)C(C(O)=O)=C)=O,1,1,0,1,28,4.7e-05
G5,C(CC(CO)=C(C=O)C=O)(O)=O,1,1,0,1,45,4.7e-05
G5,C(C(C=O)C(CO)=CC(O)=O)=O,2,1,0,1,45,4.7e-05
G5,C(C(C(C)=C(C=O)C=O)O)(O)=O,2,1,0,1,45,4.7e-05
G5,C(C(C=O)C(C(C(O)=O)O)=C)=O,2,1,0,1,45,4.7e-05
G5,C(C(C=O)=CC(O)=O)=O,1,1,0,1,33,4.7e-05
G5,C(C(C=C(C=O)C=O)O)(O)=O,2,1,0,1,45,4.7e-05
G5,C(CC(C=C(C=O)C=O)O)(O)=O,2,1,0,1,29,4.7e-05
G5,C(C)(CC(C=C(C=O)C=O)=O)=O,1,1,0,1,26,4.7e-05
G5,C(C)(CC(C=O)=C(C=O)C=O)=O,1,1,0,1,26,4.7e-05
G5,C(C(C=O)C(C=O)=CC(C)=O)=O,2,1,0,1,26,4.7e-05
G5,C(C)(CC(C=O)=O)=C(C=O)C=O,1,1,0,1,26,4.7e-05
G5,C(C(C=O)C(C)=CC(C=O)=O)=O,2,1,0,1,26,4.7e-05
G5,C(C(C=O)C(CC(C=O)=O)=C)=O,1,1,0,1,26,4.7e-05
G5,C(CC=C(C(C)=O)C(C=O)=O)=O,2,1,0,1,26,4.7e-05
G5,C(CC(C=C(C=O)C=O)=O)=O,1,3,0,3,29,0.00014199999999999998
G5,C(CC(C=O)=C(C=O)C=O)=O,1,2,0,2,29,9.499999999999999e-05
G5,C(C(C=O)C(C=O)=CC=O)=O,2,1,0,1,23,4.7e-05
G5,C(CC(C=O)=O)=C(C=O)C=O,1,3,0,3,29,0.00014199999999999998
G5,C(CC=C(C=O)C(C=O)=O)=O,2,1,0,1,23,4.7e-05
G5,C(CC(C(C)=O)=O)=C(C=O)C=O,1,1,0,1,14,4.7e-05
G5,C(C(C=O)C=CC(C(C)=O)=O)=O,2,1,0,1,14,4.7e-05
G5,C(CC(C(C)=O)=C(C=O)C=O)=O,1,1,0,1,14,4.7e-05
G5,C(C(C=O)C(C(C)=O)=CC=O)=O,2,1,0,1,14,4.7e-05
G5,C(CC(C(C)=C(C=O)C=O)=O)=O,1,1,0,1,14,4.7e-05
G5,C(C(C=O)C(C(CC=O)=O)=C)=O,1,1,0,1,14,4.7e-05
G5,C(C(C=CC=O)C(C(C)=O)=O)=O,4,1,0,1,14,4.7e-05
G5,C(CC=C(C=O)C(C(C)=O)=O)=O,2,1,0,1,14,4.7e-05
G5,C(C(C=O)=C(C(C)=O)C)=O,1,1,0,1,14,4.7e-05
G5,C(C(C=O)C(C(C)=O)=C)=O,1,1,0,1,14,4.7e-05
G5,C(CC(C)=C(C=O)C=O)=O,1,1,0,1,6,4.7e-05
G5,C(C(C=O)C(CC=O)=C)=O,1,1,0,1,6,4.7e-05
G5,C(C(C=O)C(C)=CC=O)=O,2,1,0,1,6,4.7e-05
G5,C(C)(CC=C(C=O)C=O)=O,1,1,0,1,45,4.7e-05
G5,C(C(C=O)C=CC(C)=O)=O,2,1,0,1,45,4.7e-05
G5,C(CC(CC=CC=O)=O)=O,2,1,0,1,45,4.7e-05
G5,C(CC(C=CCC=O)=O)=O,2,1,0,1,45,4.7e-05
G5,C(C(C(C)=O)C=CC=O)=O,4,1,0,1,6,4.7e-05
G5,C(CC=C(C=O)C(C)=O)=O,2,1,0,1,6,4.7e-05
G5,C1(COC(C1)O)=C(C=O)C=O,2,1,0,1,35,4.7e-05
G5,C(C(C=O)C1COC(C=1)O)=O,2,1,0,1,35,4.7e-05
G5,C1(COC(C1C=CC=O)O)=O,8,1,0,1,35,4.7e-05
G5,C(CC=C1C(COC1O)=O)=O,4,1,0,1,35,4.7e-05
G5,C(CC(C1C(COC=1)=O)O)=O,2,1,0,1,35,4.7e-05
G5,C1(CC(OC1C=CC=O)O)=O,8,1,0,1,35,4.7e-05
G5,C(C(C=O)=CC=CC(CO)=O)=O,2,1,0,1,11,4.7e-05
G5,C(C(C=O)=C(C=CC=O)CO)=O,2,1,0,1,11,4.7e-05
G5,C(C(C(C=CC=O)=O)O)=CC=O,8,1,0,1,45,4.7e-05
G5,C=CC(C=C(C=O)C=O)=O,1,1,0,1,7,4.7e-05
G5,C=CC(C=O)=C(C=O)C=O,1,1,0,1,7,4.7e-05
G5,C=CC(CO)=C(C=O)C=O,1,1,0,1,7,4.7e-05
G5,C=CC(C(C=CC=O)O)=O,4,1,0,1,45,4.7e-05
G5,C(C(C=O)=CC=CC=O)=O,2,1,0,1,43,4.7e-05
G5,C(C(C)O)=C(C=O)C=O,2,1,0,1,11,4.7e-05
G5,C(C(C=O)=C(C(O)=O)CCO)=O,1,1,0,1,7,4.7e-05
G5,C(C(C=O)C(C(O)=O)=CCO)=O,2,1,0,1,7,4.7e-05
G5,C(C(CC=C(C=O)C=O)O)(O)=O,2,1,0,1,33,4.7e-05
G5,C(C(C=O)C=CC(C(O)=O)O)=O,4,1,0,1,33,4.7e-05
G5,C(C(C(C=O)=CCC=O)O)(O)=O,4,1,0,1,33,4.7e-05
G5,C(CC(C(C=O)=CC(O)=O)O)=O,4,2,0,2,29,9.499999999999999e-05
G5,C(C(CO)(CO)O)=C(C=O)C=O,1,1,0,1,45,4.7e-05
G5,C(C(C=C(C=O)C=O)(CO)O)=O,2,1,0,1,1,4.7e-05
G5,C(C(C=O)=CC(C=CC(C)=O)=O)=O,2,1,0,1,45,4.7e-05
G5,C(C(C=CC(C)=O)=C(C=O)C=O)=O,2,1,0,1,45,4.7e-05
G5,C(C(C=O)=C(C=CC(C=O)=O)C)=O,2,1,0,1,45,4.7e-05
G5,C(C(C=O)C(C=CC(C=O)=O)=C)=O,2,1,0,1,45,4.7e-05
G5,C(CC(C=CC(C=O)=O)=O)=CC=O,4,2,0,2,29,9.499999999999999e-05
G5,C(CC=CC(C=CC(C=O)=O)=O)=O,4,2,0,2,29,9.499999999999999e-05
G5,C(CC=CC(C=C(C=O)C=O)=O)=O,2,1,0,1,45,4.7e-05
G5,C(CC=CC(C=O)=C(C=O)C=O)=O,2,1,0,1,45,4.7e-05
G5,C(CC=CC(C=O)=O)=C(C=O)C=O,2,1,0,1,45,4.7e-05
G5,C(C(C=O)C=CC=CC(C=O)=O)=O,4,1,0,1,45,4.7e-05
G5,C(C(C=CC=O)C=CC(C=O)=O)=O,8,1,0,1,45,4.7e-05
G5,C(CC=C(C=O)C=CC(C=O)=O)=O,4,1,0,1,45,4.7e-05
G5,C(C(C=O)=CC=CC(C(C)=O)=O)=O,2,1,0,1,45,4.7e-05
G5,C(C(C=O)=C(C(C)=O)C=CC=O)=O,2,1,0,1,45,4.7e-05
G5,C(C(C=O)=C(C(C=CC=O)=O)C)=O,2,1,0,1,45,4.7e-05
G5,C(C(C=O)C(C(C=CC=O)=O)=C)=O,2,1,0,1,45,4.7e-05
G5,C(CC=CC(C(C=CC=O)=O)=O)=O,4,1,0,1,45,4.7e-05
G5,C(CC(C=CC=C(C=O)C=O)=O)=O,2,1,0,1,45,4.7e-05
G5,C(CC(C=CC=O)=C(C=O)C=O)=O,2,1,0,1,45,4.7e-05
G5,C(C(C=O)C(C=CC=O)=CC=O)=O,4,1,0,1,45,4.7e-05
G5,C(CC(C=CC=O)=O)=C(C=O)C=O,2,1,0,1,45,4.7e-05
G5,C(C(C=O)C=CC(C=CC=O)=O)=O,4,1,0,1,45,4.7e-05
G5,C(C(C=CC=O)C(C=CC=O)=O)=O,8,1,0,1,45,4.7e-05
G5,C(CC=C(C=O)C(C=CC=O)=O)=O,4,1,0,1,45,4.7e-05
G5,C=CC(CC(C=C(C=O)C=O)=O)=O,1,1,0,1,45,4.7e-05
G5,C=CC(CC(C=O)=C(C=O)C=O)=O,1,1,0,1,45,4.7e-05
G5,C(C(C=O)C(C=O)=CC(C=C)=O)=O,2,1,0,1,45,4.7e-05
G5,C=CC(CC(C=O)=O)=C(C=O)C=O,1,1,0,1,45,4.7e-05
G5,C(C(C=O)C(C=C)=CC(C=O)=O)=O,2,1,0,1,45,4.7e-05
G5,C=CC(C(C=CC=O)C(C=O)=O)=O,4,1,0,1,45,4.7e-05
G5,C(CC=C(C(C=C)=O)C(C=O)=O)=O,2,1,0,1,45,4.7e-05
G5,C=CC(C(CC=C(C=O)C=O)=O)=O,1,1,0,1,45,4.7e-05
G5,C(C(C=O)C=CC(C(C=C)=O)=O)=O,2,1,0,1,45,4.7e-05
G5,C(CC(C(C=C)=O)=C(C=O)C=O)=O,1,1,0,1,45,4.7e-05
G5,C(C(C=O)C(C(C=C)=O)=CC=O)=O,2,1,0,1,45,4.7e-05
G5,C(CC(C(C=C)=C(C=O)C=O)=O)=O,1,1,0,1,45,4.7e-05
G5,C(C(C=CC=O)C(C(C=C)=O)=O)=O,4,1,0,1,45,4.7e-05
G5,C(CC=C(C=O)C(C(C=C)=O)=O)=O,2,1,0,1,45,4.7e-05
G5,C(CC(C=C(C=O)C=O)=O)=CC=O,2,1,0,1,45,4.7e-05
G5,C(CC(C=O)=C(C=O)C=O)=CC=O,2,1,0,1,27,4.7e-05
G5,C(C(C=O)C(C=O)=CC=CC=O)=O,4,1,0,1,27,4.7e-05
G5,C(CC(C=O)=O)=CC=C(C=O)C=O,2,1,0,1,27,4.7e-05
G5,C(C(C=CC=O)C(C=O)=O)=CC=O,3,1,0,1,27,4.7e-05
G5,C(CC=C(C=CC=O)C(C=O)=O)=O,4,1,0,1,27,4.7e-05
G5,C1(COCC1O)=C(C=O)C=O,2,1,0,1,10,4.7e-05
G5,C1(C(COC1C=CC=O)O)=O,8,1,0,1,10,4.7e-05
G5,C1(C(O)OCC1)=C(C=O)C=O,2,1,0,1,34,4.7e-05
G5,C(C(C=O)C1C(O)OCC=1)=O,2,1,0,1,34,4.7e-05
G5,C1(C(O)OCC1C=CC=O)=O,8,2,0,2,34,9.499999999999999e-05
G5,C(CC=C1C(C(O)OC1)=O)=O,4,2,0,2,34,9.499999999999999e-05
G5,C(C(CCO)O)=CC(C(O)=O)=O,4,1,0,1,29,4.7e-05
G5,C(C(CCO)O)=C(C=O)C(C)=O,4,1,0,1,29,4.7e-05
G5,C(C(C)=CC(C(O)=O)=O)(O)=O,2,1,0,1,29,4.7e-05
G5,C=C(C(O)=O)CC(C(O)=O)=O,1,1,0,1,29,4.7e-05
G5,C(C(C=CC(O)=O)=O)(O)=O,2,1,0,1,33,4.7e-05
G5,C(C(C=CC(C(O)=O)=O)O)(O)=O,4,1,0,1,29,4.7e-05
G5,C(CC(C=CC(C(O)=O)=O)=O)=O,2,1,0,1,23,4.7e-05
G5,C(CC(C=O)=CC(C(O)=O)=O)=O,2,1,0,1,29,4.7e-05
G5,C(C(CC(C(O)=O)=O)=CC=O)=O,2,1,0,1,29,4.7e-05
G5,C(CC(C=O)=O)=CC(C(O)=O)=O,2,1,0,1,23,4.7e-05
G5,C(CC(C(O)=O)=O)=CC(C=O)=O,2,1,0,1,23,4.7e-05
G5,C(C(C(C=O)=O)C(C(O)=O)=C)=O,2,1,0,1,23,4.7e-05
G5,C(C(C(C=O)=O)=C(C(O)=O)C)=O,2,1,0,1,23,4.7e-05
G5,C(C(C=C(C(C)=O)C)=O)(O)=O,2,1,0,1,14,4.7e-05
G5,C=C(C(C)=O)CC(C(O)=O)=O,1,1,0,1,14,4.7e-05
G5,C=C(C(O)=O)CC(C(C)=O)=O,1,1,0,1,28,4.7e-05
G5,C(C(C)=CC(C(C)=O)=O)(O)=O,2,1,0,1,28,4.7e-05
G5,C(CC(C)=CC(C(O)=O)=O)=O,2,1,0,1,28,4.7e-05
G5,C(CC(CC(C(O)=O)=O)=C)=O,1,1,0,1,28,4.7e-05
G5,C(C)(CC(C(O)=O)=O)=CC=O,2,1,0,1,28,4.7e-05
G5,C(C)(CC=CC(C(O)=O)=O)=O,2,1,0,1,28,4.7e-05
G5,C(CC(C(O)=O)=O)=CC(C)=O,2,1,0,1,28,4.7e-05
G5,C(CC(CC(C(O)=O)=C)=O)=O,1,1,0,1,29,4.7e-05
G5,C(CC(C=C(C(O)=O)C)=O)=O,2,1,0,1,29,4.7e-05
G5,C(C(C(C)=O)C(C(O)=O)=C)=O,2,1,0,1,28,4.7e-05
G5,C(C(C(C)=O)=C(C(O)=O)C)=O,2,1,0,1,28,4.7e-05
G5,C1(COC(C1)O)=CC(C(O)=O)=O,4,1,0,1,28,4.7e-05
G5,C1C(O)OCC=1CC(C(O)=O)=O,2,1,0,1,28,4.7e-05
G5,C1(COC(C1C(C(O)=O)=C)O)=O,4,1,0,1,28,4.7e-05
G5,C(C(C)=C1C(COC1O)=O)(O)=O,4,1,0,1,28,4.7e-05
G5,C(C(C1C(COC=1)=O)(C)O)(O)=O,2,1,0,1,28,4.7e-05
G5,C1(CC(OC1C(C(O)=O)=C)O)=O,4,1,0,1,28,4.7e-05
G5,C=CC(C=CC(C(O)=O)=O)=O,2,1,0,1,7,4.7e-05
G5,C=CC(C=O)=CC(C(O)=O)=O,2,1,0,1,29,4.7e-05
G5,C=CC(CO)=CC(C(O)=O)=O,2,1,0,1,29,4.7e-05
G5,C=C(C(O)=O)C(C(C=C)=O)O,2,1,0,1,7,4.7e-05
G5,C(C=CC=CC(C(O)=O)=O)=O,4,1,0,1,29,4.7e-05
G5,C(C(C)O)=CC(C(O)=O)=O,4,1,0,1,11,4.7e-05
G5,C1(COCC1O)=CC(C(O)=O)=O,4,1,0,1,10,4.7e-05
G5,C1(C(COC1C(C(O)=O)=C)O)=O,4,1,0,1,10,4.7e-05
G5,C1(C(O)OCC1)=CC(C(O)=O)=O,4,1,0,1,29,4.7e-05
G5,C1COC(C=1CC(C(O)=O)=O)O,2,1,0,1,29,4.7e-05
G5,C1(C(O)OCC1C(C(O)=O)=C)=O,4,1,0,1,34,4.7e-05
G5,C(C(C)=C1C(C(O)OC1)=O)(O)=O,4,1,0,1,34,4.7e-05
G5,C(C(C(CO)=O)=CC(O)=O)(O)=O,2,1,0,1,33,4.7e-05
G5,C1OCC(C=1C(O)=O)=O,1,1,0,1,17,4.7e-05
G5,C1C(O)OCC(C=1C(O)=O)=O,2,1,0,1,17,4.7e-05
G5,C(C(C(O)=O)=CC(C(C)=O)=O)=O,2,2,0,2,29,9.499999999999999e-05
G5,C(C(C=C(C(O)=O)C(C)=O)=O)=O,2,2,0,2,29,9.499999999999999e-05
G5,C(CCO)=C(C(O)=O)C(C=O)=O,2,1,0,1,17,4.7e-05
G5,C(CO)=C(C(O)=O)C(C(C)=O)=O,2,1,0,1,17,4.7e-05
G5,C(CC(C(C(O)=O)=CCO)=O)=O,2,2,0,2,29,9.499999999999999e-05
G5,C(C(C(CCO)=O)=CC=O)(O)=O,2,2,0,2,29,9.499999999999999e-05
G5,C=C(C(O)=O)C(C(O)=O)=O,1,1,0,1,17,4.7e-05
G5,C(C(C(O)=O)=CC(O)=O)=O,2,2,0,2,29,9.499999999999999e-05
G5,C(C1C(CC(C=1C=O)O)=O)(O)=O,2,2,0,2,29,9.499999999999999e-05
G5,C(C1(C=C(C(O)=O)C(C1)=O)O)=O,2,2,0,2,29,9.499999999999999e-05
G5,C(C(C=O)=C(C=O)CO)(O)=O,2,2,0,2,29,9.499999999999999e-05
G5,C(C(C=O)=C(C=O)C(C)O)(O)=O,4,2,0,2,29,9.499999999999999e-05
G5,C(C1C(C(C(C=1)=O)CO)=O)(O)=O,2,2,0,2,29,9.499999999999999e-05
G5,C(C1C(CC(C=1CO)=O)=O)(O)=O,1,2,0,2,29,9.499999999999999e-05
G5,C(C)(C1C(C(C(O)=O)=CO1)=O)=O,2,1,0,1,17,4.7e-05
G5,C(CC1C(C(C(O)=O)=CO1)=O)=O,2,1,0,1,17,4.7e-05
G5,C1(CC(C(C(O)=O)=CCO1)=O)=O,1,1,0,1,17,4.7e-05
G5,C1(CC=C(C(O)=O)C(CO1)=O)=O,1,1,0,1,17,4.7e-05
G5,C1COCC(C(C=1C(O)=O)=O)=O,1,1,0,1,17,4.7e-05
G5,C(C1C(COCC(C=1)=O)=O)(O)=O,1,2,0,2,29,9.499999999999999e-05
G5,C1OCCC(C(C=1C(O)=O)=O)=O,1,1,0,1,17,4.7e-05
G5,C1(COC=C(C(C1)=O)C(O)=O)=O,1,1,0,1,17,4.7e-05
G5,C(C(C(O)=O)=C1C(CCO1)=O)=O,2,1,0,1,17,4.7e-05
G5,C1(COC(C1)=C(C=O)C(O)=O)=O,2,1,0,1,48,4.7e-05
G5,C(CC1OCC(C=1C(O)=O)=O)=O,1,1,0,1,48,4.7e-05
G5,C(C1C(C(C(O)=O)=C(C)O1)=O)=O,2,1,0,1,17,4.7e-05
G5,C1(C(C(O)=O)=C(C=O)OCC1)=O,1,1,0,1,30,4.7e-05
G5,C(C1CC(C(C(O)=O)=CO1)=O)=O,2,1,0,1,17,4.7e-05
G5,C(C(C)O)=C(C(O)=O)C(CO)=O,4,1,0,1,0,4.7e-05
G5,C(C(C(C=CC(C)O)=O)O)(O)=O,8,1,0,1,11,4.7e-05
G5,C(C(C(C(C)=O)=CC(O)=O)=O)=O,2,1,0,1,26,4.7e-05
G5,C(C(CC(C=CC(O)=O)=O)=O)=O,2,1,0,1,33,4.7e-05
G5,C(C(C(C=O)=O)=CC(O)=O)=O,2,1,0,1,33,4.7e-05
G5,C(C(C(C(C)=O)=O)=CC(O)=O)=O,2,1,0,1,14,4.7e-05
G5,C(CC(C(C=CC(O)=O)=O)=O)=O,2,1,0,1,33,4.7e-05
G5,C(C(C(C)=O)=CC(O)=O)=O,2,1,0,1,33,4.7e-05
G5,C(C=C1C(COC1O)=O)(O)=O,4,1,0,1,33,4.7e-05
G5,C(C(C1C(COC=1)=O)O)(O)=O,2,1,0,1,33,4.7e-05
G5,C(C(C(CO)=CC(O)=O)=O)(O)=O,2,1,0,1,33,4.7e-05
G5,C(C(C(C(C(O)=O)=O)=C)O)(O)=O,2,1,0,1,33,4.7e-05
G5,C(C(C(C=O)=CC(O)=O)O)(O)=O,4,2,0,2,29,9.499999999999999e-05
G5,C(C=C1C(C(O)OC1)=O)(O)=O,4,1,0,1,34,4.7e-05
G5,C(C(C=C(C=O)C(C)=O)O)(O)=O,4,1,0,1,6,4.7e-05
G5,C=CC(C=C(C(C)=O)C(C=O)=O)=O,2,1,0,1,7,4.7e-05
G5,C=CC(C=CC(CC(C=O)=O)=O)=O,2,1,0,1,7,4.7e-05
G5,C=CC(C=O)=C(C(C)=O)C(C=O)=O,2,1,0,1,7,4.7e-05
G5,C=CC(C=O)=CC(CC(C=O)=O)=O,2,1,0,1,7,4.7e-05
G5,C(C(C(C(C)=O)=CC=CC=O)=O)=O,4,1,0,1,43,4.7e-05
G5,C(C(CC(C=CC=CC=O)=O)=O)=O,4,1,0,1,43,4.7e-05
G5,C(C(C)O)=C(C(C)=O)C(C=O)=O,4,1,0,1,26,4.7e-05
G5,C(C(C)O)=CC(CC(C=O)=O)=O,4,2,0,2,29,9.499999999999999e-05
G5,C(C(C(C=O)=O)=C(C(C)=O)C)=O,2,1,0,1,14,4.7e-05
G5,C(C(C(C=O)=O)C(C(C)=O)=C)=O,2,1,0,1,14,4.7e-05
G5,C(C(C)=O)(CC(C=O)=CC=O)=O,2,2,0,2,29,9.499999999999999e-05
G5,C(CC(C=O)=CC(C(C)=O)=O)=O,2,2,0,2,29,9.499999999999999e-05
G5,C(CC(C(C)=O)=O)=CC(C=O)=O,2,1,0,1,14,4.7e-05
G5,C(CC(C)=C(C=O)C(C=O)=O)=O,2,1,0,1,23,4.7e-05
G5,C(C(C(CC=O)=C)C(C=O)=O)=O,2,1,0,1,23,4.7e-05
G5,C(C(C(C)=CC=O)C(C=O)=O)=O,4,1,0,1,23,4.7e-05
G5,C(C)(CC=C(C=O)C(C=O)=O)=O,2,1,0,1,23,4.7e-05
G5,C(CC(CC(C=O)=CC=O)=O)=O,2,2,0,2,29,9.499999999999999e-05
G5,C(CC(C=O)=CC(CC=O)=O)=O,2,2,0,2,29,9.499999999999999e-05
G5,C(CC(C=C(C=O)C(C)=O)=O)=O,2,1,0,1,23,4.7e-05
G5,C(C(C(C)=O)C(C=O)=CC=O)=O,4,1,0,1,23,4.7e-05
G5,C(CC(C=O)=C(C=O)C(C)=O)=O,2,2,0,2,29,9.499999999999999e-05
G5,C(CC(C=O)=O)=C(C=O)C(C)=O,2,2,0,2,29,9.499999999999999e-05
G5,C=CC(C=C(C=O)C(C=O)=O)=O,2,1,0,1,23,4.7e-05
G5,C=CC(C=O)=C(C=O)C(C=O)=O,2,1,0,1,23,4.7e-05
G5,C=CC(CO)=C(C=O)C(C=O)=O,2,1,0,1,23,4.7e-05
G5,C=CC(C(C(C=O)=CC=O)O)=O,4,2,0,2,29,9.499999999999999e-05
G5,C=CC(C(C=CC(C=O)=O)O)=O,4,1,0,1,23,4.7e-05
G5,C(C(C(C=O)=O)=CC=CC=O)=O,4,1,0,1,23,4.7e-05
G5,C(C(C)O)=C(C=O)C(C=O)=O,4,1,0,1,23,4.7e-05
G5,C=CC(C=C(C=O)C(C(C)=O)=O)=O,2,1,0,1,14,4.7e-05
G5,C(CC(C(C=CC(C=C)=O)=O)=O)=O,2,1,0,1,14,4.7e-05
G5,C=CC(C=O)=C(C=O)C(C(C)=O)=O,2,1,0,1,14,4.7e-05
G5,C(CC(C(C=C(C=O)C=C)=O)=O)=O,2,1,0,1,14,4.7e-05
G5,C(C(C(C(C)=O)=O)=CC=CC=O)=O,4,1,0,1,14,4.7e-05
G5,C(CC(C(C=CC=CC=O)=O)=O)=O,4,1,0,1,14,4.7e-05
G5,C(C(C)O)=C(C=O)C(C(C)=O)=O,4,1,0,1,14,4.7e-05
G5,C(CC(C(C=CC(C)O)=O)=O)=O,4,2,0,2,29,9.499999999999999e-05
G5,C(C(C)=CC(C(C)=O)=O)(C)=O,2,1,0,1,14,4.7e-05
G5,C=C(C(C)=O)CC(C(C)=O)=O,1,1,0,1,14,4.7e-05
G5,C(CC(C)=CC(C(C)=O)=O)=O,2,1,0,1,14,4.7e-05
G5,C(CC(CC(C(C)=O)=O)=C)=O,1,1,0,1,14,4.7e-05
G5,C(C)(CC(C(C)=O)=O)=CC=O,2,1,0,1,14,4.7e-05
G5,C(C)(CC=CC(C(C)=O)=O)=O,2,1,0,1,14,4.7e-05
G5,C(CC(C(C)=O)=O)=CC(C)=O,2,1,0,1,14,4.7e-05
G5,C(CC=O)(CC(C(C)=O)=C)=O,1,1,0,1,14,4.7e-05
G5,C(CC(C=C(C(C)=O)C)=O)=O,2,1,0,1,14,4.7e-05
G5,C(C(C(C)=O)C(C(C)=O)=C)=O,2,1,0,1,14,4.7e-05
G5,C(C(C(C)=O)=C(C(C)=O)C)=O,2,1,0,1,14,4.7e-05
G5,C1(COC(C1)O)=CC(C(C)=O)=O,4,1,0,1,14,4.7e-05
G5,C1C(O)OCC=1CC(C(C)=O)=O,2,1,0,1,14,4.7e-05
G5,C1(COC(C1C(C(C)=O)=C)O)=O,4,1,0,1,14,4.7e-05
G5,C1(C(C(O)OC1)=C(C(C)=O)C)=O,4,1,0,1,14,4.7e-05
G5,C(C)(C(C1C(COC=1)=O)(C)O)=O,2,1,0,1,14,4.7e-05
G5,C1(CC(OC1C(C(C)=O)=C)O)=O,4,1,0,1,14,4.7e-05
G5,C=CC(C=CC(C(C)=O)=O)=O,2,1,0,1,14,4.7e-05
G5,C=CC(C=O)=CC(C(C)=O)=O,2,2,0,2,29,9.499999999999999e-05
G5,C=CC(CO)=CC(C(C)=O)=O,2,1,0,1,14,4.7e-05
G5,C=CC(C(C(C(C)=O)=C)O)=O,2,1,0,1,14,4.7e-05
G5,C(C(C)O)=CC(C(C)=O)=O,4,1,0,1,11,4.7e-05
G5,C1(COCC1O)=CC(C(C)=O)=O,4,1,0,1,10,4.7e-05
G5,C1(C(COC1C(C(C)=O)=C)O)=O,4,1,0,1,10,4.7e-05
G5,C1(C(O)OCC1)=CC(C(C)=O)=O,4,1,0,1,14,4.7e-05
G5,C1COC(C=1CC(C(C)=O)=O)O,2,1,0,1,14,4.7e-05
G5,C1(C(O)OCC1C(C(C)=O)=C)=O,4,1,0,1,34,4.7e-05
G5,C(C(C)=C1C(C(O)OC1)=O)(C)=O,4,1,0,1,34,4.7e-05
G5,C(CC(C)=CC(CC=O)=O)=O,2,1,0,1,6,4.7e-05
G5,C(CC(CC(CC=O)=C)=O)=O,1,1,0,1,6,4.7e-05
G5,C(CC=O)(CC(C)=CC=O)=O,2,1,0,1,6,4.7e-05
G5,C(CC(C)=C(C=O)C(C)=O)=O,2,1,0,1,6,4.7e-05
G5,C(C(C(C)=O)C(CC=O)=C)=O,2,1,0,1,6,4.7e-05
G5,C(C(C(C)=O)C(C)=CC=O)=O,4,1,0,1,6,4.7e-05
G5,C(CC(C=CCC(C)=O)=O)=O,2,1,0,1,6,4.7e-05
G5,C(CC=O)(CC=CC(C)=O)=O,2,1,0,1,6,4.7e-05
G5,C(C)(CC=C(C=O)C(C)=O)=O,2,1,0,1,6,4.7e-05
G5,C(C(C(C)=O)C=CC(C)=O)=O,4,1,0,1,6,4.7e-05
G5,C(CC(C=C1COC(C1)O)=O)=O,4,2,0,2,35,9.499999999999999e-05
G5,C(CC=O)(CC1COC(C=1)O)=O,2,1,0,1,35,4.7e-05
G5,C1(COC(C1)O)=C(C(C)=O)C=O,4,1,0,1,35,4.7e-05
G5,C(C(C(C)=O)C1COC(C=1)O)=O,4,1,0,1,35,4.7e-05
G5,C(CC(C1C(COC1O)=O)=C)=O,4,1,0,1,35,4.7e-05
G5,C1(COC(C1C(C)=CC=O)O)=O,8,1,0,1,35,4.7e-05
G5,C(CC(C)=C1C(COC1O)=O)=O,4,1,0,1,35,4.7e-05
G5,C(CC(C1C(COC=1)=O)(C)O)=O,2,1,0,1,35,4.7e-05
G5,C1(COC(C1C=CC(C)=O)O)=O,8,1,0,1,6,4.7e-05
G5,C(C)(CC=C1C(COC1O)=O)=O,4,1,0,1,6,4.7e-05
G5,C(C)(CC(C1C(COC=1)=O)O)=O,2,1,0,1,6,4.7e-05
G5,C(CC(C1C(CC(O1)O)=O)=C)=O,4,2,0,2,6,9.499999999999999e-05
G5,C1(CC(OC1C(C)=CC=O)O)=O,8,2,0,2,6,9.499999999999999e-05
G5,C1(CC(OC1C=CC(C)=O)O)=O,8,1,0,1,35,4.7e-05
G5,C(CC(C=CC(C=C)=O)=O)=O,2,1,0,1,7,4.7e-05
G5,C=CC(C=C(C=O)C(C)=O)=O,2,1,0,1,7,4.7e-05
G5,C(CC(C=C(C=O)C=C)=O)=O,2,3,0,3,29,0.00014199999999999998
G5,C=CC(C=O)=C(C=O)C(C)=O,2,1,0,1,7,4.7e-05
G5,C(CC(C=C(C=C)CO)=O)=O,2,1,0,1,29,4.7e-05
G5,C=CC(CO)=C(C=O)C(C)=O,2,1,0,1,7,4.7e-05
G5,C(CC(C(C(C=C)=O)O)=C)=O,2,1,0,1,7,4.7e-05
G5,C=CC(C(C(C)=CC=O)O)=O,4,1,0,1,7,4.7e-05
G5,C=CC(C(C=CC(C)=O)O)=O,4,1,0,1,7,4.7e-05
G5,C(C(C(C)=O)=CC=CC=O)=O,4,1,0,1,43,4.7e-05
G5,C(CC(C=CC(C)O)=O)=O,4,1,0,1,11,4.7e-05
G5,C(C(C)O)=C(C=O)C(C)=O,4,1,0,1,11,4.7e-05
G5,C(CC(C=C1COCC1O)=O)=O,4,1,0,1,10,4.7e-05
G5,C1(COCC1O)=C(C(C)=O)C=O,4,1,0,1,10,4.7e-05
G5,C(CC(C1C(C(CO1)O)=O)=C)=O,4,1,0,1,10,4.7e-05
G5,C1(C(COC1C(C)=CC=O)O)=O,8,1,0,1,10,4.7e-05
G5,C1(C(COC1C=CC(C)=O)O)=O,8,1,0,1,10,4.7e-05
G5,C(CC(C=C1C(O)OCC1)=O)=O,4,1,0,1,34,4.7e-05
G5,C(CC=O)(CC1C(O)OCC=1)=O,2,1,0,1,34,4.7e-05
G5,C1(C(O)OCC1)=C(C(C)=O)C=O,4,1,0,1,34,4.7e-05
G5,C(C(C(C)=O)C1C(O)OCC=1)=O,4,1,0,1,34,4.7e-05
G5,C(CC(C1C(C(O)OC1)=O)=C)=O,4,1,0,1,34,4.7e-05
G5,C1(C(O)OCC1C(C)=CC=O)=O,8,1,0,1,34,4.7e-05
G5,C(CC(C)=C1C(C(O)OC1)=O)=O,4,1,0,1,34,4.7e-05
G5,C1(C(O)OCC1C=CC(C)=O)=O,8,1,0,1,34,4.7e-05
G5,C(C)(CC=C1C(C(O)OC1)=O)=O,4,1,0,1,34,4.7e-05
G5,C=CC(C(C1C(COC=1)=O)O)=O,2,1,0,1,7,4.7e-05
G5,C=CC(C=C1C(COC1O)=O)=O,4,1,0,1,7,4.7e-05
G5,C(C(C=C)(C1C(COC=1)=O)O)=O,2,1,0,1,7,4.7e-05
G5,C=CC(C=O)=C1C(COC1O)=O,4,1,0,1,7,4.7e-05
G5,C=CC(C1C(COC=1)=O)(CO)O,2,1,0,1,7,4.7e-05
G5,C=CC(CO)=C1C(COC1O)=O,4,1,0,1,7,4.7e-05
G5,C=CC(C(C1COC(C=1)O)O)=O,4,1,0,1,7,4.7e-05
G5,C(C(C1C(COC=1)=O)O)=CC=O,4,1,0,1,43,4.7e-05
G5,C(C=CC=C1C(COC1O)=O)=O,8,1,0,1,43,4.7e-05
G5,C1OCC(C=1C(C(C)O)O)=O,4,1,0,1,35,4.7e-05
G5,C(C(C)O)=C1C(COC1O)=O,8,1,0,1,35,4.7e-05
G5,C=CC(C=C1C(C(O)OC1)=O)=O,4,1,0,1,7,4.7e-05
G5,C=CC(C=O)=C1C(C(O)OC1)=O,4,1,0,1,34,4.7e-05
G5,C=CC(C(C1C(O)OCC=1)O)=O,4,1,0,1,7,4.7e-05
G5,C=CC(CO)=C1C(C(O)OC1)=O,4,1,0,1,34,4.7e-05
G5,C(C=CC=C1C(C(O)OC1)=O)=O,8,1,0,1,34,4.7e-05
G5,C(C(C)O)=C(C(C(O)=O)=O)CO,4,1,0,1,11,4.7e-05
G5,C=C(C(C(O)=O)=O)C(C(C)O)O,4,1,0,1,11,4.7e-05
G5,C(C(C(C=O)=CC(C)O)O)(O)=O,8,2,0,2,29,9.499999999999999e-05
G5,C(C=C(C=O)C(C(C)O)O)(O)=O,8,2,0,2,29,9.499999999999999e-05
G5,C(C(C)O)=C1C(C(OC1)O)=O,8,1,0,1,34,4.7e-05
G5,C(C(C1C(C(C(C=1)O)O)O)O)=O,16,1,0,1,0,4.7e-05
G5,C(C(C(C(C=O)=O)=CCO)O)=O,4,1,0,1,0,4.7e-05
G5,C(C(C(C(CO)O)=CC=O)=O)=O,4,1,0,1,0,4.7e-05
G5,C(C(C(C=O)=CC(C)O)O)=O,8,2,0,2,29,9.499999999999999e-05
G5,C(CO)=C(C(C=O)=O)C(C)O,4,1,0,1,0,4.7e-05
G5,C(C)=C(C(C=O)=O)C(CO)O,4,1,0,1,0,4.7e-05
G5,C(C(C=CC(C=O)O)(C)O)=O,8,2,0,2,29,9.499999999999999e-05
G5,C(C(C(C(CO)O)=CCO)O)=O,8,1,0,1,0,4.7e-05
G5,C(C(C(CO)=CC(C)O)O)=O,8,1,0,1,0,4.7e-05
G5,C(C(C(C(C(C)O)O)=C)O)=O,8,1,0,1,0,4.7e-05
G5,C(C(C=CC(CO)(C)O)O)=O,8,1,0,1,49,4.7e-05
G5,C(C(C=CC(C)O)O)=O,8,1,0,1,28,4.7e-05
G5,C(CO)=C(C(C=O)=O)C(CO)O,4,1,0,1,0,4.7e-05
G5,C(CO)=C(C=O)C=O,1,1,0,1,0,4.7e-05
G5,C(CO)=C(C(C)=O)C(C=O)=O,2,1,0,1,0,4.7e-05
G5,C(C(C(C(C)=O)=CC=O)O)=O,4,1,0,1,0,4.7e-05
G5,C(CO)=C(C=O)C(C(C)=O)=O,2,1,0,1,14,4.7e-05
G5,C(CO)=C(C=O)C(C)=O,2,1,0,1,0,4.7e-05
G5,C(C(C1COC(C=1)O)O)=O,4,1,0,1,35,4.7e-05
G5,C(CO)=C1C(COC1O)=O,4,2,0,2,0,9.499999999999999e-05
G5,C1OCC(C=1C(CO)O)=O,2,1,0,1,0,4.7e-05
G5,C(C(C1COC(C(C=1)O)O)O)=O,8,1,0,1,27,4.7e-05
G5,C(CO)=C1C(COC(C1O)O)=O,8,2,0,2,0,9.499999999999999e-05
G5,C1C(OCC(C=1C(CO)O)=O)O,4,1,0,1,0,4.7e-05
G5,C(C(C(C=CC(C=O)=O)=C)O)=O,4,1,0,1,45,4.7e-05
G5,C(CO)=CC(C=CC(C=O)=O)=O,4,1,0,1,0,4.7e-05
G5,C(C(C=CC=CC(C=O)=O)O)=O,8,1,0,1,45,4.7e-05
G5,C(CO)=C(C=O)C=CC(C=O)=O,4,1,0,1,45,4.7e-05
G5,C(C(C(C(C=CC=O)=O)=C)O)=O,4,1,0,1,45,4.7e-05
G5,C(CO)=CC(C(C=CC=O)=O)=O,4,1,0,1,0,4.7e-05
G5,C(C(C(C=CC=O)=CC=O)O)=O,8,1,0,1,45,4.7e-05
G5,C(C(C=CC(C=CC=O)=O)O)=O,8,1,0,1,45,4.7e-05
G5,C(CO)=C(C=O)C(C=CC=O)=O,4,1,0,1,0,4.7e-05
G5,C(C(C(C=O)=CC(C=C)=O)O)=O,4,2,0,2,29,9.499999999999999e-05
G5,C(C(C(C=C)=CC(C=O)=O)O)=O,4,1,0,1,45,4.7e-05
G5,C=CC(C(C(C=O)=O)=CCO)=O,2,1,0,1,0,4.7e-05
G5,C(C(C=CC(C(C=C)=O)=O)O)=O,4,1,0,1,0,4.7e-05
G5,C(C(C(C(C=C)=O)=CC=O)O)=O,4,1,0,1,0,4.7e-05
G5,C=CC(C(C(C=O)=CCO)=O)=O,2,1,0,1,0,4.7e-05
G5,C(C(C(C=O)=CC=CC=O)O)=O,8,2,0,2,29,9.499999999999999e-05
G5,C(CO)=C(C=CC=O)C(C=O)=O,4,1,0,1,27,4.7e-05
G5,C(C(C1C(O)OCC=1)O)=O,4,2,0,2,29,9.499999999999999e-05
G5,C(CO)=C1C(C(O)OC1)=O,4,2,0,2,0,9.499999999999999e-05
G5,C(C(C(CO)O)O)=C(C=O)C=O,4,1,0,1,0,4.7e-05
G5,C(CO)(CO)=C(C=O)CO,1,1,0,1,5,4.7e-05
G5,C(CO)(C(C=CC(C)O)O)=O,8,1,0,1,5,4.7e-05
G5,C(CO)(CO)=C(C=O)C(C)O,2,1,0,1,5,4.7e-05
G5,C(C)=C(C=O)C(CO)(CO)O,2,1,0,1,5,4.7e-05
G5,C(CO)(CO)=C(C=O)C=O,1,1,0,1,5,4.7e-05
G5,C(CO)(CO)=C(C=O)C(C=O)=O,1,1,0,1,23,4.7e-05
G5,C(CO)(CO)=C(C=O)C(C)=O,1,1,0,1,5,4.7e-05
G5,C(CO)(C(C1COC(C=1)O)O)=O,4,1,0,1,35,4.7e-05
G5,C(CO)(CO)=C1C(COC1O)=O,2,2,0,2,29,9.499999999999999e-05
G5,C1OCC(C=1C(CO)(CO)O)=O,1,1,0,1,5,4.7e-05
G5,C(CO)(C(C1C(O)OCC=1)O)=O,4,1,0,1,5,4.7e-05
G5,C(CO)(CO)=C1C(C(O)OC1)=O,2,2,0,2,29,9.499999999999999e-05
G5,C(C(CO)O)=C(C=O)CO,4,1,0,1,41,4.7e-05
G5,C=C(C=O)C(C(CO)O)O,4,4,0,4,29,0.000212
G5,C(C(CO)O)=C(C=O)C(C)O,8,1,0,1,41,4.7e-05
G5,C(C)=C(C=O)C(C(CO)O)O,8,1,0,1,41,4.7e-05
G5,C(C(CO)O)=C(C=O)C=O,2,1,0,1,45,4.7e-05
G5,C(C(CO)O)=C(C=O)C(C=O)=O,4,1,0,1,23,4.7e-05
G5,C(C(CO)O)=C(C=O)C(C)=O,4,1,0,1,41,4.7e-05
G5,C(C(CO)O)=C1C(COC1O)=O,8,2,0,2,29,9.499999999999999e-05
G5,C1OCC(C=1C(C(CO)O)O)=O,4,1,0,1,35,4.7e-05
G5,C(C(CO)O)=C1C(C(OC1)O)=O,8,3,0,3,20,0.00014199999999999998
G5,C(C(C=C(C=O)CC(C)O)=O)=O,4,1,0,1,45,4.7e-05
G5,C(C(C)O)=C(C=O)CC(C=O)=O,4,1,0,1,45,4.7e-05
G5,C(C(C(C(C)O)=C(C=O)C)=O)=O,4,1,0,1,4,4.7e-05
G5,C(C(C(C(C=O)=O)=CC)(C)O)=O,4,1,0,1,4,4.7e-05
G5,C(C)(C(CC=CC(C=O)=O)O)=O,4,1,0,1,22,4.7e-05
G5,C(C)(C(C=CCC(C=O)=O)O)=O,4,2,0,2,29,9.499999999999999e-05
G5,C(C)(C(C(C=O)=CC(C)=O)O)=O,4,2,0,2,29,9.499999999999999e-05
G5,C(C)(C(C(C=O)=C(C=O)C)O)=O,4,1,0,1,45,4.7e-05
G5,C(C(C(C=O)=CC(C)=O)(C)O)=O,4,2,0,2,29,9.499999999999999e-05
G5,C(C(C)(CC=CC(C=O)=O)O)=O,4,1,0,1,22,4.7e-05
G5,C(C(C=CCC(C=O)=O)(C)O)=O,4,1,0,1,22,4.7e-05
G5,C(C(C(C=O)=C(C=O)C)(C)O)=O,4,1,0,1,45,4.7e-05
G5,C(C(CO)=CC(C)=O)=O,2,1,0,1,2,4.7e-05
G5,C(C(C)=C(C=O)CO)=O,2,2,0,2,29,9.499999999999999e-05
G5,C(C(C(C=O)=C)(C)O)=O,2,2,0,2,29,9.499999999999999e-05
G5,C(CO)(CC(C)O)=CC(C=O)=O,4,1,0,1,45,4.7e-05
G5,C(C(C)O)=C(CO)CC(C=O)=O,4,1,0,1,45,4.7e-05
G5,C(C(C)=C(C(CO)=O)C(C)O)=O,4,1,0,1,45,4.7e-05
G5,C(C(C(C(CO)=O)=CC)(C)O)=O,4,1,0,1,45,4.7e-05
G5,C(C)(C(C(C)O)O)=CC(C=O)=O,8,1,0,1,45,4.7e-05
G5,C=C(C(C(C)O)O)CC(C=O)=O,4,1,0,1,45,4.7e-05
G5,C(CC(C)(CO)O)=CC(C=O)=O,4,1,0,1,45,4.7e-05
G5,C(CC(C=O)=O)=CC(CO)(C)O,4,1,0,1,45,4.7e-05
G5,C(C(C(CO)(C)O)=CC(C)=O)=O,4,1,0,1,49,4.7e-05
G5,C(C)(C(C(C=O)=C(CO)C)O)=O,4,1,0,1,49,4.7e-05
G5,C(C(C(CO)(C)O)=C(C=O)C)=O,4,1,0,1,49,4.7e-05
G5,C(C(C(C=O)=C(CO)C)(C)O)=O,4,1,0,1,49,4.7e-05
G5,C(CC(C)O)=CC(C=O)=O,4,1,0,1,3,4.7e-05
G5,C(CC(C=O)=O)=CC(C)O,4,1,0,1,3,4.7e-05
G5,C(C(C(C)O)=CC(C)=O)=O,4,1,0,1,45,4.7e-05
G5,C(C)(C(C(C=O)=CC)O)=O,4,1,0,1,45,4.7e-05
G5,C(C(C(C)O)=C(C=O)C)=O,4,1,0,1,45,4.7e-05
G5,C(C(C(C=O)=CC)(C)O)=O,4,1,0,1,45,4.7e-05
G5,C(C(C(C)O)O)=CC(C=O)=O,8,1,0,1,45,4.7e-05
G5,C(C(C=C(C=O)C(CO)O)=O)=O,4,1,0,1,0,4.7e-05
G5,C(C(CO)=CC(C=O)=O)=O,2,2,0,2,55,9.499999999999999e-05
G5,C=C(C=O)C(C(C=O)=O)O,2,1,0,1,45,4.7e-05
G5,C(C(C=C(C=O)C(C)O)=O)=O,4,1,0,1,4,4.7e-05
G5,C(CO)(C(C)O)=CC(C=O)=O,4,1,0,1,29,4.7e-05
G5,C(C(C=O)=C(C=O)C)=O,1,2,0,2,29,9.499999999999999e-05
G5,C(C(C(CO)=CC(C=O)=O)O)=O,4,1,0,1,51,4.7e-05
G5,C(C(C(C(C(C=O)=C)O)=O)O)=O,4,1,0,1,5,4.7e-05
G5,C(C)(CC(C=O)=CC(C=O)=O)=O,2,1,0,1,45,4.7e-05
G5,C(C(CC(C=O)=CC(C)=O)=O)=O,2,1,0,1,45,4.7e-05
G5,C(C)(CC(C=O)=O)=CC(C=O)=O,2,1,0,1,26,4.7e-05
G5,C=C(CC(C=O)=O)CC(C=O)=O,1,1,0,1,26,4.7e-05
G5,C(C(C(C(C)=O)=CC(C)=O)=O)=O,2,1,0,1,45,4.7e-05
G5,C(C)(C(C(C=O)=O)C(C=O)=C)=O,2,1,0,1,26,4.7e-05
G5,C(C(C(C(C)=O)=C(C=O)C)=O)=O,2,1,0,1,26,4.7e-05
G5,C(CC(C=O)=O)(CC(C=O)=C)=O,1,1,0,1,45,4.7e-05
G5,C(C(CC(C=C(C=O)C)=O)=O)=O,2,1,0,1,45,4.7e-05
G5,C(CC(C=O)=CC(C=O)=O)=O,2,3,0,3,43,0.00014199999999999998
G5,C(C(C(C=O)=O)=CC(C)=O)=O,2,1,0,1,23,4.7e-05
G5,C(C(C(C=O)=O)=C(C=O)C)=O,2,1,0,1,45,4.7e-05
G5,C(CC(C(C)=O)=CC(C=O)=O)=O,2,1,0,1,45,4.7e-05
G5,C(C(CC(C(C)=O)=CC=O)=O)=O,2,2,0,2,29,9.499999999999999e-05
G5,C(CC(C(C)=CC(C=O)=O)=O)=O,2,1,0,1,45,4.7e-05
G5,C(CC(C(CC(C=O)=O)=C)=O)=O,1,1,0,1,45,4.7e-05
G5,C(C(C(C(C)=O)=O)=CC(C)=O)=O,2,1,0,1,45,4.7e-05
G5,C(C(C(C(C)=O)=O)C(C=O)=C)=O,2,1,0,1,14,4.7e-05
G5,C(C(C(C(C)=O)=O)=C(C=O)C)=O,2,1,0,1,14,4.7e-05
G5,C(CC(C(CC(C=O)=C)=O)=O)=O,1,1,0,1,45,4.7e-05
G5,C(CC(C(C=C(C=O)C)=O)=O)=O,2,1,0,1,45,4.7e-05
G5,C(C)(CC=CC(C=O)=O)=O,2,1,0,1,23,4.7e-05
G5,C(CC(C=O)=O)=CC(C)=O,2,2,0,2,29,9.499999999999999e-05
G5,C(C(C(C)=O)=CC(C)=O)=O,2,1,0,1,45,4.7e-05
G5,C(C(C(C)=O)=C(C=O)C)=O,2,2,0,2,29,9.499999999999999e-05
G5,C1(COC(C1)O)=CC(C=O)=O,4,2,0,2,29,9.499999999999999e-05
G5,C1C(O)OCC=1CC(C=O)=O,2,1,0,1,45,4.7e-05
G5,C1(C(C(O)OC1)=CC(C)=O)=O,4,2,0,2,55,9.499999999999999e-05
G5,C(C)(C(C1C(COC=1)=O)O)=O,2,1,0,1,35,4.7e-05
G5,C1(COC(C1C(C=O)=C)O)=O,4,2,0,2,45,9.499999999999999e-05
G5,C(C(C)=C1C(COC1O)=O)=O,4,2,0,2,49,9.499999999999999e-05
G5,C(C(C1C(COC=1)=O)(C)O)=O,2,1,0,1,45,4.7e-05
G5,C(C(C=CC=CC(CO)=O)=O)=O,4,1,0,1,45,4.7e-05
G5,C(C=CC(CO)=CC(C=O)=O)=O,4,1,0,1,45,4.7e-05
G5,C=C(C=O)C(C(C=CC=O)=O)O,4,1,0,1,45,4.7e-05
G5,C=CC(C=CC(C=O)=O)=O,2,2,0,2,29,9.499999999999999e-05
G5,C=CC(C=O)=CC(C=O)=O,2,2,0,2,29,9.499999999999999e-05
G5,C=CC(CO)=CC(C=O)=O,2,2,0,2,29,9.499999999999999e-05
G5,C(C=CC=CC(C=O)=O)=O,4,3,0,3,29,0.00014199999999999998
G5,C(C(C)O)=CC(C=O)=O,4,5,0,5,46,0.00023700000000000001
G5,C(C(CO)(CO)O)=CC(C=O)=O,2,3,0,3,29,0.000153
G5,C(C(C=CC(C=CC(C)=O)=O)=O)=O,4,2,0,2,29,9.499999999999999e-05
G5,C(C(C=CC(C)=O)=CC(C=O)=O)=O,4,1,0,1,45,4.7e-05
G5,C(C(C=CC(C)=CC(C=O)=O)=O)=O,4,1,0,1,45,4.7e-05
G5,C=C(C=CC(C=O)=O)CC(C=O)=O,2,1,0,1,45,4.7e-05
G5,C=C(C=O)CC(C=CC(C=O)=O)=O,2,1,0,1,45,4.7e-05
G5,C(C(C=CC(C=C(C=O)C)=O)=O)=O,4,1,0,1,45,4.7e-05
G5,C(CC=CC(C=O)=CC(C=O)=O)=O,4,1,0,1,45,4.7e-05
G5,C(CC=CC(C=O)=O)=CC(C=O)=O,3,1,0,1,45,4.7e-05
G5,C(CC(C=O)=O)=CC=CC(C=O)=O,4,2,0,2,29,9.499999999999999e-05
G5,C(C(C=CC(C=O)=O)=CC(C)=O)=O,4,1,0,1,45,4.7e-05
G5,C(C(C=CC(C=O)=O)C(C=O)=C)=O,4,1,0,1,45,4.7e-05
G5,C(C(C)=C(C=O)C=CC(C=O)=O)=O,4,1,0,1,45,4.7e-05
G5,C(C(C=CC=CC(C(C)=O)=O)=O)=O,4,1,0,1,45,4.7e-05
G5,C(C(C=C(C(C)=O)C=CC=O)=O)=O,4,1,0,1,45,4.7e-05
G5,C(C(C=C(C(C=CC=O)=O)C)=O)=O,4,1,0,1,45,4.7e-05
G5,C=C(C(C=CC=O)=O)CC(C=O)=O,2,1,0,1,45,4.7e-05
G5,C(C=CC(C(C=CC(C)=O)=O)=O)=O,4,1,0,1,45,4.7e-05
G5,C=C(C=O)CC(C(C=CC=O)=O)=O,2,1,0,1,45,4.7e-05
G5,C(C=CC(C(C=C(C=O)C)=O)=O)=O,4,1,0,1,45,4.7e-05
G5,C(CC(C=CC=CC(C=O)=O)=O)=O,4,1,0,1,45,4.7e-05
G5,C(CC(C=CC=O)=CC(C=O)=O)=O,4,1,0,1,45,4.7e-05
G5,C(C(CC(C=CC=O)=CC=O)=O)=O,4,1,0,1,45,4.7e-05
G5,C(CC(C=CC=O)=O)=CC(C=O)=O,4,1,0,1,45,4.7e-05
G5,C(CC(C=O)=O)=CC(C=CC=O)=O,4,2,0,2,29,9.499999999999999e-05
G5,C(C(C(C=CC=O)=O)=CC(C)=O)=O,4,1,0,1,45,4.7e-05
G5,C(C(C(C=CC=O)=O)C(C=O)=C)=O,4,1,0,1,45,4.7e-05
G5,C(C(C)=C(C=O)C(C=CC=O)=O)=O,4,1,0,1,45,4.7e-05
G5,C=CC(CC(C=CC(C=O)=O)=O)=O,2,1,0,1,45,4.7e-05
G5,C=CC(CC(C=O)=CC(C=O)=O)=O,2,1,0,1,45,4.7e-05
G5,C=CC(C=C(C=O)CC(C=O)=O)=O,2,1,0,1,45,4.7e-05
G5,C=CC(CC(C=O)=O)=CC(C=O)=O,2,1,0,1,45,4.7e-05
G5,C=CC(C(C(C=O)=O)=CC(C)=O)=O,2,1,0,1,45,4.7e-05
G5,C=C(C=O)C(C(C=O)=O)C(C=C)=O,2,1,0,1,45,4.7e-05
G5,C=CC(C(C(C=O)=O)=C(C=O)C)=O,2,1,0,1,45,4.7e-05
G5,C=CC(C(CC=CC(C=O)=O)=O)=O,2,1,0,1,45,4.7e-05
G5,C=CC(C(C=CCC(C=O)=O)=O)=O,2,1,0,1,45,4.7e-05
G5,C(CC(C(C=C)=O)=CC(C=O)=O)=O,2,1,0,1,45,4.7e-05
G5,C=CC(C(CC(C=O)=O)=CC=O)=O,2,1,0,1,45,4.7e-05
G5,C(CC(C(C=C)=CC(C=O)=O)=O)=O,2,1,0,1,45,4.7e-05
G5,C=CC(C(C(C=O)=CC(C)=O)=O)=O,2,1,0,1,45,4.7e-05
G5,C(C(C(C(C=C)=O)=O)C(C=O)=C)=O,2,1,0,1,45,4.7e-05
G5,C=CC(C(C(C=O)=C(C=O)C)=O)=O,2,1,0,1,45,4.7e-05
G5,C(CC(C=O)=CC(C=O)=O)=CC=O,4,1,0,1,45,4.7e-05
G5,C(C(CC(C=O)=O)=CC=CC=O)=O,4,1,0,1,45,4.7e-05
G5,C(C(C(C=CC=O)=CC(C)=O)=O)=O,4,1,0,1,45,4.7e-05
G5,C=C(C=O)C(C=CC=O)C(C=O)=O,4,1,0,1,27,4.7e-05
G5,C(C(C)=C(C=CC=O)C(C=O)=O)=O,4,1,0,1,27,4.7e-05
G5,C1(COCC1O)=CC(C=O)=O,4,1,0,1,10,4.7e-05
G5,C1(C(O)OCC1)=CC(C=O)=O,4,2,0,2,29,9.499999999999999e-05
G5,C1COC(C=1CC(C=O)=O)O,2,1,0,1,29,4.7e-05
G5,C1(C(COC1O)=CC(C)=O)=O,4,2,0,2,45,9.499999999999999e-05
G5,C1(C(O)OCC1C(C=O)=C)=O,4,2,0,2,34,9.499999999999999e-05
G5,C(C(C)=C1C(C(O)OC1)=O)=O,4,2,0,2,29,9.499999999999999e-05
G5,C(CCO)=C(C=O)C(CO)=O,2,1,0,1,49,4.7e-05
G5,C(C(C(CO)=O)C=CCO)=O,4,1,0,1,49,4.7e-05
G5,C(CC(C(C=CCO)O)=O)=O,4,1,0,1,49,4.7e-05
G5,C(CC(CO)=C(C=O)CO)=O,2,1,0,1,49,4.7e-05
G5,C(CC(C)O)=C(C=O)C(CO)=O,4,1,0,1,49,4.7e-05
G5,C(C(C(CO)=O)C=CC(C)O)=O,8,1,0,1,49,4.7e-05
G5,C(CC(C(C=CC(C)O)O)=O)=O,8,1,0,1,49,4.7e-05
G5,C(CC(CO)=C(C=O)C(C)O)=O,4,1,0,1,4,4.7e-05
G5,C(C(C(CO)=O)=C(C=O)CO)=O,2,1,0,1,5,4.7e-05
G5,C(CO)(C(C(C=O)=O)O)=CC=O,4,1,0,1,49,4.7e-05
G5,C(CO)(CC=C(C=O)C=O)=O,1,2,0,2,29,9.499999999999999e-05
G5,C(CC(CO)=C(C=O)C=O)=O,1,1,0,1,49,4.7e-05
G5,C(C(C(CO)=O)=C(C(C)=O)C)=O,2,1,0,1,14,4.7e-05
G5,C(C(C(CO)=O)C(C(C)=O)=C)=O,2,1,0,1,14,4.7e-05
G5,C(CC(C(C(C(C)=O)=C)O)=O)=O,2,1,0,1,14,4.7e-05
G5,C(CO)(CC=CC(C(C)=O)=O)=O,2,2,0,2,29,9.499999999999999e-05
G5,C(CO)(CC(C(C)=O)=O)=CC=O,2,1,0,1,14,4.7e-05
G5,C(CC(CO)=CC(C(C)=O)=O)=O,2,1,0,1,14,4.7e-05
G5,C(CC(C)=C(C=O)C(CO)=O)=O,2,1,0,1,49,4.7e-05
G5,C(C(C(CO)=O)C(CC=O)=C)=O,2,1,0,1,49,4.7e-05
G5,C(C(C(CO)=O)C(C)=CC=O)=O,4,1,0,1,49,4.7e-05
G5,C(C)(CC=C(C=O)C(CO)=O)=O,2,1,0,1,6,4.7e-05
G5,C(C(C(CO)=O)C=CC(C)=O)=O,4,1,0,1,6,4.7e-05
G5,C(CC(C=CCC(CO)=O)=O)=O,2,2,0,2,29,9.499999999999999e-05
G5,C(CO)(CC=C(C=O)C(C)=O)=O,2,2,0,2,29,9.499999999999999e-05
G5,C(C(C(C)=O)C(CO)=CC=O)=O,4,1,0,1,49,4.7e-05
G5,C(CC(CO)=C(C=O)C(C)=O)=O,2,1,0,1,49,4.7e-05
G5,C=CC(C=C(C=O)C(CO)=O)=O,2,1,0,1,7,4.7e-05
G5,C=CC(C=O)=C(C=O)C(CO)=O,2,1,0,1,7,4.7e-05
G5,C=CC(CO)=C(C=O)C(CO)=O,2,1,0,1,7,4.7e-05
G5,C=CC(C(C=CC(CO)=O)O)=O,4,1,0,1,49,4.7e-05
G5,C=CC(C(C(CO)=CC=O)O)=O,4,1,0,1,7,4.7e-05
G5,C(C(C(CO)=O)=CC=CC=O)=O,4,1,0,1,43,4.7e-05
G5,C(C(C)O)=C(C=O)C(CO)=O,4,1,0,1,49,4.7e-05
G5,C(C(C(C)=C(C=O)CO)O)=O,4,1,0,1,6,4.7e-05
G5,C(C(C(C(C=O)=C)(C)O)O)=O,4,2,0,2,29,9.499999999999999e-05
G5,C(C(C(C=CCC(C)O)=O)O)=O,8,1,0,1,1,4.7e-05
G5,C(C(C=O)O)(CC=CC(C)O)=O,8,1,0,1,1,4.7e-05
G5,C(C)(C(C=C(C=O)C(C)O)O)=O,8,1,0,1,1,4.7e-05
G5,C(C)(C(C(C(C=O)=CC)O)O)=O,8,1,0,1,1,4.7e-05
G5,C(C(C(C)=C(C=O)C(C)O)O)=O,8,1,0,1,1,4.7e-05
G5,C(C(C(C(C=O)=CC)(C)O)O)=O,8,1,0,1,1,4.7e-05
G5,C(C(C(C=C(C=O)CO)=O)O)=O,4,1,0,1,2,4.7e-05
G5,C(C(C(C(C(C=O)=O)O)=C)O)=O,4,1,0,1,0,4.7e-05
G5,C(C)(C(C=C(C=O)C=O)O)=O,2,1,0,1,1,4.7e-05
G5,C(C(C(C)=C(C=O)C=O)O)=O,2,1,0,1,1,4.7e-05
G5,C(C(C(C=C(C(C)=O)C)=O)O)=O,4,1,0,1,14,4.7e-05
G5,C(C(C=O)O)(CC(C(C)=O)=C)=O,2,1,0,1,14,4.7e-05
G5,C(C)(C(C=CC(C(C)=O)=O)O)=O,4,1,0,1,14,4.7e-05
G5,C(C(C(CC(C(C)=O)=O)=C)O)=O,2,1,0,1,14,4.7e-05
G5,C(C(C(C)=CC(C(C)=O)=O)O)=O,4,1,0,1,14,4.7e-05
G5,C(C(C(C=CCC(C)=O)=O)O)=O,4,1,0,1,6,4.7e-05
G5,C(C(C=O)O)(CC=CC(C)=O)=O,4,1,0,1,6,4.7e-05
G5,C(CC(C=CC(C(C)=O)O)=O)=O,4,2,0,2,29,9.499999999999999e-05
G5,C(CC(CC(C(C=O)O)=C)=O)=O,2,1,0,1,27,4.7e-05
G5,C(CC(C=C(C)C(C=O)O)=O)=O,4,1,0,1,27,4.7e-05
G5,C(C)(C(C=C(C=O)C(C)=O)O)=O,4,1,0,1,6,4.7e-05
G5,C(C(C(C)=O)C(C(C=O)O)=C)=O,4,1,0,1,6,4.7e-05
G5,C(C(C(C)=C(C=O)C(C)=O)O)=O,4,1,0,1,6,4.7e-05
G5,C(C(C(C=CC(C=C)=O)=O)O)=O,4,1,0,1,1,4.7e-05
G5,C(C(C(C=C(C=O)C=C)=O)O)=O,4,1,0,1,25,4.7e-05
G5,C(C(C(C=C(C=C)CO)=O)O)=O,4,1,0,1,25,4.7e-05
G5,C(C(C(C(C(C=C)=O)O)=C)O)=O,4,1,0,1,1,4.7e-05
G5,C(C(C(C=CC=CC=O)=O)O)=O,8,1,0,1,1,4.7e-05
G5,C(C(C(C=CC(C)O)=O)O)=O,8,3,0,3,46,0.00014199999999999998
G5,C(C(C(C(C=O)=O)=CC=O)O)=O,4,1,0,1,0,4.7e-05
G5,C(C(C(C(C)O)=CC=O)=O)=O,4,1,0,1,0,4.7e-05
G5,C(C(C(C(C=O)=O)=CC)O)=O,4,1,0,1,0,4.7e-05
G5,C(C(C(C(CO)=CC=O)=O)O)=O,4,1,0,1,15,4.7e-05
G5,C(C(C(C(C(C=O)O)=O)=C)O)=O,4,2,0,2,29,9.499999999999999e-05
G5,C(C(C(C(C)=O)=CC=O)=O)=O,2,2,0,2,43,9.499999999999999e-05
G5,C(C(C(C=O)=O)=CC=O)=O,2,2,0,2,29,9.499999999999999e-05
G5,C(C(C(C(C)=O)=O)=CC=O)=O,2,2,0,2,14,9.499999999999999e-05
G5,C(C=C1C(COC1O)=O)=O,4,3,0,3,35,0.00014199999999999998
G5,C(C(C1C(COC=1)=O)O)=O,2,1,0,1,0,4.7e-05
G5,C(C=C1C(COC(C1O)O)=O)=O,8,2,0,2,0,9.499999999999999e-05
G5,C(C(C1C(COC(C=1)O)=O)O)=O,4,1,0,1,0,4.7e-05
G5,C(C(C(C=O)=C(C=O)CO)O)=O,4,2,0,2,29,9.499999999999999e-05
G5,C(C(C=CC(C=CC=O)=O)=O)=O,4,1,0,1,0,4.7e-05
G5,C(C(C=CC(C=O)=O)=CC=O)=O,4,1,0,1,45,4.7e-05
G5,C(C=CC(C(C=CC=O)=O)=O)=O,3,1,0,1,0,4.7e-05
G5,C(C(C(C=CC=O)=O)=CC=O)=O,4,1,0,1,45,4.7e-05
G5,C=CC(C(C(C=O)=O)=CC=O)=O,2,1,0,1,45,4.7e-05
G5,C=CC(C(C(C=O)=CC=O)=O)=O,2,1,0,1,0,4.7e-05
G5,C(C(C(C=CC=O)=CC=O)=O)=O,4,1,0,1,0,4.7e-05
G5,C(C=C1C(C(O)OC1)=O)=O,4,3,0,3,34,0.00014199999999999998
G5,C(CCO)=CC(C(CO)O)=O,4,2,0,2,18,9.499999999999999e-05
G5,C(C(CO)O)(CC=CCO)=O,4,1,0,1,18,4.7e-05
G5,C(C)(C(CO)O)=C(C=O)CO,4,1,0,1,18,4.7e-05
G5,C=C(C=O)C(C)(C(CO)O)O,4,2,0,2,29,9.499999999999999e-05
G5,C(CC(C)O)=CC(C(CO)O)=O,8,1,0,1,28,4.7e-05
G5,C(C(CO)O)(CC=CC(C)O)=O,8,1,0,1,28,4.7e-05
G5,C(C)(C(CO)O)=C(C=O)C(C)O,8,1,0,1,28,4.7e-05
G5,C(C)=C(C=O)C(C)(C(CO)O)O,8,1,0,1,28,4.7e-05
G5,C(C)(C(CO)O)=C(C=O)C=O,2,1,0,1,28,4.7e-05
G5,C(C=C(C(C)=O)C)(C(CO)O)=O,4,1,0,1,14,4.7e-05
G5,C(C(CO)O)(CC(C(C)=O)=C)=O,2,1,0,1,14,4.7e-05
G5,C=C(C(CO)O)CC(C(C)=O)=O,2,1,0,1,14,4.7e-05
G5,C(C)(C(CO)O)=CC(C(C)=O)=O,4,1,0,1,14,4.7e-05
G5,C(C)(CC=CC(C(CO)O)=O)=O,4,1,0,1,6,4.7e-05
G5,C(C(CO)O)(CC=CC(C)=O)=O,4,1,0,1,6,4.7e-05
G5,C(CC=O)(CC(C(CO)O)=C)=O,2,1,0,1,6,4.7e-05
G5,C(CC(C=C(C)C(CO)O)=O)=O,4,1,0,1,6,4.7e-05
G5,C(C(C(C)=O)C(C(CO)O)=C)=O,4,1,0,1,6,4.7e-05
G5,C(C)(C(CO)O)=C(C=O)C(C)=O,4,1,0,1,6,4.7e-05
G5,C=CC(C=CC(C(CO)O)=O)=O,4,1,0,1,7,4.7e-05
G5,C=CC(C=O)=CC(C(CO)O)=O,4,1,0,1,7,4.7e-05
G5,C=CC(CO)=CC(C(CO)O)=O,4,1,0,1,7,4.7e-05
G5,C=C(C(CO)O)C(C(C=C)=O)O,4,1,0,1,7,4.7e-05
G5,C(C(C)O)=CC(C(CO)O)=O,8,2,0,2,46,9.499999999999999e-05
G5,C(C(C(C(CO)=C)=O)O)=O,2,3,0,3,2,0.00014199999999999998
G5,C(C(C(C(C(C)O)=C)=O)O)=O,4,3,0,3,4,0.00014199999999999998
G5,C(C(C(C(CO)=CC)=O)O)=O,4,1,0,1,4,4.7e-05
G5,C=C(C=O)CO,1,6,0,6,5,0.000285
G5,C(C(CCO)=C(C=O)CO)=O,2,2,0,2,29,9.499999999999999e-05
G5,C=C(C=O)C(CO)(CCO)O,2,2,0,2,29,9.499999999999999e-05
G5,C(CO)(CCO)=C(C=O)CO,2,1,0,1,3,4.7e-05
G5,C=C(C=O)C(CO)(C)O,2,2,0,2,29,9.499999999999999e-05
G5,C(C)(CO)=C(C=O)CO,2,1,0,1,49,4.7e-05
G5,C(C(CC(C(C=O)=C)O)O)=O,4,2,0,2,29,9.499999999999999e-05
G5,C(C(CC=C(C=O)CO)O)=O,4,1,0,1,43,4.7e-05
G5,C=C(C=O)C(C)O,2,5,0,5,46,0.00023700000000000001
G5,C(C)=C(C=O)CO,2,1,0,1,18,4.7e-05
G5,C(CO)(C(CO)O)=C(C=O)CO,4,1,0,1,2,4.7e-05
G5,C(C(CO)=CC(O)=O)(CCO)=O,2,1,0,1,2,4.7e-05
G5,C=C(C(C(C=O)=O)=O)C(CO)O,2,1,0,1,0,4.7e-05
G5,C(CO)=C(C(C(C=O)=O)=O)CO,2,1,0,1,0,4.7e-05
G5,C=C(C(C(CO)O)=O)C(C=O)=O,2,1,0,1,2,4.7e-05
G5,C=C(C(C(C(C=O)=O)O)=O)CO,2,1,0,1,2,4.7e-05
G5,C(C(C=C(C(CO)=O)CO)=O)=O,2,1,0,1,15,4.7e-05
G5,C=C(C=O)C(C(C(C=O)=O)O)O,4,1,0,1,5,4.7e-05
G5,C(C(C(C=O)=O)O)=C(C=O)CO,4,1,0,1,5,4.7e-05
G5,C(COC(C(C=O)=C)(CO)O)=O,2,1,0,1,40,4.7e-05
G5,C(COC(CO)=C(C=O)CO)=O,2,1,0,1,40,4.7e-05
G5,C(C(CO)=C(C(CO)=O)CO)=O,2,1,0,1,2,4.7e-05
G5,C1(C(CO)=C(C(C1)=O)CO)=O,1,1,0,1,2,4.7e-05
G5,C=C(C=O)C=CC(C=O)=O,2,2,0,2,29,9.499999999999999e-05
G5,C=CC(C(C=CC=O)=O)=O,2,2,0,2,29,9.499999999999999e-05
G5,C=C(C=O)C(C=CC=O)=O,2,3,0,3,29,0.00014199999999999998
G5,C=C(C(C=C)=O)C(C=O)=O,1,2,0,2,29,9.499999999999999e-05
G5,C=C(C=O)C(C(C=C)=O)=O,1,2,0,2,29,9.499999999999999e-05
G5,C=C(C=CC=O)C(C=O)=O,2,2,0,2,29,9.499999999999999e-05
G5,C=C1C(C(O)OC1)=O,2,4,0,4,7,0.00018999999999999998
G5,C=C1C(C(CO)(OC1CO)O)=O,4,2,0,2,0,9.499999999999999e-05
G5,C=C1C(C(CO)OC1(CO)O)=O,4,2,0,2,2,9.499999999999999e-05
G5,C1(CO)OC(C(C=1CO)=O)CO,2,1,0,1,2,4.7e-05
G5,C(CC1(C(C(CO1)=C)=O)O)=O,2,2,0,2,2,9.499999999999999e-05
G5,C(CC1(C(C(CO1)=O)=C)O)=O,2,2,0,2,2,9.499999999999999e-05
G5,C(CC1OCC(C=1CO)=O)=O,1,1,0,1,2,4.7e-05
G5,C(C1C(C(C(C)(O1)O)=C)=O)=O,4,2,0,2,26,9.499999999999999e-05
G5,C(C1C(C(CO)=C(C)O1)=O)=O,2,1,0,1,26,4.7e-05
G5,C(C1C(C(C(C)(O1)O)=O)=C)=O,4,2,0,2,14,9.499999999999999e-05
G5,C=C1C(C(CO)(O)OCC1O)=O,4,2,0,2,0,9.499999999999999e-05
G5,C1COC(C(C=1CO)=O)(CO)O,2,1,0,1,2,4.7e-05
G5,C=C1C(C(COC1(CO)O)O)=O,4,2,0,2,2,9.499999999999999e-05
G5,C1(CO)OCC(C(C=1CO)=O)O,2,1,0,1,2,4.7e-05
G5,C=C1C(C(C(CO)(OC1)O)O)=O,4,2,0,2,2,9.499999999999999e-05
G5,C=C1C(COC(CO)(C1O)O)=O,4,2,0,2,5,9.499999999999999e-05
G5,C1C(CO)(OCC(C=1CO)=O)O,2,2,0,2,29,9.499999999999999e-05
G5,C(C1(C(C(CCO1)=O)=C)O)=O,2,2,0,2,2,9.499999999999999e-05
G5,C1(C(CO)=C(C=O)OCC1)=O,1,1,0,1,2,4.7e-05
G5,C(C1(CC(C(CO1)=C)=O)O)=O,2,2,0,2,30,9.499999999999999e-05
G5,C(C1(CC(C(CO1)=O)=C)O)=O,2,2,0,2,12,9.499999999999999e-05
G5,C(C1C(C(CC(O1)O)=C)=O)=O,4,2,0,2,2,9.499999999999999e-05
G5,C(C1C(C(CC(O1)O)=O)=C)=O,4,2,0,2,2,9.499999999999999e-05
G5,C(C1CC(C(C(O)O1)=C)=O)=O,4,2,0,2,2,9.499999999999999e-05
G5,C(C1CC(C(CO)=CO1)=O)=O,2,1,0,1,2,4.7e-05
G5,C=C1C(C(OC1C(CO)O)=O)=O,4,1,0,1,27,4.7e-05
G5,C=C1C(OC(C1=O)C(CO)O)=O,4,1,0,1,2,4.7e-05
G5,C1(C(C(C(C(C=C)=O)O1)O)O)=O,8,2,0,2,29,9.499999999999999e-05
G5,C1(C(C(C(C(C=O)=C)O1)O)O)=O,8,1,0,1,27,4.7e-05
G5,C=C1C(C(OC(CO)C1O)=O)=O,4,1,0,1,50,4.7e-05
G5,C1C(CO)OC(C(C=1CO)=O)=O,2,1,0,1,50,4.7e-05
G5,C=C1C(OC(CO)C(C1=O)O)=O,4,1,0,1,2,4.7e-05
G5,C1(C(C(C(C(CO)O1)=C)=O)O)=O,4,1,0,1,50,4.7e-05
G5,C1(C(C(C(C(CO)O1)=O)=C)O)=O,4,1,0,1,2,4.7e-05
G5,C1(C(CO)=CC(OC1CO)=O)=O,2,1,0,1,2,4.7e-05
G5,C=C1C(C(OCC(C1O)O)=O)=O,4,1,0,1,27,4.7e-05
G5,C1C(COC(C(C=1CO)=O)=O)O,2,1,0,1,27,4.7e-05
G5,C=C1C(OCC(C(C1=O)O)O)=O,4,1,0,1,2,4.7e-05
G5,C1(C(C(C(C(CO1)O)=C)=O)O)=O,4,1,0,1,2,4.7e-05
G5,C1(C(C(C(CO)=CCO1)=O)O)=O,2,1,0,1,2,4.7e-05
G5,C1(C(C(C(C(CO1)O)=O)=C)O)=O,4,1,0,1,2,4.7e-05
G5,C1(C(CO)=CC(OCC1O)=O)=O,2,1,0,1,2,4.7e-05
G5,C1(C(C(C(C(CO1)=C)=O)O)O)=O,4,1,0,1,2,4.7e-05
G5,C1(C(C(C(C(CO1)=O)=C)O)O)=O,4,1,0,1,2,4.7e-05
G5,C1(C(C=C(C(CO1)=O)CO)O)=O,2,1,0,1,2,4.7e-05
G5,C=C1C(COC1(C(CO)O)O)=O,4,2,0,2,2,9.499999999999999e-05
G5,C1(C(CO)O)OCC(C=1CO)=O,2,1,0,1,2,4.7e-05
G5,C=C(C(C=O)=O)C(CC(C)O)O,4,2,0,2,29,9.499999999999999e-05
G5,C(CC(C)O)=C(C(C=O)=O)CO,4,1,0,1,3,4.7e-05
G5,C(C(C(C=O)=O)CO)=CC(C)O,8,1,0,1,3,4.7e-05
G5,C(C(CCO)=C(C=O)C(C)O)=O,4,1,0,1,3,4.7e-05
G5,C(C(C(C=O)=CC)(CCO)O)=O,4,1,0,1,3,4.7e-05
G5,C(C(C(CO)=C(C=O)CO)=O)=O,2,1,0,1,2,4.7e-05
G5,C(CO)=C(C=O)C(C(C=O)=O)O,4,1,0,1,1,4.7e-05
G5,C(C(C=O)=CC(CCO)=O)=O,1,1,0,1,2,4.7e-05
G5,C(C(C=O)=C(C=O)CCO)=O,1,2,0,2,29,9.499999999999999e-05
G5,C=C(C(O)=O)C(C=O)=O,1,3,0,3,12,0.00014199999999999998
G5,C(C)(C(C(C(C=O)=O)=C)(C)O)=O,2,2,0,2,29,9.499999999999999e-05
G5,C(C(C(CO)=C(C(C)=O)C)=O)=O,2,1,0,1,14,4.7e-05
G5,C=C(C(C)=O)C(C(C=O)=O)CO,2,1,0,1,14,4.7e-05
G5,C(C(C=CC(CCO)=O)=O)(C)=O,2,1,0,1,14,4.7e-05
G5,C(CO)=C(C=O)CC(C(C)=O)=O,2,2,0,2,29,9.499999999999999e-05
G5,C(C(C=C(C=O)CCO)=O)(C)=O,2,1,0,1,14,4.7e-05
G5,C(CC(C(C(C=O)=O)=C)(C)O)=O,2,2,0,2,29,9.499999999999999e-05
G5,C(CC(C)=C(C(C=O)=O)CO)=O,2,1,0,1,6,4.7e-05
G5,C(CC(C(C(C=O)=O)CO)=C)=O,2,1,0,1,6,4.7e-05
G5,C(C)(C(C(C=O)=O)CO)=CC=O,4,1,0,1,6,4.7e-05
G5,C(C)(CC(C(C(C=O)=O)=C)O)=O,2,2,0,2,29,9.499999999999999e-05
G5,C(C)(CC=C(C(C=O)=O)CO)=O,2,1,0,1,23,4.7e-05
G5,C(C(C(C=O)=O)CO)=CC(C)=O,4,1,0,1,23,4.7e-05
G5,C(CC(C=CC(CCO)=O)=O)=O,2,2,0,2,29,9.499999999999999e-05
G5,C(CC=O)(CC(C=O)=CCO)=O,2,2,0,2,29,9.499999999999999e-05
G5,C(CC(C=C(C=O)CCO)=O)=O,2,1,0,1,34,4.7e-05
G5,C(C(C(C)=O)=CC(CCO)=O)=O,2,1,0,1,3,4.7e-05
G5,C(C(C(C)=O)C(C=O)=CCO)=O,4,1,0,1,3,4.7e-05
G5,C(C(C(C)=O)=C(C=O)CCO)=O,2,1,0,1,3,4.7e-05
G5,C=C(C(C=O)=O)C(C(C=C)=O)O,2,2,0,2,29,9.499999999999999e-05
G5,C=CC(C=C(C(C=O)=O)CO)=O,2,1,0,1,7,4.7e-05
G5,C(C(C=C)(C(C(C=O)=O)=C)O)=O,2,2,0,2,29,9.499999999999999e-05
G5,C=CC(C=O)=C(C(C=O)=O)CO,2,1,0,1,7,4.7e-05
G5,C=CC(C(C(C=O)=O)=C)(CO)O,2,2,0,2,29,9.499999999999999e-05
G5,C=CC(CO)=C(C(C=O)=O)CO,2,1,0,1,7,4.7e-05
G5,C=C(C(C=O)=O)C(C=CC=O)O,4,2,0,2,29,9.499999999999999e-05
G5,C(C=CC=C(C(C=O)=O)CO)=O,4,1,0,1,20,4.7e-05
G5,C=C(C(C=O)=O)C(C(C)O)O,4,2,0,2,29,9.499999999999999e-05
G5,C(C(C)O)=C(C(C=O)=O)CO,4,1,0,1,11,4.7e-05
G5,C(CCO)(C(C=CCO)O)=O,4,1,0,1,3,4.7e-05
G5,C=C(C(CO)=O)C(CCO)O,2,2,0,2,29,9.499999999999999e-05
G5,C(CCO)=C(C(CO)=O)CO,2,1,0,1,18,4.7e-05
G5,C(CO)(C(C=CCO)CO)=O,4,1,0,1,18,4.7e-05
G5,C(CCO)(C(C=CC(C)O)O)=O,8,1,0,1,3,4.7e-05
G5,C=C(C(CO)=O)C(CC(C)O)O,4,2,0,2,29,9.499999999999999e-05
G5,C(CC(C)O)=C(C(CO)=O)CO,4,1,0,1,3,4.7e-05
G5,C(CO)(C(C=CC(C)O)CO)=O,8,1,0,1,3,4.7e-05
G5,C(CO)(CCO)=C(C=O)C(C)O,4,1,0,1,3,4.7e-05
G5,C(C)=C(C=O)C(CO)(CCO)O,4,1,0,1,3,4.7e-05
G5,C(CO)(CCO)=C(C=O)C=O,1,1,0,1,3,4.7e-05
G5,C(CCO)(C(C(C(C)=O)=C)O)=O,2,1,0,1,14,4.7e-05
G5,C(C)(C(C(C(CO)=O)=C)(C)O)=O,2,2,0,2,29,9.499999999999999e-05
G5,C(C(C)=C(C(CO)=O)CO)(C)=O,2,1,0,1,14,4.7e-05
G5,C(CO)(C(C(C(C)=O)=C)CO)=O,2,1,0,1,14,4.7e-05
G5,C(CO)=C(CO)CC(C(C)=O)=O,2,1,0,1,14,4.7e-05
G5,C(CO)(CCO)=CC(C(C)=O)=O,2,1,0,1,14,4.7e-05
G5,C(CC(C(C(CO)=O)=C)(C)O)=O,2,2,0,2,29,9.499999999999999e-05
G5,C(CC(C)=C(C(CO)=O)CO)=O,2,1,0,1,3,4.7e-05
G5,C(CC(C(C(CO)=O)CO)=C)=O,2,1,0,1,3,4.7e-05
G5,C(CO)(C(C(C)=CC=O)CO)=O,4,1,0,1,3,4.7e-05
G5,C(CCO)(C(C=CC(C)=O)O)=O,4,1,0,1,3,4.7e-05
G5,C(C)(CC=C(C(CO)=O)CO)=O,2,1,0,1,3,4.7e-05
G5,C(CO)(C(C=CC(C)=O)CO)=O,4,1,0,1,3,4.7e-05
G5,C(C(C(C)=O)C(CO)=CCO)=O,4,1,0,1,3,4.7e-05
G5,C(CO)(CCO)=C(C(C)=O)C=O,2,1,0,1,3,4.7e-05
G5,C=CC(C=C(C(CO)=O)CO)=O,2,1,0,1,7,4.7e-05
G5,C(C(C=C)(C(C(CO)=O)=C)O)=O,2,2,0,2,29,9.499999999999999e-05
G5,C=CC(C=O)=C(C(CO)=O)CO,2,1,0,1,7,4.7e-05
G5,C=CC(C(C(CO)=O)=C)(CO)O,2,2,0,2,29,9.499999999999999e-05
G5,C=CC(CO)=C(C(CO)=O)CO,2,1,0,1,7,4.7e-05
G5,C=CC(C(C(CO)=CCO)O)=O,4,1,0,1,7,4.7e-05
G5,C(C(C(C(CO)=O)=C)O)=CC=O,4,2,0,2,29,9.499999999999999e-05
G5,C(C=CC=C(C(CO)=O)CO)=O,4,1,0,1,43,4.7e-05
G5,C=C(C(CO)=O)C(C(C)O)O,4,2,0,2,29,9.499999999999999e-05
G5,C(C(C)O)=C(C(CO)=O)CO,4,1,0,1,11,4.7e-05
G5,C(C(C(C(C=O)=CC)O)O)=O,8,1,0,1,0,4.7e-05
G5,C(C(C=C(C=O)C=O)O)=O,2,1,0,1,1,4.7e-05
G5,C(C(C=C(C=O)C(C=O)=O)O)=O,4,1,0,1,23,4.7e-05
G5,C(C(C=C(C=O)C(C)=O)O)=O,4,1,0,1,1,4.7e-05
G5,C(C(C=C1C(COC1O)=O)O)=O,8,2,0,2,29,9.499999999999999e-05
G5,C(C(C(C1C(COC=1)=O)O)O)=O,4,1,0,1,35,4.7e-05
G5,C(C(C=C1C(C(O)OC1)=O)O)=O,8,2,0,2,29,9.499999999999999e-05
G5,C(C(CC(C)O)=CC(CO)=O)=O,4,1,0,1,49,4.7e-05
G5,C(CO)(CC(C=O)=CC(C)O)=O,4,1,0,1,49,4.7e-05
G5,C(CO)(C)=C(C(C=O)=O)C(C)O,4,1,0,1,49,4.7e-05
G5,C(C)=C(C(C=O)=O)C(CO)(C)O,4,1,0,1,49,4.7e-05
G5,C(C)(C(CC=CC(CO)=O)O)=O,4,1,0,1,49,4.7e-05
G5,C(CO)(CC=CC(C(C)=O)O)=O,4,2,0,2,29,9.499999999999999e-05
G5,C(C)(C(C=CC(C(C)=O)O)O)=O,6,1,0,1,45,4.7e-05
G5,C(C(C)(CC=CC(CO)=O)O)=O,4,1,0,1,49,4.7e-05
G5,C(C(C=CCC(CO)=O)(C)O)=O,4,1,0,1,49,4.7e-05
G5,C(C(C=CC(C(C)=O)O)(C)O)=O,8,2,0,2,29,9.499999999999999e-05
G5,C(CO)(CC(C)O)=CC(CO)=O,4,1,0,1,49,4.7e-05
G5,C(CO)(CC(CO)=CC(C)O)=O,4,1,0,1,49,4.7e-05
G5,C(C)(C(C(CO)=CC(C)O)O)=O,8,1,0,1,11,4.7e-05
G5,C(CO)(C)=C(C(CO)=O)C(C)O,4,1,0,1,49,4.7e-05
G5,C(C)=C(C(CO)=O)C(CO)(C)O,4,1,0,1,49,4.7e-05
G5,C(C)(C(C(C)O)O)=CC(CO)=O,8,1,0,1,49,4.7e-05
G5,C(CO)(CC(C(C(C)O)O)=C)=O,4,1,0,1,49,4.7e-05
G5,C(C)(C(C(C(C(C)O)O)=C)O)=O,8,1,0,1,49,4.7e-05
G5,C(CC(CO)(C)O)=CC(CO)=O,4,1,0,1,49,4.7e-05
G5,C(CO)(CC=CC(CO)(C)O)=O,4,1,0,1,49,4.7e-05
G5,C(C)(C(C=CC(CO)(C)O)O)=O,8,1,0,1,49,4.7e-05
G5,C(CO)(C)=C(C=O)C(CO)(C)O,4,1,0,1,49,4.7e-05
G5,C(CC(C)O)=CC(CO)=O,4,1,0,1,28,4.7e-05
G5,C(CO)(CC=CC(C)O)=O,4,1,0,1,28,4.7e-05
G5,C(C)(C(C=CC(C)O)O)=O,8,1,0,1,28,4.7e-05
G5,C(CO)(C)=C(C=O)C(C)O,4,1,0,1,49,4.7e-05
G5,C(C)=C(C=O)C(CO)(C)O,4,1,0,1,49,4.7e-05
G5,C(C(C(C)O)O)=CC(CO)=O,8,1,0,1,49,4.7e-05
G5,C=C(CO)C(C(C=O)=O)O,2,1,0,1,49,4.7e-05
G5,C(C(C)O)(C(C(CO)=C)O)=O,4,1,0,1,25,4.7e-05
G5,C(C)(CO)=C(C=O)C=O,1,1,0,1,49,4.7e-05
G5,C(C)(CC(C=O)=CC(CO)=O)=O,2,1,0,1,27,4.7e-05
G5,C(CO)(CC(C=O)=CC(C)=O)=O,2,2,0,2,29,9.499999999999999e-05
G5,C(C)(CC(C=O)=O)=CC(CO)=O,2,1,0,1,26,4.7e-05
G5,C(CO)(CC(C)=CC(C=O)=O)=O,2,1,0,1,26,4.7e-05
G5,C(CO)(CC(CC(C=O)=O)=C)=O,1,1,0,1,26,4.7e-05
G5,C(C)(C(C(C)=CC(C=O)=O)O)=O,4,1,0,1,49,4.7e-05
G5,C(C)(C(C(CC(C=O)=O)=C)O)=O,2,1,0,1,49,4.7e-05
G5,C(C)(C(C(CO)=C)C(C=O)=O)=O,2,1,0,1,26,4.7e-05
G5,C(C)(CO)=C(C(C)=O)C(C=O)=O,2,1,0,1,26,4.7e-05
G5,C(CC(CO)=C)(CC(C=O)=O)=O,1,1,0,1,49,4.7e-05
G5,C(C)(CO)=CC(CC(C=O)=O)=O,2,1,0,1,49,4.7e-05
G5,C(C)(CO)=C(C=O)C(C=O)=O,2,1,0,1,49,4.7e-05
G5,C(C)(C(C(C(C)=O)=CC=O)O)=O,4,1,0,1,14,4.7e-05
G5,C(CC(C(C)=CC(CO)=O)=O)=O,2,1,0,1,14,4.7e-05
G5,C(CC(C(CC(CO)=O)=C)=O)=O,1,1,0,1,14,4.7e-05
G5,C(CC(C(C(C(C)=O)O)=C)=O)=O,2,1,0,1,14,4.7e-05
G5,C(C(C(CO)=C)C(C(C)=O)=O)=O,2,1,0,1,14,4.7e-05
G5,C(C)(CO)=C(C=O)C(C(C)=O)=O,2,1,0,1,14,4.7e-05
G5,C(CC(C(CC(CO)=C)=O)=O)=O,1,1,0,1,49,4.7e-05
G5,C(CC(C(C=C(C)CO)=O)=O)=O,2,1,0,1,49,4.7e-05
G5,C(CO)(CC(C)=CC=O)=O,2,1,0,1,6,4.7e-05
G5,C(C)(C(C(C)=CC=O)O)=O,4,1,0,1,6,4.7e-05
G5,C(C)(CC=CC(CO)=O)=O,2,1,0,1,6,4.7e-05
G5,C(CO)(CC=CC(C)=O)=O,2,2,0,2,29,9.499999999999999e-05
G5,C(C)(C(C=CC(C)=O)O)=O,4,1,0,1,49,4.7e-05
G5,C(C)(CO)=C(C=O)C(C)=O,2,1,0,1,49,4.7e-05
G5,C1(COC(C1)O)=CC(CO)=O,4,2,0,2,49,9.499999999999999e-05
G5,C(CO)(CC1COC(C=1)O)=O,2,1,0,1,49,4.7e-05
G5,C(C)(C(C1COC(C=1)O)O)=O,4,1,0,1,49,4.7e-05
G5,C1(COC(C1C(CO)=C)O)=O,4,2,0,2,49,9.499999999999999e-05
G5,C(C)(CO)=C1C(COC1O)=O,4,2,0,2,49,9.499999999999999e-05
G5,C1OCC(C=1C(CO)(C)O)=O,2,1,0,1,49,4.7e-05
G5,C1(CC(OC1C(CO)=C)O)=O,4,2,0,2,49,9.499999999999999e-05
G5,C(C=CC=CC(CO)=O)(CO)=O,3,1,0,1,49,4.7e-05
G5,C(C=CC(CO)=CC(CO)=O)=O,4,1,0,1,49,4.7e-05
G5,C=C(CO)C(C(C=CC=O)=O)O,4,1,0,1,49,4.7e-05
G5,C=CC(C=CC(CO)=O)=O,2,2,0,2,29,9.499999999999999e-05
G5,C=CC(C=O)=CC(CO)=O,2,3,0,3,29,0.00014199999999999998
G5,C=CC(CO)=CC(CO)=O,2,2,0,2,29,9.499999999999999e-05
G5,C=C(CO)C(C(C=C)=O)O,2,2,0,2,29,9.499999999999999e-05
G5,C(C(C)O)=CC(CO)=O,4,4,0,4,46,0.00018999999999999998
G5,C1(COCC1O)=CC(CO)=O,4,1,0,1,10,4.7e-05
G5,C1(C(COC1C(CO)=C)O)=O,4,1,0,1,10,4.7e-05
G5,C1(C(O)OCC1)=CC(CO)=O,4,2,0,2,3,9.499999999999999e-05
G5,C(CO)(CC1C(O)OCC=1)=O,2,1,0,1,34,4.7e-05
G5,C(C)(C(C1C(O)OCC=1)O)=O,4,1,0,1,34,4.7e-05
G5,C1(C(O)OCC1C(CO)=C)=O,4,2,0,2,49,9.499999999999999e-05
G5,C(C)(CO)=C1C(C(O)OC1)=O,4,2,0,2,29,9.499999999999999e-05
G5,C(C=C(C=O)C(CCO)O)=O,4,2,0,2,29,9.499999999999999e-05
G5,C(C(C(C=O)=CCCO)O)=O,4,1,0,1,43,4.7e-05
G5,C(C(C=CCO)C(C=O)O)=O,8,1,0,1,43,4.7e-05
G5,C(C=C(C=O)C(CC(C)O)O)=O,8,2,0,2,29,9.499999999999999e-05
G5,C(C(C(C=O)=CCC(C)O)O)=O,8,1,0,1,43,4.7e-05
G5,C(C(C=CC(C)O)C(C=O)O)=O,16,1,0,1,43,4.7e-05
G5,C(C(CC=C(C=O)C(C)O)O)=O,8,1,0,1,43,4.7e-05
G5,C(C(CC(C(C=O)=CC)O)O)=O,8,1,0,1,43,4.7e-05
G5,C(CC(C=C(C=O)C=O)O)=O,2,1,0,1,43,4.7e-05
G5,C(C(CC=C(C=O)C=O)O)=O,2,1,0,1,43,4.7e-05
G5,C(C(C(O)=O)=CC=O)=O,2,2,0,2,29,9.499999999999999e-05
G5,C(C)(C(C(C=O)=CC=O)(C)O)=O,4,2,0,2,29,9.499999999999999e-05
G5,C(C(C(C=O)=C(C(C)=O)C)O)=O,4,1,0,1,14,4.7e-05
G5,C(C(C(C(C)=O)=C)C(C=O)O)=O,4,1,0,1,14,4.7e-05
G5,C(C(C=CCC(C(C)=O)=O)O)=O,4,1,0,1,21,4.7e-05
G5,C(C(CC=CC(C(C)=O)=O)O)=O,4,1,0,1,21,4.7e-05
G5,C(CC(C(C=O)=CC=O)(C)O)=O,4,2,0,2,29,9.499999999999999e-05
G5,C(CC(C)=C(C=O)C(C=O)O)=O,4,1,0,1,6,4.7e-05
G5,C(C(C(CC=O)=C)C(C=O)O)=O,4,1,0,1,6,4.7e-05
G5,C(C(C(C)=CC=O)C(C=O)O)=O,8,1,0,1,6,4.7e-05
G5,C(C)(CC(C(C=O)=CC=O)O)=O,4,2,0,2,29,9.499999999999999e-05
G5,C(C(C(C=O)=CCC(C)=O)O)=O,4,1,0,1,6,4.7e-05
G5,C(C(C=CC(C)=O)C(C=O)O)=O,8,1,0,1,6,4.7e-05
G5,C(CC(C=CCC(C=O)O)=O)=O,4,1,0,1,6,4.7e-05
G5,C(CC(C=C(C=O)C(C)=O)O)=O,4,1,0,1,6,4.7e-05
G5,C(C(CC=C(C=O)C(C)=O)O)=O,4,1,0,1,6,4.7e-05
G5,C(C(C=C)(C(C=O)=CC=O)O)=O,4,2,0,2,29,9.499999999999999e-05
G5,C(C(C(C=O)=C(C=O)C=C)O)=O,4,1,0,1,7,4.7e-05
G5,C=CC(C(C=O)=CC=O)(CO)O,4,2,0,2,29,9.499999999999999e-05
G5,C(C(C(C=O)=C(C=C)CO)O)=O,4,1,0,1,7,4.7e-05
G5,C(C(C(C=O)=CC=O)O)=CC=O,8,2,0,2,29,9.499999999999999e-05
G5,C(C=C(C=O)C(C(C)O)O)=O,8,2,0,2,29,9.499999999999999e-05
G5,C(C(C(C=C(C=O)C=O)O)O)=O,4,1,0,1,0,4.7e-05
G5,C1(C(C(C(C1)O)O)O)=CC=O,16,1,0,1,4,4.7e-05
G5,C(CC1C(C(C(C=1)O)O)O)=O,8,1,0,1,4,4.7e-05
G5,C1(C(C(C(C1)=CC=O)CO)O)=O,8,1,0,1,30,4.7e-05
G5,C(CC1C(CO)C(C(C=1)=O)O)=O,4,1,0,1,30,4.7e-05
G5,C(CC1CC(C(C=1CO)O)=O)=O,2,1,0,1,30,4.7e-05
G5,C(C1(CCC(C1O)=CC=O)O)=O,8,1,0,1,29,4.7e-05
G5,C(CC1C(C(C=O)(CC=1)O)O)=O,4,1,0,1,29,4.7e-05
G5,C(C1(CC(C(C1)=CC=O)O)O)=O,8,1,0,1,22,4.7e-05
G5,C(C1(C=C(C(C1)O)CC=O)O)=O,4,1,0,1,22,4.7e-05
G5,C1(C(C(C=CC=O)C(C1)O)O)=O,16,1,0,1,4,4.7e-05
G5,C(CC=C1C(CC(C1O)=O)O)=O,8,1,0,1,4,4.7e-05
G5,C(C=C1C(CC(C1CO)O)=O)=O,8,1,0,1,4,4.7e-05
G5,C(CC1C(CC(C=1CO)O)=O)=O,2,1,0,1,4,4.7e-05
G5,C1(CC(C=CC=O)C(C1O)O)=O,16,2,0,2,18,9.499999999999999e-05
G5,C(CC=C1C(C(C(C1)=O)O)O)=O,8,1,0,1,18,4.7e-05
G5,C1C(C(C(C(C=1)=CC=O)O)O)O,16,1,0,1,32,4.7e-05
G5,C(CO)(C(C(C)O)O)=CC=O,8,1,0,1,4,4.7e-05
G5,C(CC(CO)(CO)O)=CC=O,2,1,0,1,4,4.7e-05
G5,C(CC=CC(CO)(CO)O)=O,2,1,0,1,4,4.7e-05
G5,C(CC(C(CO)O)O)=CC=O,8,1,0,1,29,4.7e-05
G5,C(CC=CC(C(CO)O)O)=O,8,1,0,1,29,4.7e-05
G5,C(C(C)(CC(C=O)=CC=O)O)=O,4,1,0,1,4,4.7e-05
G5,C(C(C=C(C=O)CC=O)(C)O)=O,4,1,0,1,4,4.7e-05
G5,C(C(CC(C=O)=CC=O)O)=O,4,2,0,2,29,9.499999999999999e-05
G5,C(CC(C=O)=CC(C=O)O)=O,4,3,0,3,20,0.00014199999999999998
G5,C(C=C(C=O)CC(C)(CO)O)=O,4,1,0,1,4,4.7e-05
G5,C(CC(C=O)=CC(CO)(C)O)=O,4,1,0,1,4,4.7e-05
G5,C(C(C)(CC(CO)=CC=O)O)=O,4,1,0,1,4,4.7e-05
G5,C(C(C=C(CO)CC=O)(C)O)=O,4,1,0,1,4,4.7e-05
G5,C(C=C(C=O)CC(C)O)=O,4,1,0,1,4,4.7e-05
G5,C(CC(C=O)=CC(C)O)=O,4,1,0,1,4,4.7e-05
G5,C(C)=C(C(C=O)=O)C(C)O,4,1,0,1,4,4.7e-05
G5,C(C)(C(CC=CC=O)O)=O,4,1,0,1,45,4.7e-05
G5,C(CC=CC(C(C)=O)O)=O,4,1,0,1,45,4.7e-05
G5,C(C(C)(CC=CC=O)O)=O,4,1,0,1,18,4.7e-05
G5,C(C(C=CCC=O)(C)O)=O,4,1,0,1,18,4.7e-05
G5,C(CC(C(CO)O)=CC=O)=O,4,1,0,1,4,4.7e-05
G5,C(CC(C(C(C)O)O)=CC=O)=O,8,1,0,1,4,4.7e-05
G5,C(C(C(CCO)=CC=O)O)=O,4,1,0,1,0,4.7e-05
G5,C(CC(C(C=O)O)=CCO)=O,4,1,0,1,0,4.7e-05
G5,C(C(C(CC(C)O)=CC=O)O)=O,8,1,0,1,4,4.7e-05
G5,C(CC(C(C=O)O)=CC(C)O)=O,8,1,0,1,4,4.7e-05
G5,C(C(C(C(C(C)O)=CC)=O)O)=O,8,1,0,1,4,4.7e-05
G5,C(C(C(C)(CC=CC=O)O)O)=O,8,1,0,1,4,4.7e-05
G5,C(CC=CC(C)(C(C=O)O)O)=O,8,1,0,1,4,4.7e-05
G5,C(C(CO)O)(CCO)=CC=O,4,1,0,1,29,4.7e-05
G5,C(CC(C(CO)O)=CCO)=O,4,1,0,1,29,4.7e-05
G5,C(C(CO)O)(CC(C)O)=CC=O,8,1,0,1,4,4.7e-05
G5,C(CC(C(CO)O)=CC(C)O)=O,8,1,0,1,4,4.7e-05
G5,C(C)=C(C(C(CO)O)=O)C(C)O,8,1,0,1,4,4.7e-05
G5,C(CC(C)(C(CO)O)O)=CC=O,8,1,0,1,4,4.7e-05
G5,C(CC=CC(C)(C(CO)O)O)=O,8,1,0,1,4,4.7e-05
G5,C(C=C(C=O)C(CO)CO)=O,2,1,0,1,29,4.7e-05
G5,C(CC(C=O)=C(CO)CO)=O,1,2,0,2,29,9.499999999999999e-05
G5,C(CO)(C(CO)CO)=CC=O,2,1,0,1,29,4.7e-05
G5,C(CC(CO)=C(CO)CO)=O,1,1,0,1,29,4.7e-05
G5,C(C(C(C=CC=O)CO)O)=O,8,1,0,1,43,4.7e-05
G5,C(CC=C(CO)C(C=O)O)=O,4,1,0,1,43,4.7e-05
G5,C(C(CO)O)(C(CO)O)=CC=O,3,1,0,1,4,4.7e-05
G5,C(C=C(C=O)C(CO)C(C)O)=O,8,1,0,1,4,4.7e-05
G5,C(CC(C=O)=C(CO)C(C)O)=O,4,1,0,1,4,4.7e-05
G5,C(C(C(C)O)O)(CCO)=CC=O,8,1,0,1,4,4.7e-05
G5,C(CC(C(C(C)O)O)=CCO)=O,8,1,0,1,4,4.7e-05
G5,C(CO)(C(CO)C(C)O)=CC=O,8,1,0,1,4,4.7e-05
G5,C(CC(CO)=C(CO)C(C)O)=O,4,1,0,1,4,4.7e-05
G5,C(CC(CO)(CCO)O)=CC=O,4,1,0,1,4,4.7e-05
G5,C(CC=CC(CO)(CCO)O)=O,4,1,0,1,4,4.7e-05
G5,C(CO)(CC(CO)(C)O)=CC=O,4,1,0,1,4,4.7e-05
G5,C(CC(CO)=CC(CO)(C)O)=O,4,1,0,1,4,4.7e-05
G5,C(C)(C(C(CO)(C)O)O)=CC=O,8,1,0,1,4,4.7e-05
G5,C(CC(C(C(CO)(C)O)O)=C)=O,4,1,0,1,4,4.7e-05
G5,C(CO)(CC(C)O)=CC=O,4,1,0,1,11,4.7e-05
G5,C(CC(CO)=CC(C)O)=O,4,1,0,1,11,4.7e-05
G5,C(C)=C(C(CO)=O)C(C)O,4,1,0,1,4,4.7e-05
G5,C(C)(C(C(C)O)O)=CC=O,8,1,0,1,4,4.7e-05
G5,C(CC(C(C(C)O)O)=C)=O,4,1,0,1,4,4.7e-05
G5,C(CC(C)(CO)O)=CC=O,4,1,0,1,18,4.7e-05
G5,C(CC=CC(CO)(C)O)=O,4,1,0,1,18,4.7e-05
G5,C(C(C(C=CC=O)C(C)O)O)=O,16,1,0,1,4,4.7e-05
G5,C(CC=C(C(C)O)C(C=O)O)=O,8,1,0,1,4,4.7e-05
G5,C(C(CC(CC=CC=O)O)O)=O,8,1,0,1,4,4.7e-05
G5,C(CC=CC(CC(C=O)O)O)=O,8,1,0,1,4,4.7e-05
G5,C(CC(C)O)=CC=O,4,1,0,1,28,4.7e-05
G5,C(CC=CC(C)O)=O,4,1,0,1,28,4.7e-05
G5,C(C)=C(C=O)C(C)O,4,1,0,1,4,4.7e-05
G5,C(C(C(C(CO)O)O)O)=CC=O,16,4,0,4,29,0.000212
G5,C(C=C(C=O)CC(CO)O)=O,4,1,0,1,4,4.7e-05
G5,C(CC(C=O)=CC(CO)O)=O,4,2,0,2,29,9.499999999999999e-05
G5,C(C(C(C)O)O)=CC=O,8,1,0,1,28,4.7e-05
G5,C(CO)(C(CC=CC=O)O)=O,4,1,0,1,41,4.7e-05
G5,C(CC=CC(C(CO)=O)O)=O,4,1,0,1,41,4.7e-05
G5,C1(COC(C1)O)=CC=O,4,2,0,2,35,9.499999999999999e-05
G5,C(CC1COC(C=1)O)=O,2,1,0,1,35,4.7e-05
G5,C1(COC(C1C=C)O)=O,4,2,0,2,4,9.499999999999999e-05
G5,C(C)=C1C(COC1O)=O,4,2,0,2,4,9.499999999999999e-05
G5,C1OCC(C=1C(C)O)=O,2,1,0,1,4,4.7e-05
G5,C1(COC(C(C1)O)O)=CC=O,8,2,0,2,21,9.499999999999999e-05
G5,C(CC1COC(C(C=1)O)O)=O,4,1,0,1,27,4.7e-05
G5,C1(COC(C(C1C=C)O)O)=O,8,2,0,2,27,9.499999999999999e-05
G5,C(C)=C1C(COC(C1O)O)=O,8,2,0,2,11,9.499999999999999e-05
G5,C1C(OCC(C=1C(C)O)=O)O,4,1,0,1,27,4.7e-05
G5,C1(CC(C(OC1C=C)O)O)=O,8,2,0,2,4,9.499999999999999e-05
G5,C(C=CC(CO)=CC=O)=O,4,2,0,2,29,9.499999999999999e-05
G5,C=CC(C=CC=O)=O,2,3,0,3,29,0.00014199999999999998
G5,C=CC(CO)=CC=O,2,2,0,2,29,9.499999999999999e-05
G5,C(C(C)O)=CC=O,4,8,0,8,46,0.00037999999999999997
G5,C(C(CCC(C=O)=O)O)=CC=O,4,3,0,3,7,0.000143
G5,C(C(C)O)(CC(C=O)=O)=CC=O,4,2,0,2,29,9.499999999999999e-05
G5,C(CC(C(C)O)=CC(C=O)=O)=O,4,2,0,2,29,9.499999999999999e-05
G5,C(CC(C(C(C)=O)=CC=O)O)=O,4,1,0,1,45,4.7e-05
G5,C(C)(CC(C(CO)=CC=O)=O)=O,2,1,0,1,26,4.7e-05
G5,C(C)(CC(C(C(C=C)O)=O)=O)=O,2,1,0,1,26,4.7e-05
G5,C(CCC(C(CO)=CC=O)=O)=O,2,1,0,1,4,4.7e-05
G5,C(CCC(C(C=O)=CC=O)O)=O,4,2,0,2,27,9.499999999999999e-05
G5,C(CO)=CC(C(CO)=CC=O)=O,4,1,0,1,4,4.7e-05
G5,C=CC(C(C(C=CCO)=O)=O)O,4,1,0,1,55,4.7e-05
G5,C(C(C(C=O)=CC=O)O)=CCO,8,1,0,1,28,4.7e-05
G5,C(C(C(CO)=CC=O)O)=CC=O,8,1,0,1,32,4.7e-05
G5,C(C(C(C(C=C)O)=CC=O)O)=O,8,1,0,1,27,4.7e-05
G5,C(C)(C(C(C(C(C)O)=C)=O)O)=O,4,1,0,1,9,4.7e-05
G5,C(C(CC(C(C(C)O)=C)=O)O)=O,4,1,0,1,4,4.7e-05
G5,C1C(C(C(C=1)=CC=O)(CO)O)O,8,1,0,1,4,4.7e-05
G5,C1C(C(C=CC=O)(C(C=1)O)O)O,6,1,0,1,43,4.7e-05
G5,C(C(CO)(CO)O)=CC=O,2,2,0,2,29,9.499999999999999e-05
G5,C(C(CO)(C(C)O)O)=CC=O,8,1,0,1,4,4.7e-05
G5,C(C)(C(CO)(CO)O)=CC=O,2,1,0,1,29,4.7e-05
G5,C(CC(C(CO)(CO)O)=C)=O,1,1,0,1,29,4.7e-05
G5,C(C)(C(CO)(C(C)O)O)=CC=O,8,1,0,1,4,4.7e-05
G5,C(CC(C(CO)(C(C)O)O)=C)=O,4,1,0,1,4,4.7e-05
G5,C1(CC(C=CC=O)(C(C1)O)O)=O,8,1,0,1,26,4.7e-05
G5,C(CC(C=CC=O)(C(C)O)O)=O,8,1,0,1,4,4.7e-05
G5,C1(C(CC(C1CO)=CC=O)O)=O,8,1,0,1,30,4.7e-05
G5,C(CC1C(C(C(C=1)O)=O)CO)=O,4,2,0,2,29,9.499999999999999e-05
G5,C(CC1CC(C(C=1CO)=O)O)=O,2,1,0,1,30,4.7e-05
G5,C1(CC(C(C1CO)=CC=O)O)=O,8,1,0,1,30,4.7e-05
G5,C(CC1C(CC(C=1CO)=O)O)=O,2,1,0,1,30,4.7e-05
G5,C1(C(C=C)C(C(C1CO)=O)O)=O,8,1,0,1,2,4.7e-05
G5,C1(C(C(C(C1CO)=O)=CC)O)=O,8,1,0,1,2,4.7e-05
G5,C1(C=C(C(C1CO)=O)C(C)O)=O,4,2,0,2,29,9.499999999999999e-05
G5,C1(C(CO)CC(C1O)=CC=O)=O,8,1,0,1,47,4.7e-05
G5,C(CC1C(C(C(C=1)CO)=O)O)=O,4,1,0,1,47,4.7e-05
G5,C1(CC(C(C1O)=CC=O)CO)=O,8,1,0,1,47,4.7e-05
G5,C(CC1C(C(CC=1CO)=O)O)=O,2,1,0,1,47,4.7e-05
G5,C1(C(C=C)C(C(C1O)=O)CO)=O,8,1,0,1,4,4.7e-05
G5,C1(C(C(C(C1CO)=CC)=O)O)=O,8,1,0,1,4,4.7e-05
G5,C1(CCC(C1(CO)O)=CC=O)=O,4,1,0,1,21,4.7e-05
G5,C1(CC=C(CC=O)C1(CO)O)=O,2,1,0,1,21,4.7e-05
G5,C1(C(C=C)CC(C1(CO)O)=O)=O,4,1,0,1,2,4.7e-05
G5,C1(CC(C(C1(CO)O)=O)=CC)=O,4,1,0,1,2,4.7e-05
G5,C1(C(CO)(CC(C1)=CC=O)O)=O,4,1,0,1,2,4.7e-05
G5,C1(CC(CC=O)=CC1(CO)O)=O,2,2,0,2,29,9.499999999999999e-05
G5,C(CC1CC(C(C=1)=O)(CO)O)=O,2,1,0,1,2,4.7e-05
G5,C1(CC(C(C1)=CC=O)(CO)O)=O,4,1,0,1,4,4.7e-05
G5,C(CC1C(CO)(CC(C=1)=O)O)=O,2,1,0,1,4,4.7e-05
G5,C1(C(C=C)C(C(C1)=O)(CO)O)=O,4,1,0,1,4,4.7e-05
G5,C1(CC(C(C1(CO)O)=CC)=O)=O,4,1,0,1,4,4.7e-05
G5,C1(C(C(C)O)=C(C(C1)=O)CO)=O,2,2,0,2,29,9.499999999999999e-05
G5,C1(C(CO)(CC(C1C=C)=O)O)=O,4,1,0,1,4,4.7e-05
G5,C(C)=C1C(C(CO)(CC1=O)O)=O,4,1,0,1,4,4.7e-05
G5,C1(CC(C(C(C)=CC=O)O1)O)=O,8,1,0,1,48,4.7e-05
G5,C1(CC(C(C(CC=O)=C)O1)O)=O,4,1,0,1,48,4.7e-05
G5,C1(CC(C(C(CC=C)=O)O1)O)=O,4,1,0,1,4,4.7e-05
G5,C1(CC(C(C(C=CC)=O)O1)O)=O,8,1,0,1,4,4.7e-05
G5,C1(CC(C(CC=CC=O)O1)O)=O,8,1,0,1,48,4.7e-05
G5,C1(CC(C(C=CCC=O)O1)O)=O,8,1,0,1,48,4.7e-05
G5,C(C(C=C)C1C(CC(O1)=O)O)=O,8,1,0,1,48,4.7e-05
G5,C1(CC(C(C(C=O)=CC)O1)O)=O,8,1,0,1,48,4.7e-05
G5,C(C)(C1C(C(CO1)=CC=O)O)=O,8,1,0,1,17,4.7e-05
G5,C1(COC(C(C)=CC=O)C1O)=O,8,1,0,1,17,4.7e-05
G5,C(CC(C1C(C(CO1)=O)O)=C)=O,4,1,0,1,17,4.7e-05
G5,C1(C(C(C(C)=O)OC1C=C)O)=O,8,1,0,1,4,4.7e-05
G5,C(C1C(C(CO1)=O)O)(CC=C)=O,4,1,0,1,4,4.7e-05
G5,C1(COC(C(C=CC)=O)C1O)=O,8,1,0,1,4,4.7e-05
G5,C(CC1C(C(CO1)=CC=O)O)=O,8,1,0,1,4,4.7e-05
G5,C1(COC(C1O)CC=CC=O)=O,8,1,0,1,9,4.7e-05
G5,C(CC=CC1C(C(CO1)=O)O)=O,8,1,0,1,9,4.7e-05
G5,C(C(C=C)C1C(C(CO1)=O)O)=O,8,1,0,1,9,4.7e-05
G5,C1(COC(C(C=O)=CC)C1O)=O,8,1,0,1,9,4.7e-05
G5,C(C)(C1CC(C(O)O1)=CC=O)=O,8,2,0,2,22,9.499999999999999e-05
G5,C(CC1C(OC(C(C)=O)C=1)O)=O,4,1,0,1,22,4.7e-05
G5,C1(C(O)OC(C(C)=CC=O)C1)=O,8,2,0,2,22,9.499999999999999e-05
G5,C(CC(C1CC(C(O)O1)=O)=C)=O,4,2,0,2,22,9.499999999999999e-05
G5,C1(C(O)OC(C(C)=O)C1C=C)=O,8,2,0,2,22,9.499999999999999e-05
G5,C(C)(C1C(C(C(O1)O)=O)=CC)=O,8,2,0,2,22,9.499999999999999e-05
G5,C(C1CC(C(O)O1)=O)(CC=C)=O,4,2,0,2,22,9.499999999999999e-05
G5,C1(C(O)OC(C(C=CC)=O)C1)=O,8,2,0,2,22,9.499999999999999e-05
G5,C(CC1CC(C(O)O1)=CC=O)=O,8,2,0,2,13,9.499999999999999e-05
G5,C(CC1C(O)OC(C=1)CC=O)=O,4,1,0,1,13,4.7e-05
G5,C1(C(O)OC(C1)CC=CC=O)=O,8,2,0,2,13,9.499999999999999e-05
G5,C(CC=CC1CC(C(O)O1)=O)=O,8,2,0,2,13,9.499999999999999e-05
G5,C(CC1C(C(C(O)O1)=O)C=C)=O,8,2,0,2,4,9.499999999999999e-05
G5,C(CC1C(C(C(O)O1)=O)=CC)=O,8,2,0,2,4,9.499999999999999e-05
G5,C(C(C=C)C1CC(C(O)O1)=O)=O,8,2,0,2,23,9.499999999999999e-05
G5,C1(C(O)OC(C(C=O)=CC)C1)=O,8,2,0,2,23,9.499999999999999e-05
G5,C(C)(C1C(CC(O1)O)=CC=O)=O,8,2,0,2,9,9.499999999999999e-05
G5,C(CC1C(C(C)=O)OC(C=1)O)=O,4,1,0,1,9,4.7e-05
G5,C1(C(C(C)=O)OC(C1C=C)O)=O,8,2,0,2,29,9.499999999999999e-05
G5,C(C)(C1C(C(C(O1)O)=CC)=O)=O,8,2,0,2,9,9.499999999999999e-05
G5,C(C)(C1C(C(C(C)O)=CO1)=O)=O,4,1,0,1,9,4.7e-05
G5,C(C1C(CC(O1)O)=O)(CC=C)=O,4,2,0,2,9,9.499999999999999e-05
G5,C1(CC(OC1C(C=CC)=O)O)=O,8,2,0,2,9,9.499999999999999e-05
G5,C(CC1C(CC(O1)O)=CC=O)=O,8,2,0,2,13,9.499999999999999e-05
G5,C(CC1C(CC=O)OC(C=1)O)=O,4,1,0,1,13,4.7e-05
G5,C1(C(CC=CC=O)OC(C1)O)=O,8,2,0,2,13,9.499999999999999e-05
G5,C(CC=CC1C(CC(O1)O)=O)=O,8,2,0,2,13,9.499999999999999e-05
G5,C(CC1C(C(C=C)C(O1)O)=O)=O,8,2,0,2,4,9.499999999999999e-05
G5,C(CC1C(C(C(O)O1)=CC)=O)=O,8,2,0,2,4,9.499999999999999e-05
G5,C(CC1C(C(C(C)O)=CO1)=O)=O,4,1,0,1,4,4.7e-05
G5,C1(CC(OC1C(C=O)=CC)O)=O,8,2,0,2,4,9.499999999999999e-05
G5,C1(CC(CC(CO)O1)=CC=O)=O,4,1,0,1,19,4.7e-05
G5,C(CC1CC(CO)OC(C=1)=O)=O,2,1,0,1,19,4.7e-05
G5,C1(CC(CC=O)=CC(CO)O1)=O,2,2,0,2,29,9.499999999999999e-05
G5,C1(C(C(CC(CO)O1)=O)C=C)=O,4,1,0,1,19,4.7e-05
G5,C(C)=C1C(CC(CO)OC1=O)=O,4,1,0,1,19,4.7e-05
G5,C1(CC(OC(CO)C1C=C)=O)=O,4,1,0,1,19,4.7e-05
G5,C1(CC(C(C(CO)O1)=CC)=O)=O,4,1,0,1,19,4.7e-05
G5,C1(CCC(C(CO)O1)=CC=O)=O,4,1,0,1,4,4.7e-05
G5,C1(CC=C(C(CO)O1)CC=O)=O,2,1,0,1,4,4.7e-05
G5,C1(C(CO)OC(CC1C=C)=O)=O,4,1,0,1,46,4.7e-05
G5,C1(CC(C(C(CO)O1)=O)=CC)=O,4,1,0,1,46,4.7e-05
G5,C1(C(COC(CO)C1)=CC=O)=O,4,1,0,1,54,4.7e-05
G5,C(C=C1C(COC(CO)C1)=O)=O,4,1,0,1,54,4.7e-05
G5,C(CC1C(COC(C=1)CO)=O)=O,2,1,0,1,54,4.7e-05
G5,C=CC1C(C(CC(CO)O1)=O)=O,4,1,0,1,54,4.7e-05
G5,C=CC1C(C(COC1CO)=O)=O,4,1,0,1,54,4.7e-05
G5,C(C)=C1C(C(COC1CO)=O)=O,4,1,0,1,54,4.7e-05
G5,C1(C(CO)OCC(C1)=CC=O)=O,4,1,0,1,54,4.7e-05
G5,C(CC1COC(C(C=1)=O)CO)=O,2,1,0,1,54,4.7e-05
G5,C1(COC(C(C1)=CC=O)CO)=O,4,1,0,1,54,4.7e-05
G5,C(CC1C(CO)OCC(C=1)=O)=O,2,1,0,1,54,4.7e-05
G5,C1(C(C=C)OC(C(C1)=O)CO)=O,4,1,0,1,54,4.7e-05
G5,C1(C(CO)OCC(C1C=C)=O)=O,4,1,0,1,4,4.7e-05
G5,C(C)=C1C(C(CO)OCC1=O)=O,4,1,0,1,4,4.7e-05
G5,C1(CC(CC(CO1)O)=CC=O)=O,4,1,0,1,19,4.7e-05
G5,C(CC1CC(COC(C=1)=O)O)=O,2,1,0,1,19,4.7e-05
G5,C1(CC(CC=O)=CC(CO1)O)=O,2,2,0,2,29,9.499999999999999e-05
G5,C1(C(C(CC(CO1)O)=O)C=C)=O,4,1,0,1,19,4.7e-05
G5,C(C)=C1C(CC(COC1=O)O)=O,4,1,0,1,19,4.7e-05
G5,C1(CC(OCC(C1C=C)O)=O)=O,4,1,0,1,19,4.7e-05
G5,C1(CC(C(C(CO1)O)=CC)=O)=O,4,1,0,1,19,4.7e-05
G5,C1(CC(C(C(C)O)=CCO1)=O)=O,2,1,0,1,19,4.7e-05
G5,C1(CCC(C(CO1)O)=CC=O)=O,4,1,0,1,4,4.7e-05
G5,C1(CC=C(C(CO1)O)CC=O)=O,2,1,0,1,4,4.7e-05
G5,C1(C(COC(CC1C=C)=O)O)=O,4,1,0,1,46,4.7e-05
G5,C1(CC(C(C(CO1)O)=O)=CC)=O,4,1,0,1,46,4.7e-05
G5,C1(CC(C(CCO1)=CC=O)O)=O,4,1,0,1,19,4.7e-05
G5,C(CC1C(CC(OCC=1)=O)O)=O,2,1,0,1,19,4.7e-05
G5,C1(CC(C(C(C=C)CO1)=O)O)=O,4,1,0,1,19,4.7e-05
G5,C1(CC(C(C(CO1)=CC)=O)O)=O,4,1,0,1,19,4.7e-05
G5,C1(CC(CC(CO1)=CC=O)O)=O,4,1,0,1,48,4.7e-05
G5,C(CC1COC(CC(C=1)O)=O)=O,2,1,0,1,48,4.7e-05
G5,C1(CC(C(C(CO1)=O)C=C)O)=O,4,1,0,1,4,4.7e-05
G5,C1(CC(C(C(CO1)=O)=CC)O)=O,4,1,0,1,4,4.7e-05
G5,C1(CC=C(C(CO1)=O)C(C)O)=O,2,1,0,1,4,4.7e-05
G5,C1(CC(CC(C(C=C)O1)=O)O)=O,4,1,0,1,48,4.7e-05
G5,C1(C(COCC(C1)O)=CC=O)=O,4,1,0,1,4,4.7e-05
G5,C(C=C1C(COCC(C1)O)=O)=O,4,1,0,1,36,4.7e-05
G5,C(CC1C(COCC(C=1)O)=O)=O,2,1,0,1,36,4.7e-05
G5,C=CC1C(C(CC(CO1)O)=O)=O,4,1,0,1,36,4.7e-05
G5,C=CC1C(C(COCC1O)=O)=O,4,1,0,1,36,4.7e-05
G5,C(C)=C1C(C(COCC1O)=O)=O,4,1,0,1,36,4.7e-05
G5,C1COCC(C(C=1C(C)O)=O)=O,2,1,0,1,36,4.7e-05
G5,C1(C(COCC(C1)=CC=O)O)=O,4,1,0,1,36,4.7e-05
G5,C(CC1COCC(C(C=1)=O)O)=O,2,1,0,1,36,4.7e-05
G5,C1(COCC(C(C1)=CC=O)O)=O,4,1,0,1,36,4.7e-05
G5,C(CC1C(COCC(C=1)=O)O)=O,2,1,0,1,36,4.7e-05
G5,C1(C(C=C)OCC(C(C1)=O)O)=O,4,1,0,1,36,4.7e-05
G5,C1(C(COCC(C1C=C)=O)O)=O,4,1,0,1,36,4.7e-05
G5,C(C)=C1C(C(COCC1=O)O)=O,4,1,0,1,36,4.7e-05
G5,C1(CCOCC(C1O)=CC=O)=O,4,1,0,1,36,4.7e-05
G5,C1(COCCC(C1O)=CC=O)=O,4,1,0,1,36,4.7e-05
G5,C(CC1C(C(COCC=1)=O)O)=O,2,1,0,1,36,4.7e-05
G5,C1(C(C=C)OCCC(C1O)=O)=O,4,1,0,1,36,4.7e-05
G5,C1(C(C(COCC1C=C)=O)O)=O,4,1,0,1,36,4.7e-05
G5,C1(COCC(C(C1O)=O)=CC)=O,4,1,0,1,36,4.7e-05
G5,C1(COCC(C(C1)O)=CC=O)=O,4,1,0,1,36,4.7e-05
G5,C1(COCC(CC1O)=CC=O)=O,4,1,0,1,36,4.7e-05
G5,C(CC1COCC(C(C=1)O)=O)=O,2,1,0,1,36,4.7e-05
G5,C1(C(CC(COC1C=C)=O)O)=O,4,1,0,1,4,4.7e-05
G5,C1(COCC(C(C1C=C)O)=O)=O,4,1,0,1,4,4.7e-05
G5,C1(COCC(C(C1O)=CC)=O)=O,4,1,0,1,4,4.7e-05
G5,C1(C(C(C)O)=CC(COC1)=O)=O,2,2,0,2,29,9.499999999999999e-05
G5,C1(CC(C(COC1C=C)=O)O)=O,4,1,0,1,17,4.7e-05
G5,C1(CCOC(C(C1)=CC=O)O)=O,4,2,0,2,23,9.499999999999999e-05
G5,C(CC1C(O)OCCC(C=1)=O)=O,2,1,0,1,23,4.7e-05
G5,C1(C(O)OCCC(C1)=CC=O)=O,4,2,0,2,30,9.499999999999999e-05
G5,C(CC1CCOC(C(C=1)=O)O)=O,2,1,0,1,30,4.7e-05
G5,C(CC1CC(C(O)OCC=1)=O)=O,2,2,0,2,29,9.499999999999999e-05
G5,C1(CCOC(C(C1C=C)=O)O)=O,4,2,0,2,30,9.499999999999999e-05
G5,C(C)=C1C(CCOC(C1=O)O)=O,4,2,0,2,30,9.499999999999999e-05
G5,C1(CC(C(O)OCC1C=C)=O)=O,4,2,0,2,4,9.499999999999999e-05
G5,C1(C(O)OCC(C(C1)=O)=CC)=O,4,2,0,2,4,9.499999999999999e-05
G5,C1(COC(C(CC1)=CC=O)O)=O,4,2,0,2,29,9.499999999999999e-05
G5,C(CC1C(O)OCC(CC=1)=O)=O,2,1,0,1,29,4.7e-05
G5,C1(C(O)OCC(CC1)=CC=O)=O,4,2,0,2,29,9.499999999999999e-05
G5,C(CC1COC(C(CC=1)=O)O)=O,2,1,0,1,29,4.7e-05
G5,C1(C(O)OCC(CC1C=C)=O)=O,4,2,0,2,12,9.499999999999999e-05
G5,C1(COC(C(C(C1)=CC)=O)O)=O,4,2,0,2,12,9.499999999999999e-05
G5,C1(COC(C(CC1C=C)=O)O)=O,4,2,0,2,12,9.499999999999999e-05
G5,C1(C(O)OCC(C(C1)=CC)=O)=O,4,2,0,2,12,9.499999999999999e-05
G5,C1(CCC(C(OC1C=C)O)=O)=O,4,2,0,2,12,9.499999999999999e-05
G5,C(C=C1C(CCOC(C1)O)=O)=O,4,2,0,2,29,9.499999999999999e-05
G5,C(CC1C(CCOC(C=1)O)=O)=O,2,1,0,1,4,4.7e-05
G5,C(C=C1C(CC(O)OCC1)=O)=O,4,2,0,2,53,9.499999999999999e-05
G5,C(CC1C(CC(OCC=1)O)=O)=O,2,1,0,1,53,4.7e-05
G5,C=CC1C(C(CCOC1O)=O)=O,4,2,0,2,4,9.499999999999999e-05
G5,C(C)=C1C(C(CCOC1O)=O)=O,4,2,0,2,4,9.499999999999999e-05
G5,C1OCCC(C(C=1C(C)O)=O)=O,2,1,0,1,4,4.7e-05
G5,C=CC1C(C(CC(O)OC1)=O)=O,4,2,0,2,4,9.499999999999999e-05
G5,C(C)=C1C(C(CC(OC1)O)=O)=O,4,2,0,2,4,9.499999999999999e-05
G5,C1(COC(CC(C1)=CC=O)O)=O,4,3,0,3,32,0.00014199999999999998
G5,C(CC1CC(COC(C=1)O)=O)=O,2,2,0,2,29,9.499999999999999e-05
G5,C(CC1CC(OCC(C=1)=O)O)=O,2,1,0,1,32,4.7e-05
G5,C1(CC(OCC(C1)=CC=O)O)=O,4,2,0,2,26,9.499999999999999e-05
G5,C(CC1COC(CC(C=1)=O)O)=O,2,1,0,1,26,4.7e-05
G5,C1(CC(COC(C1C=C)O)=O)=O,4,2,0,2,4,9.499999999999999e-05
G5,C1(COC(C(C(C1)=O)=CC)O)=O,4,2,0,2,4,9.499999999999999e-05
G5,C1(COC=C(C(C1)=O)C(C)O)=O,2,1,0,1,4,4.7e-05
G5,C1(CC(OCC(C1C=C)=O)O)=O,4,2,0,2,38,9.499999999999999e-05
G5,C(C)=C1C(CC(OCC1=O)O)=O,4,2,0,2,38,9.499999999999999e-05
G5,C1(C(C=C)OC(CC(C1)=O)O)=O,4,2,0,2,38,9.499999999999999e-05
G5,C(C=C(C=CC(C=O)=O)C)=O,4,2,0,2,29,9.499999999999999e-05
G5,C(CC(C=CC(C=O)=O)=C)=O,2,2,0,2,29,9.499999999999999e-05
G5,C=CCC(C=CC(C=O)=O)=O,2,2,0,2,29,9.499999999999999e-05
G5,C(C)=CC(C=CC(C=O)=O)=O,4,2,0,2,29,9.499999999999999e-05
G5,C(CC=CC(C=O)=O)=CC=O,4,2,0,2,29,9.499999999999999e-05
G5,C(CC=CC=CC(C=O)=O)=O,4,2,0,2,29,9.499999999999999e-05
G5,C(C(C=C)C=CC(C=O)=O)=O,4,2,0,2,29,9.499999999999999e-05
G5,C(C)=C(C=O)C=CC(C=O)=O,4,2,0,2,29,9.499999999999999e-05
G5,C(C=CC(C(C)=CC=O)=O)=O,4,2,0,2,29,9.499999999999999e-05
G5,C(CC(C(C=CC=O)=O)=C)=O,2,2,0,2,29,9.499999999999999e-05
G5,C=CCC(C(C=CC=O)=O)=O,2,2,0,2,29,9.499999999999999e-05
G5,C(C)=CC(C(C=CC=O)=O)=O,4,2,0,2,29,9.499999999999999e-05
G5,C(C)=C(C=O)C(C=CC=O)=O,4,3,0,3,29,0.00014199999999999998
G5,C=CC(CC(C=O)=CC=O)=O,2,2,0,2,29,9.499999999999999e-05
G5,C(CC(C=O)=CC(C=C)=O)=O,2,3,0,3,29,0.00014199999999999998
G5,C(CC(C=C)=CC(C=O)=O)=O,2,2,0,2,29,9.499999999999999e-05
G5,C=CC(C(C(C=O)=O)=CC)=O,2,2,0,2,29,9.499999999999999e-05
G5,C(CC=CC(C(C=C)=O)=O)=O,2,2,0,2,29,9.499999999999999e-05
G5,C(CC(C(C=C)=O)=CC=O)=O,2,2,0,2,29,9.499999999999999e-05
G5,C=CC(C(C(C=O)=CC)=O)=O,2,2,0,2,29,9.499999999999999e-05
G5,C(CC(C=O)=CC=O)=CC=O,4,2,0,2,29,9.499999999999999e-05
G5,C(CC(C=O)=CC=CC=O)=O,4,2,0,2,29,9.499999999999999e-05
G5,C=CC(C=CC=O)C(C=O)=O,4,2,0,2,29,9.499999999999999e-05
G5,C(C)=C(C=CC=O)C(C=O)=O,4,2,0,2,29,9.499999999999999e-05
G5,C1(COCC1O)=CC=O,4,1,0,1,10,4.7e-05
G5,C1(C(O)OCC1)=CC=O,4,2,0,2,34,9.499999999999999e-05
G5,C(CC1C(O)OCC=1)=O,2,1,0,1,34,4.7e-05
G5,C1(C(O)OCC1C=C)=O,4,2,0,2,4,9.499999999999999e-05
G5,C(C)=C1C(C(O)OC1)=O,4,2,0,2,4,9.499999999999999e-05
G5,C1(C(CC=CC=O)OCC1O)=O,8,1,0,1,9,4.7e-05
G5,C(CC=CC1C(C(CO1)O)=O)=O,8,1,0,1,9,4.7e-05
G5,C(CC1C(C(CO1)O)=CC=O)=O,8,1,0,1,9,4.7e-05
G5,C1(C(COC1C(C=O)=CC)O)=O,8,1,0,1,9,4.7e-05
G5,C1(C(CC=CC=O)(O)OCC1)=O,4,2,0,2,53,9.499999999999999e-05
G5,C(CC=CC1(C(CCO1)=O)O)=O,4,2,0,2,53,9.499999999999999e-05
G5,C(CC1(C(CCO1)=CC=O)O)=O,4,2,0,2,53,9.499999999999999e-05
G5,C(CC1C(CC=O)(O)OCC=1)=O,2,1,0,1,53,4.7e-05
G5,C1(CCOC1(C(C=O)=CC)O)=O,4,2,0,2,4,9.499999999999999e-05
G5,C1(C(OCC1)=C(C=O)C(C)O)=O,4,1,0,1,4,4.7e-05
G5,C(CC1(C(C(C=C)CO1)=O)O)=O,4,2,0,2,4,9.499999999999999e-05
G5,C(CC1(C(C(CO1)=CC)=O)O)=O,4,2,0,2,4,9.499999999999999e-05
G5,C1(COC(C1)(CC=CC=O)O)=O,4,2,0,2,26,9.499999999999999e-05
G5,C(CC=CC1(CC(CO1)=O)O)=O,4,2,0,2,26,9.499999999999999e-05
G5,C(CC1(CC(CO1)=CC=O)O)=O,4,2,0,2,29,9.499999999999999e-05
G5,C(CC1COC(C=1)(CC=O)O)=O,2,1,0,1,26,4.7e-05
G5,C(C(C=C)C1(CC(CO1)=O)O)=O,4,2,0,2,4,9.499999999999999e-05
G5,C1(COC(C(C=O)=CC)(C1)O)=O,4,2,0,2,4,9.499999999999999e-05
G5,C1(COC(C1)=C(C=O)C(C)O)=O,4,1,0,1,4,4.7e-05
G5,C(CC1(C(C(CO1)=O)C=C)O)=O,4,2,0,2,4,9.499999999999999e-05
G5,C(CC1(C(C(CO1)=O)=CC)O)=O,4,2,0,2,4,9.499999999999999e-05
G5,C(CC1OCC(C=1C(C)O)=O)=O,2,1,0,1,4,4.7e-05
G5,C(CC1(CC(C(C=C)O1)=O)O)=O,4,2,0,2,7,9.499999999999999e-05
G5,C(C=CC(C1CC(CO1)O)=O)=O,8,1,0,1,39,4.7e-05
G5,C(C=C(C=O)C1CC(CO1)O)=O,8,1,0,1,4,4.7e-05
G5,C(C1CC(C(C=CC=O)O1)O)=O,16,1,0,1,40,4.7e-05
G5,C(C1C(CC(C=CC=O)O1)O)=O,16,1,0,1,40,4.7e-05
G5,C1(CC(C)(OC1C=CC=O)O)=O,8,2,0,2,29,9.499999999999999e-05
G5,C(C1C(CC(C)(O1)O)=CC=O)=O,8,2,0,2,29,9.499999999999999e-05
G5,C(CC1C(C=O)OC(C=1)(C)O)=O,4,1,0,1,4,4.7e-05
G5,C1(C(C=O)OC(C)(C1C=C)O)=O,8,2,0,2,26,9.499999999999999e-05
G5,C(C1C(C(C(C)(O1)O)=CC)=O)=O,8,2,0,2,29,9.499999999999999e-05
G5,C(C1C(C(C(C)O)=C(C)O1)=O)=O,4,1,0,1,26,4.7e-05
G5,C1(CC(C=CC=O)OC1(C)O)=O,8,2,0,2,21,9.499999999999999e-05
G5,C(C1CC(C(C)(O1)O)=CC=O)=O,8,2,0,2,21,9.499999999999999e-05
G5,C(CC1C(C)(OC(C=O)C=1)O)=O,4,1,0,1,21,4.7e-05
G5,C1(C(C)(OC(C=O)C1C=C)O)=O,8,2,0,2,14,9.499999999999999e-05
G5,C(C1C(C(C(C)(O1)O)=O)=CC)=O,8,2,0,2,14,9.499999999999999e-05
G5,C1(C(C(C=CC=O)OC1C)O)=O,16,1,0,1,29,4.7e-05
G5,C(C1C(C(C(C)O1)=CC=O)O)=O,16,1,0,1,29,4.7e-05
G5,C1(CC(C=CC=O)(O)OCC1)=O,4,2,0,2,30,9.499999999999999e-05
G5,C(C1(CC(CCO1)=CC=O)O)=O,4,2,0,2,30,9.499999999999999e-05
G5,C(CC1CCOC(C=O)(C=1)O)=O,2,1,0,1,30,4.7e-05
G5,C(CC1CC(C=O)(O)OCC=1)=O,2,2,0,2,29,9.499999999999999e-05
G5,C1(CCOC(C=O)(C1C=C)O)=O,4,2,0,2,30,9.499999999999999e-05
G5,C(C1(C(C(CCO1)=O)=CC)O)=O,4,2,0,2,29,9.499999999999999e-05
G5,C1(C(C(C)O)=C(C=O)OCC1)=O,2,1,0,1,30,4.7e-05
G5,C1(CC(C=O)(O)OCC1C=C)=O,4,2,0,2,4,9.499999999999999e-05
G5,C(C1(CC(C(CO1)=CC)=O)O)=O,4,2,0,2,4,9.499999999999999e-05
G5,C1(COC(C=CC=O)(CC1)O)=O,4,2,0,2,7,9.499999999999999e-05
G5,C(C1(CCC(CO1)=CC=O)O)=O,4,2,0,2,29,9.499999999999999e-05
G5,C(CC1COC(C=O)(CC=1)O)=O,2,1,0,1,29,4.7e-05
G5,C(C1(CC(C(CO1)=O)C=C)O)=O,4,2,0,2,12,9.499999999999999e-05
G5,C(C1(CC(C(CO1)=O)=CC)O)=O,4,2,0,2,12,9.499999999999999e-05
G5,C1(CCC(C=O)(OC1C=C)O)=O,4,2,0,2,12,9.499999999999999e-05
G5,C(C1C(CCC(O1)O)=CC=O)=O,8,2,0,2,29,9.499999999999999e-05
G5,C(CC1C(C=O)OC(CC=1)O)=O,4,1,0,1,29,4.7e-05
G5,C(C1C(C(CC(O1)O)=CC)=O)=O,8,2,0,2,4,9.499999999999999e-05
G5,C(C1CC(CC(O1)O)=CC=O)=O,8,2,0,2,4,9.499999999999999e-05
G5,C(CC1CC(OC(C=O)C=1)O)=O,4,2,0,2,29,9.499999999999999e-05
G5,C(CC1CC(C=O)OC(C=1)O)=O,4,1,0,1,4,4.7e-05
G5,C1(CC(OC(C=O)C1C=C)O)=O,8,2,0,2,37,9.499999999999999e-05
G5,C(C1C(C(CC(O1)O)=O)=CC)=O,8,2,0,2,37,9.499999999999999e-05
G5,C1(CC(C=O)OC(C1C=C)O)=O,8,2,0,2,37,9.499999999999999e-05
G5,C(C1CC(C(C(O)O1)=CC)=O)=O,8,2,0,2,37,9.499999999999999e-05
G5,C(C1CC(C(C(C)O)=CO1)=O)=O,4,1,0,1,37,4.7e-05
G5,C1C(C(C(C=1CO)=CC=O)O)O,8,1,0,1,2,4.7e-05
G5,C=C1C(C(C(C1O)O)O)=CC=O,16,1,0,1,47,4.7e-05
G5,C1C(C(C(C=1C=CC=O)O)O)O,16,1,0,1,29,4.7e-05
G5,C=CC(C(C(C=CC=O)O)O)O,16,2,0,2,29,9.499999999999999e-05
G5,C1C(C=CC=O)(C(C(C=1)O)O)O,16,1,0,1,29,4.7e-05
G5,C1OC(C(C=1)=CC=O)C(CO)O,8,1,0,1,9,4.7e-05
G5,C1C(CO)OC(C(C=1)=CC=O)O,8,1,0,1,46,4.7e-05
G5,C1OC(CO)C(C(C=1)=CC=O)O,8,1,0,1,9,4.7e-05
G5,C1C(OC(C(C=1)=CC=O)CO)O,8,1,0,1,2,4.7e-05
G5,C1C(COC(C(C=1)=CC=O)O)O,8,1,0,1,41,4.7e-05
G5,C1OCC(C(C(C=1)=CC=O)O)O,8,1,0,1,38,4.7e-05
G5,C1COC(C(C(C=1)=CC=O)O)O,8,1,0,1,19,4.7e-05
G5,C1C(O)OCC(C(C=1)=CC=O)O,8,1,0,1,38,4.7e-05
G5,C1C(C(OCC(C=1)=CC=O)O)O,8,1,0,1,29,4.7e-05
G5,C=CC1C(C=CC(C(O1)O)O)=O,8,1,0,1,4,4.7e-05
G5,C1C(C(CO)OC=1C=CC=O)O,8,1,0,1,29,4.7e-05
G5,C1C(C=CC=O)(OC(C=1)CO)O,8,1,0,1,41,4.7e-05
G5,C1(C(C(CO1)O)O)=CC=CC=O,16,1,0,1,29,4.7e-05
G5,C1(C(C=CC=O)O)OCC(C=1)O,8,1,0,1,36,4.7e-05
G5,C1C(C(C=CC=O)O)(O)OCC=1,8,1,0,1,39,4.7e-05
G5,C1C(C=CC=O)OC(C=1)(CO)O,8,1,0,1,40,4.7e-05
G5,C1(CO)OC(C=CC=O)C(C=1)O,8,1,0,1,40,4.7e-05
G5,C1(C(C(C(C=CC=O)O1)O)O)=C,16,1,0,1,26,4.7e-05
G5,C1C(C(C=CC=O)O)OC(C=1)O,16,2,0,2,29,9.499999999999999e-05
G5,C1OC(C(C=1)O)C(C=CC=O)O,16,2,0,2,29,9.499999999999999e-05
G5,C1C(C(COC=1C=CC=O)O)O,8,1,0,1,30,4.7e-05
G5,C1C(C=CC=O)(O)OCC(C=1)O,8,1,0,1,30,4.7e-05
G5,C1C(C(C=CC=O)OC(C=1)O)O,16,2,0,2,29,9.499999999999999e-05
G5,C1C(C(C(C=CC=O)OC=1)O)O,16,2,0,2,29,9.499999999999999e-05
G5,C(CO)(C(CO)O)=C(C=O)C=O,2,1,0,1,45,4.7e-05
G5,C=C(C(O)=O)C(CC(C=O)=O)=O,1,2,0,2,29,9.499999999999999e-05
G5,C(C(C(C(O)=O)=CC(C)=O)=O)=O,2,2,0,2,29,9.499999999999999e-05
G5,C(CC=C(C(O)=O)C(C=O)=O)=O,2,2,0,2,29,9.499999999999999e-05
G5,C(CC(C=O)=O)=C(C=O)C(O)=O,2,2,0,2,29,9.499999999999999e-05
G5,C(CC(C(C(C(O)=O)=C)=O)=O)=O,1,2,0,2,29,9.499999999999999e-05
G5,C(CC(C=C(C=O)C(O)=O)=O)=O,2,2,0,2,29,9.499999999999999e-05
G5,C(C=C(C(O)=O)C(C(C)=O)=O)=O,2,2,0,2,29,9.499999999999999e-05
G5,C(CC(C(C(O)=O)=CC=O)=O)=O,2,2,0,2,29,9.499999999999999e-05
G5,C1C(C(CC=1C(O)=O)O)O,4,1,0,1,29,4.7e-05
G5,C(C(CO)(CO)O)=CC(O)=O,2,1,0,1,29,4.7e-05
G5,C(C(C=CC(O)=O)(C)O)=O,4,1,0,1,29,4.7e-05
G5,C(C(C(C=CC(O)=O)(C)O)O)=O,8,1,0,1,26,4.7e-05
G5,C(C(C)(C(CO)O)O)=CC(O)=O,8,1,0,1,29,4.7e-05
G5,C(C(C=CC(O)=O)(CCO)O)=O,4,1,0,1,29,4.7e-05
G5,C(C(C(CO)=CC(O)=O)(C)O)=O,4,2,0,2,29,9.499999999999999e-05
G5,C(C(CO)(CCO)O)=CC(O)=O,4,1,0,1,29,4.7e-05
G5,C(C(CO)(C)O)=CC(O)=O,4,1,0,1,29,4.7e-05
G5,C(CC(C(C=CC(O)=O)O)O)=O,8,1,0,1,29,4.7e-05
G5,C(C(CC(C=CC(O)=O)O)O)=O,8,1,0,1,20,4.7e-05
G5,C(C(C)O)=CC(O)=O,4,1,0,1,27,4.7e-05
G5,C(CC(C(CO)=CC(O)=O)O)=O,4,1,0,1,33,4.7e-05
G5,C(C(C(CO)CO)=CC=O)(O)=O,2,1,0,1,29,4.7e-05
G5,C(CC(C(O)=O)=C(CO)CO)=O,1,1,0,1,29,4.7e-05
G5,C(C(C(CO)=C(C(O)=O)C)O)=O,4,1,0,1,29,4.7e-05
G5,C(C(C(C(C(O)=O)=C)CO)O)=O,4,1,0,1,29,4.7e-05
G5,C(C(C=C(C(O)=O)CCO)O)=O,4,1,0,1,29,4.7e-05
G5,C(C(CC(C(O)=O)=CCO)O)=O,4,1,0,1,29,4.7e-05
G5,C(CO)(C(CO)(C)O)=CC(O)=O,4,1,0,1,29,4.7e-05
G5,C(CO)(C(C)O)=CC(O)=O,4,1,0,1,29,4.7e-05
G5,C=C(C(O)=O)CO,1,1,0,1,25,4.7e-05
G5,C=C(C(O)=O)C,1,1,0,1,14,4.7e-05
G5,C(CO)=C(C(O)=O)C(CO)O,4,2,0,2,29,0.000106
G5,C(CC(C(C(O)=O)=C)O)=O,2,1,0,1,25,4.7e-05
G5,C=C(C(O)=O)C(C(CO)O)O,4,1,0,1,29,4.7e-05
G5,C1C(CO)OCC=1C(O)=O,2,1,0,1,54,4.7e-05
G5,C1C(COCC=1C(O)=O)O,2,1,0,1,29,4.7e-05
G5,C1C(O)OCCC=1C(O)=O,2,1,0,1,7,4.7e-05
G5,C1COC(CC=1C(O)=O)O,2,1,0,1,7,4.7e-05
G5,C=C(C(O)=O)C=CC=O,2,2,0,2,29,9.499999999999999e-05
G5,C=CC(C=CC(O)=O)=O,2,2,0,2,29,9.499999999999999e-05
G5,C=CC(C(O)=O)=CC=O,2,2,0,2,29,9.499999999999999e-05
G5,C(C=CC=CC(O)=O)=O,4,2,0,2,29,9.499999999999999e-05
G5,C(C1(C(C=CC1)=O)O)=O,2,2,0,2,29,9.499999999999999e-05
G5,C(C(C(C=CC=O)=O)(C)O)=O,4,1,0,1,9,4.7e-05
G5,C(C(C=CC(C=O)=O)(C)O)=O,4,2,0,2,29,9.499999999999999e-05
G5,C(C(C=CC(CO)=O)(C)O)=O,4,2,0,2,29,9.499999999999999e-05
G5,C(C)(C(C(C=CCO)=O)O)=O,4,2,0,2,29,9.499999999999999e-05
G5,C(C(C(C=CCO)=O)(C)O)=O,4,1,0,1,45,4.7e-05
G5,C(C(C=CC=O)(C)O)=O,4,2,0,2,29,9.499999999999999e-05
G5,C(C(C(C=C)=O)(C)O)=O,2,1,0,1,49,4.7e-05
G5,C(C=CC(C(CO)(C)O)=O)=O,4,1,0,1,49,4.7e-05
G5,C(C(CO)(C)O)=CC(C=O)=O,4,1,0,1,49,4.7e-05
G5,C(C(C(C(C=C)=O)(C)O)O)=O,4,1,0,1,49,4.7e-05
G5,C(C(CO)(C)O)=CC(CO)=O,4,1,0,1,49,4.7e-05
G5,C(C(C)(C(CO)O)O)=CC=O,8,1,0,1,52,4.7e-05
G5,C=CC(C(C)(C(CO)O)O)=O,4,1,0,1,49,4.7e-05
G5,C1(CO)C(C(CO)O)OC(C=1)=O,4,1,0,1,41,4.7e-05
G5,C1(CO)C(C(CO)OC(C=1)=O)O,4,1,0,1,41,4.7e-05
G5,C1(C(OC(C(C=1)=O)CO)O)CO,4,2,0,2,29,9.499999999999999e-05
G5,C1(CO)C(CO)OC(C(C=1)=O)O,4,2,0,2,29,9.499999999999999e-05
G5,C1(CO)C(C(COC(C=1)=O)O)O,4,1,0,1,41,4.7e-05
G5,C1(C(O)OCC(C(C=1)=O)O)CO,4,2,0,2,29,9.499999999999999e-05
G5,C1(CO)C(COC(C(C=1)=O)O)O,4,2,0,2,29,9.499999999999999e-05
G5,C1(CO)C(C(OCC(C=1)=O)O)O,4,1,0,1,2,4.7e-05
G5,C1(COC(C(C(C=1)=O)O)O)CO,4,2,0,2,29,9.499999999999999e-05
G5,C(CO)(CC(C=CCO)=O)=O,2,2,0,2,29,9.499999999999999e-05
G5,C(C(C=CC=O)(CCO)O)=O,4,2,0,2,29,9.499999999999999e-05
G5,C(C(C(C=C)=O)(CCO)O)=O,2,1,0,1,29,4.7e-05
G5,C(CO)=CC(C(CO)(C)O)=O,4,1,0,1,3,4.7e-05
G5,C=CC(C(CO)(CCO)O)=O,2,1,0,1,3,4.7e-05
G5,C(C(CO)(C)O)=CC=O,4,1,0,1,49,4.7e-05
G5,C=CC(C(CO)(C)O)=O,2,1,0,1,49,4.7e-05
G5,C(CC(C=O)=O)=CC(C(C)O)=O,4,1,0,1,12,4.7e-05
G5,C(C(CO)OC(C=C)=O)=O,2,2,0,2,2,9.499999999999999e-05
G5,C(OC(C(C=C)=O)CO)=O,2,1,0,1,2,4.7e-05
G5,C(OC(C=CC=O)CO)=O,4,1,0,1,2,4.7e-05
G5,C(C(COC(C=C)=O)O)=O,2,2,0,2,41,9.499999999999999e-05
G5,C(OCC(C(C=C)=O)O)=O,2,1,0,1,2,4.7e-05
G5,C(OCC(C=CC=O)O)=O,4,1,0,1,19,4.7e-05
G5,C(COC(C(C=C)=O)O)=O,2,2,0,2,12,9.499999999999999e-05
G5,C(C(C(C)=O)(C(C=C)=O)O)=O,2,2,0,2,29,9.499999999999999e-05
G5,C(C(C=O)(C(C=C)=O)O)=O,1,2,0,2,29,9.499999999999999e-05
G5,C(C(C=O)(C(C=CCO)=O)O)=O,2,1,0,1,3,4.7e-05
G5,C(C(C(C=C)=O)(CC=O)O)=O,2,2,0,2,29,9.499999999999999e-05
G5,C(CC(C=CC(C=O)=O)CO)=O,4,1,0,1,55,4.7e-05
G5,C(C(C(C=CCCC=O)=O)O)=O,4,1,0,1,27,4.7e-05
G5,C(C(C=C)(C)O)=O,2,2,0,2,29,9.499999999999999e-05
G5,C(C(C(C=C)(C)O)O)=O,4,1,0,1,28,4.7e-05
G5,C=CC(C)(C(CO)O)O,4,1,0,1,29,4.7e-05
G5,C(C(C(C(C=C)(C)O)O)O)=O,8,1,0,1,29,4.7e-05
G5,C=CC(CO)(C)O,2,1,0,1,18,4.7e-05
G5,C(C(CC(C=C)O)O)=O,4,1,0,1,29,4.7e-05
G5,C=CC(C)O,2,1,0,1,28,4.7e-05
G5,C(C(C=C)(CCC(CO)=O)O)=O,2,3,0,3,7,0.000143
G5,C(C(CO)(CCC(C=O)=O)O)=C,2,1,0,1,29,4.7e-05
G5,C(C(C=C)(CC(C(C)=O)O)O)=O,4,1,0,1,29,4.7e-05
G5,C(C(C)(C(CC(C=O)=O)O)O)=C,4,1,0,1,29,4.7e-05
G5,C=CC(CC(CC(C=O)=O)O)O,4,1,0,1,29,4.7e-05
G5,C=C(C(CC(C=O)=O)O)C(C)O,4,1,0,1,29,4.7e-05
G5,C(CC(C(C(C=C)(C)O)O)=O)=O,4,1,0,1,28,4.7e-05
G5,C(CC(C(CC(C=C)O)O)=O)=O,4,1,0,1,29,4.7e-05
G5,C(CC(C(C(C(C)O)=C)O)=O)=O,4,1,0,1,29,4.7e-05
G5,C(C(C(CC(C=C)(C)O)=O)O)=O,4,1,0,1,29,4.7e-05
G5,C(CCC(C=C)(C(C=O)O)O)=O,4,2,0,2,29,9.499999999999999e-05
G5,C(CCC(C=C)O)(C(C=O)O)=O,4,1,0,1,29,4.7e-05
G5,C(C(C=O)O)(CC(C(C)O)=C)=O,4,1,0,1,46,4.7e-05
G5,C(C(CC(C(C)=O)(C=C)O)O)=O,4,1,0,1,29,4.7e-05
G5,C(CC(C=O)O)(C(C=C)(C)O)=O,4,1,0,1,29,4.7e-05
G5,C(C(C=C)(C=CC(CO)O)O)=O,8,1,0,1,29,4.7e-05
G5,C(C(C(C=C)(C=CCO)O)O)=O,8,1,0,1,0,4.7e-05
G5,C=CC(C=CC(C(CO)O)=O)O,8,1,0,1,2,4.7e-05
G5,C=CC(C=CC=O)(C(CO)O)O,8,1,0,1,29,4.7e-05
G5,C(C(C(C(C=C)(C=C)O)O)O)=O,4,1,0,1,0,4.7e-05
G5,C=CC(C(C=CC(CO)=O)O)O,8,1,0,1,29,4.7e-05
G5,C(C(C=CC(C=C)(CO)O)O)=O,8,1,0,1,29,4.7e-05
G5,C(C(C(C=CC(C=C)O)O)O)=O,16,1,0,1,29,4.7e-05
G5,C(COC(C=C)(CO)O)=O,2,1,0,1,29,4.7e-05
G5,C=CC=CC(C=O)=O,2,2,0,2,29,9.499999999999999e-05
G5,C1(C(C(C(C=C)O1)O)O)=O,8,2,0,2,29,9.499999999999999e-05
G5,C(C(C(CO)O)CC(C=O)=O)=C,4,2,0,2,29,9.499999999999999e-05
G5,C(C(C(C(CCC=C)=O)O)O)=O,4,2,0,2,29,9.499999999999999e-05
G5,C(C(C(C=C)CC(CO)=O)O)=O,4,2,0,2,29,9.499999999999999e-05
G5,C(C(C(C(C=C)CC=O)O)O)=O,8,2,0,2,29,9.499999999999999e-05
G5,C(C1(C(CC(CO)=C1)=O)O)=O,2,1,0,1,55,4.7e-05
G5,C(C1(C=CC(C)(C1O)O)O)=O,8,1,0,1,16,4.7e-05
G5,C1(CC(C=CC1(C(C)=O)O)O)=O,4,1,0,1,9,4.7e-05
G5,C(C1(C(CC(C=C1)(C)O)=O)O)=O,4,1,0,1,6,4.7e-05
G5,C1(CCC(C=CC1(C=O)O)O)=O,4,1,0,1,44,4.7e-05
G5,C(C1(C(CC(C(C)O)=C1)=O)O)=O,4,1,0,1,46,4.7e-05
G5,C(C1(C=C)C(C(C(C1)=O)O)O)=O,8,1,0,1,46,4.7e-05
G5,C1C(C(C=CC(C=1)O)=O)(CO)O,4,1,0,1,21,4.7e-05
G5,C1C(C(C=C)=O)(C(C(C=1)O)O)O,8,1,0,1,7,4.7e-05
G5,C(C1(C=CC(C=C)(C1O)O)O)=O,8,1,0,1,7,4.7e-05
G5,C(C1(C=CC(C=CC1O)O)O)=O,8,1,0,1,43,4.7e-05
G5,C(C1(C(COC1O)=C)O)=O,4,2,0,2,35,9.499999999999999e-05
G5,C(C1(C(C(O)OC1)=C)O)=O,4,2,0,2,41,9.499999999999999e-05
G5,C1(C2C=CC1(CO2)O)=O,4,1,0,1,9,4.7e-05
G5,C1(C2(C=CC(C2O)O1)O)=O,8,2,0,2,29,9.499999999999999e-05
G5,C(C1(C(CC(C=C1)CO)=O)O)=O,4,1,0,1,55,4.7e-05
G5,C(C1C=CC(C(C1)=O)(CO)O)=O,4,1,0,1,43,4.7e-05
G5,C1(C(C=CC1(CO)O)CC=O)=O,4,1,0,1,46,4.7e-05
G5,C(C1(C=CCCC(C1O)=O)O)=O,4,1,0,1,7,4.7e-05
G5,C(C(C1(C(CCC=C1)=O)O)O)=O,4,1,0,1,7,4.7e-05
G5,C(C)(C(C=CCO)(C(C)O)O)=O,8,1,0,1,4,4.7e-05
G5,C(C(C=CCO)(C(C)O)O)=O,8,1,0,1,18,4.7e-05
G5,C(C(C(CO)=O)(C=CCO)O)=O,4,1,0,1,5,4.7e-05
G5,C(C(C(C)=O)(C=CCO)O)(O)=O,4,1,0,1,0,4.7e-05
G5,C(C(C=CCO)C(C=O)O)(O)=O,8,1,0,1,29,4.7e-05
G5,C(C(C(C(O)=O)=CCCO)O)=O,4,1,0,1,29,4.7e-05
G5,C(C(C(CCO)O)=CC=O)(O)=O,4,2,0,2,29,9.499999999999999e-05
G5,C1(C(C=CCO)(C(CO1)O)O)=O,8,1,0,1,40,4.7e-05
G5,C1(C(C=CCO)C(CO1)O)=O,8,1,0,1,8,4.7e-05
G5,C(CCO)=C1C(OCC1O)=O,4,1,0,1,8,4.7e-05
G5,C1COC(C=1C(CCO)O)=O,2,1,0,1,8,4.7e-05
G5,C(C(C=CCO)(C(C)O)O)(O)=O,8,1,0,1,4,4.7e-05
G5,C1(COCC1(C=CCO)O)=O,4,1,0,1,10,4.7e-05
G5,C(C(C=CC(C)O)(C(C)O)O)=O,16,1,0,1,28,4.7e-05
G5,C(C(C=O)(C=CC(C)O)O)(O)=O,8,1,0,1,17,4.7e-05
G5,C1(C(C=CC(C)O)C(CO1)O)=O,16,1,0,1,8,4.7e-05
G5,C(CC(C)O)=C1C(OCC1O)=O,8,1,0,1,8,4.7e-05
G5,C1COC(C=1C(CC(C)O)O)=O,4,1,0,1,8,4.7e-05
G5,C(C(C=CC(C)O)(CO)O)(O)=O,8,1,0,1,33,4.7e-05
G5,C1(COCC1(C=CC(C)O)O)=O,8,1,0,1,10,4.7e-05
G5,C(C(C(C(O)=O)=C)(C(C)O)O)=O,4,1,0,1,28,4.7e-05
G5,C(C(C(C(C)=O)=C)(C(C)O)O)=O,4,1,0,1,14,4.7e-05
G5,C(C(C=CC(C)=O)(C(C)O)O)=O,8,1,0,1,6,4.7e-05
G5,C1(C(C(CO1)O)=C(C=O)CO)=O,4,1,0,1,8,4.7e-05
G5,C(C(C1C(OCC=1)=O)(CO)O)=O,2,1,0,1,8,4.7e-05
G5,C1(C(C(CO1)O)=CC(CO)=O)=O,4,1,0,1,8,4.7e-05
G5,C(CO)(C(C1C(OCC=1)=O)O)=O,2,1,0,1,8,4.7e-05
G5,C(C(C(CO)=O)(C=CC=O)O)=O,4,1,0,1,5,4.7e-05
G5,C(C(C=CC=O)C(C=O)O)(O)=O,8,1,0,1,43,4.7e-05
G5,C(CC=C(C(O)=O)C(C=O)O)=O,4,1,0,1,43,4.7e-05
G5,C(CC(C(C(O)=O)=CC=O)O)=O,4,2,0,2,29,9.499999999999999e-05
G5,C1(C(C=CC=O)(C(CO1)O)O)=O,8,1,0,1,40,4.7e-05
G5,C1(C(C=CC=O)C(CO1)O)=O,8,1,0,1,8,4.7e-05
G5,C(CC=C1C(OCC1O)=O)=O,4,1,0,1,8,4.7e-05
G5,C(CC(C1C(OCC=1)=O)O)=O,2,1,0,1,8,4.7e-05
G5,C(C(C=CC=O)(CO)O)(O)=O,4,1,0,1,17,4.7e-05
G5,C(C(C=CC=O)(C(C)O)O)(O)=O,8,1,0,1,4,4.7e-05
G5,C1(COCC1(C=CC=O)O)=O,4,1,0,1,10,4.7e-05
G5,C(C(C=O)(C(C(O)=O)=C)O)(O)=O,2,1,0,1,17,4.7e-05
G5,C1(C(C(C(O)=O)=C)C(CO1)O)=O,4,1,0,1,8,4.7e-05
G5,C1(C(C(CO1)O)=C(C(O)=O)C)=O,4,1,0,1,8,4.7e-05
G5,C(C(C1C(OCC=1)=O)(C)O)(O)=O,2,1,0,1,8,4.7e-05
G5,C(C(C(C(O)=O)=C)(CO)O)(O)=O,2,1,0,1,28,4.7e-05
G5,C1(COCC1(C(C(O)=O)=C)O)=O,2,1,0,1,10,4.7e-05
G5,C(C=C(C(O)=O)C(O)=O)=O,1,2,0,2,29,9.499999999999999e-05
G5,C1COC(C=1C(O)=O)=O,1,1,0,1,17,4.7e-05
G5,C(C)(C1C=C(C(O)=O)C(O1)=O)=O,2,1,0,1,48,4.7e-05
G5,C(CC1C=C(C(O1)=O)C(O)=O)=O,2,1,0,1,17,4.7e-05
G5,C1(C(C(O)=O)=CC(CCO1)=O)=O,1,1,0,1,19,4.7e-05
G5,C1(COC(C(C(O)=O)=CC1)=O)=O,1,1,0,1,48,4.7e-05
G5,C1(C(C(O)=O)C=CC(CO1)=O)=O,2,1,0,1,48,4.7e-05
G5,C(C(C(C(O)=O)=CC(O)=O)O)=O,4,1,0,1,33,4.7e-05
G5,C(C(C(C(O)=O)=CC=O)O)(O)=O,4,2,0,2,29,9.499999999999999e-05
G5,C1(C(C(CO1)O)=CC(O)=O)=O,4,1,0,1,29,4.7e-05
G5,C(C(C1C(OCC=1)=O)O)(O)=O,2,1,0,1,29,4.7e-05
G5,C(C(C=O)(C(C(C)=O)=C)O)(O)=O,2,1,0,1,17,4.7e-05
G5,C(C(C=O)(C=CC(C)=O)O)(O)=O,4,1,0,1,17,4.7e-05
G5,C(C(C(C(C)O)O)=CC=O)(O)=O,8,2,0,2,29,9.499999999999999e-05
G5,C(C(C(C(O)=O)=CC(C)O)O)=O,8,1,0,1,11,4.7e-05
G5,C1(C(C(C(C)=O)=C)C(CO1)O)=O,4,1,0,1,8,4.7e-05
G5,C1(C(C(CO1)O)=C(C(C)=O)C)=O,4,1,0,1,8,4.7e-05
G5,C(C)(C(C1C(OCC=1)=O)(C)O)=O,2,1,0,1,8,4.7e-05
G5,C(C(C(C(C)=O)=C)(CO)O)(O)=O,2,1,0,1,14,4.7e-05
G5,C1(COCC1(C(C(C)=O)=C)O)=O,2,1,0,1,10,4.7e-05
G5,C1(C(C(CC=O)=C)C(CO1)O)=O,4,1,0,1,8,4.7e-05
G5,C1(C(C(C)=CC=O)C(CO1)O)=O,8,1,0,1,8,4.7e-05
G5,C(CC(C)=C1C(OCC1O)=O)=O,4,1,0,1,8,4.7e-05
G5,C(CC(C1C(OCC=1)=O)(C)O)=O,2,1,0,1,8,4.7e-05
G5,C1(C(C=CC(C)=O)C(CO1)O)=O,8,1,0,1,8,4.7e-05
G5,C(C)(CC=C1C(OCC1O)=O)=O,4,1,0,1,8,4.7e-05
G5,C(C)(CC(C1C(OCC=1)=O)O)=O,2,1,0,1,8,4.7e-05
G5,C(C(C(CC=O)=C)(CO)O)(O)=O,2,1,0,1,33,4.7e-05
G5,C(C(C(C)=CC=O)(CO)O)(O)=O,4,1,0,1,33,4.7e-05
G5,C(CC(C1(C(COC1)=O)O)=C)=O,2,1,0,1,10,4.7e-05
G5,C1(COCC1(C(C)=CC=O)O)=O,4,1,0,1,10,4.7e-05
G5,C1(COCC1(C=CC(C)=O)O)=O,4,1,0,1,10,4.7e-05
G5,C=CC(C=C1C(OCC1O)=O)=O,4,1,0,1,8,4.7e-05
G5,C=CC(C(C1C(OCC=1)=O)O)=O,2,1,0,1,8,4.7e-05
G5,C=CC(C=O)=C1C(OCC1O)=O,4,1,0,1,8,4.7e-05
G5,C(C(C=C)(C1C(OCC=1)=O)O)=O,2,1,0,1,8,4.7e-05
G5,C=CC(CO)=C1C(OCC1O)=O,4,1,0,1,8,4.7e-05
G5,C=CC(C1C(OCC=1)=O)(CO)O,2,1,0,1,8,4.7e-05
G5,C(C=CC=C1C(OCC1O)=O)=O,8,1,0,1,8,4.7e-05
G5,C(C(C1C(OCC=1)=O)O)=CC=O,4,1,0,1,8,4.7e-05
G5,C1COC(C=1C(C(C)O)O)=O,4,1,0,1,8,4.7e-05
G5,C(C(C)O)=C1C(OCC1O)=O,8,1,0,1,8,4.7e-05
G5,C(CO)=C1C(OCC1O)=O,4,1,0,1,0,4.7e-05
G5,C1COC(C=1C(CO)O)=O,2,1,0,1,0,4.7e-05
G5,C(C(C=CCO)(C(CO)O)O)=O,8,1,0,1,0,4.7e-05
G5,C(CO)(CO)=C1C(OCC1O)=O,2,1,0,1,8,4.7e-05
G5,C1COC(C=1C(CO)(CO)O)=O,1,1,0,1,8,4.7e-05
G5,C(C(C=CCO)(CO)O)=O,4,1,0,1,18,4.7e-05
G5,C(C(C=CC(C)O)(CO)O)=O,8,1,0,1,28,4.7e-05
G5,C(C(C=CC(C)=O)(CO)O)=O,4,1,0,1,41,4.7e-05
G5,C(C(C1COC(C=1)O)(CO)O)=O,4,1,0,1,35,4.7e-05
G5,C(C(CO)O)=C1C(OCC1O)=O,8,1,0,1,8,4.7e-05
G5,C1COC(C=1C(C(CO)O)O)=O,4,1,0,1,8,4.7e-05
G5,C(C(C1C(OCC=1)O)(CO)O)=O,4,1,0,1,34,4.7e-05
G5,C=C(C=O)C(C(C=O)=O)(CO)O,2,1,0,1,45,4.7e-05
G5,C1(C(C(C=O)=C)(C(CO1)O)O)=O,4,1,0,1,45,4.7e-05
G5,C1(C(C(CO1)O)=CC(C)=O)=O,4,1,0,1,8,4.7e-05
G5,C(C)(C(C1C(OCC=1)=O)O)=O,2,1,0,1,8,4.7e-05
G5,C1(C(C(C=O)=C)C(CO1)O)=O,4,1,0,1,8,4.7e-05
G5,C1(C(C(CO1)O)=C(C=O)C)=O,4,1,0,1,8,4.7e-05
G5,C(C(C1C(OCC=1)=O)(C)O)=O,2,1,0,1,8,4.7e-05
G5,C1(COCC1(C(C=O)=C)O)=O,2,1,0,1,10,4.7e-05
G5,C(C(C(C)=O)(C=CCO)O)=O,4,1,0,1,1,4.7e-05
G5,C(C(C(C)=O)(C=CC(C)O)O)=O,8,1,0,1,1,4.7e-05
G5,C(C(C(C)=O)(C=CC=O)O)=O,4,1,0,1,1,4.7e-05
G5,C(C(C(C)=O)(C(C(C)=O)=C)O)=O,2,1,0,1,14,4.7e-05
G5,C(C(C(C)=O)(C(CC=O)=C)O)=O,2,1,0,1,1,4.7e-05
G5,C(C(C(C)=O)(C(C)=CC=O)O)=O,4,1,0,1,1,4.7e-05
G5,C(C(C(C)=O)(C=CC(C)=O)O)=O,4,1,0,1,6,4.7e-05
G5,C1(C(C(CO1)O)=CC=O)=O,4,2,0,2,8,9.499999999999999e-05
G5,C(C(C1C(OCC=1)=O)O)=O,2,1,0,1,8,4.7e-05
G5,C(C)(C(C=CCO)(CO)O)=O,4,1,0,1,18,4.7e-05
G5,C(C)(C(C=CC(C)O)(CO)O)=O,8,1,0,1,28,4.7e-05
G5,C(C)(C(C(C(C)=O)=C)(CO)O)=O,2,1,0,1,14,4.7e-05
G5,C(CC(C(C(C)=O)(CO)O)=C)=O,2,1,0,1,6,4.7e-05
G5,C(C)(C(C(C)=CC=O)(CO)O)=O,4,1,0,1,6,4.7e-05
G5,C(C)(C(C=CC(C)=O)(CO)O)=O,4,1,0,1,6,4.7e-05
G5,C=C1C(OCC1O)=O,2,3,0,3,8,0.00014199999999999998
G5,C1COC(C=1CO)=O,1,1,0,1,27,4.7e-05
G5,C1(C(C=CC(CO1)=O)CO)=O,2,1,0,1,48,4.7e-05
G5,C(C(C1C(C(C(O1)=O)=C)O)O)=O,8,1,0,1,8,4.7e-05
G5,C(C(C1C=C(C(O1)=O)CO)O)=O,4,1,0,1,8,4.7e-05
G5,C(C1C(C(C(C(O1)=O)=C)O)O)=O,8,1,0,1,8,4.7e-05
G5,C(C1C(C=C(C(O1)=O)CO)O)=O,4,1,0,1,8,4.7e-05
G5,C(C(C=O)(C=CCO)O)=O,2,1,0,1,1,4.7e-05
G5,C(C(C=O)(C=CC(C)O)O)=O,4,1,0,1,1,4.7e-05
G5,C(C(C=O)(C=CC=O)O)=O,2,1,0,1,1,4.7e-05
G5,C(C(C=O)(C(C=O)=CC=O)O)=O,2,1,0,1,1,4.7e-05
G5,C(C(C=O)(C=CC(C=O)=O)O)=O,2,1,0,1,1,4.7e-05
G5,C(C(C=O)(C(C)=CC=O)O)=O,2,1,0,1,1,4.7e-05
G5,C(C(C=O)(C=CC(C)=O)O)=O,2,1,0,1,1,4.7e-05
G5,C(C(C=O)(C1COC(C=1)O)O)=O,2,1,0,1,1,4.7e-05
G5,C(C(C=C1C(OCC1O)=O)O)=O,8,1,0,1,8,4.7e-05
G5,C(C(C(C1C(OCC=1)=O)O)O)=O,4,1,0,1,8,4.7e-05
G5,C(C(C=O)(C1C(O)OCC=1)O)=O,2,1,0,1,34,4.7e-05
G5,C=C(CO)C(C(C=O)=O)(CO)O,2,1,0,1,49,4.7e-05
G5,C1(C(C(CO)=C)(C(CO1)O)O)=O,4,1,0,1,49,4.7e-05
G5,C1(C(C(CO)=C)C(CO1)O)=O,4,1,0,1,8,4.7e-05
G5,C(CO)(C)=C1C(OCC1O)=O,4,1,0,1,8,4.7e-05
G5,C1COC(C=1C(CO)(C)O)=O,2,1,0,1,8,4.7e-05
G5,C1(COCC1(C(CO)=C)O)=O,2,1,0,1,10,4.7e-05
G5,C1(C(C=C)(C(CO1)O)O)=O,4,2,0,2,29,9.499999999999999e-05
G5,C1(C(C=C)C(CO1)O)=O,4,1,0,1,4,4.7e-05
G5,C(C)=C1C(OCC1O)=O,4,1,0,1,4,4.7e-05
G5,C1COC(C=1C(C)O)=O,2,1,0,1,4,4.7e-05
G5,C1(CC(C(C1(C=C)CO)=O)O)=O,4,1,0,1,4,4.7e-05
G5,C1(C(CO)CC(C1(C=C)O)=O)=O,4,1,0,1,47,4.7e-05
G5,C1(C(C(CC1(C=C)CO)=O)O)=O,4,1,0,1,47,4.7e-05
G5,C1(C(C=C)C(C(C(C)=O)O1)O)=O,8,1,0,1,48,4.7e-05
G5,C(C)(C1C(C(C(O1)=O)=CC)O)=O,8,1,0,1,48,4.7e-05
G5,C(C)(C1C=C(C(O1)=O)C(C)O)=O,4,1,0,1,48,4.7e-05
G5,C1(CC(C(C(C)=O)(C=C)O1)O)=O,4,1,0,1,48,4.7e-05
G5,C1(C(C=C)C(C(CC=O)O1)O)=O,8,1,0,1,48,4.7e-05
G5,C(CC1C(C(C(O1)=O)=CC)O)=O,8,1,0,1,48,4.7e-05
G5,C(CC1C=C(C(O1)=O)C(C)O)=O,4,1,0,1,48,4.7e-05
G5,C1(COC(C(C)=O)C1(C=C)O)=O,4,1,0,1,17,4.7e-05
G5,C(C)(C1(C=C)C(C(CO1)=O)O)=O,4,1,0,1,4,4.7e-05
G5,C(CC1C(C(CO1)=O)(C=C)O)=O,4,1,0,1,9,4.7e-05
G5,C1(CC(OC1(C(C)=O)C=C)O)=O,4,2,0,2,9,9.499999999999999e-05
G5,C1(CCC(C(C=C)(CO)O1)=O)=O,2,1,0,1,4,4.7e-05
G5,C1(CC(COC1(C=C)CO)=O)=O,2,1,0,1,54,4.7e-05
G5,C1(CCC(C(C=C)(CO1)O)=O)=O,2,1,0,1,4,4.7e-05
G5,C1(C(C=C)C(C(CCO1)=O)O)=O,4,1,0,1,19,4.7e-05
G5,C1(CCOC(C(C1O)=CC)=O)=O,4,1,0,1,19,4.7e-05
G5,C1(C=C(C(OCC1)=O)C(C)O)=O,2,1,0,1,19,4.7e-05
G5,C1(C(C=C)C(CC(CO1)=O)O)=O,4,1,0,1,48,4.7e-05
G5,C1(COC(C(C(C1)O)=CC)=O)=O,4,1,0,1,48,4.7e-05
G5,C1(COC(C(C(C)O)=CC1)=O)=O,2,1,0,1,48,4.7e-05
G5,C1(C(C=CC(CO1)=O)C(C)O)=O,4,1,0,1,48,4.7e-05
G5,C1(CC(COCC1(C=C)O)=O)=O,2,1,0,1,36,4.7e-05
G5,C1(CCOCC(C1(C=C)O)=O)=O,2,1,0,1,36,4.7e-05
G5,C1(COCC1(C=C)O)=O,2,1,0,1,4,4.7e-05
G5,C(CC1C(C(C=C)(CO1)O)=O)=O,4,1,0,1,9,4.7e-05
G5,C(C1(C=C)C(CC(C=O)O1)O)=O,8,1,0,1,40,4.7e-05
G5,C(C1(C(CC(C)(O1)O)=O)C=C)=O,4,2,0,2,26,9.499999999999999e-05
G5,C(C1(C=C)C(C(C(C)O1)=O)O)=O,8,1,0,1,29,4.7e-05
G5,C1(C(C)OC(C=O)C1(C=C)O)=O,8,1,0,1,29,4.7e-05
G5,C(C1(C(CCC(O1)O)=O)C=C)=O,4,2,0,2,37,9.499999999999999e-05
G5,C=CC1(C(C(CO)=CC1O)=O)O,4,1,0,1,4,4.7e-05
G5,C=CC1(C(C(C(C1O)O)=C)=O)O,8,1,0,1,4,4.7e-05
G5,C=CC1(C(C=CO1)=O)C(CO)O,4,1,0,1,4,4.7e-05
G5,C=CC1(C(C=COC1CO)=O)O,4,1,0,1,9,4.7e-05
G5,C=CC1(C(C=CC(O1)O)=O)CO,4,1,0,1,4,4.7e-05
G5,C=CC1(C(C=COCC1O)=O)O,4,1,0,1,38,4.7e-05
G5,C=CC1(C(C=CCOC1O)=O)O,4,1,0,1,19,4.7e-05
G5,C=CC1(C(C=CC(O)OC1)=O)O,4,1,0,1,38,4.7e-05
G5,C(C(C1OCC(C=1)O)(C=C)O)=O,4,1,0,1,36,4.7e-05
G5,C(C(C=C)(C1(C=CCO1)O)O)=O,4,1,0,1,39,4.7e-05
G5,C(C1(C=C)C(C=C(CO)O1)O)=O,4,1,0,1,40,4.7e-05
G5,C(C1(C=C)C(C(C(O1)=C)O)O)=O,8,1,0,1,26,4.7e-05
G5,C(C(C=C)(C1C=CC(O)O1)O)=O,8,1,0,1,43,4.7e-05
G5,C(C(C=C)(C1C(C=CO1)O)O)=O,8,1,0,1,36,4.7e-05
G5,C(C1(C=C)C(C=CC(O1)O)O)=O,8,1,0,1,37,4.7e-05
G5,C(C1(C=C)C(C(C=CO1)O)O)=O,8,1,0,1,37,4.7e-05
G5,C(C1C(C(C(C=1)=O)O)O)(C)=O,4,1,0,1,25,4.7e-05
G5,C1C(CO)(CC(C=1C=O)O)O,4,1,0,1,21,4.7e-05
G5,C(C1(C=CC(CO)(C1)O)O)=O,4,1,0,1,21,4.7e-05
G5,C(C1(C(CO)=CC(C1)O)O)=O,4,1,0,1,21,4.7e-05
G5,C(C1(C(C(C(C1)O)O)=C)O)=O,8,1,0,1,49,4.7e-05
G5,C(C1(C=CC(C1)O)O)=O,4,1,0,1,43,4.7e-05
G5,C(C=C1C(CCC1(CO)O)=O)=O,4,1,0,1,7,4.7e-05
G5,C(C=C1C(CC(C1(C)O)O)=O)=O,8,1,0,1,45,4.7e-05
G5,C(C)(C1(C=CC(C(C1)=O)O)O)=O,4,1,0,1,45,4.7e-05
G5,C1(C=C(C(C)=O)C(CC1O)O)=O,4,1,0,1,45,4.7e-05
G5,C(C1(C=CC(C(C)=O)(C1)O)O)=O,4,2,0,2,29,9.499999999999999e-05
G5,C(C1(C=C(C(C)=O)C(C1)O)O)=O,4,1,0,1,22,4.7e-05
G5,C(CC=O)(C1(C=CC(C1)O)O)=O,4,1,0,1,13,4.7e-05
G5,C(C)(C1(C=C(C=O)C(C1)O)O)=O,4,1,0,1,21,4.7e-05
G5,C(C1(C=CC(C(C1)=O)(C)O)O)=O,4,1,0,1,21,4.7e-05
G5,C1(C=C(C=O)C(CC1(C)O)O)=O,4,1,0,1,21,4.7e-05
G5,C(C1(C=CC(CC(C1)=O)O)O)=O,4,1,0,1,26,4.7e-05
G5,C(C1(C=CC(C=C1)(CO)O)O)=O,1,1,0,1,32,4.7e-05
G5,C1C(CC(C=1C(O)=O)O)O,4,1,0,1,9,4.7e-05
G5,C(C1(C(C(CO1)O)=C)O)=O,4,3,0,3,0,0.00014199999999999998
G5,C(C1(C(CO)=CCO1)O)=O,2,2,0,2,29,9.499999999999999e-05
G5,C1C(O)OCC(C=1C=O)O,4,2,0,2,29,9.499999999999999e-05
G5,C1C(C(C(C=1)=O)=O)(C)O,2,1,0,1,4,4.7e-05
G5,C(C1C(CC(C(C=1)=O)O)=O)(O)=O,2,1,0,1,17,4.7e-05
G5,C(C(C(O)=O)=CC(C=O)=O)=O,2,1,0,1,29,4.7e-05
G5,C(C(C(C)=O)=CC(CO)=O)(O)=O,2,1,0,1,17,4.7e-05
G5,C(C=C(C(C)=O)C(CCO)O)=O,4,1,0,1,45,4.7e-05
G5,C(C=C(C(O)=O)C(C)=O)=O,2,1,0,1,29,4.7e-05
G5,C(C(C(C(C)=O)=CC=O)O)(O)=O,4,1,0,1,45,4.7e-05
G5,C(CC(C(C(C=O)(C)O)=C)O)=O,4,1,0,1,11,4.7e-05
G5,C(C=C(C(C)=O)C(C(C)O)O)=O,8,1,0,1,45,4.7e-05
G5,C(C(C=CC(C=O)(C)O)(C)O)=O,6,1,0,1,11,4.7e-05
G5,C=C(C(O)=O)C(CCO)O,2,1,0,1,25,4.7e-05
G5,C(C(C=CCO)(CCO)O)(O)=O,4,1,0,1,29,4.7e-05
G5,C(CO)=C(C(O)=O)C(CCO)O,4,1,0,1,29,4.7e-05
G5,C(C(C(C=O)=O)(C)O)=CCO,4,1,0,1,18,4.7e-05
G5,C(CO)(C(C=CCO)(C)O)=O,4,1,0,1,18,4.7e-05
G5,C(C(C=CCO)(CCO)O)=O,4,1,0,1,29,4.7e-05
G5,C(C(C=CCO)(CC(O)=O)O)=O,4,1,0,1,29,4.7e-05
G5,C(C(C=CCO)(C)O)=O,4,1,0,1,11,4.7e-05
G5,C(C(C=CCO)(CC=O)O)(O)=O,4,1,0,1,29,4.7e-05
G5,C1(CCOC1(C=CCO)O)=O,4,1,0,1,34,4.7e-05
G5,C(C(C(CO)=CC(C)O)(C)O)=O,8,1,0,1,11,4.7e-05
G5,C(C(C(C(C(C)O)O)=C)(C)O)=O,8,1,0,1,11,4.7e-05
G5,C(C(C=CC(CO)(C)O)(C)O)=O,8,1,0,1,11,4.7e-05
G5,C(C(C=CC(C)O)(C)O)(O)=O,8,1,0,1,25,4.7e-05
G5,C=C(C(O)=O)C(CC(C)O)O,4,1,0,1,25,4.7e-05
G5,C(C(C(C=O)=O)(C)O)=CC(C)O,8,1,0,1,25,4.7e-05
G5,C(CO)(C(C=CC(C)O)(C)O)=O,8,1,0,1,25,4.7e-05
G5,C(C(C=CC(C)O)(CCO)O)=O,8,1,0,1,29,4.7e-05
G5,C(C(C=CC(C)O)(C)O)=O,8,1,0,1,11,4.7e-05
G5,C1(CCOC1(C=CC(C)O)O)=O,8,1,0,1,34,4.7e-05
G5,C=C(C(O)=O)C(C(C(C)O)O)O,8,1,0,1,25,4.7e-05
G5,C(C(C=CC(CO)O)(C)O)(O)=O,8,1,0,1,25,4.7e-05
G5,C=C(C(O)=O)C(CC(CO)O)O,4,1,0,1,25,4.7e-05
G5,C(C(C=CC(CO)O)(C)O)=O,8,1,0,1,11,4.7e-05
G5,C(CO)(C(C(C(O)=O)=C)(C)O)=O,2,1,0,1,25,4.7e-05
G5,C=C(C(O)=O)C(CO)(C(C)O)O,4,1,0,1,28,4.7e-05
G5,C=C(C(O)=O)C(C(CCO)O)O,4,1,0,1,25,4.7e-05
G5,C(C(C(C(O)=O)=C)(C)O)(O)=O,2,1,0,1,25,4.7e-05
G5,C=C(C(O)=O)C(O)=O,1,1,0,1,29,4.7e-05
G5,C(C(C(C(C(O)=O)=C)O)O)(O)=O,4,1,0,1,29,4.7e-05
G5,C(C(C=CC(C=O)=O)(C)O)(O)=O,4,1,0,1,25,4.7e-05
G5,C(C)(C(C(C(O)=O)=C)(C)O)=O,2,1,0,1,25,4.7e-05
G5,C(C(C(C(C)=O)=C)(C)O)(O)=O,2,1,0,1,25,4.7e-05
G5,C(CC(C(C(O)=O)=C)(C)O)=O,2,1,0,1,25,4.7e-05
G5,C(C(C(CC=O)=C)(C)O)(O)=O,2,1,0,1,25,4.7e-05
G5,C(C(C(C)=CC=O)(C)O)(O)=O,4,1,0,1,25,4.7e-05
G5,C(C)(CC(C(C(O)=O)=C)O)=O,2,1,0,1,25,4.7e-05
G5,C(C(C=CC(C)=O)(C)O)(O)=O,4,1,0,1,25,4.7e-05
G5,C=C(C(O)=O)C1(COC(C1)O)O,4,1,0,1,25,4.7e-05
G5,C(C(C1COC(C=1)O)(C)O)(O)=O,4,1,0,1,25,4.7e-05
G5,C(C(C=C)(C(C(O)=O)=C)O)=O,2,1,0,1,28,4.7e-05
G5,C=CC(C(C(O)=O)=C)(CO)O,2,1,0,1,29,4.7e-05
G5,C=C(C(O)=O)C(C=CC=O)O,4,1,0,1,29,4.7e-05
G5,C=C(C(O)=O)C(C(C)O)O,4,1,0,1,29,4.7e-05
G5,C=C(C(O)=O)C1(COCC1O)O,4,1,0,1,25,4.7e-05
G5,C=C(C(O)=O)C1(C(O)OCC1)O,4,1,0,1,25,4.7e-05
G5,C(C(C1C(OCC=1)O)(C)O)(O)=O,4,1,0,1,25,4.7e-05
G5,C(CC(C(C(O)=O)=CCO)O)=O,4,1,0,1,45,4.7e-05
G5,C(CO)=C(C(O)=O)C(O)=O,1,1,0,1,17,4.7e-05
G5,C(CO)=C(C(O)=O)C(C(C)O)O,8,1,0,1,11,4.7e-05
G5,C(C(C(C=O)=O)(C)O)=CC=O,4,1,0,1,25,4.7e-05
G5,C=C(C(O)=O)C(C(C=O)=O)(C)O,2,1,0,1,25,4.7e-05
G5,C=C(C(C)=O)C(C(C=O)=O)(C)O,2,1,0,1,25,4.7e-05
G5,C(CC(C(C(C=O)=O)(C)O)=C)=O,2,1,0,1,25,4.7e-05
G5,C(C)(C(C(C=O)=O)(C)O)=CC=O,4,1,0,1,25,4.7e-05
G5,C(C(C(C=O)=O)(C)O)=CC(C)=O,4,1,0,1,25,4.7e-05
G5,C(CO)(C(C=CC=O)(C)O)=O,4,1,0,1,25,4.7e-05
G5,C(CO)(C(C(C(C)=O)=C)(C)O)=O,2,1,0,1,25,4.7e-05
G5,C(CC(C(C(CO)=O)(C)O)=C)=O,2,1,0,1,25,4.7e-05
G5,C(CO)(C(C(C)=CC=O)(C)O)=O,4,1,0,1,25,4.7e-05
G5,C(CO)(C(C=CC(C)=O)(C)O)=O,4,1,0,1,25,4.7e-05
G5,C(C(C=CC=O)(CC(O)=O)O)=O,4,1,0,1,29,4.7e-05
G5,C(C(C=CC=O)(CC=O)O)(O)=O,4,1,0,1,33,4.7e-05
G5,C1(CCOC1(C=CC=O)O)=O,4,3,0,3,14,0.00014199999999999998
G5,C(C(C(C(O)=O)=C)(CCO)O)=O,2,1,0,1,25,4.7e-05
G5,C(C(C(C(C)=O)=C)(CCO)O)=O,2,1,0,1,14,4.7e-05
G5,C(C(C(CC=O)=C)(CCO)O)=O,2,1,0,1,29,4.7e-05
G5,C(C(C(C)=CC=O)(CCO)O)=O,4,1,0,1,29,4.7e-05
G5,C(C(C(C(O)=O)=C)(C)O)=O,2,1,0,1,11,4.7e-05
G5,C1(CCOC1(C(C(O)=O)=C)O)=O,2,1,0,1,28,4.7e-05
G5,C(C(C(O)=O)=CC(CO)=O)(O)=O,1,1,0,1,17,4.7e-05
G5,C1(C(C(O)=O)=CC(OCC1)=O)=O,1,1,0,1,19,4.7e-05
G5,C(C(C(C)=CC(C=O)=O)(C)O)=O,4,1,0,1,11,4.7e-05
G5,C(C(C(CC(C=O)=O)=C)(C)O)=O,2,1,0,1,11,4.7e-05
G5,C(C(C=CC(C(C)=O)=O)(C)O)=O,4,1,0,1,14,4.7e-05
G5,C(C(C(C(C)=O)=CC=O)(C)O)=O,4,1,0,1,45,4.7e-05
G5,C(C(C(C(CC=O)=O)=C)(C)O)=O,2,1,0,1,45,4.7e-05
G5,C(C(C(C(C)=O)=C)(C)O)=O,2,1,0,1,11,4.7e-05
G5,C1(CCOC1(C(C(C)=O)=C)O)=O,2,1,0,1,14,4.7e-05
G5,C(C(C(CC=O)=C)(C)O)=O,2,1,0,1,11,4.7e-05
G5,C(C(C(C)=CC=O)(C)O)=O,4,1,0,1,11,4.7e-05
G5,C(C(C=CC(C)=O)(C)O)=O,4,1,0,1,11,4.7e-05
G5,C(CC(C1(C(CCO1)=O)O)=C)=O,2,1,0,1,34,4.7e-05
G5,C1(CCOC1(C(C)=CC=O)O)=O,4,1,0,1,34,4.7e-05
G5,C1(CCOC1(C=CC(C)=O)O)=O,4,1,0,1,34,4.7e-05
G5,C(C(C1COC(C=1)O)(C)O)=O,4,1,0,1,11,4.7e-05
G5,C(C(C(C(O)=O)=CCO)(C)O)=O,4,1,0,1,11,4.7e-05
G5,C(C(C=CC(C(O)=O)O)(C)O)=O,8,2,0,2,29,9.499999999999999e-05
G5,C(C(C1C(OCC=1)O)(C)O)=O,4,1,0,1,29,4.7e-05
G5,C(C=C(C(C)=O)C(CO)O)=O,4,1,0,1,0,4.7e-05
G5,C=C(C(O)=O)C(CO)O,2,1,0,1,0,4.7e-05
G5,C=C(C(O)=O)C(CO)(CO)O,1,1,0,1,29,4.7e-05
G5,C=C(C=O)C(C(C=O)=O)(C)O,2,1,0,1,11,4.7e-05
G5,C(C(C=CC(CO)=O)(C)O)(O)=O,4,1,0,1,25,4.7e-05
G5,C(CO)(CC(C(C(O)=O)=C)O)=O,2,1,0,1,25,4.7e-05
G5,C(CC(C(C(O)=O)=C)(CO)O)=O,2,1,0,1,29,4.7e-05
G5,C(C)(C(C(C(C(O)=O)=C)O)O)=O,4,1,0,1,25,4.7e-05
G5,C(C(C(C(C(O)=O)=C)(C)O)O)=O,4,1,0,1,25,4.7e-05
G5,C(C(C(C=O)=CC(C=O)=O)O)=O,4,1,0,1,0,4.7e-05
G5,C(C(C(C(CO)O)=C)(C)O)(O)=O,4,1,0,1,25,4.7e-05
G5,C=C(C(O)=O)C(C)(C(CO)O)O,4,1,0,1,25,4.7e-05
G5,C(C(C(C(CO)O)=C)(C)O)=O,4,1,0,1,11,4.7e-05
G5,C(CO)=C(C(O)=O)CO,2,1,0,1,29,4.7e-05
G5,C(C=C(C(O)=O)CO)(CCO)=O,2,1,0,1,33,4.7e-05
G5,C(CO)(CC=C(C(O)=O)CO)=O,2,1,0,1,7,4.7e-05
G5,C(C)(C(C=C(C(O)=O)CO)O)=O,4,1,0,1,5,4.7e-05
G5,C(CC(C=C(C(O)=O)CO)O)=O,4,1,0,1,33,4.7e-05
G5,C(COC(C=C(C=O)CO)O)=O,4,1,0,1,37,4.7e-05
G5,C1(C(CO)=CC(OCC1)=O)=O,1,1,0,1,19,4.7e-05
G5,C1(C=C(C(OC1CO)=O)CO)=O,2,1,0,1,2,4.7e-05
G5,C1(C=C(C(OCC1O)=O)CO)=O,2,1,0,1,2,4.7e-05
G5,C(C(C(CO)=CCO)(C)O)(O)=O,4,1,0,1,29,4.7e-05
G5,C=C(C(O)=O)C(CO)(CCO)O,2,1,0,1,29,4.7e-05
G5,C(C(C(CO)=CCO)(C)O)=O,4,1,0,1,3,4.7e-05
G5,C(C(C(C(C(O)=O)=C)O)O)=O,4,1,0,1,25,4.7e-05
G5,C(CC(C(C)=O)(C(CO)=C)O)=O,2,1,0,1,45,4.7e-05
G5,C(C=C(C(C)=O)C(CO)(C)O)=O,4,1,0,1,45,4.7e-05
G5,C(C(C(CO)=C)(C)O)(O)=O,2,1,0,1,29,4.7e-05
G5,C=C(C(O)=O)C(CO)(C)O,2,1,0,1,29,4.7e-05
G5,C(C(C(CO)=C)(CCO)O)(O)=O,2,1,0,1,29,4.7e-05
G5,C(CO)=C(C(O)=O)C(CO)(C)O,4,1,0,1,29,4.7e-05
G5,C=C(CO)C(C(C=O)=O)(C)O,2,1,0,1,49,4.7e-05
G5,C(CO)(C(C(CO)=C)(C)O)=O,2,1,0,1,25,4.7e-05
G5,C(C(C(CO)=C)(C)O)=O,2,1,0,1,11,4.7e-05
G5,C1(CCOC1(C(CO)=C)O)=O,2,1,0,1,49,4.7e-05
G5,C(C(C=CC(C)O)(CC=O)O)=O,8,1,0,1,43,4.7e-05
G5,C(CC(C(C(C(O)=O)=C)O)O)=O,4,1,0,1,25,4.7e-05
G5,C(C(CC(C(C(O)=O)=C)O)O)=O,4,1,0,1,25,4.7e-05
G5,C(C(C(C(C)=O)=C)(CC=O)O)=O,2,1,0,1,14,4.7e-05
G5,C(C(C(CC=O)=C)(CC=O)O)=O,2,1,0,1,6,4.7e-05
G5,C(C(C(C)=CC=O)(CC=O)O)=O,4,1,0,1,6,4.7e-05
G5,C1(C(C=C)(C(C(C1)=O)CO)O)=O,4,1,0,1,30,4.7e-05
G5,C(CC(C(C)=O)(C=C)O)=O,2,1,0,1,4,4.7e-05
G5,C(C=C(C(C)=O)C(C)O)=O,4,1,0,1,4,4.7e-05
G5,C(C(C=C)(C)O)(O)=O,2,1,0,1,27,4.7e-05
G5,C=C(C(O)=O)C(C)O,2,1,0,1,27,4.7e-05
G5,C(CO)=C(C(O)=O)C(C)O,4,1,0,1,29,4.7e-05
G5,C=CC(C(C=O)=O)(C)O,2,1,0,1,4,4.7e-05
G5,C(CO)(C(C=C)(C)O)=O,2,1,0,1,4,4.7e-05
G5,C(C(C=O)O)(C(C=C)(C)O)=O,4,1,0,1,4,4.7e-05
G5,C(C(C=C)(CCC(C=O)=O)O)=O,2,3,0,3,29,0.000143
G5,C(CC(C=O)=O)(C(C=C)(C)O)=O,2,1,0,1,4,4.7e-05
G5,C(CC(C=C)(C(C(C)=O)=O)O)=O,2,1,0,1,25,4.7e-05
G5,C(CC(C(C(C=C)(C)O)=O)=O)=O,2,1,0,1,4,4.7e-05
G5,C(C)(CC(C=C)(C(C=O)=O)O)=O,2,1,0,1,17,4.7e-05
G5,C(CCC(C=C)(C(C=O)=O)O)=O,2,1,0,1,27,4.7e-05
G5,C=CC(C=CCO)(C(C=O)=O)O,4,1,0,1,29,4.7e-05
G5,C(CO)(C(C=C)(C=CC=O)O)=O,4,1,0,1,32,4.7e-05
G5,C(C(C(C(C=C)(C=C)O)=O)O)=O,2,1,0,1,4,4.7e-05
G5,C1(C(C=C)(CC(C1CO)=O)O)=O,4,1,0,1,4,4.7e-05
G5,C1(CC(C(C)=O)OC1(C=C)O)=O,4,1,0,1,22,4.7e-05
G5,C(C)(C1(C=C)CC(C(O1)O)=O)=O,4,2,0,2,4,9.499999999999999e-05
G5,C1(CCOC(CC1(C=C)O)=O)=O,2,1,0,1,19,4.7e-05
G5,C1(C(C(C)O)=CC(OCC1)=O)=O,2,1,0,1,19,4.7e-05
G5,C1(COCC(CC1(C=C)O)=O)=O,2,1,0,1,17,4.7e-05
G5,C1(C(C=C)(O)OCCC(C1)=O)=O,2,1,0,1,30,4.7e-05
G5,C1(CCC(COC1(C=C)O)=O)=O,2,1,0,1,12,4.7e-05
G5,C1(C(COC1(C=C)CC=O)O)=O,4,1,0,1,9,4.7e-05
G5,C=CC1(C(C=O)=O)CC(CO1)O,4,1,0,1,4,4.7e-05
G5,C(C1(C=C)CC(C(C=O)O1)O)=O,8,1,0,1,40,4.7e-05
G5,C(C1(C=C)CC(C(C)(O1)O)=O)=O,4,2,0,2,14,9.499999999999999e-05
G5,C(C1C(C(C(C=C)(C)O1)=O)O)=O,8,1,0,1,29,4.7e-05
G5,C(C1(C=C)CC(CC(O1)O)=O)=O,4,2,0,2,25,9.499999999999999e-05
G5,C=CC1(C(C=CC(CO)O1)=O)O,4,1,0,1,46,4.7e-05
G5,C=CC1(C(C=CC(CO1)O)=O)O,4,1,0,1,41,4.7e-05
G5,C(C1(C=C)C=CC(CO)(O1)O)=O,4,1,0,1,40,4.7e-05
G5,C(C(C(CO)=CC(C)O)O)(O)=O,8,1,0,1,33,4.7e-05
G5,C(C(C(C(C(C)O)O)=C)O)(O)=O,8,1,0,1,33,4.7e-05
G5,C(C(C=CC(CO)(C)O)O)(O)=O,8,1,0,1,49,4.7e-05
G5,C(C(C=CC(C)O)O)(O)=O,8,1,0,1,33,4.7e-05
G5,C(C(C1COC(C=1)O)O)(O)=O,4,1,0,1,33,4.7e-05
G5,C(C(C1C(O)OCC=1)O)(O)=O,4,1,0,1,29,4.7e-05
G5,C(C(C(CO)O)OC(C=C)=O)=O,4,1,0,1,48,4.7e-05
G5,C(C(C(CO)OC(C=C)=O)O)=O,4,1,0,1,48,4.7e-05
G5,C(C(C(COC(C=C)=O)O)O)=O,4,1,0,1,48,4.7e-05
G5,C1C(C(C(C=1C)=O)=O)O,2,1,0,1,42,4.7e-05
G5,C1(C(C)=CC(C1O)=O)=O,2,2,0,2,29,9.499999999999999e-05
G5,C=C(C(C(CO)=O)=O)CO,1,3,0,3,55,0.00014199999999999998
G5,C(C=C(C(C(CO)=O)=O)C)=O,2,1,0,1,42,4.7e-05
G5,C(C(C(C)=CC(CO)=O)=O)=O,2,1,0,1,5,4.7e-05
G5,C(CO)=C(C(C(CO)=O)=O)C,2,1,0,1,42,4.7e-05
G5,C=C(C(C(CO)=O)=O)CCO,1,1,0,1,55,4.7e-05
G5,C=C(C(C(CO)=O)=O)C,1,1,0,1,42,4.7e-05
G5,C=C(C(C(C)=O)=O)CO,1,2,0,2,29,9.499999999999999e-05
G5,C(CC(C(C(C)=C)=O)=O)=O,1,1,0,1,42,4.7e-05
G5,C(CC(C(C(C)=O)=O)=C)=O,1,2,0,2,46,9.499999999999999e-05
G5,C(C(C(C)=CC(C)=O)=O)=O,2,1,0,1,28,4.7e-05
G5,C(C=C(C(C(C)=O)=O)C)=O,2,1,0,1,0,4.7e-05
G5,C(C(C)=CC(C)=O)(CO)=O,2,1,0,1,2,4.7e-05
G5,C(CO)=C(C(C(C)=O)=O)C,2,1,0,1,28,4.7e-05
G5,C=C(C(C(CCO)=O)=O)C,1,1,0,1,2,4.7e-05
G5,C(C=C(C=O)C)(CCO)=O,2,1,0,1,3,4.7e-05
G5,C(C(CCO)=CC(C)=O)=O,2,1,0,1,3,4.7e-05
G5,C=C(C(C(C)=O)=O)CCO,1,1,0,1,29,4.7e-05
G5,C=C(C(C(C)=O)=O)C,1,1,0,1,27,4.7e-05
G5,C(C(C)=CC(C)=O)=O,2,1,0,1,27,4.7e-05
G5,C=C(C(C(C(CO)O)=O)=O)C,2,1,0,1,42,4.7e-05
G5,C(C(C(C)=CC=O)=O)=O,2,1,0,1,28,4.7e-05
G5,C(CO)=C(C(C=O)=O)C,2,1,0,1,28,4.7e-05
G5,C=C(C(C=O)=O)CCO,1,1,0,1,55,4.7e-05
G5,C(C(C=C(C(C=O)=O)C)O)=O,4,1,0,1,49,4.7e-05
G5,C(C(C(C(C)=CC=O)=O)O)=O,4,1,0,1,42,4.7e-05
G5,C=C(C(C=O)=O)C,1,1,0,1,28,4.7e-05
G5,C1(CC(CO1)O)=CC=O,4,1,0,1,44,4.7e-05
G5,C=C1C(C=CC1=O)=O,1,2,0,2,29,9.499999999999999e-05
G5,C1C(C(CC(C=1C=O)=O)O)O,4,1,0,1,0,4.7e-05
G5,C(C(C(C)=C(C=O)CO)=O)=O,2,1,0,1,28,4.7e-05
G5,C(C(C(C(C=O)=C)=O)O)=O,2,2,0,2,29,9.499999999999999e-05
G5,C=C(C(C)=O)C(C(C)=O)=O,1,1,0,1,2,4.7e-05
G5,C(C(C=O)=CC(C(C)=O)=O)=O,1,2,0,2,45,9.499999999999999e-05
G5,C(C(C=O)=C(C(C=O)=O)C)=O,1,1,0,1,28,4.7e-05
G5,C(C(C(C)=O)=CC(C=O)=O)=O,2,1,0,1,25,4.7e-05
G5,C(C(C)=C(C(C)=O)CO)=O,2,1,0,1,29,4.7e-05
G5,C=C(C(C)=O)C(C)=O,1,1,0,1,28,4.7e-05
G5,C(CO)=C(C(CCO)=O)C=O,2,1,0,1,2,4.7e-05
G5,C1C(CO)OCC(C=1C=O)=O,2,1,0,1,29,4.7e-05
G5,C1OC(CO)CC(C=1C=O)=O,2,1,0,1,29,4.7e-05
G5,C1C(COCC(C=1C=O)=O)O,2,1,0,1,29,4.7e-05
G5,C1COC(CC(C=1C=O)=O)O,2,1,0,1,38,4.7e-05
G5,C1OCC(CC(C=1C=O)=O)O,2,1,0,1,44,4.7e-05
G5,C1C(O)OCCC(C=1C=O)=O,2,1,0,1,30,4.7e-05
G5,C=CC(C(C=O)=CC=O)=O,2,1,0,1,7,4.7e-05
G5,C1(CC(CO1)O)=C(C=O)C=O,2,1,0,1,44,4.7e-05
G5,C(C=C(C(C)=O)C(C)=O)=O,1,1,0,1,28,4.7e-05
G5,C(C(C=O)=CC(C=O)=O)=O,1,2,0,2,45,9.499999999999999e-05
G5,C(CO)=C(C(O)=O)C(C)=O,2,1,0,1,0,4.7e-05
G5,C=C(C(C)=O)C(C=CC=O)=O,2,1,0,1,29,4.7e-05
G5,C=CC(C(C(C)=O)=CC=O)=O,2,1,0,1,0,4.7e-05
G5,C(CC(C(C=O)=CCO)=O)=O,2,1,0,1,9,4.7e-05
G5,C1(C=CC(C1(C)O)=O)=O,1,1,0,1,45,4.7e-05
G5,C(CC(C=O)=CC(O)=O)=O,2,1,0,1,33,4.7e-05
G5,C(CC(C(C(O)=O)=O)=C)=O,1,1,0,1,29,4.7e-05
G5,C(C(C(C)=CC(O)=O)=O)=O,2,1,0,1,28,4.7e-05
G5,C(C=C(C(C(O)=O)=O)C)=O,2,1,0,1,28,4.7e-05
G5,C(C=C(C(CO)=O)C)(O)=O,2,1,0,1,28,4.7e-05
G5,C(CO)=C(C(C(O)=O)=O)C,2,1,0,1,0,4.7e-05
G5,C=C(C(C(O)=O)=O)CCO,1,1,0,1,29,4.7e-05
G5,C(CC(C=O)=C(C=O)C)=O,2,2,0,2,29,9.499999999999999e-05
G5,C=C(C(C(O)=O)=O)C,1,1,0,1,28,4.7e-05
G5,C=C1C=CC(C1=O)=O,1,2,0,2,29,9.499999999999999e-05
G5,C(C1OC(C(C=1)=O)CO)=O,2,1,0,1,2,4.7e-05
G5,C1(C(CC(O1)=CC=O)O)=O,4,1,0,1,2,4.7e-05
G5,C1(CCO)OC(C(C=1)=O)=O,1,1,0,1,2,4.7e-05
G5,C1(C(O)OCC1O)=CC=O,8,3,0,3,38,0.00014199999999999998
G5,C(C1(C(C=CCO1)=O)O)=O,2,1,0,1,15,4.7e-05
G5,C(C1OCC(C(C=1)=O)O)=O,2,1,0,1,2,4.7e-05
G5,C(C1(C=CC(CO1)=O)O)=O,2,3,0,3,12,0.00014199999999999998
G5,C(C1CC=CC(O1)=O)=O,2,1,0,1,48,4.7e-05
G5,C1(C)OCC(C(C=1)=O)=O,1,1,0,1,26,4.7e-05
G5,C1(C=CC(OC1C)=O)=O,2,1,0,1,24,4.7e-05
G5,C1OC(C(C(C=1)=O)=O)C,2,1,0,1,4,4.7e-05
G5,C1C(C)(OCC(C=1)=O)O,2,1,0,1,45,4.7e-05
G5,C1(C)OCC(C(C=1)=O)O,2,1,0,1,26,4.7e-05
G5,C1COC(C(C=1)=O)(C)O,2,1,0,1,14,4.7e-05
G5,C1C(C)(O)OC(C(C=1)=O)=O,2,1,0,1,14,4.7e-05
G5,C1(C(C(C=C(C)O1)=O)O)=O,2,1,0,1,14,4.7e-05
G5,C1(C=CC(C(C)(O)O1)=O)=O,2,1,0,1,14,4.7e-05
G5,C1COC(C(C(C=1)=O)=O)O,2,1,0,1,2,4.7e-05
G5,C1(C=CC(C(O)OC1)=O)=O,2,5,0,5,55,0.00023700000000000001
G5,C1CC(OCC(C=1)=O)O,2,2,0,2,32,9.499999999999999e-05
G5,C1C(CCOC(C=1)=O)O,2,1,0,1,29,4.7e-05
G5,C1CCOC(C(C=1)=O)O,2,1,0,1,4,4.7e-05
G5,C1OCCC(C(C=1)=O)O,2,1,0,1,4,4.7e-05
G5,C1CC(O)OC(C(C=1)=O)=O,2,1,0,1,45,4.7e-05
G5,C1(CC=CC(C(O)O1)=O)=O,2,1,0,1,28,4.7e-05
G5,C1(CC(C(C=CO1)=O)O)=O,2,1,0,1,29,4.7e-05
G5,C=C(C=O)C(C(C=O)=O)=C,1,2,0,2,29,9.499999999999999e-05
G5,C=C(C=O)C(C(CO)=O)=C,1,2,0,2,29,9.499999999999999e-05
G5,C=C(C=O)C(C=O)=CC=O,2,3,0,3,29,0.00014199999999999998
G5,C=CC(C(CO)=O)=CC=O,2,2,0,2,29,9.499999999999999e-05
G5,C=C(C(CO)=C)C(C=O)=O,1,2,0,2,29,9.499999999999999e-05
G5,C=C(C=C)C(C=O)=O,1,2,0,2,29,9.499999999999999e-05
G5,C=C(C(CO)=O)C(CO)=C,1,2,0,2,29,9.499999999999999e-05
G5,C=C(C(CO)=O)C=C,1,2,0,2,29,9.499999999999999e-05
G5,C=C(C(C=O)=CC=O)CO,2,3,0,3,29,0.00014199999999999998
G5,C=C(C(CC(C=O)=O)=O)C=C,1,2,0,2,29,9.499999999999999e-05
G5,C=CC(C(C=O)=O)=CC(C)=O,2,2,0,2,29,9.499999999999999e-05
G5,C(CC=C(C=C)C(C=O)=O)=O,2,2,0,2,29,9.499999999999999e-05
G5,C=CC(C=O)=CCC(C=O)=O,2,2,0,2,29,9.499999999999999e-05
G5,C(CC(C(C(C=C)=C)=O)=O)=O,1,2,0,2,29,9.499999999999999e-05
G5,C=CC(C(C(C)=O)=O)=CC=O,2,2,0,2,29,9.499999999999999e-05
G5,C=CC(C(C)=O)=CC(C=O)=O,2,2,0,2,29,9.499999999999999e-05
G5,C=C(C(C(CO)O)O)C(CO)O,8,3,0,3,29,0.000164
G5,C=C(CO)C(C(C(C=O)=O)O)O,4,2,0,2,29,0.000106
G5,C(CO)(C(C(CO)O)O)=CCO,8,3,0,3,29,0.000164
G5,C=CC(CO)(C(C(CO)O)O)O,8,3,0,3,29,0.000164
G5,C=C(CO)C(C(CO)O)O,4,3,0,3,29,0.000164
G5,C1C2(COC(C=1)(C2O)O)O,8,3,0,3,32,0.00014199999999999998
G5,C1C2C(C(C(C=1CO)(O2)O)O)O,16,2,0,2,9,9.499999999999999e-05
G5,C=C1C2(C(C(C(C1O)O2)O)O)O,32,2,0,2,9,9.499999999999999e-05
G5,C(C1(C=C(CO)CO1)O)=O,2,1,0,1,5,4.7e-05
G5,C1C(CO)(COC=1C=O)O,2,1,0,1,5,4.7e-05
G5,C(CO)(C1C=CC(CO)(O1)O)=O,4,1,0,1,20,4.7e-05
G5,C(CO)(C1C(C=C(CO)O1)O)=O,4,1,0,1,20,4.7e-05
G5,C(C1C(C=CO1)(CO)O)(CO)=O,4,1,0,1,5,4.7e-05
G5,C(CO)(C1C(CO)=CC(O1)O)=O,4,1,0,1,5,4.7e-05
G5,C1(COC(CO)(C1O)O)=CC=O,8,2,0,2,5,9.499999999999999e-05
G5,C1(COC(C=1C(CO)=O)O)CO,2,1,0,1,5,4.7e-05
G5,C1OCC(C=1C(CO)=O)(CO)O,2,1,0,1,5,4.7e-05
G5,C1(CO)COC(C=1C=O)(CO)O,2,1,0,1,20,4.7e-05
G5,C1(CO)OCC(C=1C=O)(CO)O,2,1,0,1,20,4.7e-05
G5,C1(C(C(CO)(CO1)O)O)=CC=O,8,1,0,1,23,4.7e-05
G5,C(CO)(C1C(C(C(O1)=C)O)O)=O,8,1,0,1,5,4.7e-05
G5,C(CO)(C1C(C(C(O1)O)O)=C)=O,8,2,0,2,5,9.499999999999999e-05
G5,C(C1C(C(C(CO)(O1)O)O)=C)=O,8,2,0,2,5,9.499999999999999e-05
G5,C(C(C1(C=C(CO1)CO)O)O)=O,4,1,0,1,5,4.7e-05
G5,C(C(C1OCC(C=1)(CO)O)O)=O,4,1,0,1,5,4.7e-05
G5,C=C1C(CO)OC(CO)(C1O)O,8,2,0,2,5,9.499999999999999e-05
G5,C1C(C(CO)O)(OCC=1CO)O,4,1,0,1,5,4.7e-05
G5,C1C(CO)(COC=1C(CO)O)O,4,1,0,1,5,4.7e-05
G5,C(C1(C(CO)=C(CO)CO1)O)=O,2,1,0,1,5,4.7e-05
G5,C1(CO)C(CO)(COC=1C=O)O,2,1,0,1,5,4.7e-05
G5,C(C1(C(C(CO)(CO1)O)=C)O)=O,4,2,0,2,5,9.499999999999999e-05
G5,C=C1C(C(OC1(CO)CO)O)=O,2,2,0,2,5,9.499999999999999e-05
G5,C(CO)=C1COC(CO)(C1O)O,8,2,0,2,5,9.499999999999999e-05
G5,C=CC1(COC(CO)(C1O)O)O,8,2,0,2,3,9.499999999999999e-05
G5,C1(C(C(CO)(CO1)O)O)=CCO,8,1,0,1,29,4.7e-05
G5,C1(CO)COC(C=1CO)(CO)O,2,1,0,1,5,4.7e-05
G5,C1(CO)C(CO)(COC=1CO)O,2,1,0,1,5,4.7e-05
G5,C=C1C(CO)(O)OCC1(CO)O,4,2,0,2,29,9.499999999999999e-05
G5,C=C1COC(CO)(C1O)O,4,2,0,2,49,9.499999999999999e-05
G5,C1C(CO)(OCC=1CO)O,2,1,0,1,5,4.7e-05
G5,C1C(CO)(COC=1CO)O,2,1,0,1,5,4.7e-05
G5,C=C1C(C(CO)(CO1)O)O,4,1,0,1,5,4.7e-05
G5,C(CO)(C(C1C=CC(O)O1)O)=O,8,2,0,2,29,9.499999999999999e-05
G5,C(CO)(C(C1C(C=CO1)O)O)=O,8,1,0,1,38,4.7e-05
G5,C(C(C1C(O)OCC=1CO)O)=O,4,1,0,1,5,4.7e-05
G5,C1(C(O)OCC1(CO)O)=CC=O,8,3,0,3,43,0.00014199999999999998
G5,C(C(C1C(CO)(COC=1)O)O)=O,4,1,0,1,5,4.7e-05
G5,C1C(OC(C=1C=O)(CO)CO)O,2,2,0,2,29,9.499999999999999e-05
G5,C1C(O)OCC=1CO,2,1,0,1,27,4.7e-05
G5,C1OCC(C=1)(CO)O,2,1,0,1,27,4.7e-05
G5,C1C(CO)OC(C=1C(CO)=O)O,4,1,0,1,38,4.7e-05
G5,C1OC(CO)C(C=1C(CO)=O)O,4,1,0,1,38,4.7e-05
G5,C1C(CO)OC(C=1C=O)(CO)O,4,1,0,1,40,4.7e-05
G5,C1(CO)OC(CO)C(C=1C=O)O,4,1,0,1,40,4.7e-05
G5,C1(C(C(C(CO)O1)O)O)=CC=O,16,1,0,1,49,4.7e-05
G5,C(C(C1(C=CC(CO)O1)O)O)=O,8,1,0,1,29,4.7e-05
G5,C(C(C1OC(CO)C(C=1)O)O)=O,8,1,0,1,29,4.7e-05
G5,C1C(CO)OC(C=1)(C(CO)O)O,8,1,0,1,41,4.7e-05
G5,C1(C(CO)O)OC(CO)C(C=1)O,8,1,0,1,41,4.7e-05
G5,C(C1(C(CO)=CC(CO)O1)O)=O,4,2,0,2,29,9.499999999999999e-05
G5,C1(CO)C(C(CO)OC=1C=O)O,4,1,0,1,41,4.7e-05
G5,C(C1(C(C(C(CO)O1)O)=C)O)=O,8,2,0,2,41,9.499999999999999e-05
G5,C1(C(C(C(CO)O1)O)O)=CCO,16,1,0,1,3,4.7e-05
G5,C=CC1(C(C(C(CO)O1)O)O)O,16,2,0,2,3,9.499999999999999e-05
G5,C1C(CO)OC(C=1CO)(CO)O,4,1,0,1,41,4.7e-05
G5,C1(CO)C(C(CO)OC=1CO)O,4,1,0,1,41,4.7e-05
G5,C=C1C(CO)(O)OC(CO)C1O,8,2,0,2,41,9.499999999999999e-05
G5,C(C(C1C(OC(C=1)CO)O)O)=O,8,1,0,1,41,4.7e-05
G5,C1(C(O)OC(CO)C1O)=CC=O,16,3,0,3,41,0.00014199999999999998
G5,C(C(C1C(C(CO)OC=1)O)O)=O,8,1,0,1,41,4.7e-05
G5,C1C(OC(C=1C=O)C(CO)O)O,8,2,0,2,29,9.499999999999999e-05
G5,C1C(CO)OC(C=1)O,4,2,0,2,29,9.499999999999999e-05
G5,C1OC(CO)C(C=1)O,4,1,0,1,27,4.7e-05
G5,C(CC1(C=C(C=O)OC1)O)=O,2,1,0,1,51,4.7e-05
G5,C(CC1COC(C=O)(C=1)O)=O,2,1,0,1,51,4.7e-05
G5,C(C1(CC(CO1)=CC=O)O)=O,4,2,0,2,29,9.499999999999999e-05
G5,C(C)(C1C(C=C(C=O)O1)O)=O,4,1,0,1,20,4.7e-05
G5,C(C1(C=CC(C(C)=O)O1)O)=O,4,1,0,1,20,4.7e-05
G5,C(C1C(C=C(C=O)O1)(C)O)=O,4,1,0,1,26,4.7e-05
G5,C(C1C(C)=CC(C=O)(O1)O)=O,4,1,0,1,26,4.7e-05
G5,C(C1C(CC(C=O)(O1)O)=C)=O,4,2,0,2,26,9.499999999999999e-05
G5,C1C(C)(C(CO)OC=1C=O)O,4,1,0,1,29,4.7e-05
G5,C(C1(C=C(C)C(CO)O1)O)=O,4,1,0,1,29,4.7e-05
G5,C(C1(CC(C(CO)O1)=C)O)=O,4,2,0,2,29,9.499999999999999e-05
G5,C(C1(C=C)CC(C(O1)O)=O)=O,4,2,0,2,29,9.499999999999999e-05
G5,C=C1C(C(C(C=O)=O)CO1)O,4,1,0,1,45,4.7e-05
G5,C1C(C)(OCC=1C(C=O)=O)O,2,1,0,1,45,4.7e-05
G5,C(C1(C(C(C(O1)O)=O)=C)C)=O,4,2,0,2,29,9.499999999999999e-05
G5,C=C1C(O)OCC1C(C=O)=O,4,2,0,2,29,9.499999999999999e-05
G5,C1(C)C(O)OCC=1C(C=O)=O,2,1,0,1,42,4.7e-05
G5,C1(C(OC(C=C)(CO)C1)O)=O,4,2,0,2,29,9.499999999999999e-05
G5,C1C(COC=1C=O)(CCO)O,2,1,0,1,29,4.7e-05
G5,C(C1(C=C(CO1)CCO)O)=O,2,1,0,1,29,4.7e-05
G5,C(C1(CC(CO1)=CCO)O)=O,4,2,0,2,29,9.499999999999999e-05
G5,C(C1(CC(C=C)(CO1)O)O)=O,4,2,0,2,29,9.499999999999999e-05
G5,C(CO)(C1COC(C1O)=C)=O,4,1,0,1,45,4.7e-05
G5,C1C(C)(OCC=1C(CO)=O)O,2,1,0,1,45,4.7e-05
G5,C(CO)(C1C(C(O)OC1)=C)=O,4,2,0,2,42,9.499999999999999e-05
G5,C1(C)C(O)OCC=1C(CO)=O,2,1,0,1,42,4.7e-05
G5,C(C1C(C=C(C=O)O1)O)=O,4,1,0,1,15,4.7e-05
G5,C(C1C=CC(C=O)(O)O1)=O,4,1,0,1,15,4.7e-05
G5,C1C(C)(COC=1C=O)O,2,1,0,1,49,4.7e-05
G5,C(C1(C=C(CO1)C)O)=O,2,1,0,1,49,4.7e-05
G5,C(C1(CC(CO1)=C)O)=O,2,2,0,2,49,9.499999999999999e-05
G5,C1(C(O)OC(C=CC=O)C1)=O,8,3,0,3,20,0.00014199999999999998
G5,C1C(CC(C=O)=O)OC(C=1)O,4,2,0,2,29,9.499999999999999e-05
G5,C1OC(C(C=1)O)CC(C=O)=O,4,1,0,1,20,4.7e-05
G5,C(CC1C(C=C(C=O)O1)O)=O,4,1,0,1,20,4.7e-05
G5,C(C1(C=CC(CC=O)O1)O)=O,4,1,0,1,20,4.7e-05
G5,C(C1C(C=O)C(C(O1)=C)O)=O,8,1,0,1,45,4.7e-05
G5,C(C1C(C=O)=CC(C)(O1)O)=O,4,1,0,1,45,4.7e-05
G5,C(C)(C1C(C=O)=CC(O1)O)=O,4,2,0,2,29,9.499999999999999e-05
G5,C(C1C(C(O)OC1C=O)=C)=O,8,2,0,2,45,9.499999999999999e-05
G5,C(C1C(C=O)=C(C)C(O1)O)=O,4,1,0,1,45,4.7e-05
G5,C(C1(C(C=O)=CC(O1)O)C)=O,4,2,0,2,29,9.499999999999999e-05
G5,C(C(C1C(C=C(C=O)O1)O)O)=O,8,1,0,1,0,4.7e-05
G5,C(C1(C=CC(C(C=O)O)O1)O)=O,8,1,0,1,0,4.7e-05
G5,C1C(COC=1C=O)(C(CO)O)O,4,1,0,1,51,4.7e-05
G5,C(C1(C=C(CO1)C(CO)O)O)=O,4,1,0,1,51,4.7e-05
G5,C1C(CO)(C(CO)OC=1C=O)O,4,1,0,1,51,4.7e-05
G5,C(C1(C=C(CO)C(CO)O1)O)=O,4,1,0,1,51,4.7e-05
G5,C(C1C(C(C(CO)=O)=CO1)O)=O,4,1,0,1,1,4.7e-05
G5,C(C1C=C(C(CO)=O)C(O1)O)=O,4,1,0,1,1,4.7e-05
G5,C(C1C(C(C=O)=C(CO)O1)O)=O,4,1,0,1,40,4.7e-05
G5,C(C1C=C(C=O)C(CO)(O1)O)=O,4,1,0,1,40,4.7e-05
G5,C(C1C(C(C(O1)=CC=O)O)O)=O,16,1,0,1,1,4.7e-05
G5,C1OCC(C=1C(CO)=O)(C)O,2,1,0,1,49,4.7e-05
G5,C1(COC(C=1C(CO)=O)O)C,2,1,0,1,49,4.7e-05
G5,C(CO)(C1C(COC1O)=C)=O,4,2,0,2,49,9.499999999999999e-05
G5,C1(CO)OCC(C=1C=O)(C)O,2,1,0,1,49,4.7e-05
G5,C1(COC(C=1C=O)(CO)O)C,2,1,0,1,49,4.7e-05
G5,C(C1C(COC1(CO)O)=C)=O,4,2,0,2,49,9.499999999999999e-05
G5,C1(C(C(C)(CO1)O)O)=CC=O,8,1,0,1,49,4.7e-05
G5,C(CC1(C(C(CO1)=C)O)O)=O,4,2,0,2,49,9.499999999999999e-05
G5,C1(COC(CO)(C1)O)=CC=O,4,2,0,2,51,9.499999999999999e-05
G5,C(CC1COC(C=1)(CO)O)=O,2,1,0,1,51,4.7e-05
G5,C(CC1(C=C(CO)OC1)O)=O,2,1,0,1,51,4.7e-05
G5,C(C)(C1C=CC(CO)(O1)O)=O,4,1,0,1,49,4.7e-05
G5,C(C)(C1C(C=C(CO)O1)O)=O,4,1,0,1,49,4.7e-05
G5,C1(COC(C)(C1O)O)=CC=O,8,2,0,2,49,9.499999999999999e-05
G5,C(CC1(COC(C1O)=C)O)=O,4,1,0,1,0,4.7e-05
G5,C(C1C(C=CO1)(CO)O)(C)=O,4,1,0,1,49,4.7e-05
G5,C(C)(C1C(CO)=CC(O1)O)=O,4,1,0,1,49,4.7e-05
G5,C(C(C1OC(C=O)C(C=1)O)O)=O,8,1,0,1,1,4.7e-05
G5,C(C1C=CC(C(C=O)O)(O1)O)=O,8,1,0,1,1,4.7e-05
G5,C(C(C1OCC(C=1)(C)O)O)=O,4,1,0,1,49,4.7e-05
G5,C(C(C1(C=C(CO1)C)O)O)=O,4,1,0,1,49,4.7e-05
G5,C(C(C1(CC(CO1)=C)O)O)=O,4,2,0,2,49,9.499999999999999e-05
G5,C(C1C(CC(CO)(O1)O)=C)=O,4,2,0,2,55,9.499999999999999e-05
G5,C(C1C(C)=CC(CO)(O1)O)=O,4,1,0,1,55,4.7e-05
G5,C(C1C(C=C(CO)O1)(C)O)=O,4,1,0,1,55,4.7e-05
G5,C(C)(C1C(C(C(O1)=C)O)O)=O,8,1,0,1,49,4.7e-05
G5,C(C1C(C(C(C)(O1)O)O)=C)=O,8,2,0,2,49,9.499999999999999e-05
G5,C(C1C(C)(C(C(O1)=C)O)O)=O,8,1,0,1,49,4.7e-05
G5,C(C)(C1C(C(C(O1)O)O)=C)=O,8,2,0,2,49,9.499999999999999e-05
G5,C(C1C(CC(O1)O)=C)=O,4,2,0,2,6,9.499999999999999e-05
G5,C(C1C(C)=CC(O1)O)=O,4,1,0,1,6,4.7e-05
G5,C(C1C(C=CO1)(C)O)=O,4,1,0,1,6,4.7e-05
G5,C(C1C(C(CO)=O)=CC(O1)O)=O,4,1,0,1,0,4.7e-05
G5,C(C1C(C(C(O1)O)=O)=C)=O,4,2,0,2,0,9.499999999999999e-05
G5,C1C(O)OCC=1C(C=O)=O,2,1,0,1,0,4.7e-05
G5,C(C1C(C=O)=CC(O1)O)=O,4,2,0,2,29,9.499999999999999e-05
G5,C(C1C(C=C(C(CO)O)O1)O)=O,8,1,0,1,41,4.7e-05
G5,C(C1C=CC(C(CO)O)(O1)O)=O,8,2,0,2,29,9.499999999999999e-05
G5,C1C(C)(COC=1C(CO)O)O,4,1,0,1,49,4.7e-05
G5,C1C(C(CO)O)(OCC=1C)O,4,1,0,1,49,4.7e-05
G5,C=C1COC(C(CO)O)(C1)O,4,2,0,2,49,9.499999999999999e-05
G5,C=C1C(CO)OC(CO)(C1)O,4,2,0,2,52,9.499999999999999e-05
G5,C1C(CO)(OC(C=1C)CO)O,4,1,0,1,52,4.7e-05
G5,C1C(C)(C(CO)OC=1CO)O,4,1,0,1,52,4.7e-05
G5,C=C1C(CO)OC(C)(C1O)O,8,2,0,2,28,9.499999999999999e-05
G5,C=C1C(C(C)(C(CO)O1)O)O,8,1,0,1,28,4.7e-05
G5,C=C1C(CO)OC(C1)O,4,2,0,2,17,9.499999999999999e-05
G5,C1(C)C(CO)OC(C=1)O,4,1,0,1,17,4.7e-05
G5,C1OC(CO)C(C=1)(C)O,4,1,0,1,17,4.7e-05
G5,C1C(OC(C=1C(CO)=O)C)O,4,1,0,1,11,4.7e-05
G5,C(CO)(CC1C=CC(O)O1)=O,4,2,0,2,29,9.499999999999999e-05
G5,C(CO)(CC1C(C=CO1)O)=O,4,1,0,1,21,4.7e-05
G5,C(CC1C=CC(CO)(O1)O)=O,4,1,0,1,21,4.7e-05
G5,C(CC1C(C=C(CO)O1)O)=O,4,1,0,1,21,4.7e-05
G5,C(C1(COC(C1)O)O)=CC=O,8,2,0,2,21,9.499999999999999e-05
G5,C(C(C=C1COC(C1)O)O)=O,8,2,0,2,21,9.499999999999999e-05
G5,C(C(CC1COC(C=1)O)O)=O,4,1,0,1,21,4.7e-05
G5,C(C(CC1(C=COC1)O)O)=O,4,1,0,1,21,4.7e-05
G5,C(CC1(C=CC(O1)O)CO)=O,4,1,0,1,21,4.7e-05
G5,C1C(O)OCC=1C=O,2,2,0,2,29,9.499999999999999e-05
G5,C1C(C(CO)O)(OCC=1C=O)O,4,2,0,2,29,9.499999999999999e-05
G5,C(C(CO)O)=C1C(C(CO1)O)=O,8,1,0,1,0,4.7e-05
G5,C1(C(COC1(C=CCO)O)O)=O,8,2,0,2,0,9.499999999999999e-05
G5,C(CO)=C1C(C(CO)(OC1)O)=O,4,2,0,2,0,9.499999999999999e-05
G5,C(CO)(C1(C(C(CO1)O)=C)O)=O,4,2,0,2,0,9.499999999999999e-05
G5,C1(CO)C(COC=1C(CO)=O)O,2,1,0,1,0,4.7e-05
G5,C(CO)(C1(C(CO)=CCO1)O)=O,2,1,0,1,0,4.7e-05
G5,C1(COC(C(CO)=C)(C1O)O)=O,4,2,0,2,2,9.499999999999999e-05
G5,C1(COC(C1O)=C(CO)CO)=O,2,1,0,1,2,4.7e-05
G5,C1C(CO)(OCC=1C(CO)=O)O,2,2,0,2,29,9.499999999999999e-05
G5,C(CO)(C1C(C(C(O)O1)=C)O)=O,8,2,0,2,5,9.499999999999999e-05
G5,C(CO)(C1C=C(CO)C(O1)O)=O,4,2,0,2,29,9.499999999999999e-05
G5,C(CO)(C1C(C(CO)=CO1)O)=O,4,1,0,1,5,4.7e-05
G5,C=C1C(C(CO)O)(O)OCC1O,8,2,0,2,54,9.499999999999999e-05
G5,C1(C(CO)O)OCC(C=1CO)O,4,1,0,1,54,4.7e-05
G5,C1COC(C=1CO)(C(CO)O)O,4,1,0,1,54,4.7e-05
G5,C=C1C(O)OC(C(CO)O)C1O,16,2,0,2,43,9.499999999999999e-05
G5,C1C(C(CO)O)OC(C=1CO)O,8,1,0,1,43,4.7e-05
G5,C1OC(C(CO)O)C(C=1CO)O,8,1,0,1,43,4.7e-05
G5,C1C(C(C=O)=O)COC=1CO,2,1,0,1,12,4.7e-05
G5,C(CO)(C1C=C(C=O)OC1)=O,2,1,0,1,12,4.7e-05
G5,C(C1C(C(OC1)=CCO)=O)=O,4,1,0,1,2,4.7e-05
G5,C(C1COC(C1O)=CC=O)=O,8,1,0,1,23,4.7e-05
G5,C(CC1(C=C(C=O)CO1)O)=O,2,2,0,2,29,9.499999999999999e-05
G5,C(C1C(C=C(CCO)O1)=O)=O,2,1,0,1,30,4.7e-05
G5,C(C1C(CC(C=C)(O1)O)=O)=O,4,2,0,2,30,9.499999999999999e-05
G5,C1(C(C=O)OC(C1)=CCO)=O,4,1,0,1,30,4.7e-05
G5,C(C(C=O)O)(C1C=COC1)=O,4,1,0,1,43,4.7e-05
G5,C(C1C=C(C(C=O)O)OC1)=O,4,1,0,1,55,4.7e-05
G5,C1C(O)OCC=1C(C(C)=O)=O,2,1,0,1,30,4.7e-05
G5,C1(C(COC1(C)O)=CC=O)=O,4,2,0,2,14,9.499999999999999e-05
G5,C(C(C1C(C(OC1)=C)=O)O)=O,4,1,0,1,14,4.7e-05
G5,C(C1CC(C(C=C)(O)O1)=O)=O,4,2,0,2,14,9.499999999999999e-05
G5,C(C1CC(C(O1)=CCO)=O)=O,4,1,0,1,14,4.7e-05
G5,C(C(C=C1C(CCO1)=O)O)=O,4,1,0,1,14,4.7e-05
G5,C(CC(C1COC(C=1)O)=O)=O,2,2,0,2,29,9.499999999999999e-05
G5,C=C1C2(C(OC1C(CO)O2)O)O,16,2,0,2,41,9.499999999999999e-05
G5,C=C1C(O)OC2C(COC12O)O,16,3,0,3,9,0.00014199999999999998
G5,C1OC2C(COC2(C=1CO)O)O,8,2,0,2,9,9.499999999999999e-05
G5,C12C(C(CO1)O)OC(C=2CO)O,8,1,0,1,9,4.7e-05
G5,C=CC1(C2C(C(C(O)O2)O1)O)O,32,2,0,2,30,9.499999999999999e-05
G5,C1(C2C(C(C(O2)O)O1)O)=CCO,32,1,0,1,30,4.7e-05
G5,C=C1C(O)OC2C(C(OC12)O)O,32,2,0,2,43,9.499999999999999e-05
G5,C1OC2C(C(OC2C=1CO)O)O,16,1,0,1,43,4.7e-05
G5,C=C1C(O)OC2COC1(C2O)O,16,3,0,3,9,0.00014199999999999998
G5,C1OC2COC(C=1CO)(C2O)O,8,2,0,2,9,9.499999999999999e-05
G5,C=C1C2(C(C(OC1CO2)O)O)O,16,2,0,2,54,9.499999999999999e-05
G5,C=C1C2(C(O)OCC(C1O)O2)O,16,2,0,2,41,9.499999999999999e-05
G5,C1C2COC(C(C=1CO)(O2)O)O,8,1,0,1,41,4.7e-05
G5,C=C1C2(C(COC(C1O)O2)O)O,16,2,0,2,47,9.499999999999999e-05
G5,C1(CO)C2(C(COC(C=1)O2)O)O,8,1,0,1,47,4.7e-05
G5,C=C1COC2C(C(C1(O)O2)O)O,16,2,0,2,30,9.499999999999999e-05
G5,C=C1C2(COC(C(C1O)O2)O)O,16,2,0,2,40,9.499999999999999e-05
G5,C1C2C(O)OCC(C=1CO)(O2)O,8,1,0,1,40,4.7e-05
G5,C1C2C(O)OC(CO)C(C=1)(O2)O,16,1,0,1,41,4.7e-05
G5,C(C(C1C(C(C(O)O1)=O)=C)O)=O,8,2,0,2,15,9.499999999999999e-05
G5,C(C1C(C(CO)=C(C=O)O1)O)=O,4,1,0,1,15,4.7e-05
G5,C(C1(C(C(C(C=O)O1)O)=C)O)=O,8,2,0,2,15,9.499999999999999e-05
G5,C(C1C=C(CO)C(C=O)(O1)O)=O,4,1,0,1,15,4.7e-05
G5,C=C1C(C(OC1(CO)C)O)=O,4,2,0,2,49,9.499999999999999e-05
G5,C1(CO)C(C)(COC=1C=O)O,2,1,0,1,49,4.7e-05
G5,C(C1(C(C(CO1)(C)O)=C)O)=O,4,2,0,2,49,9.499999999999999e-05
G5,C(C1(C(CO)=C(CO1)C)O)=O,2,1,0,1,49,4.7e-05
G5,C(C1(C(C(CO1)=C)CO)O)=O,4,2,0,2,49,9.499999999999999e-05
G5,C=C1C(C(OC1C)O)=O,4,2,0,2,4,9.499999999999999e-05
G5,C(C1C(C(C(O1)=CCO)O)O)=O,16,1,0,1,30,4.7e-05
G5,C(C1C(C(C(C=C)(O1)O)O)O)=O,16,2,0,2,30,9.499999999999999e-05
G5,C(C1C(C(CO)=C(CO)O1)O)=O,4,1,0,1,40,4.7e-05
G5,C(C1C(C(C(CO)(O1)O)=C)O)=O,8,2,0,2,40,9.499999999999999e-05
G5,C(C1C=C(CO)C(CO)(O1)O)=O,4,2,0,2,29,9.499999999999999e-05
G5,C1(C(C(C)(CO1)O)O)=CCO,8,1,0,1,3,4.7e-05
G5,C=CC1(C(C(CO1)(C)O)O)O,8,2,0,2,3,9.499999999999999e-05
G5,C=C1COC(CCO)(C1O)O,4,2,0,2,3,9.499999999999999e-05
G5,C1(CO)C(C)(COC=1CO)O,2,1,0,1,49,4.7e-05
G5,C=C1C(CO)(O)OCC1(C)O,4,2,0,2,49,9.499999999999999e-05
G5,C1(COC(C=1CO)(CO)O)C,2,1,0,1,49,4.7e-05
G5,C=C1COC(CO)(C1CO)O,4,2,0,2,49,9.499999999999999e-05
G5,C(CO)=C1COC(CO)(C1)O,4,2,0,2,29,9.499999999999999e-05
G5,C=CC1(COC(CO)(C1)O)O,4,2,0,2,29,9.499999999999999e-05
G5,C1C(CO)(OCC=1CCO)O,2,1,0,1,29,4.7e-05
G5,C1C(COC=1CO)(CCO)O,2,1,0,1,29,4.7e-05
G5,C(CO)=C1COC(C)(C1O)O,8,2,0,2,3,9.499999999999999e-05
G5,C=CC1(COC(C)(C1O)O)O,8,2,0,2,3,9.499999999999999e-05
G5,C=C1C(C(CO1)(CCO)O)O,4,1,0,1,3,4.7e-05
G5,C(CO)=C1COC(C1)O,4,2,0,2,3,9.499999999999999e-05
G5,C=CC1(COC(C1)O)O,4,2,0,2,3,9.499999999999999e-05
G5,C1(COC(C=1)O)CCO,2,1,0,1,3,4.7e-05
G5,C1OCC(C=1)(CCO)O,2,1,0,1,3,4.7e-05
G5,C(C)(C(C1C=CC(O)O1)O)=O,8,2,0,2,29,9.499999999999999e-05
G5,C(C)(C(C1C(C=CO1)O)O)=O,8,1,0,1,49,4.7e-05
G5,C(CC1C(C(C(O1)=C)O)O)=O,8,1,0,1,49,4.7e-05
G5,C(C(C1C(CC(O1)O)=C)O)=O,8,2,0,2,16,9.499999999999999e-05
G5,C(C(C1C(C)=CC(O)O1)O)=O,8,1,0,1,16,4.7e-05
G5,C(C(C1C(C=CO1)(C)O)O)=O,8,1,0,1,16,4.7e-05
G5,C(C(C1C(OC(C=O)C=1)O)O)=O,8,1,0,1,43,4.7e-05
G5,C(C1C(C(C(O)O1)=CC=O)O)=O,16,3,0,3,43,0.00014199999999999998
G5,C(C(C1C(C(C=O)OC=1)O)O)=O,8,1,0,1,43,4.7e-05
G5,C(C(C1C(C=O)=CC(O)O1)O)=O,8,2,0,2,29,9.499999999999999e-05
G5,C(C1C=CC(O1)O)=O,4,2,0,2,29,9.499999999999999e-05
G5,C(C1C(C=CO1)O)=O,4,1,0,1,0,4.7e-05
G5,C1C(C)(COC=1CO)O,2,1,0,1,49,4.7e-05
G5,C1C(CO)(OCC=1C)O,2,1,0,1,49,4.7e-05
G5,C=C1COC(CO)(C1)O,2,2,0,2,49,9.499999999999999e-05
G5,C=C1C(C(C)(CO1)O)O,4,1,0,1,49,4.7e-05
G5,C=C1COC(C)(C1O)O,4,2,0,2,49,9.499999999999999e-05
G5,C(C(C1C(COC1O)=C)O)=O,8,2,0,2,49,9.499999999999999e-05
G5,C(C(C1C(O)OCC=1C)O)=O,4,1,0,1,49,4.7e-05
G5,C1(C(O)OCC1(C)O)=CC=O,8,3,0,3,49,0.00014199999999999998
G5,C(C(C1C(C)(COC=1)O)O)=O,4,1,0,1,49,4.7e-05
G5,C1C(OC(C=1C=O)(CO)C)O,4,2,0,2,29,9.499999999999999e-05
G5,C(C(C1C(C=C(CO)O1)O)O)=O,8,1,0,1,20,4.7e-05
G5,C(C(C1C=CC(CO)(O1)O)O)=O,8,1,0,1,20,4.7e-05
G5,C(C(C1C(C(C(O1)=C)O)O)O)=O,16,1,0,1,5,4.7e-05
G5,C=C1COC(C1)O,2,2,0,2,18,9.499999999999999e-05
G5,C1C(O)OCC=1C,2,1,0,1,18,4.7e-05
G5,C1OCC(C=1)(C)O,2,1,0,1,18,4.7e-05
G5,C1C(COC=1CO)(C(CO)O)O,4,1,0,1,51,4.7e-05
G5,C1C(CO)(OCC=1C(CO)O)O,4,1,0,1,51,4.7e-05
G5,C1C(CO)(C(CO)OC=1CO)O,4,1,0,1,29,4.7e-05
G5,C1C(CO)(OC(C=1CO)CO)O,4,1,0,1,29,4.7e-05
G5,C=C1C(C(CO1)(C(CO)O)O)O,8,1,0,1,0,4.7e-05
G5,C=C1C(C(CO)(C(CO)O1)O)O,8,1,0,1,29,4.7e-05
G5,C=C1COC(C(CO)O)(C1O)O,8,2,0,2,49,9.499999999999999e-05
G5,C1C(OC(C=1C=O)C)O,4,2,0,2,29,9.499999999999999e-05
G5,C1OCC(C=1)(C(CO)O)O,4,1,0,1,35,4.7e-05
G5,C1(COC(C=1)O)C(CO)O,4,1,0,1,35,4.7e-05
G5,C1OC(CO)C(C=1)(CO)O,4,1,0,1,29,4.7e-05
G5,C1(CO)C(CO)OC(C=1)O,4,1,0,1,29,4.7e-05
G5,C(CC1C(C=C(CCO)O1)=O)=O,2,1,0,1,30,4.7e-05
G5,C(CC1C(CC(O1)=CCO)=O)=O,4,1,0,1,30,4.7e-05
G5,C(CC1(C=O)CC=C(CO)O1)=O,2,1,0,1,29,4.7e-05
G5,C(CC1(CO)CC=C(C=O)O1)=O,2,1,0,1,29,4.7e-05
G5,C1C(COC=1)(CCC(C=O)=O)O,2,1,0,1,29,4.7e-05
G5,C1C(O)OCC=1CCC(C=O)=O,2,1,0,1,29,4.7e-05
G5,C(CC(C=O)=O)=C1COC(C1)O,4,2,0,2,29,9.499999999999999e-05
G5,C1C(C(C=O)=O)C(C)OC=1CO,4,1,0,1,12,4.7e-05
G5,C(CO)(C1C=C(C=O)OC1C)=O,4,1,0,1,12,4.7e-05
G5,C(C1(C=CC(C)(O1)O)CC=O)=O,4,1,0,1,22,4.7e-05
G5,C(C1(CC(C(O1)=C)O)CC=O)=O,4,1,0,1,22,4.7e-05
G5,C(CC1(C)C(C=C(C=O)O1)O)=O,4,1,0,1,22,4.7e-05
G5,C(C1(C=CC(C)(CC=O)O1)O)=O,4,1,0,1,22,4.7e-05
G5,C1C(C)(C(CC(C=O)=O)OC=1)O,4,1,0,1,22,4.7e-05
G5,C1C(O)OC(C=1C)CC(C=O)=O,4,1,0,1,22,4.7e-05
G5,C=C1C(CC(C=O)=O)OC(C1)O,4,2,0,2,22,9.499999999999999e-05
G5,C(C=C1C(C(OC1C)O)=O)(C)=O,8,2,0,2,45,9.499999999999999e-05
G5,C1C(C)(OC(C=1C(C=O)=O)C)O,4,1,0,1,45,4.7e-05
G5,C=C1C(C(C(C=O)=O)C(C)O1)O,8,1,0,1,45,4.7e-05
G5,C(CC=C1C(C(OC1C)O)=O)=O,8,2,0,2,45,9.499999999999999e-05
G5,C1(C(O)OC(C)C1C=CC=O)=O,16,2,0,2,45,9.499999999999999e-05
G5,C(CC1CC(C(O1)=CCO)=O)=O,4,1,0,1,53,4.7e-05
G5,C(CC1(C(C=CO1)=O)CCO)=O,2,1,0,1,53,4.7e-05
G5,C(C1C(C(OC1C)=CCO)=O)=O,8,1,0,1,7,4.7e-05
G5,C(C=C1C(C(CO)C(C)O1)=O)=O,8,1,0,1,4,4.7e-05
G5,C(CC1(C(C(C(C)O1)=C)=O)O)=O,4,2,0,2,4,9.499999999999999e-05
G5,C(CC(C1C(C=CO1)(C)O)=O)=O,4,1,0,1,6,4.7e-05
G5,C(CC(C1C(C)=CC(O1)O)=O)=O,4,1,0,1,6,4.7e-05
G5,C(CC(C1C(CC(O1)O)=C)=O)=O,4,2,0,2,6,9.499999999999999e-05
G5,C(CC1(C=CC(O)O1)CC=O)=O,2,2,0,2,29,9.499999999999999e-05
G5,C(CC1(C(C=CO1)O)CC=O)=O,2,1,0,1,13,4.7e-05
G5,C(CC1CC(C(O1)=CC=O)O)=O,8,1,0,1,13,4.7e-05
G5,C(CC1C=CC(CC=O)(O)O1)=O,4,2,0,2,29,9.499999999999999e-05
G5,C(C1C(C)OC(C1O)=CC=O)=O,16,1,0,1,4,4.7e-05
G5,C(CC1(C=C(C=O)C(C)O1)O)=O,4,2,0,2,29,9.499999999999999e-05
G5,C(C1C(C=CO1)O)(CC(C)=O)=O,4,1,0,1,26,4.7e-05
G5,C(C1C=CC(O1)O)(CC(C)=O)=O,4,1,0,1,26,4.7e-05
G5,C(C1C(C=CO1)(CC(C)=O)O)=O,4,1,0,1,27,4.7e-05
G5,C(C1C(CC(C)=O)=CC(O1)O)=O,4,1,0,1,27,4.7e-05
G5,C(C1C(CC(O1)O)=CC(C)=O)=O,8,2,0,2,27,9.499999999999999e-05
G5,C(C1C(CC(CC=C)(O1)O)=O)=O,4,2,0,2,4,9.499999999999999e-05
G5,C(C1C(C=C(CC(C)O)O1)=O)=O,4,1,0,1,4,4.7e-05
G5,C(C1C(CC(C=CC)(O1)O)=O)=O,8,2,0,2,4,9.499999999999999e-05
G5,C1(C(C=O)OC(C1)=CC(C)O)=O,8,1,0,1,4,4.7e-05
G5,C(CC1(C(C=O)O)CC=CO1)=O,4,1,0,1,29,4.7e-05
G5,C(CCC1(C=COC1C=O)O)=O,4,1,0,1,44,4.7e-05
G5,C(C1C(CCC=O)=CC(O1)O)=O,4,1,0,1,44,4.7e-05
G5,C(CC=C1CC(OC1C=O)O)=O,8,2,0,2,44,9.499999999999999e-05
G5,C(C(C1OC(CC=O)CC=1)O)=O,4,1,0,1,44,4.7e-05
G5,C(C(C=O)O)(C1C=COC1C)=O,8,1,0,1,46,4.7e-05
G5,C(C1C=C(C(C=O)O)OC1C)=O,8,1,0,1,46,4.7e-05
G5,C(CC1C=CC(C(C)=O)(O)O1)=O,4,1,0,1,21,4.7e-05
G5,C(CC1C(C=C(C(C)=O)O1)O)=O,4,1,0,1,21,4.7e-05
G5,C1C(C(CC(C(C)=O)=O)OC=1)O,4,1,0,1,21,4.7e-05
G5,C1C(O)OC(C=1)CC(C(C)=O)=O,4,1,0,1,21,4.7e-05
G5,C(CC1(C(C)=O)C=CC(O1)O)=O,4,1,0,1,21,4.7e-05
G5,C1C(OC(C=1C(C(C)=O)=O)C)O,4,1,0,1,14,4.7e-05
G5,C(C=C1C(C(C)(OC1C)O)=O)=O,8,2,0,2,14,9.499999999999999e-05
G5,C(C(C1C(C(OC1C)=C)=O)O)=O,8,1,0,1,14,4.7e-05
G5,C(C1CC(C(CC=C)(O)O1)=O)=O,4,2,0,2,14,9.499999999999999e-05
G5,C(C1CC(C(C=CC)(O)O1)=O)=O,8,2,0,2,14,9.499999999999999e-05
G5,C(C1CC(C(O1)=CC(C)O)=O)=O,8,1,0,1,14,4.7e-05
G5,C1(CC(C)OC1(C=CC=O)O)=O,8,2,0,2,14,9.499999999999999e-05
G5,C(C(C=C1C(CC(C)O1)=O)O)=O,8,1,0,1,14,4.7e-05
G5,C(CC1C(C=C(CC=O)O1)O)=O,4,1,0,1,6,4.7e-05
G5,C(CC1C(CC(O1)=CC=O)O)=O,8,1,0,1,6,4.7e-05
G5,C(CC(C1C(C)OC(C=1)O)=O)=O,4,2,0,2,29,9.499999999999999e-05
G5,C1OC(C(C=CCO)=O)C(C=1)O,8,1,0,1,11,4.7e-05
G5,C1C(C(C=CCO)=O)OC(C=1)O,8,1,0,1,11,4.7e-05
G5,C(C1C(C=CO1)(C=CCO)O)=O,8,1,0,1,0,4.7e-05
G5,C(C1C(C=CCO)=CC(O1)O)=O,8,1,0,1,0,4.7e-05
G5,C1OC(CO)C(C=1)(C=CC=O)O,8,1,0,1,21,4.7e-05
G5,C1C(OC(C=1C=CC=O)CO)O,8,1,0,1,21,4.7e-05
G5,C1OC(C(C=1)O)C(C(C=C)=O)O,8,1,0,1,7,4.7e-05
G5,C=CC(C(C1C=CC(O)O1)O)=O,8,1,0,1,7,4.7e-05
G5,C(C(C1C(C=CO1)(C=C)O)O)=O,8,1,0,1,7,4.7e-05
G5,C(C(C1C(C=C)=CC(O)O1)O)=O,8,1,0,1,7,4.7e-05
G5,C1OC(C=CC(CO)=O)C(C=1)O,8,1,0,1,32,4.7e-05
G5,C1C(C=CC(CO)=O)OC(C=1)O,8,1,0,1,32,4.7e-05
G5,C(C(C=CC1(C=COC1)O)O)=O,8,1,0,1,32,4.7e-05
G5,C(C(C=CC1COC(C=1)O)O)=O,8,1,0,1,32,4.7e-05
G5,C(C1(C=CCO1)O)=O,2,1,0,1,0,4.7e-05
G5,C1C(COC=1C=O)O,2,1,0,1,0,4.7e-05
G5,C1(COC(C1O)O)=CC=O,8,2,0,2,5,9.499999999999999e-05
G5,C=C1C(CO)OC(C1O)O,8,2,0,2,28,9.499999999999999e-05
G5,C(C(C1(C=CC(O1)O)CO)O)=O,8,1,0,1,20,4.7e-05
G5,C(C1(COC(C1O)O)O)=CC=O,16,2,0,2,12,9.499999999999999e-05
G5,C(C(C=C1COC(C1O)O)O)=O,16,2,0,2,29,9.499999999999999e-05
G5,C(C(C1C(CO)(OCC=1)O)O)=O,4,1,0,1,0,4.7e-05
G5,C1(C(CO)(O)OCC1O)=CC=O,8,2,0,2,0,9.499999999999999e-05
G5,C(C(C1C(COC=1CO)O)O)=O,4,1,0,1,0,4.7e-05
G5,C1C(OC(C=1C(CO)=O)CO)O,4,1,0,1,0,4.7e-05
G5,C(C1(C(C(CO1)O)O)O)=CC=O,16,2,0,2,0,9.499999999999999e-05
G5,C(C(C=C1C(C(CO1)O)O)O)=O,16,1,0,1,0,4.7e-05
G5,C1(CO)C(COC=1C=O)O,2,1,0,1,0,4.7e-05
G5,C=C1C(C(OC1CO)O)=O,4,2,0,2,0,9.499999999999999e-05
G5,C(CO)=C1COC(C1O)O,8,2,0,2,3,9.499999999999999e-05
G5,C=CC1(COC(C1O)O)O,8,2,0,2,3,9.499999999999999e-05
G5,C1COC(C=1CO)(CO)O,2,1,0,1,40,4.7e-05
G5,C1(CO)C(COC=1CO)O,2,1,0,1,40,4.7e-05
G5,C=C1C(CO)(O)OCC1O,4,2,0,2,40,9.499999999999999e-05
G5,C(C(C1C(C(C(O1)O)O)=C)O)=O,16,2,0,2,5,9.499999999999999e-05
G5,C(C(C(C1(C=CCO1)O)O)O)=O,8,1,0,1,0,4.7e-05
G5,C(C(C(C1OCC(C=1)O)O)O)=O,8,1,0,1,0,4.7e-05
G5,C=C1COC(C1O)O,4,2,0,2,27,9.499999999999999e-05
G5,C1C(CO)(OCC=1)O,2,2,0,2,29,9.499999999999999e-05
G5,C1C(COC=1CO)O,2,2,0,2,27,9.499999999999999e-05
G5,C=C1C(C(CO1)O)O,4,2,0,2,27,9.499999999999999e-05
G5,C(C(C1C(COC=1)O)O)=O,4,1,0,1,38,4.7e-05
G5,C1C(OC(C=1C=O)CO)O,4,2,0,2,29,9.499999999999999e-05
G5,C1COC(C=1)O,2,2,0,2,29,9.499999999999999e-05
G5,C1OCC(C=1)O,2,1,0,1,43,4.7e-05
G5,C(C1(C=CC(C(CO)O)O1)O)=O,8,1,0,1,20,4.7e-05
G5,C1C(C(C(CO)O)OC=1C=O)O,8,1,0,1,20,4.7e-05
G5,C1C(C(CO)O)OC(C=1)(CO)O,8,1,0,1,49,4.7e-05
G5,C1C(C(C(CO)O)OC=1CO)O,8,1,0,1,49,4.7e-05
G5,C=C1C(C(C(C(CO)O)O1)O)O,16,1,0,1,49,4.7e-05
G5,C(C(C1OCC(C=1CO)O)O)=O,4,1,0,1,54,4.7e-05
G5,C(C(C1(C(CO)=CCO1)O)O)=O,4,2,0,2,29,9.499999999999999e-05
G5,C(C(C1(C(C(CO1)O)=C)O)O)=O,8,2,0,2,54,9.499999999999999e-05
G5,C1C(OCC=1C(C(CO)O)=O)O,4,2,0,2,29,9.499999999999999e-05
G5,C(C(C1C=C(C(O)O1)CO)O)=O,8,2,0,2,29,9.499999999999999e-05
G5,C(C(C1C(C(CO)=CO1)O)O)=O,8,1,0,1,43,4.7e-05
G5,C(C(C1C(C(C(O)O1)=C)O)O)=O,16,2,0,2,43,9.499999999999999e-05
G5,C1C(CCO)(O)OC(C=1)=O,2,1,0,1,30,4.7e-05
G5,C1(C(C=C(CCO)O1)O)=O,2,1,0,1,30,4.7e-05
G5,C1(C(CC(O1)=CCO)O)=O,4,1,0,1,30,4.7e-05
G5,C1(C(CC(C=C)(O)O1)O)=O,4,2,0,2,30,9.499999999999999e-05
G5,C(C1CC=C(CO)O1)(O)=O,2,1,0,1,12,4.7e-05
G5,C(C1C=CC(C)(O1)O)(O)=O,4,1,0,1,45,4.7e-05
G5,C(C1CC(C(O1)=C)O)(O)=O,4,1,0,1,45,4.7e-05
G5,C1(C(C=CO1)(CCO)O)=O,2,1,0,1,7,4.7e-05
G5,C1C(O)OC(C=1CCO)=O,2,1,0,1,7,4.7e-05
G5,C(CO)=C1C(OC(C1)O)=O,4,2,0,2,7,9.499999999999999e-05
G5,C1(C(C=C)(CC(O)O1)O)=O,4,2,0,2,7,9.499999999999999e-05
G5,C(C1(C=CC(O1)O)C)(O)=O,4,1,0,1,14,4.7e-05
G5,C1(COC(C1O)=C)=O,2,1,0,1,0,4.7e-05
G5,C1C(CO)(O)OC(C=1)=O,2,1,0,1,33,4.7e-05
G5,C1(C(C=C(CO)O1)O)=O,2,1,0,1,33,4.7e-05
G5,C1(C(C(C(O1)=C)O)O)=O,4,1,0,1,17,4.7e-05
G5,C1C(O)OC(C=1)=O,2,2,0,2,29,9.499999999999999e-05
G5,C(OC1C(OCC1O)=C)=O,4,1,0,1,35,4.7e-05
G5,C(OC1COC(C1O)=C)=O,4,1,0,1,9,4.7e-05
G5,C(OC1C=C(CO)OC1)=O,2,1,0,1,2,4.7e-05
G5,C(COC1(C=COC1)O)=O,2,1,0,1,40,4.7e-05
G5,C(COC1COC(C=1)O)=O,2,1,0,1,40,4.7e-05
G5,C(COC1C=CC(O)O1)=O,4,1,0,1,37,4.7e-05
G5,C1(C(CO)OC(C1O)=C)=O,4,1,0,1,0,4.7e-05
G5,C(C1CC=C(C=O)O1)=O,2,1,0,1,12,4.7e-05
G5,C(C1OC(C(C=1)=O)C)=O,2,1,0,1,24,4.7e-05
G5,C1OC(C(C=O)=O)CC=1,2,1,0,1,27,4.7e-05
G5,C1(C(CCO1)O)=CC=O,4,1,0,1,4,4.7e-05
G5,C(C(C1OCCC=1)O)=O,2,1,0,1,29,4.7e-05
G5,C1(C(C=CO1)O)=O,2,1,0,1,45,4.7e-05
G5,C1(CC(C(O1)=CC=O)O)=O,4,1,0,1,29,4.7e-05
G5,C1(CC=C(C(C=O)O)O1)=O,2,1,0,1,45,4.7e-05
G5,C1C2C(C(CO)(C(C=1)(O2)O)O)O,16,2,0,2,2,9.499999999999999e-05
G5,C(C1(C(OCC1(CO)O)=C)O)=O,4,1,0,1,5,4.7e-05
G5,C=C1C(CO)(C(CO)(CO1)O)O,4,1,0,1,5,4.7e-05
G5,C(C1(COC(C1O)=C)O)=O,4,1,0,1,24,4.7e-05
G5,C(C1(CO)C(C=CO1)(CO)O)=O,4,1,0,1,38,4.7e-05
G5,C(C1(C(CO)=CC(O1)O)CO)=O,4,1,0,1,38,4.7e-05
G5,C1(COC(C1(CO)O)O)=CC=O,8,2,0,2,29,9.499999999999999e-05
G5,C(C1(C(OC(CO)C1O)=C)O)=O,8,1,0,1,1,4.7e-05
G5,C(C1(C(C(C(O1)O)O)=C)CO)=O,8,2,0,2,19,9.499999999999999e-05
G5,C(C1C(C(C(O1)O)(CO)O)=C)=O,8,2,0,2,19,9.499999999999999e-05
G5,C=C1C(CO)(C(C(CO)O1)O)O,8,1,0,1,41,4.7e-05
G5,C=C1C(CO)OC(C1(CO)O)O,8,2,0,2,28,9.499999999999999e-05
G5,C(C1(COC(C1O)=CCO)O)=O,8,1,0,1,7,4.7e-05
G5,C(C1(C(C(O)OC1)=CCO)O)=O,8,2,0,2,43,9.499999999999999e-05
G5,C(C1(COC(C1(C=C)O)O)O)=O,8,2,0,2,41,9.499999999999999e-05
G5,C(CO)=C1COC(C1(CO)O)O,8,2,0,2,29,9.499999999999999e-05
G5,C=CC1(COC(C1(CO)O)O)O,8,2,0,2,3,9.499999999999999e-05
G5,C=C1COC(C1(CO)O)O,4,2,0,2,49,9.499999999999999e-05
G5,C(C)(C1(COC(C1O)=C)O)=O,4,1,0,1,0,4.7e-05
G5,C(C)(C1(C(C(O)OC1)=C)O)=O,4,2,0,2,45,9.499999999999999e-05
G5,C(C1C(C=O)(C(C(O1)=C)O)O)=O,8,1,0,1,0,4.7e-05
G5,C(C1(C(C(O)OC1C=O)=C)O)=O,8,2,0,2,45,9.499999999999999e-05
G5,C(CO)(C1(COC(C1O)=C)O)=O,4,1,0,1,0,4.7e-05
G5,C(CO)(C1(C(C(O)OC1)=C)O)=O,4,2,0,2,42,9.499999999999999e-05
G5,C(C1(C=O)C=CC(CO)(O1)O)=O,2,1,0,1,40,4.7e-05
G5,C(C1(C=O)C(C=C(CO)O1)O)=O,2,1,0,1,40,4.7e-05
G5,C(C1(C(COC1O)=CC=O)O)=O,8,2,0,2,29,9.499999999999999e-05
G5,C(C1(C=O)C(C=CO1)(CO)O)=O,2,1,0,1,1,4.7e-05
G5,C(C1(C=O)C(CO)=CC(O1)O)=O,2,1,0,1,1,4.7e-05
G5,C(C1(C=O)C(C(C(O1)=C)O)O)=O,4,1,0,1,1,4.7e-05
G5,C(C1(C(C(C=O)OC1O)=C)O)=O,8,2,0,2,1,9.499999999999999e-05
G5,C(C1(C=O)C(C(C(O1)O)O)=C)=O,4,2,0,2,29,9.499999999999999e-05
G5,C(C1(C(OC(C=O)C1O)=C)O)=O,8,1,0,1,1,4.7e-05
G5,C(C)(C1(C(COC1O)=C)O)=O,4,2,0,2,29,9.499999999999999e-05
G5,C(C1(C(OCC1(C)O)=C)O)=O,4,1,0,1,49,4.7e-05
G5,C(C1(C(COC1(C)O)=C)O)=O,4,2,0,2,49,9.499999999999999e-05
G5,C(C1(C(C(CO)OC1O)=C)O)=O,8,2,0,2,29,9.499999999999999e-05
G5,C(C1C(C(C(O1)=C)(CO)O)O)=O,8,1,0,1,1,4.7e-05
G5,C=C1C(CO)(C(C)(CO1)O)O,4,1,0,1,49,4.7e-05
G5,C=C1COC(C)(C1(CO)O)O,4,2,0,2,49,9.499999999999999e-05
G5,C1(C(CO)(CO)O)OCC(C=1)=O,1,1,0,1,2,4.7e-05
G5,C=CC1(C(CO)(C(CO1)O)O)O,8,2,0,2,9,9.499999999999999e-05
G5,C1(C(CO)(C(CO1)O)O)=CCO,8,1,0,1,9,4.7e-05
G5,C=CC1C(C(CO)(C(O1)O)O)O,16,2,0,2,29,9.499999999999999e-05
G5,C1OC2(CO)C(COC2(C=1)O)O,8,2,0,2,9,9.499999999999999e-05
G5,C12C(CO)(C(CO1)O)OC(C=2)O,8,1,0,1,9,4.7e-05
G5,C=C1C2(CO)C(C(C(O2)O)O1)O,16,1,0,1,1,4.7e-05
G5,C1OC2COC(C=1)(C2(CO)O)O,8,2,0,2,9,9.499999999999999e-05
G5,C1C2(C(CO)(COC(C=1)O2)O)O,8,1,0,1,2,4.7e-05
G5,C=C1C2C(C(CO)(C(O2)O)O1)O,16,2,0,2,35,9.499999999999999e-05
G5,C1OC2C(CO)(C(OC2C=1)O)O,16,2,0,2,43,9.499999999999999e-05
G5,C1OC2(CO)C(C(C=1)OC2O)O,16,2,0,2,37,9.499999999999999e-05
G5,C(C1(C(COC1O)=CCO)O)=O,8,2,0,2,29,9.499999999999999e-05
G5,C(C1(C(O)OCC1(C=C)O)O)=O,8,2,0,2,1,9.499999999999999e-05
G5,C(C1(C(C)OC(C1O)=C)O)=O,8,1,0,1,0,4.7e-05
G5,C(C(C=O)(C1C=CC(O)O1)O)=O,4,2,0,2,29,9.499999999999999e-05
G5,C(C(C=O)(C1C(C=CO1)O)O)=O,4,1,0,1,43,4.7e-05
G5,C(C(C1(C(COC1O)=C)O)O)=O,8,2,0,2,49,9.499999999999999e-05
G5,C=C1COC(CO)(C1(CO)O)O,4,2,0,2,49,9.499999999999999e-05
G5,C=C1C(CO)(C(CO1)O)O,4,1,0,1,0,4.7e-05
G5,C(C1(C(CO)OC(C1O)=C)O)=O,8,1,0,1,0,4.7e-05
G5,C(C(C1(C(OCC1O)=C)O)O)=O,8,1,0,1,0,4.7e-05
G5,C(C1(C(C(O)OC1CO)=C)O)=O,8,2,0,2,45,9.499999999999999e-05
G5,C=C(C=O)C1(C(O)OCC1O)O,8,2,0,2,45,9.499999999999999e-05
G5,C=C(CO)C1(C(O)OCC1O)O,8,2,0,2,49,9.499999999999999e-05
G5,C=C1COC(C1(C(CO)O)O)O,8,2,0,2,49,9.499999999999999e-05
G5,C=CC1(C(O)OCC1O)O,8,2,0,2,4,9.499999999999999e-05
G5,C1(C(CO)(C(CO1)O)O)=CC=O,8,1,0,1,9,4.7e-05
G5,C(C1(C=COC1(CO)CO)O)=O,2,1,0,1,43,4.7e-05
G5,C(C1(C=COC1C(CO)O)O)=O,8,1,0,1,41,4.7e-05
G5,C(C1(C=COC1C(C)=O)O)=O,4,1,0,1,49,4.7e-05
G5,C(C1(C=COC1(C=O)C)O)=O,4,1,0,1,49,4.7e-05
G5,C1(C(C(C(O)O1)=C)O)=O,4,2,0,2,45,9.499999999999999e-05
G5,C(C1C(C=CO1)(CO)O)(O)=O,4,1,0,1,29,4.7e-05
G5,C(C1C(CO)=CC(O1)O)(O)=O,4,1,0,1,29,4.7e-05
G5,C(C1C(C(C(O1)O)O)=C)(O)=O,8,2,0,2,29,9.499999999999999e-05
G5,C(C1C(C=O)=CC(CO)(O1)O)=O,4,1,0,1,51,4.7e-05
G5,C(C1(C=C(CO)OC1C=O)O)=O,4,1,0,1,51,4.7e-05
G5,C(C1(C=COC1C=O)O)=O,4,1,0,1,2,4.7e-05
G5,C1C(CO)(OCC=1C=O)O,2,1,0,1,2,4.7e-05
G5,C(C1(C=C(CO)OC1)O)=O,2,1,0,1,2,4.7e-05
G5,C1C(CO)(OC(C=1C=O)C)O,4,1,0,1,41,4.7e-05
G5,C(C1(C=C(CO)OC1C)O)=O,4,1,0,1,41,4.7e-05
G5,C(C1(C=COC1)O)=O,2,1,0,1,27,4.7e-05
G5,C(C(CO)O)(C1(C=COC1)O)=O,4,1,0,1,2,4.7e-05
G5,C1(C(O)OCC1(C=CCO)O)=O,8,2,0,2,20,9.499999999999999e-05
G5,C(CO)(C1(C=C(CO)OC1)O)=O,2,1,0,1,32,4.7e-05
G5,C(C)(C1(C=C(C=O)OC1)O)=O,2,1,0,1,45,4.7e-05
G5,C(C1(C=C(C(C)=O)CO1)O)=O,2,1,0,1,45,4.7e-05
G5,C(CC=O)(C1(C=COC1)O)=O,2,1,0,1,2,4.7e-05
G5,C(C)(C1(C=C(C=O)CO1)O)=O,2,1,0,1,14,4.7e-05
G5,C(C1(C=C(C(C)=O)OC1)O)=O,2,1,0,1,14,4.7e-05
G5,C(C1(C=C(CC=O)OC1)O)=O,2,1,0,1,14,4.7e-05
G5,C(C1(COC(C1)=CC=O)O)=O,4,1,0,1,14,4.7e-05
G5,C1C2COC(CO)(C(C=1)(O2)O)O,8,1,0,1,41,4.7e-05
G5,C1(C(C(C(O)O1)=CCO)O)=O,8,2,0,2,29,9.499999999999999e-05
G5,C1(C(C(C=C)(C(O)O1)O)O)=O,8,2,0,2,29,9.499999999999999e-05
G5,C(C1(C=COC1C(C=O)O)O)=O,8,1,0,1,1,4.7e-05
G5,C(CC1(C(COC1O)=C)O)=O,4,2,0,2,49,9.499999999999999e-05
G5,C(C1(C=COC1(CO)C)O)=O,4,1,0,1,29,4.7e-05
G5,C(C1(C=COC1C)O)=O,4,1,0,1,4,4.7e-05
G5,C(C)(C1(C=C(C=O)OC1C)O)=O,4,1,0,1,45,4.7e-05
G5,C(C1(C=C(C(C)=O)C(C)O1)O)=O,4,1,0,1,45,4.7e-05
G5,C(CC=O)(C1(C=COC1C)O)=O,4,1,0,1,4,4.7e-05
G5,C(C)(C1(C=C(C=O)C(C)O1)O)=O,4,1,0,1,14,4.7e-05
G5,C(C1(C=C(C(C)=O)OC1C)O)=O,4,1,0,1,14,4.7e-05
G5,C(C1(C=C(CC=O)OC1C)O)=O,4,1,0,1,25,4.7e-05
G5,C(C1(C(C)OC(C1)=CC=O)O)=O,8,1,0,1,25,4.7e-05
G5,C1(C(O)OCC1O)=CC(CO)=O,8,2,0,2,51,9.499999999999999e-05
G5,C1C(CO)(OC(C=1C=O)CO)O,4,1,0,1,51,4.7e-05
G5,C(C1(C=C(CO)OC1CO)O)=O,4,1,0,1,51,4.7e-05
G5,C(C1(C=COC1CO)O)=O,4,1,0,1,0,4.7e-05
G5,C(C1(C=C(C(CO)O)OC1)O)=O,4,1,0,1,14,4.7e-05
G5,C=C1C(C(C(CO)O1)O)=O,4,1,0,1,0,4.7e-05
G5,C12C(C(CO1)O)OC(C=2)=O,4,1,0,1,2,4.7e-05
G5,C1(C2C(C(C(O2)=C)O1)O)=O,8,2,0,2,29,9.499999999999999e-05
G5,C1(C(C2C(C=CO2)O1)O)=O,8,2,0,2,29,9.499999999999999e-05
G5,C1(C2(C=CC(CO1)O2)O)=O,4,1,0,1,27,4.7e-05
G5,C1(C2C=CC(CO1)(O2)O)=O,4,1,0,1,2,4.7e-05
G5,C1C(C(CO)OC=1)CC(C=O)=O,4,1,0,1,46,4.7e-05
G5,C(CC1C=C(C=O)OC1CO)=O,4,1,0,1,46,4.7e-05
G5,C(C(C(CC1C=COC1)=O)O)=O,4,1,0,1,55,4.7e-05
G5,C(C(C1OCC(C=1)CC=O)O)=O,4,1,0,1,55,4.7e-05
G5,C(C1C(C=CO1)CC(CO)=O)=O,4,1,0,1,32,4.7e-05
G5,C(CC1C=C(CO)OC1C=O)=O,4,1,0,1,32,4.7e-05
G5,C(C(C1C(C=CO1)CC=O)O)=O,8,1,0,1,43,4.7e-05
G5,C1(COC(C(C1O)=C)O)=O,4,2,0,2,2,9.499999999999999e-05
G5,C1(COC(C(C=1)=O)O)CO,2,1,0,1,5,4.7e-05
G5,C1OC(CO)(CO)C(C(C=1)=O)O,2,1,0,1,2,4.7e-05
G5,C=C1C(C(CO)(O)OCC1O)O,8,2,0,2,5,9.499999999999999e-05
G5,C1(COC(C(C1O)O)=CCO)=O,8,1,0,1,5,4.7e-05
G5,C1(COC(C=C)(C(C1O)O)O)=O,8,2,0,2,5,9.499999999999999e-05
G5,C1(COC(C(C1O)=CCO)O)=O,8,2,0,2,5,9.499999999999999e-05
G5,C1(C(C(C=C)(C(OC1)O)O)O)=O,8,2,0,2,5,9.499999999999999e-05
G5,C1COC(CO)(C(C=1C=O)O)O,4,1,0,1,5,4.7e-05
G5,C1(COC(C(C=1CO)=O)O)CO,2,1,0,1,5,4.7e-05
G5,C=C1C(C(O)OCC1(CO)O)=O,4,2,0,2,5,9.499999999999999e-05
G5,C1(CO)C(C(CO)(OCC=1)O)O,4,1,0,1,55,4.7e-05
G5,C(CO)(C1C(C=CC(O)O1)O)=O,8,2,0,2,29,9.499999999999999e-05
G5,C(CO)(C1C(C(C=CO1)O)O)=O,8,1,0,1,51,4.7e-05
G5,C(CO)(C1C=CC(C(O1)O)O)=O,8,1,0,1,51,4.7e-05
G5,C(C1C=CC(C(CO)(O1)O)O)=O,8,1,0,1,51,4.7e-05
G5,C1(COC(C(C=1C=O)O)O)CO,4,1,0,1,51,4.7e-05
G5,C1C(O)OCC(C=1C=O)(CO)O,4,2,0,2,29,9.499999999999999e-05
G5,C1C(COC(C=1C(CO)=O)O)O,4,1,0,1,41,4.7e-05
G5,C1OCC(C(C=1C(CO)=O)O)O,4,1,0,1,41,4.7e-05
G5,C1C(COC(C=1C=O)(CO)O)O,4,1,0,1,30,4.7e-05
G5,C1(CO)OCC(C(C=1C=O)O)O,4,1,0,1,30,4.7e-05
G5,C1(C(C(C(CO1)O)O)O)=CC=O,16,1,0,1,3,4.7e-05
G5,C1OC(C(CO)O)C(C(C=1)=O)O,8,1,0,1,49,4.7e-05
G5,C(C(C1(C=CC(CO1)O)O)O)=O,8,1,0,1,41,4.7e-05
G5,C(C(C1OCC(C(C=1)O)O)O)=O,8,1,0,1,41,4.7e-05
G5,C1C(COC(C=1)(C(CO)O)O)O,8,1,0,1,41,4.7e-05
G5,C1(C(CO)O)OCC(C(C=1)O)O,8,1,0,1,41,4.7e-05
G5,C(C1(C(CO)=CC(CO1)O)O)=O,4,2,0,2,29,9.499999999999999e-05
G5,C1(CO)C(C(COC=1C=O)O)O,4,1,0,1,41,4.7e-05
G5,C(C1(C(C(C(CO1)O)O)=C)O)=O,8,2,0,2,41,9.499999999999999e-05
G5,C1(C(C(C(CO1)O)O)O)=CCO,16,1,0,1,3,4.7e-05
G5,C=CC1(C(C(C(CO1)O)O)O)O,16,2,0,2,3,9.499999999999999e-05
G5,C1C(COC(C=1CO)(CO)O)O,4,1,0,1,41,4.7e-05
G5,C1(CO)C(C(COC=1CO)O)O,4,1,0,1,41,4.7e-05
G5,C=C1C(CO)(O)OCC(C1O)O,8,2,0,2,29,9.499999999999999e-05
G5,C1C(CO)OC(C(C=1C=O)O)O,8,1,0,1,37,4.7e-05
G5,C1C(O)OC(CO)C(C=1C=O)O,8,2,0,2,29,9.499999999999999e-05
G5,C(C(C1C(O)OCC(C=1)O)O)=O,8,1,0,1,41,4.7e-05
G5,C1(C(O)OCC(C1O)O)=CC=O,16,3,0,3,41,0.00014199999999999998
G5,C(C(C1C(C(COC=1)O)O)O)=O,8,1,0,1,41,4.7e-05
G5,C1C(COC(C=1)O)O,4,2,0,2,29,9.499999999999999e-05
G5,C1OCC(C(C=1)O)O,4,1,0,1,27,4.7e-05
G5,C(CC1COC(C(C=1)=O)O)=O,2,1,0,1,51,4.7e-05
G5,C1(C(O)OCC(C1)=CC=O)=O,4,2,0,2,51,9.499999999999999e-05
G5,C(C1C(COC(C1O)=C)=O)=O,4,1,0,1,24,4.7e-05
G5,C1C(C)(OCC(C=1C=O)=O)O,2,1,0,1,24,4.7e-05
G5,C(C1C(COC(C1=C)O)=O)=O,4,2,0,2,16,9.499999999999999e-05
G5,C1(C)C(O)OCC(C=1C=O)=O,2,1,0,1,16,4.7e-05
G5,C(C)(C1C(C(C=CO1)=O)O)=O,4,1,0,1,49,4.7e-05
G5,C(C1(C)C(C(C=CO1)=O)O)=O,4,1,0,1,49,4.7e-05
G5,C(C)(C1C=CC(C(O1)O)=O)=O,4,1,0,1,49,4.7e-05
G5,C(C1C(C)=CC(C(O1)O)=O)=O,4,1,0,1,26,4.7e-05
G5,C(C1C(CC(C(O1)O)=O)=C)=O,4,2,0,2,26,9.499999999999999e-05
G5,C(C1C(CC(C(O1)=C)O)=O)=O,4,1,0,1,29,4.7e-05
G5,C(C1C(C=CC(C)(O1)O)=O)=O,4,1,0,1,29,4.7e-05
G5,C1(C(C=O)OC(C(C1)=C)O)=O,4,3,0,3,55,0.00014199999999999998
G5,C(C1C(C=C(C)C(O1)O)=O)=O,4,1,0,1,16,4.7e-05
G5,C1(C)C(CO)OC(C(C=1)=O)O,4,1,0,1,29,4.7e-05
G5,C1(C(OC(C(C1)=C)CO)O)=O,4,3,0,3,46,0.00014199999999999998
G5,C1C(C)(C(COC=1C=O)O)O,4,1,0,1,29,4.7e-05
G5,C(C1(C=C(C)C(CO1)O)O)=O,4,1,0,1,29,4.7e-05
G5,C(C1(CC(C(CO1)O)=C)O)=O,4,2,0,2,29,9.499999999999999e-05
G5,C1(CC(C(OC1CO)=C)O)=O,4,1,0,1,45,4.7e-05
G5,C1C(C)(OC(C(C=1)=O)CO)O,4,1,0,1,45,4.7e-05
G5,C1(C(CO)OC(C(C1)=C)O)=O,4,3,0,3,16,0.00014199999999999998
G5,C1(C(OC(C(C=1)=O)CO)O)C,4,1,0,1,16,4.7e-05
G5,C(C1(C=C(C=O)OCC1)O)=O,2,1,0,1,29,4.7e-05
G5,C(C1(C=C(C=O)CCO1)O)=O,2,1,0,1,29,4.7e-05
G5,C(C1(CC(C=O)=CCO1)O)=O,2,1,0,1,29,4.7e-05
G5,C1(COC(C(C=1)=O)O)CCO,2,1,0,1,29,4.7e-05
G5,C1(C(O)OCC(C1)=CCO)=O,4,2,0,2,29,9.499999999999999e-05
G5,C1(C(O)OCC(C=C)(C1)O)=O,4,2,0,2,29,9.499999999999999e-05
G5,C1C(CO)(CCOC=1C=O)O,2,1,0,1,29,4.7e-05
G5,C(C1(C=C(CO)CCO1)O)=O,2,1,0,1,29,4.7e-05
G5,C(C1(CC(CO)=CCO1)O)=O,2,1,0,1,29,4.7e-05
G5,C1(COC(C(C1CO)O)=C)=O,4,1,0,1,45,4.7e-05
G5,C1C(C)(OCC(C=1CO)=O)O,2,1,0,1,45,4.7e-05
G5,C=C1C(COC(C)(C1O)O)=O,4,2,0,2,45,9.499999999999999e-05
G5,C1(COC(C(C1CO)=C)O)=O,4,2,0,2,55,9.499999999999999e-05
G5,C1(C)C(O)OCC(C=1CO)=O,2,1,0,1,16,4.7e-05
G5,C=C1C(COC(C1(C)O)O)=O,4,2,0,2,3,9.499999999999999e-05
G5,C(C1C=CC(C(O1)O)=O)=O,4,1,0,1,15,4.7e-05
G5,C1(COC(C(C=1)=O)O)C,2,1,0,1,49,4.7e-05
G5,C1(C(O)OCC(C1)=C)=O,2,2,0,2,49,9.499999999999999e-05
G5,C1(COC(C(C1)=C)O)=O,2,2,0,2,16,9.499999999999999e-05
G5,C1(C)C(O)OCC(C=1)=O,2,1,0,1,16,4.7e-05
G5,C(CC1C=CC(C(O)O1)=O)=O,4,1,0,1,20,4.7e-05
G5,C(C1CC(C=C(C=O)O1)O)=O,4,1,0,1,20,4.7e-05
G5,C(C1(C=CCC(C=O)O1)O)=O,4,1,0,1,20,4.7e-05
G5,C(C1C=CCC(C=O)(O1)O)=O,4,1,0,1,20,4.7e-05
G5,C(C(C1C=CC(C(O)O1)=O)O)=O,8,1,0,1,0,4.7e-05
G5,C(C1C(C(C=C(C=O)O1)O)O)=O,8,1,0,1,0,4.7e-05
G5,C(C1(C=CC(C(C=O)O1)O)O)=O,8,1,0,1,0,4.7e-05
G5,C1(COC(C(C=1)=O)O)C(CO)O,4,1,0,1,51,4.7e-05
G5,C1C(CO)(C(COC=1C=O)O)O,4,1,0,1,51,4.7e-05
G5,C(C1(C=C(CO)C(CO1)O)O)=O,4,1,0,1,51,4.7e-05
G5,C1C(O)OCC(C=1C=O)=O,2,1,0,1,15,4.7e-05
G5,C(C1C(C(C=CO1)=O)O)=O,4,1,0,1,2,4.7e-05
G5,C1OCC(C(C=1)=O)O,2,1,0,1,27,4.7e-05
G5,C(C(C1C(C(C=CO1)=O)O)O)=O,8,1,0,1,1,4.7e-05
G5,C1OC(CO)(C)C(C(C=1)=O)O,4,1,0,1,49,4.7e-05
G5,C1OC(C)C(C(C=1)=O)O,4,1,0,1,4,4.7e-05
G5,C(C1C(C=CC(O1)O)=O)=O,4,3,0,3,46,0.00014199999999999998
G5,C=C1C(COC(CO)(C1)O)O,4,2,0,2,52,9.499999999999999e-05
G5,C1C(CO)(O)OCC(C=1C)O,4,1,0,1,52,4.7e-05
G5,C1C(C)(C(COC=1CO)O)O,4,1,0,1,52,4.7e-05
G5,C=C1C(C(C)(O)OCC1O)O,8,2,0,2,28,9.499999999999999e-05
G5,C=C1C(C(C)(C(CO1)O)O)O,8,1,0,1,28,4.7e-05
G5,C=C1C(COC(C1)O)O,4,2,0,2,17,9.499999999999999e-05
G5,C1(C)C(COC(C=1)O)O,4,1,0,1,17,4.7e-05
G5,C1OCC(C(C=1)(C)O)O,4,1,0,1,17,4.7e-05
G5,C(C1C=C(CO)CC(O1)O)=O,4,1,0,1,21,4.7e-05
G5,C(C1CC(CO)=CC(O)O1)=O,4,1,0,1,21,4.7e-05
G5,C(C1CC(C=CO1)(CO)O)=O,4,1,0,1,21,4.7e-05
G5,C1COC(C(C=1)=O)(C(CO)O)O,4,1,0,1,0,4.7e-05
G5,C1(C(CO)O)OCC(C(C=1)=O)O,4,1,0,1,2,4.7e-05
G5,C1(C(COC(C1O)=CCO)O)=O,8,1,0,1,5,4.7e-05
G5,C1(C(C(C=C)(O)OCC1O)O)=O,8,2,0,2,5,9.499999999999999e-05
G5,C1C(C(CO)O)(OCC(C=1)=O)O,4,2,0,2,29,9.499999999999999e-05
G5,C1(COC(C(C1O)=C)(CO)O)=O,4,2,0,2,2,9.499999999999999e-05
G5,C1(CO)C(CO)(OCC(C=1)=O)O,2,2,0,2,29,9.499999999999999e-05
G5,C1(COC(CO)=C(CO)C1O)=O,2,1,0,1,2,4.7e-05
G5,C1(COC(C(CO)O)=CC1O)=O,4,1,0,1,2,4.7e-05
G5,C1C(C(CO)(OCC=1C=O)O)O,4,2,0,2,29,9.499999999999999e-05
G5,C=C1C(O)OC(CO)C(C1O)O,16,2,0,2,55,9.499999999999999e-05
G5,C1C(C(CO)OC(C=1CO)O)O,8,1,0,1,55,4.7e-05
G5,C1OC(CO)C(C(C=1CO)O)O,8,1,0,1,55,4.7e-05
G5,C(C1(C(CC(CO1)=O)=C)O)=O,2,2,0,2,12,9.499999999999999e-05
G5,C1(COC(C=O)=C(CO)C1)=O,1,1,0,1,12,4.7e-05
G5,C1CC(OCC=1C(C=O)=O)O,2,1,0,1,33,4.7e-05
G5,C1C(C(C=O)=O)COC(C=1)O,4,1,0,1,33,4.7e-05
G5,C1OCC(C(C=O)=O)C(C=1)O,4,1,0,1,33,4.7e-05
G5,C(C1COC(C=O)=CC1O)=O,4,1,0,1,23,4.7e-05
G5,C(C1C=CC(C=O)(O)OC1)=O,4,1,0,1,23,4.7e-05
G5,C(C1(CC=C(C=O)CO1)O)=O,2,1,0,1,23,4.7e-05
G5,C(C1C(C=C(CO)OC1)=O)=O,2,1,0,1,30,4.7e-05
G5,C(CO)(C1C(C=COC1)=O)=O,2,1,0,1,12,4.7e-05
G5,C1(C(COC(C1)=CC=O)O)=O,4,1,0,1,3,4.7e-05
G5,C(CC1OCC(C(C=1)=O)O)=O,2,1,0,1,3,4.7e-05
G5,C(C1C(C(C(OC1)=C)O)=O)=O,4,1,0,1,26,4.7e-05
G5,C1(CCOC(C1O)=CC=O)=O,4,1,0,1,9,4.7e-05
G5,C(C(C1OCCC(C=1)=O)O)=O,2,1,0,1,41,4.7e-05
G5,C1(C(C=O)OC=C(CO)C1)=O,2,1,0,1,55,4.7e-05
G5,C1(C(COC(C1)O)=CC=O)=O,4,3,0,3,2,0.00014199999999999998
G5,C(C(C1C(C=COC1)=O)O)=O,4,1,0,1,2,4.7e-05
G5,C=C1C2(C(OC1C(CO2)O)O)O,16,2,0,2,41,9.499999999999999e-05
G5,C=C1C(O)OC2C(OC1C2O)O,32,2,0,2,55,9.499999999999999e-05
G5,C1OC2C(OC(C=1CO)C2O)O,16,1,0,1,55,4.7e-05
G5,C=C1C2(C(O)OC(CO2)C1O)O,16,2,0,2,41,9.499999999999999e-05
G5,C1C2COC(C=1CO)(C(O2)O)O,8,1,0,1,41,4.7e-05
G5,C1C(C(OCC=1C(C=O)=O)O)O,4,1,0,1,15,4.7e-05
G5,C(C1C(C(C(C(O)O1)=O)=C)O)=O,8,2,0,2,15,9.499999999999999e-05
G5,C(C1C=C(C(C(O1)O)=O)CO)=O,4,1,0,1,15,4.7e-05
G5,C=C1C(C(O)OCC1(C)O)=O,4,2,0,2,49,9.499999999999999e-05
G5,C1(COC(C(C=1CO)=O)O)C,2,1,0,1,49,4.7e-05
G5,C1(C(OCC(C1CO)=C)O)=O,4,2,0,2,49,9.499999999999999e-05
G5,C1(COC(C(C1)O)=CCO)=O,4,1,0,1,3,4.7e-05
G5,C1(COC(C=C)(C(C1)O)O)=O,4,2,0,2,3,9.499999999999999e-05
G5,C1C(CCO)(OCC(C=1)=O)O,2,1,0,1,3,4.7e-05
G5,C1COC(CO)(CC=1C=O)O,2,1,0,1,3,4.7e-05
G5,C1C(CO)(O)OCCC=1C=O,2,1,0,1,3,4.7e-05
G5,C(C1(C=C(CO)OCC1)O)=O,2,1,0,1,3,4.7e-05
G5,C1(COC(C(C1)=CCO)O)=O,4,2,0,2,3,9.499999999999999e-05
G5,C1(COC(C(C=C)(C1)O)O)=O,4,3,0,3,3,0.00014199999999999998
G5,C1(C(OCC(C=1)=O)O)CCO,2,1,0,1,3,4.7e-05
G5,C1COC(C)(C(C=1C=O)O)O,4,1,0,1,3,4.7e-05
G5,C(C1(CCOC(C1O)=C)O)=O,4,1,0,1,3,4.7e-05
G5,C1COC(CC=1C=O)O,2,1,0,1,3,4.7e-05
G5,C1C(O)OCCC=1C=O,2,1,0,1,3,4.7e-05
G5,C(C1(C=COCC1)O)=O,2,1,0,1,3,4.7e-05
G5,C1C(C(OCC=1C(CO)=O)O)O,4,2,0,2,29,9.499999999999999e-05
G5,C1(CO)CC(CO)(OCC=1)O,2,1,0,1,29,4.7e-05
G5,C1C(CO)(O)OCCC=1CO,2,1,0,1,29,4.7e-05
G5,C1C(CO)(CCOC=1CO)O,2,1,0,1,29,4.7e-05
G5,C1(CO)C(C(C)(OCC=1)O)O,4,1,0,1,3,4.7e-05
G5,C=C1C(C(CO)(CCO1)O)O,4,1,0,1,3,4.7e-05
G5,C1(CO)CC(OCC=1)O,2,1,0,1,3,4.7e-05
G5,C1(CO)CCOC(C=1)O,2,1,0,1,3,4.7e-05
G5,C1OCCC(C=1)(CO)O,2,1,0,1,3,4.7e-05
G5,C(C)(C1C(C=CC(O)O1)O)=O,8,2,0,2,29,9.499999999999999e-05
G5,C(C)(C1C(C(C=CO1)O)O)=O,8,1,0,1,43,4.7e-05
G5,C(C1C(C(CC(O1)O)=C)O)=O,8,2,0,2,16,9.499999999999999e-05
G5,C(C1C(C(C)=CC(O)O1)O)=O,8,1,0,1,16,4.7e-05
G5,C(C1C(C(C=CO1)(C)O)O)=O,8,1,0,1,16,4.7e-05
G5,C(C1C=C(C=O)C(C(O1)O)O)=O,8,1,0,1,43,4.7e-05
G5,C(C1C(C(C=O)=CC(O)O1)O)=O,8,2,0,2,29,9.499999999999999e-05
G5,C(C1C(C=O)=CC(C(O1)O)O)=O,8,1,0,1,43,4.7e-05
G5,C(C1CC(C=C(CO)O1)O)=O,4,1,0,1,21,4.7e-05
G5,C(C1CC=CC(CO)(O1)O)=O,4,1,0,1,21,4.7e-05
G5,C(C1C=CCC(CO)(O1)O)=O,4,1,0,1,21,4.7e-05
G5,C(C)(C1C=CC(C(O1)O)O)=O,8,1,0,1,49,4.7e-05
G5,C(C1CC(C(C(O1)=C)O)O)=O,8,1,0,1,49,4.7e-05
G5,C(C1C=CC(C(C)(O1)O)O)=O,8,1,0,1,49,4.7e-05
G5,C(C1C(COC(C1O)O)=C)=O,8,2,0,2,49,9.499999999999999e-05
G5,C1(COC(C(C=1C=O)O)O)C,4,1,0,1,49,4.7e-05
G5,C1C(O)OCC(C=1C=O)(C)O,4,2,0,2,29,9.499999999999999e-05
G5,C(C1C(C(C=C(CO)O1)O)O)=O,8,1,0,1,20,4.7e-05
G5,C(C1C(C=CC(CO)(O1)O)O)=O,8,1,0,1,20,4.7e-05
G5,C(C1C(C(C(C(O1)=C)O)O)O)=O,16,1,0,1,24,4.7e-05
G5,C1C(CO)(C(COC=1CO)O)O,4,1,0,1,29,4.7e-05
G5,C1C(CO)(O)OCC(C=1CO)O,4,1,0,1,29,4.7e-05
G5,C=C1C(C(CO)(C(CO1)O)O)O,8,1,0,1,45,4.7e-05
G5,C(C1C=CCC(O1)O)=O,4,1,0,1,43,4.7e-05
G5,C(C1CC=CC(O)O1)=O,4,1,0,1,43,4.7e-05
G5,C(C1CC(C=CO1)O)=O,4,1,0,1,43,4.7e-05
G5,C1OCC(C(C=1)(CO)O)O,4,1,0,1,37,4.7e-05
G5,C1(CO)C(COC(C=1)O)O,4,1,0,1,37,4.7e-05
G5,C1C(CCOC=1)(CC(C=O)=O)O,2,1,0,1,30,4.7e-05
G5,C1(CCOC(C=1)O)CC(C=O)=O,2,1,0,1,30,4.7e-05
G5,C1(CCOC(C1)O)=CC(C=O)=O,4,2,0,2,30,9.499999999999999e-05
G5,C1(CC(OCC=1)O)CC(C=O)=O,2,2,0,2,29,9.499999999999999e-05
G5,C(C1OC(C)C(C(C=1)=O)CO)=O,4,1,0,1,4,4.7e-05
G5,C(C1(CC(C(C(C)O1)=C)=O)O)=O,4,2,0,2,4,9.499999999999999e-05
G5,C(CC1C(CC=C(CO)O1)=O)=O,2,1,0,1,7,4.7e-05
G5,C(C1(C(C=C)CC(CO1)=O)O)=O,4,2,0,2,12,9.499999999999999e-05
G5,C(C1(C(CC(CO1)=O)=CC)O)=O,4,2,0,2,12,9.499999999999999e-05
G5,C1(COC(C=O)=C(C(C)O)C1)=O,2,1,0,1,12,4.7e-05
G5,C(CC1C(C=CC(C)(O1)O)=O)=O,4,1,0,1,45,4.7e-05
G5,C(CC1C(CC(C(O1)=C)O)=O)=O,4,1,0,1,45,4.7e-05
G5,C(C1(C=COC(C(C)=O)C1)O)=O,4,1,0,1,22,4.7e-05
G5,C(C)(C1CC(C=O)=CC(O)O1)=O,4,1,0,1,22,4.7e-05
G5,C(C)(C1C=C(C=O)CC(O1)O)=O,4,1,0,1,22,4.7e-05
G5,C(CC1(C=CC(C(O1)O)=O)C)=O,4,1,0,1,22,4.7e-05
G5,C(C1(C=CCC(O1)O)CC=O)=O,4,1,0,1,13,4.7e-05
G5,C(CC1(C=O)CC=CC(O)O1)=O,4,1,0,1,13,4.7e-05
G5,C(C1(CC(C=CO1)O)CC=O)=O,4,1,0,1,13,4.7e-05
G5,C(C1(C=COC(C1)CC=O)O)=O,4,1,0,1,13,4.7e-05
G5,C(CC1CC(C=O)=CC(O)O1)=O,4,1,0,1,13,4.7e-05
G5,C(CC1C=C(C=O)CC(O1)O)=O,4,1,0,1,13,4.7e-05
G5,C(CC1CC(C=C(C=O)O1)O)=O,4,1,0,1,13,4.7e-05
G5,C(C1(C=CCC(CC=O)O1)O)=O,4,1,0,1,13,4.7e-05
G5,C(CC1C=CCC(C=O)(O)O1)=O,4,1,0,1,13,4.7e-05
G5,C1OC(CC(C=1)O)CC(C=O)=O,4,1,0,1,13,4.7e-05
G5,C1CC(CC(C=O)=O)OC(C=1)O,4,1,0,1,13,4.7e-05
G5,C1CC(OC(C=1)CC(C=O)=O)O,4,1,0,1,13,4.7e-05
G5,C1CC(OC(C=1C(C=O)=O)C)O,4,1,0,1,4,4.7e-05
G5,C1C(C(C=O)=O)C(C)OC(C=1)O,8,1,0,1,4,4.7e-05
G5,C1OC(C)C(C(C=O)=O)C(C=1)O,8,1,0,1,4,4.7e-05
G5,C(C1C(C)OC(C=O)=CC1O)=O,8,1,0,1,23,4.7e-05
G5,C(C1C=CC(C=O)(O)OC1C)=O,8,1,0,1,23,4.7e-05
G5,C(C1(CC=C(C=O)C(C)O1)O)=O,4,1,0,1,23,4.7e-05
G5,C(CC=O)(C1(C=COCC1)O)=O,2,1,0,1,53,4.7e-05
G5,C(CC(C1CCOC(C=1)O)=O)=O,2,1,0,1,53,4.7e-05
G5,C(CC(C1CC(OCC=1)O)=O)=O,2,1,0,1,53,4.7e-05
G5,C(CC1CC(C=C(CO)O1)=O)=O,2,1,0,1,26,4.7e-05
G5,C(CC1(CO)CC(C=CO1)=O)=O,2,1,0,1,26,4.7e-05
G5,C(C1C(C=C(CO)OC1C)=O)=O,4,1,0,1,4,4.7e-05
G5,C(CO)(C1C(C=COC1C)=O)=O,4,1,0,1,4,4.7e-05
G5,C1(C(C(C)OC(C1)=CC=O)O)=O,8,1,0,1,4,4.7e-05
G5,C(CC1OC(C)C(C(C=1)=O)O)=O,4,1,0,1,4,4.7e-05
G5,C(CC1CC(C(C(O1)=C)O)=O)=O,4,1,0,1,9,4.7e-05
G5,C(CC1(C)C(C(C=CO1)=O)O)=O,4,1,0,1,6,4.7e-05
G5,C(C1C(C(C(OC1C)=C)O)=O)=O,8,1,0,1,9,4.7e-05
G5,C1(CC(C)OC(C1O)=CC=O)=O,8,1,0,1,9,4.7e-05
G5,C(CC(C1CC(C=CO1)O)=O)=O,4,1,0,1,13,4.7e-05
G5,C(CC(C1CC=CC(O)O1)=O)=O,4,1,0,1,13,4.7e-05
G5,C(CC(C1C=CCC(O1)O)=O)=O,4,1,0,1,13,4.7e-05
G5,C(CC1C(C(C=C(C)O1)=O)O)=O,4,1,0,1,26,4.7e-05
G5,C(CC1C(C(CC(O1)=C)=O)O)=O,4,1,0,1,26,4.7e-05
G5,C(C(C1OC(C)CC(C=1)=O)O)=O,4,1,0,1,4,4.7e-05
G5,C(C1C(CC(C=C)C(O1)O)=O)=O,8,2,0,2,46,9.499999999999999e-05
G5,C1(C(C=O)OC(C(C1)=CC)O)=O,8,2,0,2,46,9.499999999999999e-05
G5,C1(C(C=O)OC=C(C(C)O)C1)=O,4,1,0,1,46,4.7e-05
G5,C(CC1C=CC(C(C)(O1)O)=O)=O,4,1,0,1,21,4.7e-05
G5,C(CC1C(CC(C(O1)=C)=O)O)=O,4,1,0,1,21,4.7e-05
G5,C(C1CC(C(C)=O)(C=CO1)O)=O,4,1,0,1,21,4.7e-05
G5,C(C1CC(C(C)=O)=CC(O)O1)=O,4,1,0,1,21,4.7e-05
G5,C(C1C=C(C(C)=O)CC(O1)O)=O,4,1,0,1,21,4.7e-05
G5,C(CC1(C(C=CC(O1)O)=O)C)=O,4,1,0,1,21,4.7e-05
G5,C1(C(C(C)OC(C1)O)=CC=O)=O,8,3,0,3,4,0.00014199999999999998
G5,C(C(C1C(C=COC1C)=O)O)=O,8,1,0,1,4,4.7e-05
G5,C1OCC(C(C=1)(C=CC=O)O)O,8,1,0,1,21,4.7e-05
G5,C1C(O)OCC(C=1C=CC=O)O,8,1,0,1,21,4.7e-05
G5,C1C(C(C(C(C=C)=O)OC=1)O)O,8,1,0,1,7,4.7e-05
G5,C=CC(C1C(C=CC(O)O1)O)=O,8,1,0,1,7,4.7e-05
G5,C(C1C(C(C=CO1)(C=C)O)O)=O,8,1,0,1,7,4.7e-05
G5,C(C1C(C(C=C)=CC(O)O1)O)=O,8,1,0,1,7,4.7e-05
G5,C=C1C(C(O)OCC1O)O,8,2,0,2,28,9.499999999999999e-05
G5,C(C1C(C=CC(O1)O)(CO)O)=O,8,1,0,1,20,4.7e-05
G5,C(C1C(CO)=CC(C(O1)O)O)=O,8,1,0,1,20,4.7e-05
G5,C(C1C=C(CO)C(C(O1)O)O)=O,8,1,0,1,20,4.7e-05
G5,C1COC(C(C=1C(CO)=O)O)O,4,1,0,1,20,4.7e-05
G5,C1C(O)OCC(C=1C(CO)=O)O,4,1,0,1,20,4.7e-05
G5,C1COC(C(C=1C=O)O)O,4,2,0,2,29,9.499999999999999e-05
G5,C1COC(C(C=1CO)=O)O,2,1,0,1,2,4.7e-05
G5,C=C1C(C(O)OCC1O)=O,4,2,0,2,2,9.499999999999999e-05
G5,C1(CO)C(C(OCC=1)O)O,4,1,0,1,3,4.7e-05
G5,C(C1C(C(C(C(O1)O)O)O)=C)=O,16,2,0,2,26,9.499999999999999e-05
G5,C(C1C(C(C(C(O1)O)O)=C)O)=O,16,2,0,2,0,9.499999999999999e-05
G5,C1C(C(CO)O)OC(C(C=1)=O)O,8,1,0,1,20,4.7e-05
G5,C(C1(C=CC(C(CO)O1)O)O)=O,8,1,0,1,20,4.7e-05
G5,C1C(C(C(CO)OC=1C=O)O)O,8,1,0,1,20,4.7e-05
G5,C1C(C(CO)OC(C=1)(CO)O)O,8,1,0,1,49,4.7e-05
G5,C1C(C(C(CO)OC=1CO)O)O,8,1,0,1,49,4.7e-05
G5,C=C1C(C(C(C(CO)O1)O)O)O,16,1,0,1,45,4.7e-05
G5,C(CO)=C1C(C(C(OC1)O)O)=O,8,3,0,3,2,0.00014199999999999998
G5,C(C1C(C=C(C(O)O1)CO)O)=O,8,2,0,2,29,9.499999999999999e-05
G5,C(C1C(C(C(CO)=CO1)O)O)=O,8,1,0,1,55,4.7e-05
G5,C(C1C(C(C(C(O1)O)=C)O)O)=O,16,2,0,2,55,9.499999999999999e-05
G5,C1CC(CO)(O)OC(C=1)=O,2,1,0,1,12,4.7e-05
G5,C1(C(CC=C(CO)O1)O)=O,2,1,0,1,12,4.7e-05
G5,C1C(C(C)(O)OC(C=1)=O)O,4,1,0,1,24,4.7e-05
G5,C1(C(C=CC(C)(O)O1)O)=O,4,1,0,1,24,4.7e-05
G5,C1(C(CC(C(O1)=C)O)O)=O,4,1,0,1,24,4.7e-05
G5,C(C1C=CCC(O1)O)(O)=O,4,1,0,1,33,4.7e-05
G5,C(C1CC=CC(O)O1)(O)=O,4,1,0,1,33,4.7e-05
G5,C(C1CC(C=CO1)O)(O)=O,4,1,0,1,33,4.7e-05
G5,C1(C(C=CC(O)O1)(C)O)=O,4,1,0,1,14,4.7e-05
G5,C1C(C(O)OC(C=1C)=O)O,4,1,0,1,14,4.7e-05
G5,C=C1C(OC(C(C1)O)O)=O,4,2,0,2,14,9.499999999999999e-05
G5,C1C(C(CO)(O)OC(C=1)=O)O,4,2,0,2,29,9.499999999999999e-05
G5,C1C(CCOC=1C=O)O,2,1,0,1,4,4.7e-05
G5,C(C1(C=CCCO1)O)=O,2,1,0,1,4,4.7e-05
G5,C(C1(CC=CCO1)O)=O,2,1,0,1,4,4.7e-05
G5,C1(CC(C=C(C=O)O1)O)=O,2,1,0,1,28,4.7e-05
G5,C1(CC=CC(C=O)(O)O1)=O,2,1,0,1,28,4.7e-05
G5,C(C1(CC=CC(O1)=O)O)=O,2,1,0,1,28,4.7e-05
G5,C(C1(C=CC(CO)(O)OC1)O)=O,4,2,0,2,29,9.499999999999999e-05
G5,C(C1(COC(CO)=CC1O)O)=O,4,1,0,1,30,4.7e-05
G5,C(C1(COC=CC1(CO)O)O)=O,4,1,0,1,41,4.7e-05
G5,C(C1(C(CO)=CC(O)OC1)O)=O,4,1,0,1,41,4.7e-05
G5,C(C1(C(OCC(C1O)O)=C)O)=O,8,1,0,1,26,4.7e-05
G5,C(C1(COC(C(C1O)O)=C)O)=O,8,1,0,1,26,4.7e-05
G5,C(C1(C(C(C(O)OC1)O)=C)O)=O,8,2,0,2,1,9.499999999999999e-05
G5,C=C1C(CO)(C(C(CO1)O)O)O,8,1,0,1,41,4.7e-05
G5,C=C1C(COC(C1(CO)O)O)O,8,2,0,2,28,9.499999999999999e-05
G5,C1COC(C(C=1C=O)(CO)O)O,4,1,0,1,3,4.7e-05
G5,C1(CO)C(C(OCC=1)O)(CO)O,4,1,0,1,3,4.7e-05
G5,C(C1C=CC(C(O1)O)(CO)O)=O,8,2,0,2,29,9.499999999999999e-05
G5,C1(COC(C(C1(CO)O)=C)O)=O,4,2,0,2,2,9.499999999999999e-05
G5,C(C1(C(C(COC1O)O)=C)O)=O,8,2,0,2,29,9.499999999999999e-05
G5,C1(C(C(C(OC1)=C)(CO)O)O)=O,4,1,0,1,5,4.7e-05
G5,C(CO)(C1(C=CC(O)OC1)O)=O,4,2,0,2,29,9.499999999999999e-05
G5,C(CO)(C1(COC=CC1O)O)=O,4,1,0,1,12,4.7e-05
G5,C(C)(C1(C(C=COC1)=O)O)=O,2,1,0,1,12,4.7e-05
G5,C(C1(C(C=C(C)OC1)=O)O)=O,2,1,0,1,26,4.7e-05
G5,C(C1(C(CC(OC1)=C)=O)O)=O,2,1,0,1,26,4.7e-05
G5,C(C1(C(C=O)=CCOC1O)O)=O,4,1,0,1,3,4.7e-05
G5,C(C1(C(CO)=CCOC1O)O)=O,4,1,0,1,12,4.7e-05
G5,C(C1(C=O)C(C=CC(O1)O)O)=O,4,2,0,2,29,9.499999999999999e-05
G5,C(C1(C=O)C(C(C=CO1)O)O)=O,4,1,0,1,43,4.7e-05
G5,C(C1(C=O)C=CC(C(O1)O)O)=O,4,1,0,1,43,4.7e-05
G5,C(C1(C=CC(C=O)OC1O)O)=O,8,1,0,1,43,4.7e-05
G5,C(C1(C(COC(C1O)O)=C)O)=O,8,2,0,2,49,9.499999999999999e-05
G5,C(C)(C1(C(C=COC1C)=O)O)=O,4,1,0,1,9,4.7e-05
G5,C(C1(C(C=C(C)OC1C)=O)O)=O,4,1,0,1,2,4.7e-05
G5,C(C1(C(CC(OC1C)=C)=O)O)=O,4,1,0,1,2,4.7e-05
G5,C(C1(C(COC(C1O)=C)O)O)=O,8,1,0,1,24,4.7e-05
G5,C(C1(C(C(O)OCC1O)=C)O)=O,8,2,0,2,16,9.499999999999999e-05
G5,C1OCC(C(C=1)=O)(C(CO)O)O,4,1,0,1,12,4.7e-05
G5,C(C1(C=COCC1(CO)O)O)=O,4,1,0,1,43,4.7e-05
G5,C(C1(C=COC(CO)C1O)O)=O,8,1,0,1,37,4.7e-05
G5,C1(C(C(C=CO1)(CO)O)O)=O,4,1,0,1,43,4.7e-05
G5,C1(C(C(CO)=CC(O)O1)O)=O,4,1,0,1,43,4.7e-05
G5,C1(C(C(C(C(O)O1)O)=C)O)=O,8,2,0,2,28,9.499999999999999e-05
G5,C(C(C1C(O)OCC(C=1)=O)O)=O,4,1,0,1,51,4.7e-05
G5,C1(C(O)OCC(C=1)=O)CO,2,1,0,1,2,4.7e-05
G5,C1(C(OCC(C=1)=O)O)C(C)O,4,1,0,1,41,4.7e-05
G5,C(C1(C(C=CCO1)(CO)O)O)=O,4,1,0,1,20,4.7e-05
G5,C1(C(C(O)OCC1(C=C)O)O)=O,8,2,0,2,2,9.499999999999999e-05
G5,C(C1COC(C(C=1)=O)O)(C)=O,2,1,0,1,45,4.7e-05
G5,C(CC1(C(C=COC1)=O)O)=O,2,1,0,1,12,4.7e-05
G5,C1(C=C(C=O)COC1(C)O)=O,2,1,0,1,14,4.7e-05
G5,C(C1(COC(C(C1)=O)=C)O)=O,2,1,0,1,14,4.7e-05
G5,C1C2COC(C=1)(C(CO)(O2)O)O,8,1,0,1,2,4.7e-05
G5,C(C1(C=COC(C=O)C1O)O)=O,8,1,0,1,1,4.7e-05
G5,C(C1(C(COC(C1)O)=C)O)=O,4,2,0,2,43,9.499999999999999e-05
G5,C(C1(C=COCC1(C)O)O)=O,4,1,0,1,43,4.7e-05
G5,C(C1C(C)OC(C(C=1)=O)O)(C)=O,4,1,0,1,45,4.7e-05
G5,C(CC1(C(C=COC1C)=O)O)=O,4,1,0,1,4,4.7e-05
G5,C(C1C(C)OC(C(C=1)=O)(C)O)=O,4,1,0,1,14,4.7e-05
G5,C(C1(C(C)OC(C(C1)=O)=C)O)=O,4,1,0,1,14,4.7e-05
G5,C1C(CO)(O)OCC(C=1C=O)O,4,1,0,1,51,4.7e-05
G5,C(C1(C=C(CO)OCC1O)O)=O,4,1,0,1,51,4.7e-05
G5,C1(C(OCC(C=1)=O)O)C(CO)O,4,1,0,1,51,4.7e-05
G5,C=C1C(C(C(CO1)O)O)=O,4,1,0,1,2,4.7e-05
G5,C1C2(COC(C=1)(CO2)O)O,3,1,0,1,32,4.7e-05
G5,C1(C2C(C(C=CO2)O1)O)=O,8,2,0,2,29,9.499999999999999e-05
G5,C1(C2(C=CC(CO2)O1)O)=O,4,1,0,1,50,4.7e-05
G5,C1C2C(OC(C=1)C(O2)O)O,10,1,0,1,37,4.7e-05
G5,C1C(C(COC=1)O)CC(C=O)=O,4,1,0,1,46,4.7e-05
G5,C(CC1C=C(C=O)OCC1O)=O,4,1,0,1,46,4.7e-05
G5,C(CC1CC(C(CO)OC=1)=O)=O,2,1,0,1,43,4.7e-05
G5,C(C1C(C(C=CO1)CC=O)O)=O,8,1,0,1,43,4.7e-05
G5,C1(COC(C=CC1O)(CO)O)=O,4,1,0,1,32,4.7e-05
G5,C1(COC(CO)=CC(C1O)O)=O,4,1,0,1,32,4.7e-05
G5,C1C(C(CO)(OCC(C=1)=O)O)O,4,1,0,1,12,4.7e-05
G5,C1(C(C(C=COC1)(CO)O)O)=O,4,1,0,1,5,4.7e-05
G5,C1OCC(CO)(C(C(C=1)=O)O)O,4,1,0,1,5,4.7e-05
G5,C1(COC(C(C(C1O)O)O)=C)=O,8,1,0,1,5,4.7e-05
G5,C1OC(CO)C(C(C(C=1)=O)O)O,8,1,0,1,38,4.7e-05
G5,C1C(CO)OC(C(C(C=1)=O)O)O,8,1,0,1,19,4.7e-05
G5,C1C(COC(C(C=1C=O)O)O)O,8,1,0,1,30,4.7e-05
G5,C1C(O)OCC(C(C=1C=O)O)O,8,2,0,2,29,9.499999999999999e-05
G5,C1(COC(C=O)=CC(C1)O)=O,2,1,0,1,20,4.7e-05
G5,C(C1(C=CCC(CO1)=O)O)=O,2,1,0,1,20,4.7e-05
G5,C(C1(CC=CC(CO1)=O)O)=O,2,1,0,1,20,4.7e-05
G5,C1(C)C(COC(C(C=1)=O)O)O,4,1,0,1,29,4.7e-05
G5,C1(C(O)OCC(C(C1)=C)O)=O,4,3,0,3,29,0.00014199999999999998
G5,C1(CC(C(OCC1O)=C)O)=O,4,1,0,1,45,4.7e-05
G5,C1C(C)(O)OCC(C(C=1)=O)O,4,1,0,1,45,4.7e-05
G5,C1(C(COC(C(C1)=C)O)O)=O,4,3,0,3,16,0.00014199999999999998
G5,C1(C(O)OCC(C(C=1)=O)O)C,4,1,0,1,16,4.7e-05
G5,C1(CCOC(C=O)=CC1O)=O,2,1,0,1,20,4.7e-05
G5,C(C1(C=CC(CCO1)=O)O)=O,2,1,0,1,20,4.7e-05
G5,C(C1CCOC(C(C=1)=O)O)=O,2,1,0,1,29,4.7e-05
G5,C1(C(O)OCC=C(C=O)C1)=O,2,1,0,1,29,4.7e-05
G5,C1(CO)CCOC(C(C=1)=O)O,2,1,0,1,29,4.7e-05
G5,C1(C(O)OCC=C(CO)C1)=O,2,2,0,2,29,9.499999999999999e-05
G5,C1(C(C(C(OCC1)=C)O)O)=O,4,1,0,1,45,4.7e-05
G5,C1(CCOC(C(C1O)=C)O)=O,4,2,0,2,2,9.499999999999999e-05
G5,C(C1CC=CC(C(O)O1)=O)=O,4,1,0,1,20,4.7e-05
G5,C(C1C=CCC(C(O1)O)=O)=O,4,1,0,1,20,4.7e-05
G5,C(C1C(C=CC(C(O)O1)=O)O)=O,8,1,0,1,0,4.7e-05
G5,C1(C(C(C(OCC1O)=C)O)O)=O,8,1,0,1,0,4.7e-05
G5,C1C(C(OCC(C=1C=O)=O)O)O,4,1,0,1,1,4.7e-05
G5,C(C1C(C(C(C=CO1)=O)O)O)=O,8,1,0,1,1,4.7e-05
G5,C1OCC(C)(C(C(C=1)=O)O)O,4,1,0,1,49,4.7e-05
G5,C1(CC(OCC(C1O)=C)O)=O,4,2,0,2,49,9.499999999999999e-05
G5,C1CC(CO)(OCC(C=1)=O)O,2,1,0,1,49,4.7e-05
G5,C1(COC(C=CC1)(CO)O)=O,2,1,0,1,49,4.7e-05
G5,C1(COC(CO)=CC(C1)O)=O,2,1,0,1,49,4.7e-05
G5,C1(CC(C=COC1)(CO)O)=O,2,1,0,1,49,4.7e-05
G5,C1(COC(C=C(CO)C1)O)=O,2,2,0,2,29,9.499999999999999e-05
G5,C1(CO)CC(OCC(C=1)=O)O,2,1,0,1,49,4.7e-05
G5,C1C(C(C)(OCC(C=1)=O)O)O,4,1,0,1,49,4.7e-05
G5,C1(COC(C(C(C1)O)O)=C)=O,4,1,0,1,49,4.7e-05
G5,C(C1C(C=CC(C(O1)O)O)=O)=O,8,1,0,1,1,4.7e-05
G5,C(C1C=CC(C(C(O1)O)O)=O)=O,8,1,0,1,1,4.7e-05
G5,C1(COC(C(C(C=1)=O)O)O)C,4,1,0,1,49,4.7e-05
G5,C1(C(C(OCC(C1)=C)O)O)=O,4,3,0,3,49,0.00014199999999999998
G5,C1(COC(C(C(C1)=C)O)O)=O,4,3,0,3,55,0.00014199999999999998
G5,C1(C)C(C(OCC(C=1)=O)O)O,4,1,0,1,55,4.7e-05
G5,C(C1C(C(C=CC(O)O1)=O)O)=O,8,1,0,1,0,4.7e-05
G5,C1C(O)OC(C)C(C(C=1)=O)O,8,1,0,1,11,4.7e-05
G5,C1C(CO)(O)OCC(C(C=1)=O)O,4,2,0,2,29,9.499999999999999e-05
G5,C1(C(COC(CO)=CC1O)O)=O,4,1,0,1,32,4.7e-05
G5,C1(COC(C(C(C1O)O)=C)O)=O,8,2,0,2,5,9.499999999999999e-05
G5,C1(COC(C(CO)=CC1O)O)=O,4,2,0,2,29,9.499999999999999e-05
G5,C1(COC=C(CO)C(C1O)O)=O,4,1,0,1,5,4.7e-05
G5,C=C1C(O)OCC(C(C1O)O)O,16,2,0,2,38,9.499999999999999e-05
G5,C1C(C(COC(C=1CO)O)O)O,8,1,0,1,38,4.7e-05
G5,C1OCC(C(C(C=1CO)O)O)O,8,1,0,1,38,4.7e-05
G5,C1(C(COC(C=O)=CC1)O)=O,2,1,0,1,12,4.7e-05
G5,C(C1C=CC(C(O)OC1)=O)=O,4,1,0,1,23,4.7e-05
G5,C1(C(O)OCC(C=O)=CC1)=O,2,1,0,1,23,4.7e-05
G5,C(C1C(C(C=COC1)O)=O)=O,4,1,0,1,38,4.7e-05
G5,C(C1COC=CC(C1O)=O)=O,4,1,0,1,23,4.7e-05
G5,C1(C=C(C=O)COC(C1)O)=O,2,2,0,2,29,9.499999999999999e-05
G5,C=C1C(O)OC2C(C(C1O2)O)O,32,2,0,2,23,9.499999999999999e-05
G5,C1OC2C(C(C(C=1CO)O2)O)O,16,1,0,1,23,4.7e-05
G5,C1C(CO)(O)OCCC(C=1)=O,2,1,0,1,20,4.7e-05
G5,C1(CCOC(CO)=CC1O)=O,2,1,0,1,20,4.7e-05
G5,C1(C(OC(C(C(C1)=O)=C)C)O)=O,4,2,0,2,4,9.499999999999999e-05
G5,C1(C(C(C)OC(C=O)=CC1)O)=O,4,1,0,1,12,4.7e-05
G5,C1(CC(C(C)=O)OC=CC1O)=O,4,1,0,1,45,4.7e-05
G5,C(C)(C1CC(C=CC(O)O1)=O)=O,4,1,0,1,45,4.7e-05
G5,C1(CC(C)OC(C=O)=CC1O)=O,4,1,0,1,22,4.7e-05
G5,C(C1(C=CC(CC(C)O1)=O)O)=O,4,1,0,1,22,4.7e-05
G5,C(CC1C(C=CCC(O1)O)=O)=O,4,1,0,1,13,4.7e-05
G5,C(CC1C(CC=CC(O)O1)=O)=O,4,1,0,1,13,4.7e-05
G5,C(CC1C(CC(C=CO1)O)=O)=O,4,1,0,1,13,4.7e-05
G5,C(CC1CC(C(C=CO1)O)=O)=O,4,1,0,1,13,4.7e-05
G5,C(CC1CC(C=CC(O)O1)=O)=O,4,2,0,2,29,9.499999999999999e-05
G5,C(CC1CC=CC(C(O)O1)=O)=O,4,1,0,1,13,4.7e-05
G5,C(CC1C=CCC(C(O)O1)=O)=O,4,1,0,1,13,4.7e-05
G5,C(C1C=CC(C(O)OC1C)=O)=O,8,1,0,1,23,4.7e-05
G5,C1(C(OC(C(C=O)=CC1)C)O)=O,4,1,0,1,23,4.7e-05
G5,C1OC(C)C(C(C(C=1)=O)=O)CO,4,1,0,1,4,4.7e-05
G5,C=C1C(C(CC(OC1C)O)=O)=O,4,2,0,2,29,9.499999999999999e-05
G5,C1(CC(C=COC1C(C)=O)O)=O,4,1,0,1,9,4.7e-05
G5,C1(C(C(C)=O)OC(C=CC1)O)=O,4,1,0,1,9,4.7e-05
G5,C(C)(C1C(C=CCC(O1)O)=O)=O,4,1,0,1,9,4.7e-05
G5,C(CC1CC(C(C=CO1)=O)O)=O,4,1,0,1,13,4.7e-05
G5,C(CC1C=CC(CC(O1)O)=O)=O,4,2,0,2,29,9.499999999999999e-05
G5,C(C1C(C=CC(O)OC1C)=O)=O,8,2,0,2,29,9.499999999999999e-05
G5,C(C1C(C(C=COC1C)O)=O)=O,8,1,0,1,4,4.7e-05
G5,C(C1C(C)OC=CC(C1O)=O)=O,8,1,0,1,4,4.7e-05
G5,C1(C=C(C=O)C(C)OC(C1)O)=O,4,2,0,2,29,9.499999999999999e-05
G5,C(C1C(CC(C=CO1)(C)O)=O)=O,4,1,0,1,6,4.7e-05
G5,C1(C(C=O)OC(C=C(C)C1)O)=O,4,1,0,1,6,4.7e-05
G5,C(C1C(C=C(C)CC(O1)O)=O)=O,4,1,0,1,6,4.7e-05
G5,C1(C(C=O)OC(CC(C1)=C)O)=O,4,3,0,3,55,0.00014199999999999998
G5,C(CC1C(C(CC=CO1)=O)O)=O,4,1,0,1,45,4.7e-05
G5,C1(CC(C=O)OC=CC1(C)O)=O,4,1,0,1,21,4.7e-05
G5,C(C1CC(C(C)=CC(O)O1)=O)=O,4,1,0,1,21,4.7e-05
G5,C(C1CC(C(CC(O1)O)=C)=O)=O,4,2,0,2,21,9.499999999999999e-05
G5,C(CC1C(CC(C=CO1)=O)O)=O,4,1,0,1,6,4.7e-05
G5,C1C(O)OC(CO)C(C(C=1)=O)O,8,1,0,1,0,4.7e-05
G5,C1C(C(CO)OC(C(C=1)=O)O)O,8,1,0,1,12,4.7e-05
G5,C(C1(C=CC(C(CO1)O)O)O)=O,8,1,0,1,20,4.7e-05
G5,C1C(C(C(COC=1C=O)O)O)O,8,1,0,1,20,4.7e-05
G5,C1C(C(COC(C=1)(CO)O)O)O,8,1,0,1,20,4.7e-05
G5,C1C(C(C(COC=1CO)O)O)O,8,1,0,1,20,4.7e-05
G5,C=C1C(C(C(C(CO1)O)O)O)O,16,1,0,1,45,4.7e-05
G5,C1C(C(C(OCC=1C=O)O)O)O,8,2,0,2,29,9.499999999999999e-05
G5,C1C(CC(O)OC(C=1)=O)O,4,1,0,1,33,4.7e-05
G5,C1(C(C=CCC(O)O1)O)=O,4,1,0,1,33,4.7e-05
G5,C1(C(CC=CC(O)O1)O)=O,4,1,0,1,33,4.7e-05
G5,C1(C(CC(C=CO1)O)O)=O,4,1,0,1,33,4.7e-05
G5,C1C(C(O)OCC(C=1)O)O,8,2,0,2,29,9.499999999999999e-05
G5,C1(C(C=CC(C(O)O1)O)O)=O,8,2,0,2,29,9.499999999999999e-05
G5,C1C(C(OCC(C=1)=O)O)(CO)O,4,2,0,2,29,9.499999999999999e-05
G5,C(C1(COC(C=CC1O)O)O)=O,8,2,0,2,29,9.499999999999999e-05
G5,C(C1(COC=CC(C1O)O)O)=O,8,1,0,1,38,4.7e-05
G5,C(C1(C=CC(C(O)OC1)O)O)=O,8,2,0,2,29,9.499999999999999e-05
G5,C(C1(C=CC(COC1O)=O)O)=O,4,1,0,1,1,4.7e-05
G5,C1C(C(C(OCC=1)O)(CO)O)O,8,1,0,1,29,4.7e-05
G5,C(C1(C(CC=COC1)=O)O)=O,2,1,0,1,38,4.7e-05
G5,C1C2(C(O)OCC(C=1)(O2)O)CO,8,1,0,1,35,4.7e-05
G5,C1C2C(C(OC(C=1)O2)O)(CO)O,16,1,0,1,2,4.7e-05
G5,C(C1(C(CC=COC1C)=O)O)=O,4,1,0,1,4,4.7e-05
G5,C(C1(C=COCC(C1O)O)O)=O,8,1,0,1,41,4.7e-05
G5,C(C1C(C(OCC(C=1)=O)O)O)=O,4,1,0,1,51,4.7e-05
G5,C(C1(COC=CC(C1)=O)O)=O,2,1,0,1,38,4.7e-05
G5,C(C1(C(C)OC=CC(C1)=O)O)=O,4,1,0,1,25,4.7e-05
G5,C(C1C(CC(C=CO1)CO)=O)=O,4,1,0,1,55,4.7e-05
G5,C(C1C=COC(C(C1)=O)CO)=O,4,1,0,1,43,4.7e-05
G5,C(CC1CC(C(COC=1)O)=O)=O,2,1,0,1,38,4.7e-05
G5,C(C(C1C(CCC=CO1)=O)O)=O,4,1,0,1,27,4.7e-05
G5,C(C(C1C=COCC(C1)=O)O)=O,4,1,0,1,32,4.7e-05
G5,C1C(CO)OC(C=1CO)=O,2,1,0,1,29,4.7e-05
G5,C(C=C1C(OCC1)=O)=O,2,2,0,2,29,9.499999999999999e-05
G5,C(CC1C(OCC=1)=O)=O,1,1,0,1,28,4.7e-05
G5,C(C1C=C(C(O1)=O)C)=O,2,1,0,1,14,4.7e-05
G5,C(C1CC(C(O1)=O)=C)=O,2,2,0,2,29,9.499999999999999e-05
G5,C1(C(C(CO1)=CC=O)O)=O,4,2,0,2,29,9.499999999999999e-05
G5,C1(C(C(C(C=O)O1)=C)O)=O,4,2,0,2,29,9.499999999999999e-05
G5,C1(C(C(C(CO)O1)=C)O)=O,4,2,0,2,29,9.499999999999999e-05
G5,C1(C(C(CO1)=CCO)O)=O,4,2,0,2,29,9.499999999999999e-05
G5,C1(C(C(C=C)(CO1)O)O)=O,4,2,0,2,29,9.499999999999999e-05
G5,C1(C(C(CO1)=C)O)=O,2,2,0,2,29,9.499999999999999e-05
G5,C1C(COC(C=1CO)=O)O,2,1,0,1,29,4.7e-05
G5,C1(C(C=CCO1)(CO)O)=O,2,1,0,1,29,4.7e-05
G5,C1(C2C=CC(CO)(O2)O1)=O,4,1,0,1,2,4.7e-05
G5,C1(C(C(C(CO1)O)=C)O)=O,4,2,0,2,29,9.499999999999999e-05
G5,C1(C(C(C=O)=CCO1)O)=O,2,1,0,1,29,4.7e-05
G5,C1(C(C(CO)=CCO1)O)=O,2,1,0,1,29,4.7e-05
G5,C1(C(C(C=CC(O1)=O)O)O)=O,4,1,0,1,29,4.7e-05
G5,C1(C(C2C=CC(O2)O1)O)=O,8,1,0,1,2,4.7e-05
G5,C1(C2C(C=CC(O2)O1)O)=O,8,1,0,1,2,4.7e-05
G5,C(C(C1C(C(C(C1)=O)O)=C)O)=O,8,1,0,1,32,4.7e-05
G5,C(C(C1CC(C(C=1C)O)=O)O)=O,4,1,0,1,32,4.7e-05
G5,C1(C(C(C(C1)=CC=O)(C)O)O)=O,8,1,0,1,32,4.7e-05
G5,C1(CC=CC1(C(C=O)O)O)=O,4,1,0,1,20,4.7e-05
G5,C(C1(C(CC(C1=C)CO)=O)O)=O,4,1,0,1,29,4.7e-05
G5,C(C1(C(CC(CO)=C1C)=O)O)=O,2,1,0,1,29,4.7e-05
G5,C1(C(C=O)(C(C(C1)=C)(C)O)O)=O,4,1,0,1,29,4.7e-05
G5,C(C1C(C(C(C1)=O)(CO)O)=C)=O,4,1,0,1,41,4.7e-05
G5,C1(CC(C=O)=C(C)C1(CO)O)=O,2,1,0,1,41,4.7e-05
G5,C(C1(C(CCC(C1O)=O)=C)O)=O,4,1,0,1,7,4.7e-05
G5,C(C1(C(C)=CCC(C1O)=O)O)=O,4,1,0,1,7,4.7e-05
G5,C(C(C1(C(CCC1=C)=O)O)O)=O,4,1,0,1,7,4.7e-05
G5,C1(CC=C(C)C1(C(C=O)O)O)=O,4,1,0,1,7,4.7e-05
G5,C1(C(C(C=C(CCO)C1)O)O)=O,4,1,0,1,46,4.7e-05
G5,C1(CC(C=C)C(C(C1O)O)O)=O,16,2,0,2,29,9.499999999999999e-05
G5,C1(C(C(C=C(C(C)O)C1)O)O)=O,8,1,0,1,46,4.7e-05
G5,C1(C(C(C(C(C1)=CC)O)O)O)=O,16,1,0,1,46,4.7e-05
G5,C(CC=C(C=O)CC(CO)=O)=O,2,1,0,1,18,4.7e-05
G5,C(C(C(C=O)=C)CC(CO)=O)=O,2,2,0,2,29,9.499999999999999e-05
G5,C(CC(C(CO)=O)C(C=O)=C)=O,2,2,0,2,29,9.499999999999999e-05
G5,C(CCC(C=O)=O)=CC=O,2,2,0,2,29,9.499999999999999e-05
G5,C(CC=CCC(C=O)=O)=O,2,1,0,1,7,4.7e-05
G5,C=C(C=O)CCC(C=O)=O,1,2,0,2,29,9.499999999999999e-05
G5,C(CO)(CCC=CC=O)=O,2,2,0,2,29,9.499999999999999e-05
G5,C(CC=CCC(CO)=O)=O,2,1,0,1,7,4.7e-05
G5,C(CO)(CCC(C=O)=C)=O,1,2,0,2,29,9.499999999999999e-05
G5,C(CC(C=O)=CCC=O)=O,2,1,0,1,18,4.7e-05
G5,C(C(C(C=O)=C)CC=O)=O,2,2,0,2,29,9.499999999999999e-05
G5,C(C)=C(C=O)CCC(C=O)=O,2,1,0,1,7,4.7e-05
G5,C(C(C=C)CCC(C=O)=O)=O,2,2,0,2,7,9.499999999999999e-05
G5,C(CCCC(C=O)=O)=CC=O,2,2,0,2,7,9.499999999999999e-05
G5,C(CC=CCCC(C=O)=O)=O,2,1,0,1,7,4.7e-05
G5,C(C)(CCC(C=O)=O)=CC=O,2,1,0,1,7,4.7e-05
G5,C(CC(CCC(C=O)=O)=C)=O,1,1,0,1,7,4.7e-05
G5,C(CC(C)=CCC(C=O)=O)=O,2,1,0,1,7,4.7e-05
G5,C(CO)(CCC(C=O)=CC)=O,2,1,0,1,7,4.7e-05
G5,C(C(C=C)CCC(CO)=O)=O,2,2,0,2,7,9.499999999999999e-05
G5,C(CO)(CCCC=CC=O)=O,2,2,0,2,7,9.499999999999999e-05
G5,C(CC=CCCC(CO)=O)=O,2,1,0,1,7,4.7e-05
G5,C(CO)(CCC(C)=CC=O)=O,2,1,0,1,7,4.7e-05
G5,C(CC(CCC(CO)=O)=C)=O,1,1,0,1,7,4.7e-05
G5,C(CC(C)=CCC(CO)=O)=O,2,1,0,1,7,4.7e-05
G5,C(C(C(C=O)=CC)CC=O)=O,4,1,0,1,28,4.7e-05
G5,C(C(C=C)C(C=O)CC=O)=O,4,2,0,2,28,9.499999999999999e-05
G5,C(CC(C=O)CC=CC=O)=O,4,2,0,2,43,9.499999999999999e-05
G5,C(C(C=CCC=O)CC=O)=O,4,1,0,1,43,4.7e-05
G5,C(C(C(C)=CC=O)CC=O)=O,4,1,0,1,28,4.7e-05
G5,C(C(C(CC=O)=C)CC=O)=O,2,1,0,1,28,4.7e-05
G5,C(CC(C)=C(C=O)CC=O)=O,2,1,0,1,28,4.7e-05
G5,C(C(C=CCCC(C=O)=O)O)=O,4,2,0,2,29,9.499999999999999e-05
G5,C(C(C(CCC(C=O)=O)=C)O)=O,2,2,0,2,29,9.499999999999999e-05
G5,C(C(C(C)=CCC(C=O)=O)O)=O,4,1,0,1,7,4.7e-05
G5,C(C(C=CCCC(CO)=O)O)=O,4,2,0,2,29,9.499999999999999e-05
G5,C(C(C(CCC(CO)=O)=C)O)=O,2,2,0,2,29,9.499999999999999e-05
G5,C(C(C(C)=CCC(CO)=O)O)=O,4,1,0,1,7,4.7e-05
G5,C(C(C(C(C=O)O)=C)CC=O)=O,4,2,0,2,29,9.499999999999999e-05
G5,C(CC(C=O)=C(C)C(C=O)O)=O,4,1,0,1,45,4.7e-05
G5,C(CO)=C(C=O)CCC(C=O)=O,2,2,0,2,29,9.499999999999999e-05
G5,C(CO)(CCC(C=CC=O)O)=O,4,3,0,3,7,0.000143
G5,C(C(C(CO)=CC=O)CC=O)=O,4,2,0,2,29,9.499999999999999e-05
G5,C(CC(CO)=C(C=O)CC=O)=O,2,1,0,1,29,4.7e-05
G5,C(C(C(C=O)=CCO)CC=O)=O,4,2,0,2,29,9.499999999999999e-05
G5,C=C(C(O)=O)CCC(C=O)=O,1,1,0,1,25,4.7e-05
G5,C(CC(C=O)=O)=C(C(O)=O)C,2,1,0,1,25,4.7e-05
G5,C(CCC(C=O)=O)=CC(O)=O,2,1,0,1,7,4.7e-05
G5,C(CO)(CCC(C(O)=O)=C)=O,1,1,0,1,25,4.7e-05
G5,C(CO)(CC=C(C(O)=O)C)=O,2,1,0,1,25,4.7e-05
G5,C(CO)(CCC=CC(O)=O)=O,2,1,0,1,7,4.7e-05
G5,C(C(C(C(O)=O)=C)CC=O)=O,2,1,0,1,29,4.7e-05
G5,C(CC(C=O)=C(C(O)=O)C)=O,2,1,0,1,29,4.7e-05
G5,C(C(C=CC(O)=O)CC=O)=O,4,1,0,1,25,4.7e-05
G5,C=C(C(C=O)=O)CCC(C=O)=O,1,2,0,2,29,9.499999999999999e-05
G5,C(CC(C=O)=O)=C(C(C=O)=O)C,2,1,0,1,25,4.7e-05
G5,C(CO)(CCC(C(C=O)=O)=C)=O,1,2,0,2,29,9.499999999999999e-05
G5,C(CO)(CC=C(C(C=O)=O)C)=O,2,1,0,1,7,4.7e-05
G5,C(CO)(CCC=CC(C=O)=O)=O,2,2,0,2,29,9.499999999999999e-05
G5,C(C(C(C(C=O)=O)=C)CC=O)=O,2,2,0,2,29,9.499999999999999e-05
G5,C(CC(C=O)=C(C(C=O)=O)C)=O,2,1,0,1,25,4.7e-05
G5,C=C(C(CO)=O)CCC(C=O)=O,1,2,0,2,29,9.499999999999999e-05
G5,C(CC(C=O)=O)=C(C(CO)=O)C,2,1,0,1,7,4.7e-05
G5,C(CCC(C=O)=O)=CC(CO)=O,2,2,0,2,29,9.499999999999999e-05
G5,C(CO)(CC=CC(C(C)O)=O)=O,4,1,0,1,7,4.7e-05
G5,C(CO)(CCC(C(CO)=O)=C)=O,1,2,0,2,29,9.499999999999999e-05
G5,C(CO)(CC=C(C(CO)=O)C)=O,2,1,0,1,7,4.7e-05
G5,C(CO)(CCC=CC(CO)=O)=O,2,2,0,2,29,9.499999999999999e-05
G5,C(C(C(C(CO)=O)=C)CC=O)=O,2,2,0,2,29,9.499999999999999e-05
G5,C(CC(C=O)=C(C(CO)=O)C)=O,2,1,0,1,25,4.7e-05
G5,C(CC(C=O)=O)=C(C=O)CCO,2,1,0,1,7,4.7e-05
G5,C(C(CC=CCC(C=O)=O)O)=O,4,1,0,1,7,4.7e-05
G5,C(C(CC=CCC(CO)=O)O)=O,4,1,0,1,7,4.7e-05
G5,C(CC(C=O)=C(C=O)CCO)=O,2,1,0,1,29,4.7e-05
G5,C(CC(C=O)=C(C=O)C(O)=O)=O,2,1,0,1,17,4.7e-05
G5,C1(CCC(C=O)=O)OCC(C=1)=O,1,1,0,1,35,4.7e-05
G5,C1(COC(C1)=CCC(C=O)=O)=O,2,1,0,1,35,4.7e-05
G5,C1OCC(C=1CCC(C=O)=O)=O,1,1,0,1,7,4.7e-05
G5,C1OC(C(C=1)=O)CCC(C=O)=O,2,2,0,2,7,9.499999999999999e-05
G5,C(CO)(CCC1OCC(C=1)=O)=O,1,1,0,1,35,4.7e-05
G5,C1(COC(C1)=CCC(CO)=O)=O,2,1,0,1,35,4.7e-05
G5,C(CO)(CCC1C(COC=1)=O)=O,1,1,0,1,7,4.7e-05
G5,C(CO)(CCC1C(C=CO1)=O)=O,2,2,0,2,7,9.499999999999999e-05
G5,C(C(C1OCC(C=1)=O)CC=O)=O,2,1,0,1,35,4.7e-05
G5,C(CC(C=O)=C1CC(CO1)=O)=O,2,1,0,1,35,4.7e-05
G5,C(C(C1C(COC=1)=O)CC=O)=O,2,1,0,1,35,4.7e-05
G5,C(CC(C=O)C1C(C=CO1)=O)=O,4,2,0,2,43,9.499999999999999e-05
G5,C(CC(C=O)=CC(C=CC=O)=O)=O,4,1,0,1,43,4.7e-05
G5,C(CO)(CC(C=O)=C(C=O)C)=O,2,1,0,1,11,4.7e-05
G5,C(CC(C(CO)=O)=C(C=O)C)=O,2,1,0,1,7,4.7e-05
G5,C(CC(C(CO)=O)C=C)=O,2,2,0,2,29,9.499999999999999e-05
G5,C(CO)(CC(C=O)=CC)=O,2,1,0,1,46,4.7e-05
G5,C(CC(C(CO)=O)=CC)=O,2,1,0,1,46,4.7e-05
G5,C=CC(C=CCC(C=O)=O)=O,2,1,0,1,7,4.7e-05
G5,C1COC(C=1CCC(C=O)=O)=O,1,1,0,1,8,4.7e-05
G5,C1(CC(CO1)=CCC(C=O)=O)=O,2,1,0,1,8,4.7e-05
G5,C1(COC(C=1)=O)CCC(C=O)=O,1,1,0,1,8,4.7e-05
G5,C1C(CCC(C=O)=O)OC(C=1)=O,2,2,0,2,7,9.499999999999999e-05
G5,C(CC(C=O)=O)=C(C=O)C,2,1,0,1,29,4.7e-05
G5,C=CCCC(C=O)=O,1,2,0,2,29,9.499999999999999e-05
G5,C(CC(C=O)=O)=CC,2,1,0,1,27,4.7e-05
G5,C(CC(C=O)=O)=C1C(COC1)=O,2,1,0,1,10,4.7e-05
G5,C(CC(C=O)=O)=C1C(CCO1)=O,2,1,0,1,34,4.7e-05
G5,C(CO)(CC=CC(C=C)=O)=O,2,1,0,1,7,4.7e-05
G5,C(CO)(CCC1C(OCC=1)=O)=O,1,1,0,1,8,4.7e-05
G5,C1(CC(CO1)=CCC(CO)=O)=O,2,1,0,1,8,4.7e-05
G5,C(CO)(CCC1COC(C=1)=O)=O,1,1,0,1,8,4.7e-05
G5,C(CO)(CCC1C=CC(O1)=O)=O,2,2,0,2,7,9.499999999999999e-05
G5,C(CO)(CC=C(C=O)C)=O,2,1,0,1,11,4.7e-05
G5,C(CO)(CC=C(CO)CO)=O,1,1,0,1,7,4.7e-05
G5,C(CO)(CCC=C)=O,1,2,0,2,29,9.499999999999999e-05
G5,C(CO)(CC=CC)=O,2,1,0,1,27,4.7e-05
G5,C(CO)(CC=C1C(COC1)=O)=O,2,1,0,1,10,4.7e-05
G5,C(CO)(CC=C1C(CCO1)=O)=O,2,1,0,1,34,4.7e-05
G5,C(C(C1C(OCC=1)=O)CC=O)=O,2,1,0,1,8,4.7e-05
G5,C(CC(C=O)=C1COC(C1)=O)=O,2,1,0,1,8,4.7e-05
G5,C(C(C1COC(C=1)=O)CC=O)=O,2,1,0,1,8,4.7e-05
G5,C(CC(C=O)C1C=CC(O1)=O)=O,4,2,0,2,8,9.499999999999999e-05
G5,C(CC(C=O)=CC)=O,2,1,0,1,27,4.7e-05
G5,C(CC(C=O)=C(C(O)=O)CO)=O,2,1,0,1,33,4.7e-05
G5,C(C(C=C(C=O)CC=O)O)(O)=O,4,1,0,1,43,4.7e-05
G5,C(CC(C=O)=C1C(COC1)=O)=O,2,1,0,1,10,4.7e-05
G5,C(CC(C=O)=C1C(CCO1)=O)=O,2,1,0,1,34,4.7e-05
G5,C=C(CCO)CC(C(CO)=O)=O,1,1,0,1,46,4.7e-05
G5,C(C(CO)CC(C(CO)=O)=O)=C,2,2,0,2,29,9.499999999999999e-05
G5,C=C(C(C)O)CC(C(CO)=O)=O,2,1,0,1,46,4.7e-05
G5,C(C)=C(CO)CC(C(CO)=O)=O,2,1,0,1,46,4.7e-05
G5,C(CC(C=C)C(C(CO)=O)O)=O,4,2,0,2,29,9.499999999999999e-05
G5,C(CC(C(C)O)=CC(CO)=O)=O,4,1,0,1,46,4.7e-05
G5,C(CC(C(C(CO)=O)O)=CC)=O,4,1,0,1,46,4.7e-05
G5,C(CCC=C)(C(C(CO)=O)O)=O,2,2,0,2,29,9.499999999999999e-05
G5,C(C(C(CO)=O)O)(CC=CC)=O,4,1,0,1,46,4.7e-05
G5,C(CC(C(C(CO)O)=O)=C)(O)=O,2,1,0,1,29,4.7e-05
G5,C1(CC(CO)=CC1(CO)O)=O,2,1,0,1,55,4.7e-05
G5,C(C)(CC(C(C=O)=O)=C)=O,1,2,0,2,55,9.499999999999999e-05
G5,C=C1C(C(C(C1CO)O)O)=O,8,1,0,1,55,4.7e-05
G5,C1C(C(C(C=1CCO)=O)O)O,4,1,0,1,55,4.7e-05
G5,C1C(C(C(C=1C=O)CO)O)O,8,1,0,1,55,4.7e-05
G5,C(CC(C(C(CO)O)O)=C)(O)=O,4,1,0,1,55,4.7e-05
G5,C(CC(CO)=CC(CO)O)(O)=O,4,1,0,1,55,4.7e-05
G5,C1(CC(C(C(CO)O)O1)=C)=O,4,1,0,1,55,4.7e-05
G5,C1(CC(C(C(CO)O1)O)=C)=O,4,1,0,1,55,4.7e-05
G5,C1(CC(CO)=CC(CO)O1)=O,2,1,0,1,55,4.7e-05
G5,C1(C(CO)OC=C(CO)C1)=O,2,1,0,1,55,4.7e-05
G5,C1(CC(C(C(CO1)O)O)=C)=O,4,1,0,1,55,4.7e-05
G5,C1(CC(CO)=CC(CO1)O)=O,2,1,0,1,55,4.7e-05
G5,C1(C(COC=C(CO)C1)O)=O,2,1,0,1,38,4.7e-05
G5,C(CC(C=C)C(CO)O)(CO)=O,4,2,0,2,29,9.499999999999999e-05
G5,C(CO)(CC(CCO)=CCO)=O,2,1,0,1,46,4.7e-05
G5,C(CO)(CC(C(CO)O)=CC)=O,4,1,0,1,46,4.7e-05
G5,C(CO)(CC(C(C)O)=CCO)=O,4,1,0,1,46,4.7e-05
G5,C(CC(C=C)CO)(C(CO)O)=O,4,2,0,2,29,9.499999999999999e-05
G5,C(C(CO)O)(CC(CCO)=C)=O,2,1,0,1,46,4.7e-05
G5,C(C(CO)O)(CC(CO)=CC)=O,4,1,0,1,46,4.7e-05
G5,C(C(CO)O)(CC(C(C)O)=C)=O,4,1,0,1,46,4.7e-05
G5,C(CCC=C)(C(C(CO)O)O)=O,4,2,0,2,29,9.499999999999999e-05
G5,C(C(C(CO)O)O)(CC=CC)=O,8,1,0,1,27,4.7e-05
G5,C(CC(C=C)C(C(CO)O)O)=O,8,2,0,2,29,9.499999999999999e-05
G5,C(CC(CCO)=CC(CO)O)=O,4,1,0,1,46,4.7e-05
G5,C(CC(C(C(CO)O)O)=CC)=O,8,1,0,1,46,4.7e-05
G5,C(CC(C(C)O)=CC(CO)O)=O,8,1,0,1,46,4.7e-05
G5,C1(CC(C=C)C(C1(CO)O)O)=O,8,2,0,2,29,9.499999999999999e-05
G5,C1(CC(CCO)=CC1(CO)O)=O,2,1,0,1,46,4.7e-05
G5,C1(C(CO)(C(C(C1)=CC)O)O)=O,8,1,0,1,46,4.7e-05
G5,C1(CC(C(C)O)=CC1(CO)O)=O,4,1,0,1,46,4.7e-05
G5,C(C)(CC(C=C)C(C=O)=O)=O,2,2,0,2,29,9.499999999999999e-05
G5,C(C)(CC(C(C=O)=O)=CC)=O,2,1,0,1,46,4.7e-05
G5,C(C)(C(C=C)CC(C=O)=O)=O,2,2,0,2,29,9.499999999999999e-05
G5,C(C)=C(C(C)=O)CC(C=O)=O,2,1,0,1,46,4.7e-05
G5,C(CC(C=C)CC(C=O)=O)=O,2,2,0,2,29,9.499999999999999e-05
G5,C(CC(CC(C=O)=O)=CC)=O,2,1,0,1,46,4.7e-05
G5,C(C)=C(C=O)CC(C(C)=O)=O,2,1,0,1,46,4.7e-05
G5,C(CC(C=C)C(C(C)=O)=O)=O,2,2,0,2,29,9.499999999999999e-05
G5,C(CC(C(C(C)=O)=O)=CC)=O,2,1,0,1,46,4.7e-05
G5,C(CC=O)(CC(C=O)=CC)=O,2,1,0,1,46,4.7e-05
G5,C(CC=O)(C(C=C)CC=O)=O,2,2,0,2,29,9.499999999999999e-05
G5,C(CC(C(CC=O)=CC)=O)=O,2,1,0,1,46,4.7e-05
G5,C(CCC=C)(CC(C=O)=O)=O,1,2,0,2,29,9.499999999999999e-05
G5,C(CC=CC)(CC(C=O)=O)=O,2,1,0,1,46,4.7e-05
G5,C(CC(C(CCC=C)=O)=O)=O,1,2,0,2,29,9.499999999999999e-05
G5,C(CC(C(CC=CC)=O)=O)=O,2,1,0,1,46,4.7e-05
G5,C=C1C(C(C(C1CCO)O)O)=O,8,1,0,1,46,4.7e-05
G5,C1(C(CO)C(C=C)C(C1O)O)=O,16,2,0,2,29,9.499999999999999e-05
G5,C1(C(C=C(CCO)C1CO)O)=O,4,1,0,1,46,4.7e-05
G5,C=C1C(C(C(C1C(C)O)O)O)=O,16,1,0,1,46,4.7e-05
G5,C1(C(C(C(C1CO)=CC)O)O)=O,16,1,0,1,46,4.7e-05
G5,C1(C(C=C(C(C)O)C1CO)O)=O,8,1,0,1,46,4.7e-05
G5,C1C(C(C(C=1CCCO)=O)O)O,4,1,0,1,46,4.7e-05
G5,C1(C(C(C(C1O)O)O)CC=C)=O,16,2,0,2,29,9.499999999999999e-05
G5,C1C(C(C(C=1CC(C)O)=O)O)O,8,1,0,1,46,4.7e-05
G5,C1(C(C(C(C1C=CC)O)O)O)=O,32,1,0,1,46,4.7e-05
G5,C1C(C(C(C=1C=O)CCO)O)O,8,1,0,1,46,4.7e-05
G5,C(C1C(C(C(C1C=C)O)O)O)=O,32,2,0,2,29,9.499999999999999e-05
G5,C(C1C(CCO)=CC(C1O)O)=O,8,1,0,1,46,4.7e-05
G5,C1C(C(C(C=1C=O)C(C)O)O)O,16,1,0,1,46,4.7e-05
G5,C(C1C(C(C(C1O)O)O)=CC)=O,32,1,0,1,46,4.7e-05
G5,C(C1C(C(C)O)=CC(C1O)O)=O,16,1,0,1,46,4.7e-05
G5,C1(CC(C=C)C(C(CO)O)O1)=O,8,2,0,2,29,9.499999999999999e-05
G5,C1(CC(C(C(CO)O)O1)=CC)=O,8,1,0,1,46,4.7e-05
G5,C1(CC(C=C)C(C(CO)O1)O)=O,8,2,0,2,29,9.499999999999999e-05
G5,C1(CC(CCO)=CC(CO)O1)=O,2,1,0,1,46,4.7e-05
G5,C1(CC(C(C(CO)O1)O)=CC)=O,8,1,0,1,46,4.7e-05
G5,C1(CC(C(C)O)=CC(CO)O1)=O,4,1,0,1,46,4.7e-05
G5,C1(C(O)OC(CO)C(C=C)C1)=O,8,2,0,2,29,9.499999999999999e-05
G5,C1(C(OC(C(C1)=CC)CO)O)=O,8,1,0,1,46,4.7e-05
G5,C1(CC(C=C)C(OC1CO)O)=O,8,2,0,2,29,9.499999999999999e-05
G5,C1(C(CO)OC=C(CCO)C1)=O,2,1,0,1,46,4.7e-05
G5,C1(C(CO)OC(C(C1)=CC)O)=O,8,1,0,1,46,4.7e-05
G5,C1(C(CO)OC=C(C(C)O)C1)=O,4,1,0,1,46,4.7e-05
G5,C1(CC(C=C)C(C(CO1)O)O)=O,8,2,0,2,29,9.499999999999999e-05
G5,C1(CC(CCO)=CC(CO1)O)=O,2,1,0,1,46,4.7e-05
G5,C1(CC(C(C(CO1)O)O)=CC)=O,8,1,0,1,46,4.7e-05
G5,C1(CC(C(C)O)=CC(CO1)O)=O,4,1,0,1,46,4.7e-05
G5,C1(C(O)OCC(C(C=C)C1)O)=O,8,2,0,2,29,9.499999999999999e-05
G5,C1(C(OCC=C(CCO)C1)O)=O,2,1,0,1,46,4.7e-05
G5,C1(C(O)OCC(C(C1)=CC)O)=O,8,1,0,1,46,4.7e-05
G5,C1(C(OCC=C(C(C)O)C1)O)=O,4,1,0,1,46,4.7e-05
G5,C1(CC(C=C)COC(C1O)O)=O,8,2,0,2,29,9.499999999999999e-05
G5,C1(C(C(OCC(C1)=CC)O)O)=O,8,1,0,1,46,4.7e-05
G5,C1(CC(C=C)C(O)OCC1O)=O,8,2,0,2,29,9.499999999999999e-05
G5,C1(C(COC=C(CCO)C1)O)=O,2,1,0,1,38,4.7e-05
G5,C1(C(COC(C(C1)=CC)O)O)=O,8,1,0,1,38,4.7e-05
G5,C1(C(COC=C(C(C)O)C1)O)=O,4,1,0,1,38,4.7e-05
G5,C1(CC(C=C)C(C(OC1)O)O)=O,8,2,0,2,29,9.499999999999999e-05
G5,C1(COC(C=C(CCO)C1)O)=O,2,1,0,1,46,4.7e-05
G5,C1(COC(C(C(C1)=CC)O)O)=O,8,1,0,1,46,4.7e-05
G5,C1(COC(C=C(C(C)O)C1)O)=O,4,1,0,1,46,4.7e-05
G5,C(C)(CC(C(C=O)=O)=CC=O)=O,2,1,0,1,0,4.7e-05
G5,C(CC(CC(C=O)=O)=CC=O)=O,2,1,0,1,0,4.7e-05
G5,C(CC(C(C(C)=O)=O)=CC=O)=O,2,1,0,1,46,4.7e-05
G5,C(CC(C(CC=O)=O)=CC=O)=O,2,1,0,1,0,4.7e-05
G5,C(CC(C=O)=O)=C(C(C)=O)CO,2,1,0,1,7,4.7e-05
G5,C(CO)(CC=C(C(C)=O)CO)=O,2,1,0,1,7,4.7e-05
G5,C(CC(C=O)=C(C(C)=O)CO)=O,2,1,0,1,43,4.7e-05
G5,C(CO)(CC=CCC(C=O)=O)=O,2,2,0,2,29,9.499999999999999e-05
G5,C(CC(C=O)=CCC(C=O)=O)=O,2,2,0,2,29,9.499999999999999e-05
G5,C(CC(C=O)=O)=CC(CCO)=O,2,1,0,1,7,4.7e-05
G5,C(CO)(CC=CC(CCO)=O)=O,2,1,0,1,7,4.7e-05
G5,C(CO)(CC=CCC(CO)=O)=O,2,1,0,1,7,4.7e-05
G5,C(C(CCC(C=O)=O)=CC=O)=O,2,2,0,2,29,9.499999999999999e-05
G5,C(C(C(C=O)=CC=O)CC=O)=O,4,2,0,2,29,9.499999999999999e-05
G5,C(CC(C=O)=C(C=O)CC=O)=O,2,1,0,1,43,4.7e-05
G5,C(CC1C(C(C(C1O)O)=O)=C)=O,8,1,0,1,43,4.7e-05
G5,C(CC(C(CO)=O)=CCO)=O,2,1,0,1,46,4.7e-05
G5,C(C)(CC(C(C=O)=O)=CCO)=O,2,1,0,1,46,4.7e-05
G5,C(CO)=C(C(C)=O)CC(C=O)=O,2,1,0,1,46,4.7e-05
G5,C(CC(C(C(C)=O)=O)=CCO)=O,2,1,0,1,46,4.7e-05
G5,C(CO)(CC(C=O)=CC(O)=O)=O,2,1,0,1,33,4.7e-05
G5,C(CC(C(CO)=O)=CC(O)=O)=O,2,1,0,1,33,4.7e-05
G5,C(C(C)O)(CC(C=O)=O)=CCO,4,1,0,1,46,4.7e-05
G5,C(C(CO)O)(CC(C=O)=O)=CC,4,1,0,1,46,4.7e-05
G5,C(C(C(C(CC=CC)=O)O)O)=O,8,1,0,1,46,4.7e-05
G5,C(CO)(CC(C(C)O)=CC=O)=O,4,1,0,1,46,4.7e-05
G5,C(C(C(CC(CO)=O)=CC)O)=O,4,1,0,1,46,4.7e-05
G5,C(CC(C(C)O)=CC(C=O)O)=O,8,1,0,1,46,4.7e-05
G5,C(CC(C(C(C=O)O)O)=CC)=O,8,1,0,1,46,4.7e-05
G5,C(CC1(C(C(C(C1O)O)O)O)O)O,10,3,0,3,29,0.000176
G5,CC1(C(C(C(C1O)O)O)O)O,10,3,0,3,29,0.000176
G5,C1C(C(C(C1O)O)O)O,10,1,0,1,45,5.9e-05
G5,C(C1(CC(C(C(C1O)O)O)O)O)O,32,2,0,2,29,0.000117
G5,CC1(C(C(C(C(C1O)O)O)O)O)O,10,2,0,2,29,0.000117
G5,C1C(C(C(C(C1O)O)O)O)O,10,2,0,2,29,0.000117
G5,CC(C1(C(C(C(C1O)O)O)O)O)O,20,4,0,4,29,0.000234
G5,C(C(C1(C(C(CC1O)O)O)O)O)O,32,2,0,2,29,0.000117
G5,C1C(C(C(C(C(C1O)O)O)O)O)O,36,2,0,2,29,0.000117
G5,C1C2(C(C(C(C2O)O1)O)O)O,32,1,0,1,17,5.9e-05
G5,C1C(C(C(O)O1)(C(CCO)O)O)O,16,2,0,2,35,0.000106
G5,C(CC(C1C(C(C(O)O1)O)O)O)O,32,1,0,1,35,5.9e-05
G5,C1C(C(C(O)O1)O)(C(CCO)O)O,16,1,0,1,34,5.9e-05
G5,C(C(C=CC(C=O)=O)(CO)O)(O)=O,4,1,0,1,17,5.9e-05
G5,C1C(C(C(O)O1)(C(C(C)O)O)O)O,32,2,0,2,11,0.000106
G5,CC(C(C1C(C(C(O)O1)O)O)O)O,64,2,0,2,35,0.000106
G5,C1C(C(C(O)O1)O)(C(C(C)O)O)O,32,2,0,2,34,0.000106
G5,C(C(C)(C1C(C(C(O)O1)O)O)O)=O,32,3,0,3,29,0.000164
G5,C1(CC(C(C(C(CO)O)O)O1)O)=O,16,1,0,1,2,5.9e-05
G5,C(CC1C(CO)(C(C(O)O1)O)O)=O,16,2,0,2,2,0.000106
G5,C1(C(O)OC(C(CO)(CO)O)C1)=O,4,2,0,2,23,0.000106
G5,C1(CC(C(CO)(C(CO)O1)O)O)=O,8,1,0,1,19,5.9e-05
G5,C1(CC(CO)(C(C(CO)O1)O)O)=O,8,1,0,1,2,5.9e-05
G5,C1(CC(C(CO)(C(CO1)O)O)O)=O,8,2,0,2,29,0.000117
G5,C1(CC(CO)(C(C(CO1)O)O)O)=O,8,2,0,2,29,0.000117
G5,C1(CC(C(C(CO1)(CO)O)O)O)=O,8,2,0,2,29,0.000117
G5,C1(CC(C(C(C(CO)O1)O)O)O)=O,16,1,0,1,48,5.9e-05
G5,C1(COC(CO)C(C(C1O)O)O)=O,16,1,0,1,2,5.9e-05
G5,C(C1(C(CO)(C(CCO1)O)O)O)=O,8,2,0,2,2,0.000106
G5,C(C1(C(C(C(CO)CO1)O)O)O)=O,16,2,0,2,18,0.000106
G5,C(C1(CC(C(CO)(CO1)O)O)O)=O,8,3,0,3,30,0.000164
G5,C(C1C(CO)(C(CC(O1)O)O)O)=O,16,2,0,2,2,0.000106
G5,CC(CC(C(C(CO)O)O)O)O,16,2,0,2,29,0.000117
G5,C1C(CC(O)O1)(C(C(CO)O)O)O,16,3,0,3,49,0.000164
G5,CC(CO)(C1C(C(C(O)O1)O)O)O,32,2,0,2,49,0.000106
G5,C1C(C(CO1)O)(C(C(CO)O)O)O,16,2,0,2,29,0.000117
G5,C1CC(C(O)O1)(C(C(CO)O)O)O,16,3,0,3,34,0.000164
G5,C1C(C(C(O)O1)O)(C(C)(CO)O)O,16,2,0,2,49,0.000106
G5,CC(C(C(C)O)(C(CO)O)O)O,6,2,0,2,29,0.000117
G5,CC(C(C(C(C(C)O)O)O)O)O,10,1,0,1,4,5.9e-05
G5,CC(C1C(C(C(O)O1)O)O)O,32,3,0,3,4,0.000164
G5,C1C(C(C(C)O)(C(C(O)O1)O)O)O,32,2,0,2,27,0.000106
G5,CC(C1C(C(C(C(O)O1)O)O)O)O,64,2,0,2,4,0.000106
G5,C(C(C(C(C)O)O)O)=CC(C=O)=O,16,1,0,1,4,5.9e-05
G5,C(C(CO)(C(C)O)O)=CC(C=O)=O,8,1,0,1,46,5.9e-05
G5,C1C(C(C)O)(C(C(O)O1)O)O,16,2,0,2,4,0.000106
G5,C(C(O)OCC(CO)O)=O,4,1,0,1,27,5.9e-05
G5,C(C(C=O)(CC(CO)O)O)=O,2,1,0,1,17,5.9e-05
G5,C(C(CO)(O)OCC(CO)O)=O,4,1,0,1,2,5.9e-05
G5,C(C=O)(OCCC(CO)O)=O,2,1,0,1,30,5.9e-05
G5,C(C=O)(OCC(C(C)O)O)=O,4,1,0,1,30,5.9e-05
G5,C(OC(C=O)CC(CO)O)=O,4,1,0,1,37,5.9e-05
G5,C(C(C=O)O)(OCC(CO)O)=O,4,1,0,1,2,5.9e-05
G5,C(C=O)(OC(CO)C(CO)O)=O,4,1,0,1,2,5.9e-05
G5,C(C=O)(OCC(C(CO)O)O)=O,4,2,0,2,29,0.000117
G5,C(C(CO)O)(OCC(CO)O)=O,4,1,0,1,2,5.9e-05
G5,C1(CC(C(CO)(C(CO)O)O1)O)=O,8,1,0,1,48,5.9e-05
G5,C1C(C(C(C(CCO)O)(O)O1)O)O,16,2,0,2,34,0.000106
G5,C(CC(C1(C(C(CO1)O)O)O)O)=O,16,2,0,2,34,0.000106
G5,C(C1(C(C(CO1)O)O)O)(O)=O,8,1,0,1,17,5.9e-05
G5,CC(C(C1(C(C(CO1)O)O)O)O)O,32,2,0,2,34,0.000106
G5,C(C)(C(C1(C(C(CO1)O)O)O)O)=O,16,2,0,2,34,0.000106
G5,C(C(C)(C1(C(C(CO1)O)O)O)O)=O,16,3,0,3,45,0.000164
G5,CC(CO)(C1(C(C(CO1)O)O)O)O,16,2,0,2,49,0.000106
G5,C(CO)(OC(CO)(C(CO)O)O)=O,4,1,0,1,17,5.9e-05
G5,C(CCC(C=O)=O)(CC(CO)O)=O,2,1,0,1,12,5.9e-05
G5,C(C(C(CC(C=O)=O)O)O)(CC)=O,4,1,0,1,29,5.9e-05
G5,C(C(C)C(CO)O)(CC(C=O)=O)=O,4,1,0,1,29,5.9e-05
G5,C(C(CO)O)(CC(C(CC)=O)=O)=O,2,1,0,1,4,5.9e-05
G5,C(CC(C(C(C(CO)O)=O)=O)C)=O,4,1,0,1,29,5.9e-05
G5,C(CC(C(C=O)=O)CC(CO)O)=O,4,4,0,4,29,0.000223
G5,C(C(CO)O)(CC(C=CCO)=O)=O,4,1,0,1,29,5.9e-05
G5,C(C(C=CC(CC(CO)O)=O)O)=O,8,1,0,1,29,5.9e-05
G5,C(C1(C(COC1C(CO)O)O)O)=O,16,1,0,1,29,5.9e-05
G5,C(C1(C(COC(CO)C1O)O)O)=O,16,1,0,1,29,5.9e-05
G5,C(C1(C(CO)OC(CC1O)O)O)=O,16,2,0,2,9,0.000106
G5,C(C1C(O)OC(CO)C(C1O)O)=O,32,2,0,2,29,0.000106
G5,C(C1(C(COCC(C1O)O)O)O)=O,16,1,0,1,29,5.9e-05
G5,C(C1C(COC(C(C1O)O)O)O)=O,32,2,0,2,38,0.000106
G5,C(C1(C(COC(CC1O)O)O)O)=O,16,2,0,2,38,0.000106
G5,C(C1(C(O)OCC(CC1O)O)O)=O,16,2,0,2,6,0.000106
G5,C(C1C(O)OCC(C(C1O)O)O)=O,32,2,0,2,44,0.000106
G5,C(C1(C(C(O)OCCC1O)O)O)=O,16,2,0,2,30,0.000106
G5,C(C(CO)O)(C(C(C)=O)C(C)=O)=O,2,1,0,1,29,5.9e-05
G5,C(C)(C(C(C=CCO)=O)(CO)O)=O,4,1,0,1,29,5.9e-05
G5,C(C1C(C(C(C(CO)O)O1)O)O)=O,32,1,0,1,29,5.9e-05
G5,C(C1C(C(C(C(CO)O1)O)O)O)=O,32,1,0,1,29,5.9e-05
G5,C(C1C(C(C(C(CO1)O)O)O)O)=O,32,1,0,1,29,5.9e-05
G5,C(C)(C(C(C(CO)O)=O)CC=O)=O,4,1,0,1,29,5.9e-05
G5,C(CCC(C(CC(C=O)=O)O)O)=O,4,3,0,3,27,0.000165
G5,C(C=C(C=O)C(C(CCO)O)O)=O,8,1,0,1,23,5.9e-05
G5,C(C=C(C=O)CC(C(CO)O)O)=O,8,5,0,5,29,0.000293
G5,C(C=C(C=O)C(CO)O)(CCO)=O,4,1,0,1,23,5.9e-05
G5,C(CC(C=O)=CC(C(CO)O)O)=O,8,4,0,4,29,0.000234
G5,C(C(CO)O)(CCO)=CC(C=O)=O,4,1,0,1,29,5.9e-05
G5,C(C(CO)O)(CC(C=O)=O)=CCO,4,1,0,1,29,5.9e-05
G5,C=CC(C(C=O)=O)(C(CCO)O)O,4,1,0,1,29,5.9e-05
G5,C(C)=C(C(C=O)=O)C(C(CO)O)O,8,4,0,4,29,0.000234
G5,C(C(CO)C(C(C(C=O)=O)O)O)=C,8,1,0,1,29,5.9e-05
G5,C(C)=C(CO)C(C(C(C=O)=O)O)O,8,1,0,1,29,5.9e-05
G5,C=C(C(C(C(C=O)=O)O)O)C(C)O,8,1,0,1,29,5.9e-05
G5,C(CO)(CC=C(C=O)C(CO)O)=O,4,1,0,1,29,5.9e-05
G5,C(CC(C=O)=O)=C(CO)C(CO)O,4,1,0,1,29,5.9e-05
G5,C(C)(C(C=C(C=O)C(CO)O)O)=O,8,1,0,1,29,5.9e-05
G5,C=C(C(CC(C=O)=O)O)C(CO)O,4,1,0,1,22,5.9e-05
G5,C(C(CO)O)=C(C(C=O)=O)C(C)O,8,2,0,2,29,0.000117
G5,C(C(CO)O)=CC(C(CCO)=O)=O,4,1,0,1,53,5.9e-05
G5,C(C(C(CO)O)=CC=O)(CCO)=O,4,1,0,1,29,5.9e-05
G5,C(CC(C(C(CO)O)O)=CC=O)=O,8,4,0,4,29,0.000234
G5,C(C=C(C(C(CO)O)=O)CCO)=O,4,1,0,1,29,5.9e-05
G5,C(CC(C(C(CO)O)=CCO)=O)=O,4,1,0,1,29,5.9e-05
G5,C(CC(C(C(CO)O)=O)=CCO)=O,4,1,0,1,29,5.9e-05
G5,C=CC(C(C(CCO)=O)=O)(CO)O,2,2,0,2,34,0.000106
G5,C=CC(C(C(C(CO)O)=O)=O)CO,4,1,0,1,29,5.9e-05
G5,C(C)=C(C(C(C(CO)O)=O)=O)CO,4,1,0,1,4,5.9e-05
G5,C=C(C(C(C(CO)O)=O)=O)C(C)O,4,1,0,1,29,5.9e-05
G5,C(CO)(CC(C=CC(CO)O)=O)=O,4,1,0,1,26,5.9e-05
G5,C(CO)(CC(C(CO)O)=CC=O)=O,4,1,0,1,32,5.9e-05
G5,C(CC(C(CO)O)=CC(CO)=O)=O,4,1,0,1,46,5.9e-05
G5,C(CC(C=C(CO)C(CO)O)=O)=O,4,1,0,1,26,5.9e-05
G5,C(CC(CO)=O)(C(C=C)(CO)O)=O,2,1,0,1,4,5.9e-05
G5,C(CO)(C(C(C(C=O)=CC)O)O)=O,8,1,0,1,4,5.9e-05
G5,C(C(CO)O)(C(C(CO)=O)C=C)=O,4,1,0,1,4,5.9e-05
G5,C(C)=C(C(C(CO)O)=O)C(CO)=O,4,1,0,1,4,5.9e-05
G5,C(C)(C(C(C=CC(CO)O)=O)O)=O,8,1,0,1,9,5.9e-05
G5,C(C)(C(C(C(CO)O)=CC=O)O)=O,8,1,0,1,29,5.9e-05
G5,C(C(CO)O)(C(C(C)=CC=O)O)=O,8,1,0,1,29,5.9e-05
G5,C(CC(C(C(C(CO)O)=C)O)=O)=O,4,1,0,1,29,5.9e-05
G5,C(CC(C(C(C(CO)O)=O)O)=C)=O,4,1,0,1,29,5.9e-05
G5,C(C(C(C(CO)O)=O)O)(CC=C)=O,4,1,0,1,9,5.9e-05
G5,C(C(CO)O)(C(C(C=CC)=O)O)=O,8,1,0,1,9,5.9e-05
G5,C(C(CC=CC=O)O)(C(CO)O)=O,8,2,0,2,29,0.000117
G5,C(CC=CC(C(C(CO)O)=O)O)=O,8,1,0,1,13,5.9e-05
G5,C(C(CO)O)(C(C(C=O)=CC)O)=O,8,1,0,1,29,5.9e-05
G5,C(C(C(C(C(C)O)O)=CC=O)O)=O,16,1,0,1,29,5.9e-05
G5,C(C(C(CC(CO)O)=CC=O)O)=O,8,3,0,3,29,0.000176
G5,C(C(C(C(CO)O)=CC(C)=O)O)=O,8,1,0,1,29,5.9e-05
G5,C(CC(C(C=O)O)=CC(CO)O)=O,8,2,0,2,29,0.000117
G5,C(C(C(C=C(C)C(CO)O)=O)O)=O,8,1,0,1,6,5.9e-05
G5,C(C(C=O)O)(CC(C(CO)O)=C)=O,4,1,0,1,29,5.9e-05
G5,C(C(C(C(C(CO)O)=CC)=O)O)=O,8,2,0,2,29,0.000117
G5,C(CC=C(C(CO)O)C(C=O)O)=O,8,1,0,1,29,5.9e-05
G5,C(C(C=O)O)(CC=CC(CO)O)=O,8,1,0,1,44,5.9e-05
G5,C(C(CC(C(CO)O)=CC=O)O)=O,8,3,0,3,29,0.000176
G5,C(C(C=C(C(C)=O)C(CO)O)O)=O,8,1,0,1,29,5.9e-05
G5,C(CC(C(CO)O)=CC(C=O)O)=O,8,2,0,2,29,0.000117
G5,C(C(CC(C(C(CO)O)=C)=O)O)=O,4,1,0,1,21,5.9e-05
G5,C(C(CC(C(C=CC=O)O)O)O)=O,16,2,0,2,29,0.000117
G5,C(C(CC(C=CC(CO)O)=O)O)=O,8,2,0,2,29,0.000117
G5,C(C(CO)O)(C(C(C)=O)(C=C)O)=O,4,1,0,1,29,5.9e-05
G5,C(C(CO)O)(C(C)O)=CC(C=O)=O,8,1,0,1,29,5.9e-05
G5,C(C1(C)C(C(C(O1)O)O)O)=O,16,2,0,2,11,0.000106
G5,C1(C(C(C(CO)(CCO)O1)O)O)O,16,2,0,2,29,0.000106
G5,C1C(C(CO)O)(C(C)(C(O)O1)O)O,16,3,0,3,45,0.000164
G5,CC1(CO)C(C(C(O)O1)O)O,16,2,0,2,49,0.000106
G5,CC1C(C(C(O)O1)O)O,16,2,0,2,11,0.000106
G5,CC1C(C(C(O)O1)O)(C(CO)O)O,32,3,0,3,11,0.000164
G5,C(C(C(C1C(CC(O)O1)O)O)O)O,32,3,0,3,49,0.000164
G5,C(C(C(C1CC(C(O)O1)O)O)O)O,32,3,0,3,49,0.000164
G5,C(C1(C(C(C(C)O1)O)O)O)=O,16,2,0,2,24,0.000106
G5,C(C1(C)C(C(C(C(O1)O)O)O)O)=O,32,3,0,3,49,0.000164
G5,C(C1C(C(C(C)(C(O1)O)O)O)O)=O,32,2,0,2,16,0.000106
G5,CC1(C(O)OC(CO)C(C1O)O)O,32,2,0,2,16,0.000106
G5,C1C(CCO)(C(C(C(O)O1)O)O)O,16,2,0,2,29,0.000106
G5,C1C(C)(C(C(C(O)O1)O)O)O,16,2,0,2,11,0.000106
G5,CC1(C(O)OCC(C1O)O)O,16,2,0,2,11,0.000106
G5,C(CC1C(C(C(C(O)O1)O)O)O)=O,32,2,0,2,20,0.000106
G5,CC1(CO)C(C(C(C(O)O1)O)O)O,32,3,0,3,49,0.000164
G5,CC1C(C(C(C(O)O1)O)O)O,32,3,0,3,28,0.000164
G5,C1(C(C(O)OCC1(C(C)O)O)O)=O,16,2,0,2,2,0.000106
G5,C(C(C1(C(C(CCO1)O)O)O)O)=O,16,2,0,2,41,0.000106
G5,C(C(C1C(C(CC(O)O1)O)O)O)O,32,2,0,2,43,0.000106
G5,C(C(C1C(CC(C(O)O1)O)O)O)O,32,2,0,2,49,0.000106
G5,C1C(C(C(C(O)O1)(C(C)O)O)O)O,32,2,0,2,41,0.000106
G5,CC1(C(COC(C(C1O)O)O)O)O,32,2,0,2,29,0.000106
G5,CC1(C(O)OCC(C(C1O)O)O)O,32,3,0,3,45,0.000164
G5,C(C1(CCOC(C(C1O)O)O)O)=O,16,2,0,2,29,0.000106
G5,C1CC(CO)(C(C(C(O)O1)O)O)O,16,2,0,2,29,0.000106
G5,C(C1CC(C(C(C(O1)O)O)O)O)=O,32,2,0,2,20,0.000106
G5,C1C(C)(C(C(C(C(O)O1)O)O)O)O,32,3,0,3,49,0.000164
G5,CC1(C(C(O)OCC(C1O)O)O)O,32,2,0,2,55,0.000106
G5,CC1C(C(C(C(C(O)O1)O)O)O)O,64,3,0,3,11,0.000164
G5,C(C1C(C(C(C(C1O)O)O)O)O)O,10,1,0,1,55,5.9e-05
G5,C(C(CO)CC(C(CO)O)O)=O,8,1,0,1,7,5.9e-05
G5,C(C(CC(C(CO)O)O)C(C)O)=O,16,1,0,1,7,5.9e-05
G5,C(CC(CCC(C(CO)O)O)O)=O,8,1,0,1,7,5.9e-05
G5,C(CC(C)(CC(C(CO)O)O)O)=O,8,1,0,1,7,5.9e-05
G5,C(C(C)=O)(CCC(C(CO)O)O)=O,4,1,0,1,14,5.9e-05
G5,C(CC(CCC(C(CO)O)O)=O)=O,4,1,0,1,7,5.9e-05
G5,C(C(C(C)=O)CC(C(CO)O)O)=O,8,1,0,1,7,5.9e-05
G5,C=CC(C(CC(C(CO)O)O)O)=O,8,1,0,1,7,5.9e-05
G5,C(C(C(CCCO)O)O)O,4,1,0,1,27,5.9e-05
G5,C(CCC(C(CO)O)O)(O)=O,4,2,0,2,28,0.000106
G5,C(C(C(C(CCCO)O)O)=O)=O,4,1,0,1,55,5.9e-05
G5,C1(C(C(C(CO)C(CO)O1)O)O)O,32,1,0,1,46,5.9e-05
G5,C1C(C(CO)C(C(C(O)O1)O)O)O,32,1,0,1,41,5.9e-05
G5,C(C(C(CCO)CC(CO)O)=O)=O,4,1,0,1,46,5.9e-05
G5,C(C(C(C(C(C)=O)CCO)O)O)=O,8,1,0,1,29,5.9e-05
G5,C(C(C(C(CCCCO)O)O)=O)=O,4,1,0,1,46,5.9e-05
G5,C(C(CC(C(CCCO)O)O)=O)=O,4,1,0,1,46,5.9e-05
G5,C(C(C(C(CCC(C)O)O)O)=O)=O,8,1,0,1,46,5.9e-05
G5,C(CC(C(C(CCCO)O)O)=O)=O,4,1,0,1,46,5.9e-05
G5,C(C(C=O)(CC(C(CO)O)O)O)=O,4,1,0,1,29,5.9e-05
G5,C(CCC(C(C(CCO)O)=O)=O)=O,2,1,0,1,29,5.9e-05
G5,C(C(CCO)CC=O)(C(C=O)O)=O,4,3,0,3,29,0.000154
G5,C(CCC(C(CO)=O)O)(CC=O)=O,2,1,0,1,32,5.9e-05
G5,C(CCC(CC(C(CO)=O)O)=O)=O,2,1,0,1,32,5.9e-05
G5,C(C(CC(C(C(CC)=O)=O)O)O)=O,4,1,0,1,32,5.9e-05
G5,C(C(CC(C(CCC=O)=O)O)O)=O,4,1,0,1,29,5.9e-05
G5,C(C)(C(C(C(C)O)=O)C(C=O)O)=O,8,1,0,1,0,5.9e-05
G5,C(C)(C(C=O)CC(C(CO)=O)O)=O,4,1,0,1,32,5.9e-05
G5,C(C(C(CO)(C(CO)CO)O)=O)=O,2,1,0,1,29,5.9e-05
G5,C(C(C(C(C)C(CO)O)O)=O)=O,8,1,0,1,29,5.9e-05
G5,C(C(C(C(CO)C)O)=O)=O,4,1,0,1,49,5.9e-05
G5,C(C(C(CC)O)=O)=O,2,1,0,1,28,5.9e-05
G5,C(C(C(CO)=O)(C(CO)C)O)=O,4,1,0,1,49,5.9e-05
G5,C(C(C(CO)=O)(CC)O)=O,2,1,0,1,45,5.9e-05
G5,C(C(C(C(C(CO)C)O)=O)O)=O,8,1,0,1,49,5.9e-05
G5,C(C(C(C(CC)O)=O)O)=O,4,1,0,1,28,5.9e-05
G5,C(CO)(C(C(C)C(CO)O)O)=O,8,1,0,1,52,5.9e-05
G5,C(C(CC)O)(C(CO)O)=O,4,1,0,1,28,5.9e-05
G5,C(C(C(C)C(CO)O)O)=O,8,1,0,1,46,5.9e-05
G5,C1(C(O)OC(C(CO)O)C1(C)O)=O,16,2,0,2,41,0.000106
G5,C1(C(C(CO)O)OC(C1(C)O)O)=O,16,2,0,2,0,0.000106
G5,C1(C(O)OC(CO)C(C1(C)O)O)=O,16,2,0,2,41,0.000106
G5,C1(C(C(O)OC(CO)C1(C)O)O)=O,16,2,0,2,54,0.000106
G5,C1(C(CO)OC(C(C1(C)O)O)O)=O,16,2,0,2,47,0.000106
G5,C1(C(O)OCC(C(C1(C)O)O)O)=O,16,2,0,2,41,0.000106
G5,C1(C(C(O)OCC(C1(C)O)O)O)=O,16,2,0,2,19,0.000106
G5,C1(COC(C(C(C1(C)O)O)O)O)=O,16,2,0,2,9,0.000106
G5,C(C(C(CO)(C(CO)C)O)=O)=O,4,1,0,1,29,5.9e-05
G5,C(C(C(CO)(CC)O)=O)=O,2,1,0,1,27,5.9e-05
G5,C(CO)(C(CO)(CC)O)=O,2,1,0,1,27,5.9e-05
G5,C(C(C(C=O)O)O)(C(CC)O)=O,8,1,0,1,28,5.9e-05
G5,C(CO)(C(CC)O)=O,2,1,0,1,28,5.9e-05
G5,C(C(CC)O)=O,2,1,0,1,45,5.9e-05
G5,C(CC(CCO)C(C(C=O)=O)O)=O,4,2,0,2,29,0.000106
G5,C(CCO)(C(C(C=O)=O)CCO)=O,2,2,0,2,2,0.000106
G5,C(CCO)(C(C(C=O)=O)(CC)O)=O,2,1,0,1,29,5.9e-05
G5,C(C(CO)(CC)O)(CC(C=O)=O)=O,2,1,0,1,29,5.9e-05
G5,C(C(CC(CCC(CO)=O)=O)O)=O,2,1,0,1,7,5.9e-05
G5,C(CC(C(C=O)=O)CCO)(CO)=O,2,3,0,3,12,0.000154
G5,C(CC(C(C=O)=O)(CC)O)(CO)=O,2,1,0,1,12,5.9e-05
G5,C(C)(C(CC(C=O)C(C=O)O)O)=O,8,2,0,2,29,0.00010700000000000001
G5,C(C(C(C(C=O)=O)(CC)O)O)(C)=O,4,1,0,1,45,5.9e-05
G5,C(C(CC(C=O)=O)O)(C(CC)O)=O,4,1,0,1,22,5.9e-05
G5,C(CC(C(C(C=O)=O)(CC)O)O)=O,4,1,0,1,29,5.9e-05
G5,C(C(C(CC(C=O)=O)O)(CC)O)=O,4,1,0,1,29,5.9e-05
G5,C(CCC(C(C(CCO)=O)=O)O)=O,2,2,0,2,53,0.000106
G5,C(C(C(C(CCO)=O)=O)(CC)O)=O,2,1,0,1,4,5.9e-05
G5,C(CC(C(C(CO)(CC)O)=O)=O)=O,2,1,0,1,4,5.9e-05
G5,C(CCC(C(CC(CO)=O)=O)O)=O,2,2,0,2,26,0.000106
G5,C(C(C(CC(CO)=O)=O)CCO)=O,2,2,0,2,4,0.000106
G5,C(C(C(CC(CO)=O)=O)(CC)O)=O,2,1,0,1,4,5.9e-05
G5,C(CC=O)(C(C(CO)=O)CCO)=O,2,2,0,2,2,0.000106
G5,C(CC=O)(C(C(CO)=O)(CC)O)=O,2,1,0,1,4,5.9e-05
G5,C(C(CCC(C(C(C)=O)O)=O)O)=O,4,2,0,2,9,0.00010700000000000001
G5,C(CCC(C(C(C(C)=O)O)=O)O)=O,4,2,0,2,9,0.000106
G5,C(CC(C(C(C)C(C=O)O)O)=O)=O,8,1,0,1,29,5.9e-05
G5,C(C(C(C(C(C)=O)O)=O)CCO)=O,4,2,0,2,29,0.000106
G5,C(C(C(C(C(C)=O)O)=O)(CC)O)=O,4,1,0,1,9,5.9e-05
G5,C(CC(C(C(CCCO)=O)O)=O)=O,2,2,0,2,9,0.000106
G5,C(CC(C(C(C(CC)O)=O)O)=O)=O,4,1,0,1,9,5.9e-05
G5,C(CC(C(C(C=O)(CC)O)=O)O)=O,4,1,0,1,29,5.9e-05
G5,C(C(C(C(C=O)O)CC(C)=O)O)=O,3,1,0,1,29,5.9e-05
G5,C(CC(C)C(C=O)O)(C(C=O)O)=O,8,2,0,2,29,0.00010700000000000001
G5,C(CC(C)C(C(C(C=O)O)=O)O)=O,8,2,0,2,6,0.000106
G5,C(C(C=O)O)(C(C(C)=O)CCO)=O,4,2,0,2,29,0.000106
G5,C(C(C=O)O)(C(C(C)=O)(CC)O)=O,4,1,0,1,29,5.9e-05
G5,C(C(C=O)O)(CC(CCCO)=O)=O,2,2,0,2,4,0.000106
G5,C(C(C=O)O)(CC(C(CC)O)=O)=O,4,1,0,1,29,5.9e-05
G5,C(CCC(C(C=O)O)C(C=O)O)=O,3,2,0,2,29,0.000106
G5,C(C)(C(CC(C=O)O)C(C=O)O)=O,8,1,0,1,29,5.9e-05
G5,C(CC(C=O)O)(C(C)C(C=O)O)=O,8,1,0,1,29,5.9e-05
G5,C(CC(C=O)O)(C(CO)CC=O)=O,4,1,0,1,21,5.9e-05
G5,C(C(C(C(C(C)=O)=O)(CC)O)O)=O,4,1,0,1,14,5.9e-05
G5,C(C(CC(C(CCCO)=O)=O)O)=O,2,2,0,2,29,0.000106
G5,C(C(CC(C(C(CC)O)=O)=O)O)=O,4,1,0,1,29,5.9e-05
G5,C(CC(C=O)O)(CCC(C=O)O)=O,4,2,0,2,26,0.00010700000000000001
G5,C(CC(C=O)O)(C(CCC=O)O)=O,4,2,0,2,29,0.000106
G5,C(CC(C=O)O)(C(C=O)CCO)=O,4,2,0,2,2,0.000106
G5,C(CC(C=O)O)(C(C=O)(CC)O)=O,4,1,0,1,29,5.9e-05
G5,C(C=CC(C(CC(CO)O)O)=O)=O,8,1,0,1,29,5.9e-05
G5,C(C(C=CC(CO)O)C(C=O)O)=O,16,1,0,1,29,5.9e-05
G5,C(C=C(C=O)C(CC(CO)O)O)=O,8,1,0,1,29,5.9e-05
G5,C(C(CC(C(C=CCO)=O)O)O)=O,8,1,0,1,29,5.9e-05
G5,C(C(C(C=CCO)C(C=O)O)O)=O,6,1,0,1,29,5.9e-05
G5,C(C(C(C(CCO)O)=CC=O)O)=O,8,1,0,1,29,5.9e-05
G5,C(C(C(C=CC=O)C(CO)O)O)=O,16,1,0,1,29,5.9e-05
G5,C(C(CC(C(CO)=CC=O)O)O)=O,8,1,0,1,29,5.9e-05
G5,C(C(C=CC(CO)C(C=O)O)O)=O,16,1,0,1,29,5.9e-05
G5,C(C(C=CC(C(CCO)O)=O)O)=O,8,1,0,1,29,5.9e-05
G5,C(C(C)C(C(C=O)O)O)(O)=O,8,1,0,1,14,5.9e-05
G5,C(C(CO)CC(C=O)O)(O)=O,4,1,0,1,14,5.9e-05
G5,C(C(C=O)(CC(C(CO)=O)O)O)=O,2,1,0,1,1,5.9e-05
G5,C(C(C=O)(C(CO)C(C=O)O)O)=O,4,2,0,2,29,0.000117
G5,C(C(C=O)(C(CO)C(CO)O)O)=O,4,2,0,2,29,0.000117
G5,C1(C(C)(C(C(C(CO)O)O1)O)O)=O,16,1,0,1,48,5.9e-05
G5,C1(C(C)(C(C(C(CO)O1)O)O)O)=O,16,1,0,1,48,5.9e-05
G5,C1(C(C)(C(C(C(CO1)O)O)O)O)=O,16,1,0,1,48,5.9e-05
G5,C(CC=O)(C(C(C)=O)(CCO)O)=O,2,1,0,1,29,5.9e-05
G5,C(C(C(CC(C)=O)=O)(CCO)O)=O,2,1,0,1,29,5.9e-05
G5,C(C(C(CCC=O)=O)(CCO)O)=O,2,1,0,1,29,5.9e-05
G5,C(C(C(C=CCO)=O)(CCO)O)=O,4,1,0,1,29,5.9e-05
G5,C(C=CC(C(CO)(CCO)O)=O)=O,4,1,0,1,29,5.9e-05
G5,C(C(C=CC(CO)=O)(CCO)O)=O,4,1,0,1,32,5.9e-05
G5,C1C(C2C(C(C(O)O2)O)O1)O,32,3,0,3,29,0.000164
G5,C1C(C(C(C(CO1)O)O)O)O,10,1,0,1,29,5.9e-05
G5,C1C(C2C(C(C(O2)O1)O)O)O,32,1,0,1,29,5.9e-05
G5,C(C(C(CCO)=O)OCO)=O,2,1,0,1,37,5.9e-05
G5,C(C(C(C(C)O)=O)OCO)=O,4,1,0,1,37,5.9e-05
G5,C1C(C(C(C=1)O)O)O,3,1,0,1,17,4.7e-05
G5,C=C(CO)CO,1,1,0,1,49,4.7e-05
G5,C(C1(C2C(CC(C1O)(O)O2)O)O)O,32,1,0,1,5,4.7e-05
G5,C1C2(C(C(CC(C2O)O)(O)O1)O)O,32,2,0,2,5,9.499999999999999e-05
G5,C1C2(CC(C(C(C2O)(O)O1)O)O)O,32,2,0,2,5,9.499999999999999e-05
G5,C(C1(C2C(C(C(C1)(O)O2)O)O)O)O,32,1,0,1,12,4.7e-05
G5,C1C2(CC(C(C(C2O)O)O)(O)O1)O,32,2,0,2,12,9.499999999999999e-05
G5,CC1(C2C(C(C(C1O)(O)O2)O)O)O,64,1,0,1,5,4.7e-05
G5,C1C2(C(C(C(C2CO)(O)O1)O)O)O,32,2,0,2,2,9.499999999999999e-05
G5,C12C(C(C(C(C1O)O)(O)O2)O)O,10,1,0,1,5,4.7e-05
G5,C(C1(C(C2C(C1C(O)O2)O)O)O)O,64,2,0,2,51,9.499999999999999e-05
G5,C(C1(C2C(C(C1C(O)O2)O)O)O)O,64,2,0,2,51,9.499999999999999e-05
G5,C1C2(C(C(C(C2C(O)O1)O)O)O)O,64,1,0,1,51,4.7e-05
G5,C12CC(C(C(C(C1O)O)(O)O2)O)O,64,2,0,2,51,9.499999999999999e-05
G5,C(C1C2(CC(C(C2)(O1)O)O)O)=O,16,2,0,2,26,9.499999999999999e-05
G5,C(C1C2(CC(C(C2)(O)O1)O)O)O,16,2,0,2,45,9.499999999999999e-05
G5,C1(C(CC2(C(O)OCC12)O)O)=O,16,1,0,1,2,4.7e-05
G5,C(C1(CC2(C(C1CO2)O)O)O)=O,16,2,0,2,45,9.499999999999999e-05
G5,C1C2(CC(C(C2CO)O)(O)O1)O,16,2,0,2,45,9.499999999999999e-05
G5,C1C2C(C(CC2(CO)O)(O)O1)O,16,2,0,2,45,9.499999999999999e-05
G5,C1C2(CC(C(C2)(O)O1)O)O,8,2,0,2,3,9.499999999999999e-05
G5,C1(C(C2C(O)OC(C2O)C1)O)=O,32,2,0,2,20,9.499999999999999e-05
G5,C(C1(CC2C(C1C(O)O2)O)O)=O,32,2,0,2,20,9.499999999999999e-05
G5,C(C1(C2C(C(CC2O)O1)O)O)=O,32,2,0,2,20,9.499999999999999e-05
G5,C1(C(C2C(C1)OC(C2O)O)O)=O,32,1,0,1,20,4.7e-05
G5,C(C1C2C(CC(C2O)(O1)O)O)=O,32,2,0,2,20,9.499999999999999e-05
G5,C(C1(C2C(C(C(C2O)O1)O)O)O)=O,64,2,0,2,0,9.499999999999999e-05
G5,C(C1C2(CC(C(C2O)O)(O)O1)O)O,32,2,0,2,51,9.499999999999999e-05
G5,C1C2(CC(CC(C2O)(O)O1)O)O,16,2,0,2,49,9.499999999999999e-05
G5,C1C2(CC(C(C(C2)(O)O1)O)O)O,16,2,0,2,49,9.499999999999999e-05
G5,CC1(C2C(CC(C1O)(O)O2)O)O,32,1,0,1,49,4.7e-05
G5,CC1(C2C(C(C(C1)(O)O2)O)O)O,32,1,0,1,0,4.7e-05
G5,C(C1(CC2C(C1C(O)O2)O)O)O,32,2,0,2,21,9.499999999999999e-05
G5,C1C2(CC(C(C2C(O)O1)O)O)O,32,1,0,1,21,4.7e-05
G5,C(C1(C2C(CC(C2O)O1)O)O)O,32,2,0,2,21,9.499999999999999e-05
G5,C12CC(C(C(CC1O)(O)O2)O)O,32,2,0,2,21,9.499999999999999e-05
G5,C(C1C2(C(C(CC2O)(O)O1)O)O)O,32,2,0,2,32,9.499999999999999e-05
G5,C1C2(C(C(C(CO)C2O)(O)O1)O)O,32,2,0,2,2,9.499999999999999e-05
G5,C1C2C(C(C(C2(CO)O)O)(O)O1)O,32,2,0,2,2,9.499999999999999e-05
G5,C1C2(C(C(C(C2CO)O)(O)O1)O)O,32,2,0,2,2,9.499999999999999e-05
G5,C(C1C2(CC(C(C2O)(O)O1)O)O)O,32,2,0,2,2,9.499999999999999e-05
G5,C(C1(C(C2(CC1CO2)O)O)O)=O,16,2,0,2,12,9.499999999999999e-05
G5,C1(C(C(C2C(O)OCC12)O)O)=O,32,1,0,1,2,4.7e-05
G5,C1C2(CC(C(C2CO)(O)O1)O)O,16,2,0,2,3,9.499999999999999e-05
G5,CC1(C(C2C(C1C(O)O2)O)O)O,64,2,0,2,16,9.499999999999999e-05
G5,CC1(C2C(C(C1C(O)O2)O)O)O,64,2,0,2,16,9.499999999999999e-05
G5,C12CC(CC(C(C1O)O)(O)O2)O,32,2,0,2,21,9.499999999999999e-05
G5,C(C1(C2C(C(C(C2O)O1)O)O)O)O,64,2,0,2,20,9.499999999999999e-05
G5,C12C(C(C(C(CC1O)(O)O2)O)O)O,64,2,0,2,20,9.499999999999999e-05
G5,C12C(C(C(CC(C1O)O)(O)O2)O)O,64,2,0,2,20,9.499999999999999e-05
G5,C1(C2C(C(CC2O)O1)O)O,32,2,0,2,43,9.499999999999999e-05
G5,C1(C2CC(C(CO)C(C1)(O2)O)O)=O,16,2,0,2,30,9.499999999999999e-05
G5,C1(CC2(C(CC(C1CO)O2)O)O)=O,16,2,0,2,30,9.499999999999999e-05
G5,C1(CC2(C(O)OC(C2)C1CO)O)=O,16,2,0,2,23,9.499999999999999e-05
G5,C1(CC2(C(C1CO)OC(C2)O)O)=O,16,1,0,1,23,4.7e-05
G5,C1(C(CC2C1CC(CO)(O)O2)O)=O,16,1,0,1,7,4.7e-05
G5,C(CO)(C1CC2(C(CC1O2)O)O)=O,16,1,0,1,7,4.7e-05
G5,C1(C(C2CC(C(CC1)(O)O2)O)O)=O,16,2,0,2,7,9.499999999999999e-05
G5,C(CC1C2(CCC(C2O)(O)O1)O)=O,16,2,0,2,7,9.499999999999999e-05
G5,C1(C(C2(CC1)C(CC(O)O2)O)O)=O,16,2,0,2,7,9.499999999999999e-05
G5,C1(C(C2C(O)OCC2(CC1)O)O)=O,16,1,0,1,7,4.7e-05
G5,C(C12CC(C(C1)O)C(CO)(O2)O)=O,16,2,0,2,29,9.499999999999999e-05
G5,C(CO)(C1CC2(C(O)OC1C2)O)=O,16,2,0,2,29,9.499999999999999e-05
G5,C(C12CC(C(C(CC1)(O2)O)O)O)=O,16,2,0,2,29,9.499999999999999e-05
G5,C1(C(C2CC(C(O)O2)(CC1)O)O)=O,16,1,0,1,29,4.7e-05
G5,C(CC12CCC(C(C1O)O)(O)O2)=O,16,1,0,1,29,4.7e-05
G5,C1(C(C2C(CC1)(CC(O)O2)O)O)=O,16,2,0,2,7,9.499999999999999e-05
G5,C(C1(CCC2(COC(C21)O)O)O)=O,16,1,0,1,29,4.7e-05
G5,C(C1(C2C(CC(CO)(C2)O1)O)O)=O,16,2,0,2,29,9.499999999999999e-05
G5,C1(C(O)OC2CC(CO)(CC12)O)=O,16,1,0,1,29,4.7e-05
G5,C(C1(C(C2(CC1C(C)O2)O)O)O)=O,32,2,0,2,12,9.499999999999999e-05
G5,C1(C(CC2C1C(C(C)(O)O2)O)O)=O,32,1,0,1,45,4.7e-05
G5,C1(C(CC2(C(CC(C1)O2)O)O)O)=O,16,2,0,2,22,9.499999999999999e-05
G5,C(CC1C2(CC(C(C2)(O)O1)O)O)=O,16,2,0,2,22,9.499999999999999e-05
G5,C1(C(CC2(C(CC(O)O2)O)C1)O)=O,16,1,0,1,22,4.7e-05
G5,C1(C(C2C(O)OC(C2(C)O)C1)O)=O,32,2,0,2,22,9.499999999999999e-05
G5,C(C12CC(CC(C(C1)O)(O2)O)O)=O,16,2,0,2,22,9.499999999999999e-05
G5,C1(C(CC2(C(O)OC(C2)C1)O)O)=O,16,1,0,1,22,4.7e-05
G5,C(CC12CC(C(CC1O)(O)O2)O)=O,16,1,0,1,22,4.7e-05
G5,C1(C(CC2(C(C1)OC(C2)O)O)O)=O,16,1,0,1,22,4.7e-05
G5,C(C1(CC2C(C)(C1C(O)O2)O)O)=O,32,2,0,2,22,9.499999999999999e-05
G5,C(C1(C2C(CC(C)(C2O)O1)O)O)=O,32,2,0,2,22,9.499999999999999e-05
G5,C1(C(O)OC2CC(C)(C(C12)O)O)=O,32,1,0,1,22,4.7e-05
G5,C(C1(CC2(C(C1C(C)O2)O)O)O)=O,32,2,0,2,22,9.499999999999999e-05
G5,C1(C(CC2(C(O)OC(C)C12)O)O)=O,32,1,0,1,22,4.7e-05
G5,C(CC12CC(C(C(O)O1)C2O)O)=O,32,2,0,2,13,9.499999999999999e-05
G5,C1(C2(C(CO)C(CC(C1)O2)O)O)=O,16,2,0,2,53,9.499999999999999e-05
G5,C1(C2(CC(CC(C1CO)O2)O)O)=O,16,2,0,2,53,9.499999999999999e-05
G5,C1(C2(C(CO)C(C1C(C)O2)O)O)=O,32,2,0,2,4,9.499999999999999e-05
G5,C1(C2C(C)(C(C(C1)O)C(O2)O)O)=O,32,2,0,2,6,9.499999999999999e-05
G5,C1(C2C(C(C(O2)O)C(C)(C1)O)O)=O,32,2,0,2,26,9.499999999999999e-05
G5,C(C1C2(CC(CC(C2)(O1)O)O)O)=O,16,2,0,2,27,9.499999999999999e-05
G5,C1(C(C(CC2C1CC(O)O2)O)O)=O,32,1,0,1,18,4.7e-05
G5,C(C1CC2(C(C(CC1O2)O)O)O)=O,32,2,0,2,18,9.499999999999999e-05
G5,C1(C2C(C(C(O2)O)C(CC1)O)O)=O,32,1,0,1,44,4.7e-05
G5,C(C(C12CC(C(C(O)O1)C2)O)O)=O,32,2,0,2,44,9.499999999999999e-05
G5,C(CC12CC(C(O)O1)C(C2O)O)=O,32,2,0,2,44,9.499999999999999e-05
G5,C(C1C2(CCC(C2C(O1)O)O)O)=O,32,1,0,1,44,4.7e-05
G5,C(C(C1(C2C(CC(C2)O1)O)O)O)=O,32,2,0,2,44,9.499999999999999e-05
G5,C1(C(C(C2C(O)OC(C)C12)O)O)=O,64,1,0,1,4,4.7e-05
G5,C(C)(C1(C2C(C(CC2O)O1)O)O)=O,32,2,0,2,21,9.499999999999999e-05
G5,C1(C(C)(O)OC2CC(C(C12)O)O)=O,32,1,0,1,21,4.7e-05
G5,C1(C2(CC(CC(C(C1)O2)O)O)O)=O,16,2,0,2,21,9.499999999999999e-05
G5,C1(C2(CC(C(CC(C1)O2)O)O)O)=O,16,2,0,2,21,9.499999999999999e-05
G5,C(C)(C1(CC2C(C1C(O)O2)O)O)=O,32,2,0,2,21,9.499999999999999e-05
G5,C1(CC2C(C(C(O)O2)C1(C)O)O)=O,32,2,0,2,21,9.499999999999999e-05
G5,C(C1CC2(CC(CC2(O1)O)O)O)=O,16,1,0,1,21,4.7e-05
G5,C1(C(C)(CC2C1C(C(O)O2)O)O)=O,32,1,0,1,21,4.7e-05
G5,C1(C2(C(C(C)O)C(C(C1)O2)O)O)=O,32,1,0,1,14,4.7e-05
G5,C(CC1(C2C(C(CC2O)O1)O)O)=O,32,2,0,2,6,9.499999999999999e-05
G5,C1(CC(C2C(O)OC(C2O)C1)O)=O,32,1,0,1,6,4.7e-05
G5,C1(CC(CC2C1C(C(O)O2)O)O)=O,32,1,0,1,26,4.7e-05
G5,C1C2(C(CO)OC(C2C(C=1)O)O)O,32,1,0,1,21,4.7e-05
G5,C=CC1(C(C2C(C1C(O)O2)O)O)O,64,2,0,2,7,9.499999999999999e-05
G5,C=CC1(C2C(C(C1C(O)O2)O)O)O,64,2,0,2,7,9.499999999999999e-05
G5,C1C(CO)(C2C(OC(C=1)C2O)O)O,32,1,0,1,32,4.7e-05
G5,C1C2(COC(C2C(C(C=1)O)O)O)O,32,1,0,1,32,4.7e-05
G5,C1C(C2C(O)OC(C2O)C(C=1)O)O,64,1,0,1,43,4.7e-05
G5,C1C(C2C(C(C(C2O)O)O)(O)O1)O,64,1,0,1,0,4.7e-05
G5,C1(C2C(C(C(O2)O)C1O)O)=O,32,2,0,2,5,9.499999999999999e-05
G5,C1C2C(C(C(CO)(O)O2)O1)O,16,1,0,1,36,4.7e-05
G5,C1C2(C(C(O)O1)OC(C2)O)O,16,2,0,2,38,9.499999999999999e-05
G5,CC1(C2C(O)OC1C(O)O2)O,10,1,0,1,19,4.7e-05
G5,C1C2C(C(O1)OC2(CO)O)O,16,1,0,1,30,4.7e-05
G5,C1C(C2C(O)OCC2(O)O1)O,16,2,0,2,40,9.499999999999999e-05
G5,C1(C2(CCC(C1O)O2)O)=O,8,1,0,1,17,4.7e-05
G5,C1(C2CC(C(O2)O)C1O)=O,16,2,0,2,32,9.499999999999999e-05
G5,C1C2(CCC(C2O)(O)O1)O,8,2,0,2,29,9.499999999999999e-05
G5,C1(C2(C(C(CC2)(O)O1)O)O)=O,8,2,0,2,29,9.499999999999999e-05
G5,C1(C2(CC(C(C2)O)(O)O1)O)=O,8,2,0,2,29,9.499999999999999e-05
G5,C(C12C(C(C(CC1O)(O)O2)O)O)O,32,1,0,1,2,4.7e-05
G5,C(C1(C2C(C(C(O)O2)C1O)O)O)O,64,2,0,2,2,9.499999999999999e-05
G5,C(C12C(C(C(C(O)O1)C2O)O)O)O,64,2,0,2,2,9.499999999999999e-05
G5,CC1(CC2(C(C1(CO2)O)O)O)O,16,2,0,2,25,9.499999999999999e-05
G5,C1(C(C2(C(C1)OC(C2O)O)O)O)=O,32,1,0,1,0,4.7e-05
G5,C(C1C2(C(CC(C2O)(O1)O)O)O)=O,32,2,0,2,0,9.499999999999999e-05
G5,C1(C(C2(C(O)OC(C2O)C1)O)O)=O,32,2,0,2,0,9.499999999999999e-05
G5,C1C2(CC(C(C2(CO)O)O)(O)O1)O,16,2,0,2,32,9.499999999999999e-05
G5,C1C2(C(C(CC2(CO)O)(O)O1)O)O,16,2,0,2,32,9.499999999999999e-05
G5,C1C2(CC(C(CO)(C2O)O)(O)O1)O,16,2,0,2,2,9.499999999999999e-05
G5,CC1(C(C2(C(C1(CO2)O)O)O)O)O,32,2,0,2,5,9.499999999999999e-05
G5,CC1C2(C(C(CC2O)(O)O1)O)O,32,2,0,2,49,9.499999999999999e-05
G5,C(C1(C(C2C(O)OC1C2O)O)O)=O,64,2,0,2,43,9.499999999999999e-05
G5,C1C(C2(C(CC(C2O)O)(O)O1)O)O,32,1,0,1,0,4.7e-05
G5,C1(C(C2(C(C1)OC(C2)O)O)O)=O,16,1,0,1,20,4.7e-05
G5,C(C1(CC2(C(C(C1O2)O)O)O)O)=O,32,1,0,1,51,4.7e-05
G5,C1(C(C2C(C(C(O)O2)(C1)O)O)O)=O,32,2,0,2,51,9.499999999999999e-05
G5,C(C1C2(C(C(C(C2)(O1)O)O)O)O)=O,32,2,0,2,51,9.499999999999999e-05
G5,C1(C(C2C(C(C(O)O2)O)(C1)O)O)=O,32,1,0,1,51,4.7e-05
G5,CC1C2(CC(C(C2O)O)(O)O1)O,32,2,0,2,41,9.499999999999999e-05
G5,C(C12CC(C(C(C1O)O)(O)O2)O)O,32,1,0,1,43,4.7e-05
G5,C(C1(CC2C(C(C1(O)O2)O)O)O)O,32,1,0,1,32,4.7e-05
G5,C1C2(CC(CO)(C(C2O)(O)O1)O)O,16,2,0,2,32,9.499999999999999e-05
G5,C1(CC(C2C(O)OCC12O)O)=O,16,1,0,1,2,4.7e-05
G5,C1(C2(CC(C(CO)(C1)O2)O)O)=O,8,1,0,1,5,4.7e-05
G5,C1(C2(CC(C(C1)O2)(CO)O)O)=O,8,1,0,1,5,4.7e-05
G5,C1C2(CO)C(C(C(C=1)(O2)O)O)O,16,1,0,1,43,4.7e-05
G5,C(C1(C2C(C(C1C(O)O2)O)O)O)=O,64,2,0,2,43,9.499999999999999e-05
G5,C(C1C2C(C(C1(C(O)O2)O)O)O)=O,64,2,0,2,43,9.499999999999999e-05
G5,C1(CC(C2C(O)OC(C)C12O)O)=O,32,1,0,1,4,4.7e-05
G5,C1(C2(CC(C(C(C)O)(C1)O2)O)O)=O,16,1,0,1,14,4.7e-05
G5,C1(C2(CC(C(C1)O2)(C(C)O)O)O)=O,16,1,0,1,14,4.7e-05
G5,C1C2(C(C)O)C(C(C(C=1)(O2)O)O)O,32,1,0,1,32,4.7e-05
G5,C1(C(C2C(O)OC(CO)C2C1)O)=O,32,1,0,1,46,4.7e-05
G5,C1(C2C(C(C(O2)O)C(CO)C1)O)=O,32,3,0,3,11,0.00014199999999999998
G5,C1(C(C(C2C(O)OCC2C1)O)O)=O,32,1,0,1,11,4.7e-05
G5,C(C1CCC2(C(C(C1O2)O)O)O)=O,32,2,0,2,7,9.499999999999999e-05
G5,C1(C(C2C(C(C(O)O2)CC1)O)O)=O,32,2,0,2,7,9.499999999999999e-05
G5,C(C1C2CC(C(C(C2)(O1)O)O)O)=O,32,2,0,2,32,9.499999999999999e-05
G5,C(CC1C2C(C(C(C1)(O)O2)O)O)=O,32,1,0,1,32,4.7e-05
G5,C(CC1C(C2C(C1C(O)O2)O)O)=O,64,3,0,3,4,0.00014199999999999998
G5,C(CC1C2C(C(C1C(O)O2)O)O)=O,64,3,0,3,4,0.00014199999999999998
G5,C1(C2C(C(C(C(C2)(O)O1)O)O)=O)=O,16,2,0,2,12,9.499999999999999e-05
G5,C1(C2C(C(CC(C2O)(O)O1)O)=O)=O,16,2,0,2,17,9.499999999999999e-05
G5,C1(C2C(C(CC2(C(O)O1)O)O)=O)=O,16,1,0,1,17,4.7e-05
G5,C1(C2C(C(C(CO)C2O)(O)O1)=O)=O,16,2,0,2,17,9.499999999999999e-05
G5,C1(C2C(C(C(C2C(O)O1)O)O)=O)=O,32,1,0,1,17,4.7e-05
G5,C1(C2C(C(CC(C2O)O)(O)O1)=O)=O,16,2,0,2,17,9.499999999999999e-05
G5,C(C1C(C2CC(C1(O)O2)=O)O)(O)=O,16,1,0,1,17,4.7e-05
G5,C(C1C(O)OCC1(CO)O)(O)=O,8,1,0,1,5,4.7e-05
G5,C(C1C(O)OC(CO)C1O)(O)=O,16,1,0,1,17,4.7e-05
G5,C(C(C)(C1C(OC(C1=O)O)=O)O)=O,8,1,0,1,17,4.7e-05
G5,C1(C(C(C=O)=O)C(C)(C(O)O1)O)=O,8,1,0,1,17,4.7e-05
G5,C1(C(C(C(O)O1)=O)C(C=O)O)=O,8,1,0,1,0,4.7e-05
G5,C1(C(C(C=O)=O)C(C(O)O1)O)=O,8,1,0,1,0,4.7e-05
G5,C1(C(C(C(O)O1)=O)C(CO)(C)O)=O,8,1,0,1,49,4.7e-05
G5,C(C1C(COC1(C=O)O)(C)O)(O)=O,8,1,0,1,49,4.7e-05
G5,C1(C(C(CO)=O)C(C(C)(O)O1)O)=O,8,1,0,1,45,4.7e-05
G5,C1(C(C(CO)=O)C(C)(C(O)O1)O)=O,8,1,0,1,16,4.7e-05
G5,C(C1COC(C1O)(CC(C)O)O)=O,16,1,0,1,4,4.7e-05
G5,C(C1COC(C1(CC(C)O)O)O)=O,16,1,0,1,4,4.7e-05
G5,C1(C(C(C(O)O1)=O)C(C)O)=O,8,1,0,1,4,4.7e-05
G5,C1(C(OC(C(O)=O)C1C(C)O)O)=O,16,1,0,1,4,4.7e-05
G5,C1(C(C(C(C)O)C(C=O)(O)O1)O)=O,16,1,0,1,4,4.7e-05
G5,C1(C(O)OC(C(C)O)C1C(C)O)=O,32,1,0,1,4,4.7e-05
G5,C(C1(C(C(C(C)O1)O)C(C)O)O)=O,32,1,0,1,4,4.7e-05
G5,C(C1C(CCO)OC(C)(C1O)O)=O,16,1,0,1,45,4.7e-05
G5,C(CC1C(C)(C(C(O)O1)CO)O)=O,16,1,0,1,45,4.7e-05
G5,C(C(CO)C1(C)C(CC(O)O1)O)=O,16,1,0,1,45,4.7e-05
G5,C(C(CO)C1CC(C(C)(O)O1)O)=O,16,1,0,1,45,4.7e-05
G5,C(C1C(CC=O)OC(C)(C1O)O)=O,16,1,0,1,45,4.7e-05
G5,C(C1C(O)OC(C1(C)O)CC=O)=O,16,1,0,1,45,4.7e-05
G5,C(C(C=O)C1(C)C(CC(O)O1)O)=O,8,1,0,1,45,4.7e-05
G5,C(C(C=O)C1CC(C(C)(O)O1)O)=O,8,1,0,1,45,4.7e-05
G5,C1(C(C=O)C(C(C)(O)O1)O)=O,8,1,0,1,17,4.7e-05
G5,C(CC(C1(CC(C(O1)=O)O)O)O)=O,8,1,0,1,33,4.7e-05
G5,C1(C(C(C(O)O1)C(C(C)=O)O)O)=O,16,1,0,1,45,4.7e-05
G5,C(CC(C1(CC(C(C)O1)O)O)O)=O,16,1,0,1,11,4.7e-05
G5,C(C1C(C(C)O)OC(C)(C1O)O)=O,32,1,0,1,45,4.7e-05
G5,C(C)(C(C1C(O)OC(C)C1O)O)=O,32,1,0,1,45,4.7e-05
G5,C(C1C(CCO)OC(C1(C)O)O)=O,16,1,0,1,45,4.7e-05
G5,C(CC1(C)C(C(C(O)O1)CO)O)=O,16,1,0,1,45,4.7e-05
G5,C(C(CO)C1C(C)(CC(O)O1)O)=O,16,1,0,1,45,4.7e-05
G5,C(C(CO)C1CC(C)(C(O)O1)O)=O,16,1,0,1,18,4.7e-05
G5,C(C1C(CC=O)OC(C1(C)O)O)=O,16,1,0,1,45,4.7e-05
G5,C(C1C(O)OC(C)(C1O)CC=O)=O,16,1,0,1,45,4.7e-05
G5,C(C(C=O)C1C(C)(CC(O)O1)O)=O,8,1,0,1,45,4.7e-05
G5,C(C(C=O)C1CC(C)(C(O)O1)O)=O,8,1,0,1,45,4.7e-05
G5,C1(C(C=O)C(C)(C(O)O1)O)=O,8,1,0,1,17,4.7e-05
G5,C(C(C)(C1C(O)OC(C1O)=O)O)=O,16,1,0,1,45,4.7e-05
G5,C(C1C(C(C)O)OC(C1(C)O)O)=O,32,1,0,1,11,4.7e-05
G5,C(C(C)(C1C(O)OC(C)C1O)O)=O,32,1,0,1,11,4.7e-05
G5,C(C1C(C(C(C)=O)OC1O)O)(O)=O,16,1,0,1,17,4.7e-05
G5,C(C1C(OC(C=O)C1(C)O)O)(O)=O,16,1,0,1,17,4.7e-05
G5,C(C1C(O)OC(CO)C1(C)O)(O)=O,16,1,0,1,17,4.7e-05
G5,C1C(CC(C)O)(C(C(O)O1)CO)O,16,1,0,1,11,4.7e-05
G5,CC1(C(C(C)O)OC(C1CO)O)O,32,1,0,1,4,4.7e-05
G5,C1C(C)(C(C(O)O1)C(CCO)O)O,16,1,0,1,49,4.7e-05
G5,CC(C1C(C(C(O)O1)CO)O)O,32,1,0,1,28,4.7e-05
G5,C1C(C(C(O)O1)C(CCO)O)O,16,1,0,1,18,4.7e-05
G5,C(C1COC(C1(C(CO)O)O)O)=O,16,1,0,1,0,4.7e-05
G5,C(C1(C(CO)OC(C1CO)O)O)=O,16,1,0,1,0,4.7e-05
G5,C(C1(COC(C1CO)O)O)=O,8,1,0,1,2,4.7e-05
G5,C(C)(C1(COC(C1CO)O)O)=O,8,1,0,1,25,4.7e-05
G5,C(C1COC(CO)(C1(C)O)O)=O,8,1,0,1,25,4.7e-05
G5,C1(C(C)(O)OC(CCO)C1O)=O,8,1,0,1,25,4.7e-05
G5,C(C1COC(C1O)(C(C)O)O)=O,16,1,0,1,25,4.7e-05
G5,C(C1COC(C1(C(C)O)O)O)=O,16,1,0,1,4,4.7e-05
G5,C(C1(C(C)OC(C1CO)O)O)=O,16,1,0,1,4,4.7e-05
G5,C1C(C(C)O)(C(C(O)O1)CO)O,16,1,0,1,25,4.7e-05
G5,CC1C(CO)(C(C(O)O1)CO)O,16,1,0,1,25,4.7e-05
G5,C1(C(CO)C(C(CCO)O1)O)O,16,1,0,1,29,4.7e-05
G5,C1(C(C)(C(CO)C(O)O1)O)=O,8,1,0,1,28,4.7e-05
G5,C(CC1(COC(C1CO)O)O)(O)=O,8,1,0,1,29,4.7e-05
G5,C(C1C(C)(C(CO)C(O1)O)O)(O)=O,16,1,0,1,33,4.7e-05
G5,C1(C(C(CO)C(O)O1)O)=O,8,1,0,1,33,4.7e-05
G5,C(C1C(C(CO)C(O1)O)O)(O)=O,16,1,0,1,18,4.7e-05
G5,C(CC1C(C(C(O)O1)CO)O)(O)=O,16,1,0,1,29,4.7e-05
G5,C(C1COC(C1O)(CC(C)=O)O)=O,8,1,0,1,26,4.7e-05
G5,C(C(CO)C1C(CC(C)(O1)O)=O)=O,8,1,0,1,26,4.7e-05
G5,C(C1COC(C1(CC(C)=O)O)O)=O,8,1,0,1,23,4.7e-05
G5,C(C(CO)C1(C)CC(C(O)O1)=O)=O,8,1,0,1,6,4.7e-05
G5,C(C)(C1C(C(O)OC1CCO)=O)=O,8,1,0,1,26,4.7e-05
G5,C(C1C(C(O)OC1CCO)=O)=O,8,1,0,1,23,4.7e-05
G5,C(C(C1CC(C(C)(O)O1)=O)CO)=O,8,1,0,1,14,4.7e-05
G5,C(C1COC(C)(C1(CC=O)O)O)=O,8,1,0,1,4,4.7e-05
G5,C(C1COC(C1(C)O)(CC=O)O)=O,8,1,0,1,14,4.7e-05
G5,C(C(CO)C1(C(CC(O1)O)=O)C)=O,8,1,0,1,14,4.7e-05
G5,C(C1C(C(C)(O)OC1CCO)=O)=O,8,1,0,1,14,4.7e-05
G5,C(CC1(C(CC(CCO)O1)=O)O)=O,4,1,0,1,18,4.7e-05
G5,C(C1COC(C)(C1(C)O)O)=O,8,1,0,1,14,4.7e-05
G5,C1(C(C)(O)OC(CCO)C1)=O,4,1,0,1,18,4.7e-05
G5,C(C1(COC(C1CO)O)O)=CC=O,16,1,0,1,11,4.7e-05
G5,C(C1COC(C=C)(C1O)O)=O,8,1,0,1,7,4.7e-05
G5,C(C1COC(C1(C=C)O)O)=O,8,1,0,1,7,4.7e-05
G5,C=CC1(COC(C1CO)O)O,8,1,0,1,7,4.7e-05
G5,CC1C(C(C(O)O1)CO)O,16,1,0,1,11,4.7e-05
G5,C1(C(CCO)(C(CO)C(O)O1)O)=O,8,1,0,1,7,4.7e-05
G5,C1(C(C(C(O)O1)C(CCO)O)O)=O,16,1,0,1,33,4.7e-05
G5,C1(C(CO)C(C(CO)(CO)O1)O)O,8,1,0,1,18,4.7e-05
G5,C(C1(CO)C(C(CO)C(O1)O)O)=O,16,1,0,1,18,4.7e-05
G5,C1C2(C(CO1)OC(C2CO)O)O,16,1,0,1,10,4.7e-05
G5,C12C(CCO1)(C(C(O)O2)CO)O,16,1,0,1,34,4.7e-05
G5,C1(C(C=O)C(C(CCO)(O)O1)O)=O,8,1,0,1,17,4.7e-05
G5,C1(C(C=O)C(C(O)O1)(CCO)O)=O,8,1,0,1,3,4.7e-05
G5,C(C1C(O)OCC1(CCO)O)(O)=O,8,1,0,1,3,4.7e-05
G5,C(C1C(C(C=O)OC1O)O)(O)=O,16,1,0,1,0,4.7e-05
G5,C(C1C(O)OCC1(CC(C)O)O)=O,16,1,0,1,45,4.7e-05
G5,C1(C(C(C(C)O)C(CO)(O)O1)O)=O,16,1,0,1,11,4.7e-05
G5,C1(C(C(C(CC(C)O)(O)O1)O)O)=O,16,1,0,1,33,4.7e-05
G5,CC(C1C(CO)(O)OC(C)C1O)O,32,1,0,1,11,4.7e-05
G5,CC(CC1(C(C(C(C)O1)O)O)O)O,32,1,0,1,11,4.7e-05
G5,C(C1C(O)OC(C(C)O)C1(C)O)=O,32,1,0,1,45,4.7e-05
G5,C1(C(CC(C(C(C)O)O)(O)O1)O)=O,16,1,0,1,4,4.7e-05
G5,CC(C(C1(CC(C(C)O1)O)O)O)O,32,1,0,1,11,4.7e-05
G5,C(CC(C1C(O)OCC1(C)O)O)=O,16,1,0,1,49,4.7e-05
G5,C(C1C(O)OCC1(C)O)(O)=O,8,1,0,1,49,4.7e-05
G5,C1(C(C(C(O)O1)C(CO)(C)O)O)=O,16,1,0,1,49,4.7e-05
G5,C1C(C)(C(C(O)O1)C(C(C)O)O)O,32,1,0,1,49,4.7e-05
G5,CC(CO)(C1C(O)OC(C)C1O)O,32,1,0,1,49,4.7e-05
G5,C(C1C(O)OC(C1O)CC=O)(O)=O,16,1,0,1,43,4.7e-05
G5,CC(C1C(C(C(O)O1)C(C)O)O)O,64,1,0,1,28,4.7e-05
G5,CC(CC(C1C(O)OCC1O)O)O,32,1,0,1,6,4.7e-05
G5,C(C1C(C)OC(C1(CO)O)O)=O,16,1,0,1,43,4.7e-05
G5,C(C1(COC(C1C(C)O)O)O)=O,16,1,0,1,43,4.7e-05
G5,C(C1C(C)OC(CO)(C1O)O)=O,16,1,0,1,28,4.7e-05
G5,C1(C(O)OC(CC(C)O)C1O)=O,16,1,0,1,5,4.7e-05
G5,C(C1C(C)OC(C)(C1(CO)O)O)=O,16,1,0,1,25,4.7e-05
G5,C(C)(C1(COC(C1C(C)O)O)O)=O,16,1,0,1,25,4.7e-05
G5,C(C1C(C)OC(CO)(C1(C)O)O)=O,16,1,0,1,25,4.7e-05
G5,C1(C(C)(O)OC(CC(C)O)C1O)=O,16,1,0,1,25,4.7e-05
G5,C1(C(CO)(O)OC(CC(C)O)C1)=O,8,1,0,1,25,4.7e-05
G5,C(C1C(C)OC(C1O)(C(C)O)O)=O,32,1,0,1,25,4.7e-05
G5,C(C1C(C)OC(C1(C(C)O)O)O)=O,32,1,0,1,4,4.7e-05
G5,C(C1(C(C)OC(C1C(C)O)O)O)=O,32,1,0,1,4,4.7e-05
G5,C1C(C(C)O)(C(C(O)O1)C(C)O)O,32,1,0,1,25,4.7e-05
G5,CC(C1C(O)OC(C)C1(CO)O)O,32,1,0,1,25,4.7e-05
G5,CC(C1C(O)OC(CCO)C1O)O,32,1,0,1,29,4.7e-05
G5,C1(C(C)(C(C(O)O1)C(C)O)O)=O,16,1,0,1,28,4.7e-05
G5,C1(C(C(C(O)O1)C(C)O)O)=O,16,1,0,1,33,4.7e-05
G5,C(C1C(C(C(O1)O)C(C)O)O)(O)=O,32,1,0,1,17,4.7e-05
G5,C(C1C(C)OC(C1(CC=O)O)O)=O,16,1,0,1,23,4.7e-05
G5,C(C1C(C(O)OC1CC(C)O)=O)=O,16,1,0,1,23,4.7e-05
G5,C(C1C(C)OC(C)(C1(C)O)O)=O,16,1,0,1,14,4.7e-05
G5,C1(C(C)(O)OC(CC(C)O)C1)=O,8,1,0,1,14,4.7e-05
G5,C(C1C(C(C=C)(O)OC1C)O)=O,16,1,0,1,7,4.7e-05
G5,C(C1C(C)OC(C1(C=C)O)O)=O,16,1,0,1,7,4.7e-05
G5,C=CC1(COC(C1C(C)O)O)O,16,1,0,1,7,4.7e-05
G5,CC(C1C(O)OC(C)C1O)O,32,1,0,1,11,4.7e-05
G5,C1C2(C(CO1)OC(C2C(C)O)O)O,32,1,0,1,10,4.7e-05
G5,C12C(CCO1)(C(C(O)O2)C(C)O)O,32,1,0,1,34,4.7e-05
G5,C(C1C(COC1(C=O)O)O)(O)=O,8,1,0,1,0,4.7e-05
G5,C(C1(C(C(C(C(C)O)O1)O)O)O)=O,32,1,0,1,5,4.7e-05
G5,C1(C(O)OC(C(C(C)O)O)C1O)=O,32,1,0,1,5,4.7e-05
G5,C(C1C(O)OC(C1O)C(C)O)=O,32,1,0,1,28,4.7e-05
G5,C(C1(CC(C(C(C)O)O1)O)O)(O)=O,16,1,0,1,28,4.7e-05
G5,C(C)(C1(CC(C(C(C)O)O1)O)O)=O,16,1,0,1,14,4.7e-05
G5,C1(C(C)(O)OC(C(C(C)O)O)C1)=O,16,1,0,1,14,4.7e-05
G5,C(CC1(CC(C(C(C)O)O1)O)O)=O,16,1,0,1,6,4.7e-05
G5,C(C1C(C)(O)OC(C1O)C(C)O)=O,32,1,0,1,6,4.7e-05
G5,C(C)(C1C(O)OC(C1O)C(C)O)=O,32,1,0,1,6,4.7e-05
G5,C=CC1(C(C(C(C(C)O)O1)O)O)O,32,1,0,1,7,4.7e-05
G5,C(C1C(CO)OC(C1(CO)O)O)=O,16,1,0,1,43,4.7e-05
G5,C(C1(COC(C1C(CO)O)O)O)=O,16,1,0,1,43,4.7e-05
G5,C(CO)(C(C1C(O)OCC1O)O)=O,16,1,0,1,0,4.7e-05
G5,C(C1C(CO)OC(CO)(C1O)O)=O,16,1,0,1,0,4.7e-05
G5,C1(C(O)OC(CC(CO)O)C1O)=O,16,1,0,1,6,4.7e-05
G5,C(CC(C1C(O)OCC1O)O)=O,16,1,0,1,6,4.7e-05
G5,C(C(C)(C1C(O)OCC1O)O)(O)=O,16,1,0,1,28,4.7e-05
G5,C1(C(C)(C(C(O)O1)C(CO)O)O)=O,16,1,0,1,28,4.7e-05
G5,C(C1C(O)OCC1O)(O)=O,8,1,0,1,0,4.7e-05
G5,C1(C(C(C(O)O1)C(CO)O)O)=O,16,1,0,1,29,4.7e-05
G5,C(C)(C(C)(C1C(O)OCC1O)O)=O,16,1,0,1,14,4.7e-05
G5,C(C1C(CO)OC(C)(C1(C)O)O)=O,16,1,0,1,14,4.7e-05
G5,C1(C(C)(O)OC(CC(CO)O)C1)=O,8,1,0,1,14,4.7e-05
G5,C(CC(C)(C1C(O)OCC1O)O)=O,16,1,0,1,6,4.7e-05
G5,C(C)(CC(C1C(O)OCC1O)O)=O,16,1,0,1,6,4.7e-05
G5,C=CC(C(C1C(O)OCC1O)O)=O,16,1,0,1,7,4.7e-05
G5,C(C1C(C(C=C)(O)OC1CO)O)=O,16,1,0,1,7,4.7e-05
G5,C(C(C=C)(C1C(O)OCC1O)O)=O,16,1,0,1,7,4.7e-05
G5,C(C1C(CO)OC(C1(C=C)O)O)=O,16,1,0,1,7,4.7e-05
G5,C=CC(CO)(C1C(O)OCC1O)O,16,1,0,1,7,4.7e-05
G5,C=CC1(COC(C1C(CO)O)O)O,16,1,0,1,7,4.7e-05
G5,C(C(C1C(O)OCC1O)O)=CC=O,32,1,0,1,43,4.7e-05
G5,C1C(C(C(O)O1)C(C(C)O)O)O,32,1,0,1,6,4.7e-05
G5,CC1C(C(C(O)O1)C(CO)O)O,32,1,0,1,6,4.7e-05
G5,C(C1C(O)OC(CO)C1(C=O)O)=O,16,1,0,1,0,4.7e-05
G5,C(C1(CO)C(C(C(O1)O)=O)O)=O,8,1,0,1,1,4.7e-05
G5,C(C1(COC(C=O)(C1O)O)O)=O,8,1,0,1,1,4.7e-05
G5,C1(C(O)OC(C(CO)=O)C1O)=O,8,1,0,1,5,4.7e-05
G5,C(C1(C(C(C(C)=O)(CO1)O)O)O)=O,8,1,0,1,1,4.7e-05
G5,C(CO)(C1(C)C(C(C(O1)O)=O)O)=O,8,1,0,1,25,4.7e-05
G5,C(C1(COC(C(C)=O)(C1O)O)O)=O,8,1,0,1,25,4.7e-05
G5,C(C1(CO)C(C(C(C)(O1)O)=O)O)=O,8,1,0,1,25,4.7e-05
G5,C(C1C(C(C(C)(O1)O)=O)O)(CO)=O,8,1,0,1,5,4.7e-05
G5,C(C1(COC(C(CO)=O)(C1)O)O)=O,4,1,0,1,5,4.7e-05
G5,C(C1(CO)CC(C(CO)(O1)O)=O)=O,4,1,0,1,5,4.7e-05
G5,C1(CC(C(CO)=O)OC1(CO)O)=O,4,1,0,1,1,4.7e-05
G5,C(C1C(C(C(O1)O)=O)O)(C(C)O)=O,16,1,0,1,25,4.7e-05
G5,C(C1(C(C)O)C(C(C(O1)O)=O)O)=O,16,1,0,1,1,4.7e-05
G5,C(C1(C(C(C=O)(O)OC1C)O)O)=O,16,1,0,1,1,4.7e-05
G5,C1(C(O)OC(CO)(C(C)O)C1O)=O,16,1,0,1,25,4.7e-05
G5,C(C1(C(C(CO1)(C(C)O)O)O)O)=O,16,1,0,1,25,4.7e-05
G5,C(C1(C(C(CO)(C(C)O1)O)O)O)=O,16,1,0,1,25,4.7e-05
G5,C(C1C(O)OCC1(C=O)O)=O,8,1,0,1,5,4.7e-05
G5,C1(C(O)OC(C(CCO)O)C1O)=O,16,1,0,1,5,4.7e-05
G5,C(C1(C(C(C(CCO)O1)O)O)O)=O,16,1,0,1,5,4.7e-05
G5,C(C1(C)C(C(C(O1)O)=O)O)(O)=O,8,1,0,1,5,4.7e-05
G5,C1(C(C)(C(C(C=O)(O)O1)O)O)=O,8,1,0,1,5,4.7e-05
G5,C(C1(COC(C(O)=O)(C1)O)O)=O,4,1,0,1,17,4.7e-05
G5,C1(C(C(C(O)O1)=O)O)=O,4,1,0,1,17,4.7e-05
G5,C(C1C(C(C(O)O1)=O)O)(O)=O,8,1,0,1,33,4.7e-05
G5,C1(C(C(C(C=O)(O)O1)O)O)=O,8,1,0,1,33,4.7e-05
G5,C(C(C1C(C(C(O)O1)=O)O)O)(O)=O,16,1,0,1,5,4.7e-05
G5,C(C1C(C(C(C=O)(O1)O)O)O)(O)=O,16,1,0,1,5,4.7e-05
G5,C(CC(C1C(C(C(O)O1)=O)O)=O)=O,8,1,0,1,1,4.7e-05
G5,C(CC1(C=O)C(C(C(O)O1)=O)O)=O,8,1,0,1,23,4.7e-05
G5,C(C1(CC(OC1C(C=O)=O)O)O)=O,8,1,0,1,23,4.7e-05
G5,C1(C(O)OC(C1O)CC(C=O)=O)=O,8,1,0,1,23,4.7e-05
G5,C1(C(O)OC(C(C(C=O)=O)O)C1)=O,8,1,0,1,23,4.7e-05
G5,C(C1(CC(C(C(C=O)=O)O1)O)O)=O,8,1,0,1,23,4.7e-05
G5,C(C1C(C=O)(O)OCC1(C=O)O)=O,8,1,0,1,23,4.7e-05
G5,C(C1(COC(C1C(C=O)=O)O)O)=O,8,1,0,1,23,4.7e-05
G5,C(C1(CO)C(C=O)C(C(O1)O)=O)=O,8,1,0,1,23,4.7e-05
G5,C(C1C(C(O)OC1C(CO)=O)=O)=O,8,1,0,1,23,4.7e-05
G5,C(C)(C1(C)C(C(C(O1)O)=O)O)=O,8,1,0,1,14,4.7e-05
G5,C(CC1(C)C(C(C(O)O1)=O)O)=O,8,1,0,1,6,4.7e-05
G5,C(C(C1C(C)(CC(O1)O)O)=O)=O,8,1,0,1,6,4.7e-05
G5,C(C)(CC1C(C(C(O)O1)=O)O)=O,8,1,0,1,5,4.7e-05
G5,C(C(C1C(CC(C)(O1)O)O)=O)=O,8,1,0,1,5,4.7e-05
G5,C(C1C(C)(O)OCC1(C=O)O)=O,8,1,0,1,6,4.7e-05
G5,C(C1(COC(C1C(C)=O)O)O)=O,8,1,0,1,6,4.7e-05
G5,C1(C(O)OC2(COC(C2)O)C1O)=O,16,1,0,1,35,4.7e-05
G5,C(C1(COC2(COC(C21)O)O)O)=O,16,1,0,1,5,4.7e-05
G5,C1(COC2C1C(C(O)O2)(CO)O)=O,16,1,0,1,5,4.7e-05
G5,C1(COC2C1C(C(CO)(O)O2)O)=O,16,1,0,1,5,4.7e-05
G5,C(C1(COC2(C1OC(C2)O)O)O)=O,16,1,0,1,5,4.7e-05
G5,C1(C(O)OC(C(C=C)=O)C1O)=O,8,1,0,1,5,4.7e-05
G5,C(C1(C=C)C(C(C(O1)O)=O)O)=O,8,1,0,1,1,4.7e-05
G5,C1(C(C(C=C)(CO)OC1O)O)=O,8,1,0,1,7,4.7e-05
G5,C(C1(C(C(C=C)(CO1)O)O)O)=O,8,1,0,1,7,4.7e-05
G5,C1(C(O)OC(C=CC=O)C1O)=O,16,1,0,1,43,4.7e-05
G5,C1(C(O)OC2(COCC2O)C1O)=O,16,1,0,1,10,4.7e-05
G5,C(C1(C(C2(COCC2O1)O)O)O)=O,16,1,0,1,10,4.7e-05
G5,C(C1(COC2(C1OCC2O)O)O)=O,16,1,0,1,10,4.7e-05
G5,C1(C(O)OC2(C(O)OCC2)C1O)=O,16,1,0,1,34,4.7e-05
G5,C(C1(C(C2(C(O1)OCC2)O)O)O)=O,16,1,0,1,34,4.7e-05
G5,C(C1(COC2(C(O)OCC21)O)O)=O,16,1,0,1,34,4.7e-05
G5,C1(C(C=O)C(C(CO)(O)O1)O)=O,8,1,0,1,28,4.7e-05
G5,C(CC1C(C(C(C)(O)O1)=O)O)=O,8,1,0,1,25,4.7e-05
G5,C(C1C(O)OCC1(C(C)=O)O)=O,8,1,0,1,45,4.7e-05
G5,C(C1(C)C(C(C(C)(O1)O)=O)O)(O)=O,8,1,0,1,25,4.7e-05
G5,C1(C(C)(C(C(C(C)=O)(O)O1)O)O)=O,8,1,0,1,25,4.7e-05
G5,C(C1(C)CC(C(CO)(O1)O)=O)(O)=O,4,1,0,1,25,4.7e-05
G5,C1(C(C)(CC(C(CO)=O)(O)O1)O)=O,4,1,0,1,25,4.7e-05
G5,C1(C(C(C(C)(O)O1)=O)O)=O,4,1,0,1,17,4.7e-05
G5,C1(CC(C(CO)(O)O1)=O)=O,2,1,0,1,17,4.7e-05
G5,C(C1C(C(C(C)(O1)O)=O)O)(O)=O,8,1,0,1,33,4.7e-05
G5,C1(C(C(C(C(C)=O)(O)O1)O)O)=O,8,1,0,1,33,4.7e-05
G5,C1(CC(C(O)=O)OC1(CO)O)=O,4,1,0,1,33,4.7e-05
G5,C1(C(CC(C(CO)=O)(O)O1)O)=O,4,1,0,1,33,4.7e-05
G5,C(C)(C1(C)C(C(C(C)(O1)O)=O)O)=O,8,1,0,1,14,4.7e-05
G5,C(C)(C1(C)CC(C(CO)(O1)O)=O)=O,4,1,0,1,14,4.7e-05
G5,C(C)(C1(COC(C(C)=O)(C1)O)O)=O,4,1,0,1,14,4.7e-05
G5,C(C)(C1(CO)CC(C(C)(O1)O)=O)=O,4,1,0,1,14,4.7e-05
G5,C(CO)(C1(C)CC(C(C)(O1)O)=O)=O,4,1,0,1,14,4.7e-05
G5,C(CC1(C)C(C(C(C)(O)O1)=O)O)=O,8,1,0,1,25,4.7e-05
G5,C(C(C)=O)(C1C(C)(CC(O1)O)O)=O,8,1,0,1,25,4.7e-05
G5,C(CC1(C)CC(C(CO)(O)O1)=O)=O,4,1,0,1,26,4.7e-05
G5,C1(C(C)(O)OC(C1O)CC(C)=O)=O,8,1,0,1,25,4.7e-05
G5,C(C(C)=O)(C1C(CC(C)(O1)O)O)=O,8,1,0,1,25,4.7e-05
G5,C1(C(CO)(O)OC(C1)CC(C)=O)=O,4,1,0,1,25,4.7e-05
G5,C(CC1(CC(C(C)=O)(CO1)O)O)=O,4,1,0,1,25,4.7e-05
G5,C(C1C(C)(O)OCC1(C(C)=O)O)=O,8,1,0,1,25,4.7e-05
G5,C(C)(C1C(O)OCC1(C(C)=O)O)=O,8,1,0,1,25,4.7e-05
G5,C1(C(C(C(C=C)=O)OC1(C)O)O)=O,8,1,0,1,25,4.7e-05
G5,C1(CC(C(C=C)=O)OC1(CO)O)=O,4,1,0,1,25,4.7e-05
G5,C(C1(C=C)C(C(C(C)(O1)O)=O)O)=O,8,1,0,1,25,4.7e-05
G5,C(C1(C=C)CC(C(CO)(O1)O)=O)=O,4,1,0,1,25,4.7e-05
G5,C1(C(C(C=C)(CO)OC1(C)O)O)=O,8,1,0,1,25,4.7e-05
G5,C(C)(C1(C(C(C=C)(CO1)O)O)O)=O,8,1,0,1,25,4.7e-05
G5,C1(CC(C=C)(CO)OC1(CO)O)=O,4,1,0,1,25,4.7e-05
G5,C(CO)(C1(CC(C=C)(CO1)O)O)=O,4,1,0,1,25,4.7e-05
G5,C(C)(C1(COC(C=C)(C1O)O)O)=O,8,1,0,1,7,4.7e-05
G5,C1(C(C(C=CC=O)OC1(C)O)O)=O,16,1,0,1,25,4.7e-05
G5,C1(CC(C=CC=O)OC1(CO)O)=O,8,1,0,1,25,4.7e-05
G5,C1(C(C)(O)OC(C(C)O)C1O)=O,16,1,0,1,25,4.7e-05
G5,C(C)(C1(C(C(C(C)O1)O)O)O)=O,16,1,0,1,25,4.7e-05
G5,C1(C(CO)(O)OC(C(C)O)C1)=O,8,1,0,1,11,4.7e-05
G5,C(CO)(C1(CC(C(C)O1)O)O)=O,8,1,0,1,11,4.7e-05
G5,C(C(C1(CC(CO1)=O)O)O)(O)=O,4,1,0,1,27,4.7e-05
G5,C(CC1(C(C(CO1)=O)O)O)(O)=O,4,1,0,1,17,4.7e-05
G5,C(C1C(O)OC(C)C1(C=O)O)=O,16,1,0,1,25,4.7e-05
G5,C(C1(CC(C(O)=O)(O)OC1C)O)=O,8,1,0,1,17,4.7e-05
G5,C1(CC(C(C(C)O)=O)OC1(C)O)=O,8,1,0,1,14,4.7e-05
G5,C(C1C(C)(O)OC(C)C1(C=O)O)=O,16,1,0,1,25,4.7e-05
G5,C(C1(C(C)OC(C1C(C)=O)O)O)=O,16,1,0,1,25,4.7e-05
G5,C(C1C(O)OCC1(C(C)O)O)=O,16,1,0,1,25,4.7e-05
G5,C(C1C(O)OC(C)C1(CO)O)=O,16,1,0,1,25,4.7e-05
G5,C1(C(C)(C(C(C(C)O)(O)O1)O)O)=O,16,1,0,1,25,4.7e-05
G5,C(C1(CC(CO1)(C(C)O)O)O)(O)=O,8,1,0,1,29,4.7e-05
G5,C(C1(CC(CO)(C(C)O1)O)O)(O)=O,8,1,0,1,29,4.7e-05
G5,C(C)(C1(CC(CO1)(C(C)O)O)O)=O,8,1,0,1,29,4.7e-05
G5,C(C1C(C)(CC(O1)O)O)(C(C)O)=O,16,1,0,1,25,4.7e-05
G5,C(C1C(CC(C)(O1)O)O)(C(C)O)=O,16,1,0,1,25,4.7e-05
G5,C(CC1(CC(CO1)(C(C)O)O)O)=O,8,1,0,1,29,4.7e-05
G5,C(C1C(C)(O)OCC1(C(C)O)O)=O,16,1,0,1,25,4.7e-05
G5,C(C)(C1C(O)OCC1(C(C)O)O)=O,16,1,0,1,25,4.7e-05
G5,C(C1C(C)(O)OC(C)C1(CO)O)=O,16,1,0,1,25,4.7e-05
G5,C(C)(C1C(O)OC(C)C1(CO)O)=O,16,1,0,1,25,4.7e-05
G5,C=CC1(COC(C1O)(C(C)O)O)O,16,1,0,1,7,4.7e-05
G5,C=CC1(C(C(CO1)(C(C)O)O)O)O,16,1,0,1,7,4.7e-05
G5,CC(C1(C(C(C(C)O1)O)O)O)O,32,1,0,1,25,4.7e-05
G5,C(C1C(O)OCC1(C(C=O)O)O)=O,16,1,0,1,1,4.7e-05
G5,C(C1C(OC(C=O)C1(CO)O)O)=O,16,1,0,1,1,4.7e-05
G5,C(C1C(OC(C(CO)=O)C1O)O)=O,16,1,0,1,5,4.7e-05
G5,C(C(C(C1C(CC(O1)O)O)=O)O)=O,16,1,0,1,5,4.7e-05
G5,C(C1C(O)OC(C1(C)O)=O)=O,8,1,0,1,28,4.7e-05
G5,C(C1C(O)OCC1(CC(O)=O)O)=O,8,1,0,1,45,4.7e-05
G5,C(C1C(OC(C(O)=O)C1(C)O)O)=O,16,1,0,1,45,4.7e-05
G5,C(C1C(O)OC(C1O)=O)=O,8,1,0,1,33,4.7e-05
G5,C(C1C(C(C(O)=O)OC1O)O)=O,16,1,0,1,45,4.7e-05
G5,C(C1C(O)OC(C1O)CC(O)=O)=O,16,1,0,1,29,4.7e-05
G5,C(C(C=O)C1C(CC(C)(O1)O)=O)=O,4,1,0,1,26,4.7e-05
G5,C(C(C=O)C1(C)CC(C(O)O1)=O)=O,4,1,0,1,26,4.7e-05
G5,C(CC1C(C(C)=O)C(C(O)O1)=O)=O,8,1,0,1,26,4.7e-05
G5,C(C(C=O)C1CC(C(O)O1)=O)=O,4,1,0,1,23,4.7e-05
G5,C(CC1C(C=O)C(C(O)O1)=O)=O,8,1,0,1,23,4.7e-05
G5,C(C(C=O)C1CC(C(C)(O)O1)=O)=O,4,1,0,1,14,4.7e-05
G5,C(C(C=O)C1(C(CC(O1)O)=O)C)=O,4,1,0,1,14,4.7e-05
G5,C(CC1C(C=O)C(C(C)(O)O1)=O)=O,8,1,0,1,14,4.7e-05
G5,C(CC1(C(CC(CC=O)O1)=O)O)=O,4,1,0,1,14,4.7e-05
G5,C(C1C(O)OCC1(C=CC=O)O)=O,16,1,0,1,11,4.7e-05
G5,C(C=CC(C1C(CC(O1)O)O)=O)=O,16,1,0,1,45,4.7e-05
G5,C(C1C(O)OCC1(C=C)O)=O,8,1,0,1,7,4.7e-05
G5,C=CC(C1C(CC(O1)O)O)=O,8,1,0,1,45,4.7e-05
G5,C(C1C(O)OC(C)C1O)=O,16,1,0,1,11,4.7e-05
G5,C(C1C(O)OC(C1(CCO)O)=O)=O,8,1,0,1,7,4.7e-05
G5,C(CC(C1C(O)OC(C1O)=O)O)=O,16,1,0,1,33,4.7e-05
G5,C(C1C(O)OC(CO)(CO)C1O)=O,8,1,0,1,45,4.7e-05
G5,C(C1C(C(C=O)(CO)OC1O)O)=O,16,1,0,1,1,4.7e-05
G5,C(CC1CC(C(C=CC=O)(O)O1)=O)=O,8,1,0,1,45,4.7e-05
G5,C(C(C=O)C1C(CC(C=C)(O)O1)=O)=O,4,1,0,1,45,4.7e-05
G5,C(C(C=O)C1(C=C)CC(C(O)O1)=O)=O,4,1,0,1,45,4.7e-05
G5,C(CC1C(C(C(O)O1)=O)C(C=C)=O)=O,8,1,0,1,45,4.7e-05
G5,C(C(C=O)C1CC(C(C=C)(O)O1)=O)=O,4,1,0,1,45,4.7e-05
G5,C(C(C=O)C1(C(CC(O1)O)=O)C=C)=O,4,1,0,1,45,4.7e-05
G5,C(C1C(C(C=C)(O)OC1CC=O)=O)=O,8,1,0,1,45,4.7e-05
G5,C(CC1C(C(C(O)O1)=O)C=CC=O)=O,16,1,0,1,27,4.7e-05
G5,C(C1C(O)OC2COCC21O)=O,16,1,0,1,10,4.7e-05
G5,C(C1C(O)OC2C1(CCO2)O)=O,16,1,0,1,34,4.7e-05
G5,C1(C(C(C(C(C=O)O)(O)O1)O)O)=O,16,1,0,1,5,4.7e-05
G5,C(C(C1(C(C(C(C)O1)O)O)O)O)=O,32,1,0,1,5,4.7e-05
G5,C(C1(CC(C(CCO)O1)O)O)(O)=O,8,1,0,1,29,4.7e-05
G5,C(C1C(C)(O)OC(C1O)CCO)=O,16,1,0,1,29,4.7e-05
G5,C(C)(C1C(O)OC(C1O)CCO)=O,16,1,0,1,29,4.7e-05
G5,C1(C(C)(CC(C(O)=O)(O)O1)O)=O,4,1,0,1,29,4.7e-05
G5,C1(C(CC(C(O)=O)(O)O1)O)=O,4,1,0,1,33,4.7e-05
G5,C(C1C(CC(C(O)=O)(O1)O)O)(O)=O,8,1,0,1,29,4.7e-05
G5,C1(C(CC(C(O)=O)=O)OC(C1)O)=O,4,1,0,1,23,4.7e-05
G5,C1(C(O)OC(CC(C(O)=O)=O)C1)=O,4,1,0,1,23,4.7e-05
G5,C1(C(C)(C(C=O)C(C=O)(O)O1)O)=O,8,1,0,1,23,4.7e-05
G5,C1(C(C)(C(C(C=O)=O)C(O)O1)O)=O,8,1,0,1,23,4.7e-05
G5,C(C1(C)C(C=O)C(C(O1)O)=O)(O)=O,8,1,0,1,23,4.7e-05
G5,C1(C(C)(CC(C(C)=O)(O)O1)O)=O,4,1,0,1,28,4.7e-05
G5,C(C1(C)CC(C(C)(O1)O)=O)(O)=O,4,1,0,1,28,4.7e-05
G5,C1(C(C)(CC(CC=O)(O)O1)O)=O,4,1,0,1,29,4.7e-05
G5,C(C1C(C)(O)OC(C1(C)O)=O)=O,8,1,0,1,28,4.7e-05
G5,C1(C(C)(C(C(C)=O)C(O)O1)O)=O,8,1,0,1,28,4.7e-05
G5,C1(C(C)(C2C(O)OCC2(O)O1)O)=O,16,1,0,1,28,4.7e-05
G5,C1(C(C)(C2C(CC(O)O2)(O)O1)O)=O,16,1,0,1,28,4.7e-05
G5,C(C1(CC(C=C)(CO1)O)O)(O)=O,4,1,0,1,29,4.7e-05
G5,C1(C(C)(C(C(C=C)(O)O1)O)O)=O,8,1,0,1,7,4.7e-05
G5,C(C1(CC(C(C)O1)O)O)(O)=O,8,1,0,1,11,4.7e-05
G5,C(C1(CC2(COCC2O1)O)O)(O)=O,8,1,0,1,10,4.7e-05
G5,C1(C(C)(C2C(C(CO2)O)(O)O1)O)=O,16,1,0,1,10,4.7e-05
G5,C(C1(CC2(C(O1)OCC2)O)O)(O)=O,8,1,0,1,29,4.7e-05
G5,C1(C(C)(C2COC(C2(O)O1)O)O)=O,16,1,0,1,34,4.7e-05
G5,C(C1C(CO)(O)OC(C1O)=O)(O)=O,8,1,0,1,33,4.7e-05
G5,C1(C(CC(C(C(O)=O)O)(O)O1)O)=O,8,1,0,1,33,4.7e-05
G5,C(CC1(C(C(C(O1)=O)O)O)O)(O)=O,8,1,0,1,33,4.7e-05
G5,C1(C(C(C)=O)C(C(O)O1)=O)=O,4,1,0,1,17,4.7e-05
G5,C1(C(C=O)C(C(O)O1)=O)=O,4,1,0,1,17,4.7e-05
G5,C1(C(C=O)C(C(C)(O)O1)=O)=O,4,1,0,1,17,4.7e-05
G5,C1(CC(C(CC=O)(O)O1)=O)=O,2,1,0,1,17,4.7e-05
G5,C(C(CC1C(OC(C1=O)O)=O)O)=O,8,1,0,1,12,4.7e-05
G5,C(C1CC(C=O)OC1(C=O)O)(O)=O,8,1,0,1,12,4.7e-05
G5,C(C(C)O)(C1C(OC(C1=O)O)=O)=O,8,1,0,1,24,4.7e-05
G5,C1(C(C=O)C(C(C(C)=O)(O)O1)O)=O,8,1,0,1,25,4.7e-05
G5,C(CC(C1(C(CC(O1)=O)=O)O)O)=O,4,1,0,1,17,4.7e-05
G5,C1(C(C=O)C(C(C(C)O)(O)O1)=O)=O,8,1,0,1,17,4.7e-05
G5,C1(C(C(C(CC(C)=O)(O)O1)=O)O)=O,4,1,0,1,26,4.7e-05
G5,C1(C(CO)(O)OC(C1C(C)=O)=O)=O,4,1,0,1,26,4.7e-05
G5,C(C1(C(C(C(O1)=O)C(C)=O)O)O)=O,8,1,0,1,17,4.7e-05
G5,C(CCC1(C(C(C(O1)=O)O)=O)O)=O,4,1,0,1,17,4.7e-05
G5,C1(C(CO)(O)OC(C1CC=O)=O)=O,4,1,0,1,17,4.7e-05
G5,C1(C(C(C(CO)=O)=O)CC(O)O1)=O,4,1,0,1,17,4.7e-05
G5,C1(C(C=O)CC(C(CO)=O)(O)O1)=O,4,1,0,1,17,4.7e-05
G5,C(C1CC(C(C=O)=O)OC1O)(O)=O,8,1,0,1,17,4.7e-05
G5,C1(C(C)(O)OC(C1C(CO)=O)=O)=O,4,1,0,1,24,4.7e-05
G5,C1(CC(C(CC(CO)=O)(O)O1)=O)=O,2,1,0,1,17,4.7e-05
G5,C1(C(C(C(C=CCO)(O)O1)=O)O)=O,8,1,0,1,55,4.7e-05
G5,C1(C(C(CO)=O)CC(CO)(O)O1)=O,4,1,0,1,29,4.7e-05
G5,C1(C(C(C(O)O1)=O)C(CCO)O)=O,8,1,0,1,17,4.7e-05
G5,C1(C(C(C(CO)O)=O)CC(O)O1)=O,8,1,0,1,17,4.7e-05
G5,C1(C(C=O)CC(C(CO)O)(O)O1)=O,8,1,0,1,29,4.7e-05
G5,C(C1C(C(C=O)O)(O)OCC1)(O)=O,8,1,0,1,17,4.7e-05
G5,C(C1C(COC1(C(C)=O)O)O)(O)=O,8,1,0,1,17,4.7e-05
G5,C1(C(C(C(C)(O)O1)=O)C(CO)O)=O,8,1,0,1,17,4.7e-05
G5,C(CC1(C(CC(CO)O1)=O)O)(O)=O,4,1,0,1,17,4.7e-05
G5,C1(CC(C(CC(CO)O)(O)O1)=O)=O,4,1,0,1,17,4.7e-05
G5,C(C1C(CC=O)(O)OCC1O)(O)=O,8,1,0,1,17,4.7e-05
G5,C1(C(C(CCO)=O)C(C(O)O1)O)=O,8,1,0,1,17,4.7e-05
G5,C(C1C(O)OC(C1O)=O)(O)=O,8,1,0,1,17,4.7e-05
G5,C1(C2C(CC(C2(C(O)O1)O)O)=O)=O,16,1,0,1,17,4.7e-05
G5,C(C1C(O)OCC1(C=O)O)(O)=O,8,1,0,1,5,4.7e-05
G5,C1(C(C=O)C(CO)(C(O)O1)O)=O,8,1,0,1,5,4.7e-05
G5,C(C1C(O)OC(C)C1(C=O)O)(O)=O,16,1,0,1,4,4.7e-05
G5,C1(C(C=O)C(C(O)O1)(C(C)O)O)=O,16,1,0,1,4,4.7e-05
G5,C1(C2C(C(CO)C(C2O)(O)O1)=O)=O,16,2,0,2,2,9.499999999999999e-05
G5,C1(C2C(C(C(C2CO)(O)O1)O)=O)=O,16,2,0,2,17,9.499999999999999e-05
G5,C1(C2COC(C2C(O)=O)(C1O)O)=O,16,2,0,2,17,9.499999999999999e-05
G5,C1(C2C(C(CO)(C(C2)(O)O1)O)=O)=O,8,2,0,2,17,9.499999999999999e-05
G5,C1(C2C(CC(C2(CO)O)(O)O1)=O)=O,8,2,0,2,17,9.499999999999999e-05
G5,C(C1C2(CC(C1(CO2)O)=O)O)(O)=O,8,2,0,2,17,9.499999999999999e-05
G5,C(C1C(O)OC2C1OC(C2)=O)(O)=O,16,1,0,1,48,4.7e-05
G5,C(C1C(OC2C(COC21)=O)O)(O)=O,16,1,0,1,9,4.7e-05
G5,C1(C2C(C(O)OC2C(C)(O)O1)=O)=O,16,1,0,1,22,4.7e-05
G5,C1(C(C=O)C2C(CC(O)O2)(O)O1)=O,16,1,0,1,17,4.7e-05
G5,C(C1C2(CC(OC1CO2)=O)O)(O)=O,8,1,0,1,19,4.7e-05
G5,C1(C2C(C(CC(CO)O2)(O)O1)=O)=O,8,1,0,1,54,4.7e-05
G5,C1(C2C(C(COC2CO)(O)O1)=O)=O,8,1,0,1,54,4.7e-05
G5,C(C1C2COC1(C(CO2)=O)O)(O)=O,8,1,0,1,54,4.7e-05
G5,C1(C2C(C(CC(CO2)O)(O)O1)=O)=O,8,1,0,1,36,4.7e-05
G5,C(C1C2(C(CC(CO1)O2)=O)O)(O)=O,8,1,0,1,36,4.7e-05
G5,C1(C2C(C(COCC2O)(O)O1)=O)=O,8,1,0,1,17,4.7e-05
G5,C1(C2COC(C(O)=O)C(C1)(O2)O)=O,8,1,0,1,36,4.7e-05
G5,C1(C2C(COCC(C2O)(O)O1)=O)=O,8,1,0,1,17,4.7e-05
G5,C(C1COC2C(CC1(O2)O)=O)(O)=O,8,1,0,1,30,4.7e-05
G5,C1(C2C(C(O)OCC(C2)(O)O1)=O)=O,8,1,0,1,12,4.7e-05
G5,C1(C2C(COC(C(C2)(O)O1)O)=O)=O,8,1,0,1,17,4.7e-05
G5,C1(C2C(C(CCOC2O)(O)O1)=O)=O,8,1,0,1,17,4.7e-05
G5,C1(C2C(C(CC(O)OC2)(O)O1)=O)=O,8,1,0,1,17,4.7e-05
G5,C(C1COC2CC(C1(O)O2)=O)(O)=O,8,1,0,1,17,4.7e-05
G5,C1(CC(C(C=CC=O)(O)O1)=O)=O,4,1,0,1,17,4.7e-05
G5,C1(C(C(C(O)O1)=O)C(C=C)=O)=O,4,1,0,1,17,4.7e-05
G5,C1(C(C=O)C(C(C=C)(O)O1)=O)=O,4,1,0,1,17,4.7e-05
G5,C1(C(C(C(O)O1)=O)C=CC=O)=O,8,1,0,1,17,4.7e-05
G5,C1(C(C=O)C2C(C(CO2)O)(O)O1)=O,16,1,0,1,9,4.7e-05
G5,C1(C(C=O)C2(C(CCO2)(O)O1)O)=O,8,1,0,1,17,4.7e-05
G5,C1(C2C(C(C)(O)OC2C(O)O1)=O)=O,16,1,0,1,14,4.7e-05
G5,C1(C2C(CCOC2(C(O)O1)O)=O)=O,8,1,0,1,30,4.7e-05
G5,C1(C2C(CC(O)OC2C(O)O1)=O)=O,16,1,0,1,37,4.7e-05
G5,C(C1C(CO)(O)OC(C)C1O)(O)=O,16,1,0,1,0,4.7e-05
G5,C(CC1(C(C(C(C)O1)O)O)O)(O)=O,16,1,0,1,0,4.7e-05
G5,C(C(C1(CC(C(C)O1)O)O)O)(O)=O,16,1,0,1,11,4.7e-05
G5,C1(C(C(C(C)=O)C(C=O)(O)O1)O)=O,8,1,0,1,26,4.7e-05
G5,C1(C(C(C(C=O)=O)C(C)(O)O1)O)=O,8,1,0,1,26,4.7e-05
G5,C(C1C(C(C)=O)C(C(O)O1)=O)(O)=O,8,1,0,1,26,4.7e-05
G5,C1(C(CC(CC(C=O)=O)(O)O1)O)=O,4,1,0,1,33,4.7e-05
G5,C1(C(C(C=O)C(C=O)(O)O1)O)=O,8,1,0,1,33,4.7e-05
G5,C1(C(C(C(C=O)=O)C(O)O1)O)=O,8,1,0,1,33,4.7e-05
G5,C(C1C(C(O)OC1C(O)=O)=O)=O,8,1,0,1,33,4.7e-05
G5,C1(C(C(C(C(C)=O)=O)C(O)O1)O)=O,8,1,0,1,14,4.7e-05
G5,C1(C(C(C=O)C(C(C)=O)(O)O1)O)=O,8,1,0,1,14,4.7e-05
G5,C1(C(C)(OC(C(O)=O)C1C=O)O)=O,8,1,0,1,14,4.7e-05
G5,C1(C(CC(C(CC=O)=O)(O)O1)O)=O,4,1,0,1,33,4.7e-05
G5,C(C1CC(C(CC=O)(O)O1)=O)(O)=O,4,1,0,1,33,4.7e-05
G5,C(C1C(C)(O)OC(C1O)=O)=O,8,1,0,1,33,4.7e-05
G5,C(C)(C1C(O)OC(C1O)=O)=O,8,1,0,1,33,4.7e-05
G5,C1(C(C2C(O)OCC2(O)O1)O)=O,16,1,0,1,33,4.7e-05
G5,C1(C(C2C(CC(O)O2)(O)O1)O)=O,16,1,0,1,33,4.7e-05
G5,C1(C(C(C(C=CC=O)(O)O1)O)O)=O,16,1,0,1,33,4.7e-05
G5,C1(C(C(CO)C(C(O)=O)(O)O1)O)=O,8,1,0,1,33,4.7e-05
G5,C1(C(C(C(O)O1)C(C(O)=O)O)O)=O,16,1,0,1,33,4.7e-05
G5,C1(C(C2C(C(CO2)O)(O)O1)O)=O,16,1,0,1,10,4.7e-05
G5,C1(C(C2COC(C2(O)O1)O)O)=O,16,1,0,1,34,4.7e-05
G5,C(C1C(CC(C(C)=O)(O1)O)O)(O)=O,8,1,0,1,14,4.7e-05
G5,C(C(C1CC(C(C)(O)O1)=O)O)(O)=O,8,1,0,1,14,4.7e-05
G5,C(CC1(CC(C(C(O)=O)O1)O)O)=O,8,1,0,1,9,4.7e-05
G5,C(C1C(C(C(O)=O)OC1(C)O)O)=O,16,1,0,1,6,4.7e-05
G5,C(C1C(C(C(C)=O)C(O1)O)O)(O)=O,16,1,0,1,6,4.7e-05
G5,C(C1C(C(C(C=C)(O1)O)O)O)(O)=O,16,1,0,1,7,4.7e-05
G5,C(C)(C1C(C(O)OC1C(C=C)=O)=O)=O,8,1,0,1,7,4.7e-05
G5,C(C1(C=C)C(C(C)=O)C(C(O1)O)=O)=O,8,1,0,1,7,4.7e-05
G5,C(C)(C1C(C(O)OC1C=CC=O)=O)=O,16,1,0,1,43,4.7e-05
G5,C(C)(C1C(C(O)OC1C(C)O)=O)=O,16,1,0,1,26,4.7e-05
G5,C(C)(C1C(C(C)OC1(C=O)O)O)=O,16,1,0,1,26,4.7e-05
G5,C(C(C1C(C)(O)OC(C)C1O)=O)=O,16,1,0,1,26,4.7e-05
G5,C(C(CC1(CC(C(C)O1)O)O)=O)=O,8,1,0,1,11,4.7e-05
G5,C(C)(C1(C)C(C=O)C(C(O1)O)=O)=O,8,1,0,1,14,4.7e-05
G5,C1(C(CC(C(C)=O)=O)OC(C1)O)=O,4,1,0,1,14,4.7e-05
G5,C1(CC(C(CC=O)=O)OC1(C)O)=O,4,1,0,1,14,4.7e-05
G5,C1(CC(C=O)(CC=O)OC1(C)O)=O,4,1,0,1,14,4.7e-05
G5,C1(C(O)OC(CC(C(C)=O)=O)C1)=O,4,1,0,1,14,4.7e-05
G5,C1(C(C)(O)OC(CC(C=O)=O)C1)=O,4,1,0,1,14,4.7e-05
G5,C(CC1(C)C(C=O)C(C(O)O1)=O)=O,8,1,0,1,23,4.7e-05
G5,C(C)(CC1C(C=O)C(C(O)O1)=O)=O,8,1,0,1,23,4.7e-05
G5,C(CC1C(CC(O1)O)=O)(CC=O)=O,4,1,0,1,23,4.7e-05
G5,C(CC1CC(C(O)O1)=O)(CC=O)=O,4,1,0,1,23,4.7e-05
G5,C(C)(C(C=O)C1C(CC(O1)O)=O)=O,8,1,0,1,23,4.7e-05
G5,C(C)(C(C=O)C1CC(C(O)O1)=O)=O,8,1,0,1,23,4.7e-05
G5,C(C1C(C(O)OC1C(C=C)=O)=O)=O,8,1,0,1,23,4.7e-05
G5,C(C1C(C(OC1(C=O)C=C)O)=O)=O,8,1,0,1,23,4.7e-05
G5,C(C1C(C(OC1(C=C)CO)O)=O)=O,8,1,0,1,23,4.7e-05
G5,C(C1C(C=O)(O)OCC1(C=C)O)=O,8,1,0,1,23,4.7e-05
G5,C=CC1(COC(C1C(C=O)=O)O)O,8,1,0,1,23,4.7e-05
G5,C(C1(CC(OC1C(C=C)=O)O)O)=O,8,1,0,1,23,4.7e-05
G5,C1(C(O)OC(C(C(C=C)=O)O)C1)=O,8,1,0,1,23,4.7e-05
G5,C(C1(CC(C(C(C=C)=O)O1)O)O)=O,8,1,0,1,23,4.7e-05
G5,C(C1C(C(O)OC1C=CC=O)=O)=O,16,1,0,1,23,4.7e-05
G5,C(C1C(C(O)OC1C(C)O)=O)=O,16,1,0,1,23,4.7e-05
G5,C(C1C(C(C)OC1(C=O)O)O)=O,16,1,0,1,23,4.7e-05
G5,C(C(C1C(O)OC(C)C1O)=O)=O,16,1,0,1,23,4.7e-05
G5,C1(C(C)(OC(C(C=C)=O)C1C=O)O)=O,8,1,0,1,14,4.7e-05
G5,C(CC1(C(CC(C(C=C)=O)O1)=O)O)=O,4,1,0,1,14,4.7e-05
G5,C(C1C(C(C)(OC1(C=O)C=C)O)=O)=O,8,1,0,1,14,4.7e-05
G5,C(C1(C=C)CC(C(CC=O)(O1)O)=O)=O,4,1,0,1,14,4.7e-05
G5,C1(C(C)(OC(C=CC=O)C1C=O)O)=O,16,1,0,1,14,4.7e-05
G5,C(CC1(C(CC(C=CC=O)O1)=O)O)=O,8,1,0,1,14,4.7e-05
G5,C(C1C(C(C)(O)OC1C(C)O)=O)=O,16,1,0,1,14,4.7e-05
G5,C(C(C)=O)(C1C(O)OC(C)C1O)=O,16,1,0,1,14,4.7e-05
G5,C(C1C(C(C)OC1(C(C)=O)O)O)=O,16,1,0,1,14,4.7e-05
G5,C(CC1(C(CC(C(C)O)O1)=O)O)=O,8,1,0,1,11,4.7e-05
G5,C(CC(C1(CC(C(C)O1)O)O)=O)=O,8,1,0,1,11,4.7e-05
G5,C(C)(C1(C)CC(C(C)(O1)O)=O)=O,4,1,0,1,14,4.7e-05
G5,C(CC1(C)CC(C(C)(O)O1)=O)=O,4,1,0,1,14,4.7e-05
G5,C1(C(C)(O)OC(C1)CC(C)=O)=O,4,1,0,1,14,4.7e-05
G5,C1(C(C)(O)OC2(COC(C2)O)C1)=O,8,1,0,1,14,4.7e-05
G5,C1(COC2C1C(C)(C(C)(O)O2)O)=O,16,1,0,1,14,4.7e-05
G5,C1(CC(C(C=C)=O)OC1(C)O)=O,4,1,0,1,14,4.7e-05
G5,C1(CC(C=C)(CO)OC1(C)O)=O,4,1,0,1,14,4.7e-05
G5,C(C)(C1(CC(C=C)(CO1)O)O)=O,4,1,0,1,14,4.7e-05
G5,C1(C(C)(O)OC(C(C)O)C1)=O,8,1,0,1,11,4.7e-05
G5,C(C)(C1(CC(C(C)O1)O)O)=O,8,1,0,1,11,4.7e-05
G5,C1(C(C)(O)OC2(COCC2O)C1)=O,8,1,0,1,10,4.7e-05
G5,C(C)(C1(CC2(COCC2O1)O)O)=O,8,1,0,1,10,4.7e-05
G5,C1(C(C)(O)OC2(C(O)OCC2)C1)=O,8,1,0,1,14,4.7e-05
G5,C(C)(C1(CC2(C(O1)OCC2)O)O)=O,8,1,0,1,14,4.7e-05
G5,C(CC1(CC(C=C)(CO1)O)O)=O,4,1,0,1,29,4.7e-05
G5,C(C1C(C)(O)OCC1(C=C)O)=O,8,1,0,1,7,4.7e-05
G5,C(C)(C1C(O)OCC1(C=C)O)=O,8,1,0,1,7,4.7e-05
G5,C=CC(C1C(C)(CC(O1)O)O)=O,8,1,0,1,7,4.7e-05
G5,C=CC(C1C(CC(C)(O1)O)O)=O,8,1,0,1,7,4.7e-05
G5,C(CC1(CC(C(C)O1)O)O)=O,8,1,0,1,11,4.7e-05
G5,C(C1C(C)(O)OC(C)C1O)=O,16,1,0,1,11,4.7e-05
G5,C(C)(C1C(O)OC(C)C1O)=O,16,1,0,1,11,4.7e-05
G5,C(CC1(CC2(COCC2O1)O)O)=O,8,1,0,1,10,4.7e-05
G5,C(C1C(C)(O)OC2COCC21O)=O,16,1,0,1,10,4.7e-05
G5,C(C)(C1C(O)OC2COCC21O)=O,16,1,0,1,10,4.7e-05
G5,C(CC1(CC2(C(OCC2)O1)O)O)=O,8,1,0,1,34,4.7e-05
G5,C(C1C(C)(O)OC2C1(CCO2)O)=O,16,1,0,1,34,4.7e-05
G5,C(C)(C1C(O)OC2C1(CCO2)O)=O,16,1,0,1,34,4.7e-05
G5,C1(COC2C1C(C(C=C)(O)O2)O)=O,16,1,0,1,7,4.7e-05
G5,C1(COC2C1C(C=C)(C(O)O2)O)=O,16,1,0,1,7,4.7e-05
G5,C=CC1(COC2(COC(C21)O)O)O,16,1,0,1,7,4.7e-05
G5,C=CC1(COC2(C1OC(C2)O)O)O,16,1,0,1,35,4.7e-05
G5,C1C2(C(C(O)O1)C(C(C)O2)O)O,32,1,0,1,35,4.7e-05
G5,CC1C(C2C(CC(O)O2)(O)O1)O,32,1,0,1,35,4.7e-05
G5,C(C1(C(C(C(C)O1)O)O)O)=CC=O,32,1,0,1,11,4.7e-05
G5,C(C1(COC(C=C)(C1O)O)O)=C,8,1,0,1,7,4.7e-05
G5,C=CC1(C(C(C(C)O1)O)O)O,16,1,0,1,11,4.7e-05
G5,C=CC1(C(C2(COCC2O1)O)O)O,16,1,0,1,10,4.7e-05
G5,C=CC1(COC2(C1OCC2O)O)O,16,1,0,1,10,4.7e-05
G5,C=CC1(C(C2(C(O1)OCC2)O)O)O,16,1,0,1,7,4.7e-05
G5,C=CC1(COC2(C(O)OCC21)O)O,16,1,0,1,34,4.7e-05
G5,C(C1(C(CO)C(C(C)O1)O)O)(O)=O,16,1,0,1,11,4.7e-05
G5,C(C(C1C(O)OC(C)C1O)O)(O)=O,32,1,0,1,33,4.7e-05
G5,C1(C(C(C(O)O1)C(C(C)O)O)O)=O,32,1,0,1,33,4.7e-05
G5,C1C(C2(C(C(C(C)O2)O)O1)O)O,32,1,0,1,10,4.7e-05
G5,C1C2C(C(O)O1)(O)OC(C)C2O,32,1,0,1,34,4.7e-05
G5,C1(C(C2(C(C(C(C2)O)O)O1)O)O)O,64,1,0,1,0,4.7e-05
G5,CC(C1C(CO)(C(C(O)O1)O)O)O,32,1,0,1,0,4.7e-05
G5,C1C(C(C(O)O1)C(CO)(CO)O)O,8,1,0,1,5,4.7e-05
G5,C1C(C(C(O)O1)C(C(CO)O)O)O,32,1,0,1,41,4.7e-05
G5,C(C(C1C(COC1(C=O)O)O)O)=O,16,1,0,1,0,4.7e-05
G5,C(C(C1C(CO)OC(C1O)O)=O)=O,16,1,0,1,0,4.7e-05
G5,C(C1(C(C(C)O)C(CO1)O)O)=O,16,1,0,1,0,4.7e-05
G5,C(C(C1(C)C(CC(O)O1)O)O)=O,16,1,0,1,0,4.7e-05
G5,C(CC1C(C)(C(C(O)O1)O)O)=O,16,1,0,1,0,4.7e-05
G5,C(C(C1CC(C(C)(O)O1)O)O)=O,16,1,0,1,0,4.7e-05
G5,C(C)(C(C1C(O)OCC1O)O)=O,16,1,0,1,45,4.7e-05
G5,C(C(C1CC(C(O)O1)(C)O)O)=O,16,1,0,1,16,4.7e-05
G5,C(C(C)(C1C(O)OCC1O)O)=O,16,1,0,1,29,4.7e-05
G5,C(CC1(C(CO)OC(C1O)O)O)=O,16,1,0,1,0,4.7e-05
G5,C(C1C(COC1(C(CO)O)O)O)=O,16,1,0,1,0,4.7e-05
G5,C1(C(C(CCO)(C(CO)O1)O)O)O,16,1,0,1,0,4.7e-05
G5,C1C(C(C(O)O1)O)(C(CO)CO)O,8,1,0,1,2,4.7e-05
G5,C1C(C(C(O)O1)CO)O,8,1,0,1,6,4.7e-05
G5,C(C(C(C1C(O)OCC1O)O)O)=O,32,1,0,1,0,4.7e-05
G5,CC(CC1(COC(C1O)O)O)O,16,1,0,1,0,4.7e-05
G5,C1C(C(C(C)O)C(CO)(O)O1)O,16,1,0,1,0,4.7e-05
G5,CC(CC1(C(C(CO1)O)O)O)O,16,1,0,1,0,4.7e-05
G5,CC(C1C(C)(C(C(O)O1)O)O)O,32,1,0,1,0,4.7e-05
G5,CC(C(C1(CC(CO1)O)O)O)O,16,1,0,1,0,4.7e-05
G5,CC(CO)(C1C(O)OCC1O)O,16,1,0,1,49,4.7e-05
G5,C1C(C(C(O)O1)C(C)O)O,16,1,0,1,6,4.7e-05
G5,C(C(C1C(C(C(O)O1)(C)O)O)O)=O,32,1,0,1,16,4.7e-05
G5,C(C1(C(C(CO)O)C(CO1)O)O)=O,16,1,0,1,0,4.7e-05
G5,C(C1(C(C(CO1)O)O)O)=O,8,1,0,1,0,4.7e-05
G5,C(C(C1CC(C(CO)(O)O1)O)O)=O,16,1,0,1,0,4.7e-05
G5,C1(COC(C(C(CO)O)O)(C1)O)=O,8,1,0,1,0,4.7e-05
G5,C1(C(C)(C(C(O)O1)O)O)=O,8,1,0,1,28,4.7e-05
G5,C(C1(CC(C)(OC1C=O)O)O)=O,8,1,0,1,0,4.7e-05
G5,C(C)(C1C(COC1(C=O)O)O)=O,8,1,0,1,0,4.7e-05
G5,C(C1C(COC1(C=O)O)O)=O,8,1,0,1,0,4.7e-05
G5,C(C)(C1(CC(OC1C=O)O)O)=O,8,1,0,1,0,4.7e-05
G5,C(C1C(COC1(C(C)=O)O)O)=O,8,1,0,1,14,4.7e-05
G5,C(C1C(CC(C)(O1)O)O)=O,8,1,0,1,0,4.7e-05
G5,C1C(C2C(COC(C2O)O)(O)O1)O,32,2,0,2,0,9.499999999999999e-05
G5,C1C(C2C(CC(C(O)O2)O)(O)O1)O,32,2,0,2,0,9.499999999999999e-05
G5,C(C1C(C(C(C(C)O)(O1)O)O)O)=O,32,1,0,1,0,4.7e-05
G5,C(C1C(C(C(O1)O)O)(C(C)O)O)=O,32,1,0,1,0,4.7e-05
G5,C1(C(C(C(O)O1)O)(CCO)O)=O,8,1,0,1,7,4.7e-05
G5,CC(C1(CO)C(C(C(O)O1)O)O)O,32,1,0,1,0,4.7e-05
G5,C(C1C(C(C(O1)O)(C(C)O)O)O)=O,32,1,0,1,1,4.7e-05
G5,C(C1(CC(CO1)O)O)=CC(C=O)=O,8,1,0,1,0,4.7e-05
G5,C(C1C(O)OCC1O)=CC(C=O)=O,16,1,0,1,45,4.7e-05
G5,C(C=CC(C1(CC(CO1)O)O)=O)=O,8,1,0,1,0,4.7e-05
G5,C1(CC(CO)OC1(C=CC=O)O)=O,8,1,0,1,0,4.7e-05
G5,C(C1C(C=CC=O)(CC(O1)O)O)=O,16,1,0,1,45,4.7e-05
G5,C(C1C(CC(C=CC=O)(O1)O)O)=O,16,1,0,1,45,4.7e-05
G5,C(C1C(COC1(C=CC=O)O)O)=O,16,1,0,1,0,4.7e-05
G5,C(C=CC(C1C(O)OCC1O)=O)=O,16,1,0,1,0,4.7e-05
G5,C(C(C1C(CC(C=C)(O)O1)=O)O)=O,8,1,0,1,27,4.7e-05
G5,C(C1(CC(C=C)(OC1C=O)O)O)=O,8,1,0,1,0,4.7e-05
G5,C(C(C1(C=C)CC(C(O)O1)=O)O)=O,8,1,0,1,45,4.7e-05
G5,C(C1(CC(C=C)(C(C=O)O1)O)O)=O,8,1,0,1,45,4.7e-05
G5,C(C1(C(C(C=C)=O)C(CO1)O)O)=O,8,1,0,1,0,4.7e-05
G5,C=CC1(C(C(C=O)=O)C(CO1)O)O,8,1,0,1,0,4.7e-05
G5,C1(C(O)OC(CO)C1C(C=C)=O)=O,8,1,0,1,0,4.7e-05
G5,C1(CC(C(C=O)O)OC1(C=C)O)=O,8,1,0,1,0,4.7e-05
G5,C(C1C(CC(C(C=C)=O)(O1)O)O)=O,8,1,0,1,0,4.7e-05
G5,C(C1C(C(C=C)=O)(CC(O1)O)O)=O,8,1,0,1,0,4.7e-05
G5,C1(CC(OC1(C=C)C(C=O)O)O)=O,8,1,0,1,0,4.7e-05
G5,C=CC(C(C1C(O)OCC1O)=O)=O,8,1,0,1,0,4.7e-05
G5,C(C1C(COC1(C(C=C)=O)O)O)=O,8,1,0,1,0,4.7e-05
G5,C(C1C(C(C=C)(O)OC1CO)=O)=O,8,1,0,1,0,4.7e-05
G5,C(C1(C(C=CC=O)C(CO1)O)O)=O,16,1,0,1,27,4.7e-05
G5,C1(C(O)OC(CO)C1C=CC=O)=O,16,1,0,1,27,4.7e-05
G5,C1C2(C(CO1)OC(C2O)O)O,16,1,0,1,10,4.7e-05
G5,C12C(CCO1)(C(C(O)O2)O)O,16,1,0,1,34,4.7e-05
G5,C1C2C(COC2(C(O)O1)O)O,16,2,0,2,0,9.499999999999999e-05
G5,C(C1C(O)OC(C1O)C(CO)O)=O,32,1,0,1,0,4.7e-05
G5,C1C(CO)(C(C(O)O1)CO)O,8,1,0,1,5,4.7e-05
G5,C1C(CO)(C(C(O)O1)C(C)O)O,16,1,0,1,5,4.7e-05
G5,CC(C1C(C(C(CO)(O)O1)O)O)O,32,1,0,1,11,4.7e-05
G5,C(C1(COC(CO)(C1O)O)O)=O,8,1,0,1,5,4.7e-05
G5,C(C1(C(C(CO)(CO1)O)O)O)=O,8,1,0,1,5,4.7e-05
G5,C1(C(O)OC(CO)(CO)C1O)=O,4,1,0,1,5,4.7e-05
G5,C1(C(C)(O)OC(CO)(CO)C1O)=O,4,1,0,1,25,4.7e-05
G5,C(C1(C(C)OC(CO)(C1O)O)O)=O,16,1,0,1,5,4.7e-05
G5,C1C(C(C)O)(C(C(CO)(O)O1)O)O,16,1,0,1,25,4.7e-05
G5,CC1C(CO)(C(C(CO)(O)O1)O)O,16,1,0,1,25,4.7e-05
G5,C1(C(C)(C(C(CO)(O)O1)O)O)=O,8,1,0,1,5,4.7e-05
G5,C1(C(C(C(CO)(O)O1)O)O)=O,8,1,0,1,33,4.7e-05
G5,C(C1C(CO)(COC1(C=O)O)O)=O,8,1,0,1,23,4.7e-05
G5,C(C(C1C(O)OCC1(CO)O)=O)=O,8,1,0,1,23,4.7e-05
G5,C(C1C(C(O)OC1(CO)CO)=O)=O,4,1,0,1,23,4.7e-05
G5,C(CO)(C1C(CC(C)(O1)O)O)=O,8,1,0,1,5,4.7e-05
G5,C(C)(C1C(O)OCC1(CO)O)=O,8,1,0,1,5,4.7e-05
G5,C1C(CO)(C2C(O)OCC2(O)O1)O,16,2,0,2,20,9.499999999999999e-05
G5,C1C(CO)(C2C(CC(O)O2)(O)O1)O,16,2,0,2,23,9.499999999999999e-05
G5,CC1C(C(C(CO)(O)O1)O)O,16,1,0,1,11,4.7e-05
G5,C1C2(C(CO1)OC(CO)(C2O)O)O,16,1,0,1,10,4.7e-05
G5,C1C(C2(C(C(CO2)(CO)O)O1)O)O,16,1,0,1,10,4.7e-05
G5,C12C(CCO1)(C(C(CO)(O)O2)O)O,16,1,0,1,5,4.7e-05
G5,C1C(CO)(C2COC(C2(O)O1)O)O,16,2,0,2,5,9.499999999999999e-05
G5,C1(C(CO)C(C(CO)O1)O)O,16,1,0,1,41,4.7e-05
G5,CC(C1C(O)OC(CO)C1O)O,32,1,0,1,41,4.7e-05
G5,C(C)(C1(C(C(C(CO)O1)O)O)O)=O,16,1,0,1,25,4.7e-05
G5,C1(C(C)(O)OC(C(CO)O)C1O)=O,16,1,0,1,25,4.7e-05
G5,CC(C1(C(C(C(CO)O1)O)O)O)O,32,1,0,1,25,4.7e-05
G5,C(C1C(C(CO)OC1(C=O)O)O)=O,16,1,0,1,23,4.7e-05
G5,C(C(C1C(O)OC(CO)C1O)=O)=O,16,1,0,1,23,4.7e-05
G5,C(C1C(C(O)OC1C(CO)O)=O)=O,16,1,0,1,23,4.7e-05
G5,C(C)(C1C(O)OC(CO)C1O)=O,16,1,0,1,41,4.7e-05
G5,C1C2(C(C(O)O1)C(C(CO)O2)O)O,32,2,0,2,40,9.499999999999999e-05
G5,C1(CC2(C(C(C(CO)O2)O)O1)O)O,32,2,0,2,49,9.499999999999999e-05
G5,C1C(C2(C(C(C(CO)O2)O)O1)O)O,32,1,0,1,10,4.7e-05
G5,C1C2C(C(O)O1)(O)OC(CO)C2O,32,2,0,2,41,9.499999999999999e-05
G5,C(C1(CC(C)O)CC(C(O1)O)=O)=O,8,1,0,1,45,4.7e-05
G5,C(C(C1C(C)OC(C1(C)O)O)=O)=O,16,1,0,1,4,4.7e-05
G5,C(C(CC1(C)C(CC(O)O1)O)=O)=O,8,1,0,1,4,4.7e-05
G5,C(CC1C(C)(CC(C=O)(O)O1)O)=O,8,1,0,1,4,4.7e-05
G5,C(C)(C(CC1CC(C(O)O1)=O)O)=O,8,1,0,1,22,4.7e-05
G5,C(C(CC1CC(C(C)(O)O1)O)=O)=O,8,1,0,1,22,4.7e-05
G5,C(C1C(C(C)(OC1C(C)=O)O)O)=O,16,1,0,1,45,4.7e-05
G5,C(C1C(C)(C(OC1C(C)=O)O)O)=O,16,1,0,1,45,4.7e-05
G5,C(C1C(C(C)(OC1(C=O)C)O)O)=O,16,1,0,1,45,4.7e-05
G5,C(C(C)(CC1CC(C(O)O1)=O)O)=O,8,1,0,1,22,4.7e-05
G5,C(C(CC1CC(C)(C(O)O1)O)=O)=O,8,1,0,1,22,4.7e-05
G5,C(C1C(C)(C(OC1(C=O)C)O)O)=O,16,1,0,1,45,4.7e-05
G5,C(C1COC(C1(C)O)O)=O,8,1,0,1,45,4.7e-05
G5,C1(C(O)OC(CO)(CC(C)O)C1)=O,8,1,0,1,45,4.7e-05
G5,C(C1(CC(CO1)(CC(C)O)O)O)=O,8,1,0,1,45,4.7e-05
G5,C(CO)(C1C(C)OC(C1(C)O)O)=O,16,1,0,1,45,4.7e-05
G5,C1(C(O)OC(C)(C(C(C)O)O)C1)=O,16,1,0,1,45,4.7e-05
G5,C(C1(CC(C)(C(C(C)O)O1)O)O)=O,16,1,0,1,45,4.7e-05
G5,C1(C(O)OC(CC(CO)(C)O)C1)=O,8,1,0,1,45,4.7e-05
G5,C(C)(C(C1C(O)OCC1(C)O)O)=O,16,1,0,1,49,4.7e-05
G5,C(C1C(C(C)(O)OC1(C)CO)O)=O,16,1,0,1,49,4.7e-05
G5,C(C(C)(C1C(O)OCC1(C)O)O)=O,16,1,0,1,49,4.7e-05
G5,C(C1C(C)(CO)OC(C1(C)O)O)=O,16,1,0,1,49,4.7e-05
G5,C1(C(O)OC(CC(C)O)C1)=O,8,1,0,1,3,4.7e-05
G5,C(C1C(C)OC(C)(C1O)O)=O,16,1,0,1,45,4.7e-05
G5,C(C1C(C)OC(C1(C)O)O)=O,16,1,0,1,45,4.7e-05
G5,C1(C(O)OC(C(C(C)O)O)C1)=O,16,1,0,1,45,4.7e-05
G5,C(C1(CC(C(C(C)O)O1)O)O)=O,16,1,0,1,45,4.7e-05
G5,C(C1(CC(C=O)(O)OC1CO)O)=O,8,1,0,1,0,4.7e-05
G5,C1(C(OC(C(C(CO)O)=O)C1)O)=O,8,1,0,1,5,4.7e-05
G5,C(C1(COC(C=O)(C1)O)O)=O,4,1,0,1,2,4.7e-05
G5,C(C1(C)C(C(C(O1)O)=O)O)=O,8,1,0,1,45,4.7e-05
G5,C(C1C(C(C(C)(O1)O)=O)O)(C)=O,8,1,0,1,25,4.7e-05
G5,C(C1(C)C(C(C(C)(O1)O)=O)O)=O,8,1,0,1,25,4.7e-05
G5,C(C1(CC(C=O)(O)OC1C)O)=O,8,1,0,1,4,4.7e-05
G5,C1(C(O)OC(CO)(C(C)O)C1)=O,8,1,0,1,29,4.7e-05
G5,C(C1(CC(CO1)(C(C)O)O)O)=O,8,1,0,1,29,4.7e-05
G5,C(C1(CC(CO)(C(C)O1)O)O)=O,8,1,0,1,29,4.7e-05
G5,C(C(C1(CO)CC(C(O)O1)=O)O)=O,8,1,0,1,51,4.7e-05
G5,C(C(C1(COC(C=O)(C1)O)O)O)=O,8,1,0,1,51,4.7e-05
G5,C(C1C(CO)(CC(C=O)(O1)O)O)=O,8,1,0,1,51,4.7e-05
G5,C1(C(C)(CC(C=O)(O)O1)O)=O,4,1,0,1,29,4.7e-05
G5,C1(C(CC(C=O)(O)O1)O)=O,4,1,0,1,33,4.7e-05
G5,C(C)(CC(C1CC(C(O)O1)=O)=O)=O,4,1,0,1,26,4.7e-05
G5,C1(C(CC(C=O)=O)OC(C)(C1)O)=O,4,1,0,1,26,4.7e-05
G5,C(C1(CC(C)=O)CC(C(O)O1)=O)=O,4,1,0,1,45,4.7e-05
G5,C1(C(O)OC(C)(CC(C=O)=O)C1)=O,4,1,0,1,26,4.7e-05
G5,C(C)(C1C(C(O)OC1C(C)=O)=O)=O,8,1,0,1,45,4.7e-05
G5,C(C1(C)C(C(C)=O)C(C(O1)O)=O)=O,8,1,0,1,26,4.7e-05
G5,C(CC1(C(C)=O)CC(C(O)O1)=O)=O,4,1,0,1,45,4.7e-05
G5,C(C1(C)CC(C(O1)O)=O)(CC=O)=O,4,1,0,1,45,4.7e-05
G5,C1(C(C)(CC(C=O)=O)OC(C1)O)=O,4,1,0,1,45,4.7e-05
G5,C1(C(C)(OC(C(C)=O)C1C=O)O)=O,8,1,0,1,45,4.7e-05
G5,C(C1C(C(C)(OC1(C=O)C)O)=O)=O,8,1,0,1,14,4.7e-05
G5,C(CC1(C(CC(C(C)=O)O1)=O)O)=O,4,1,0,1,45,4.7e-05
G5,C(CC1(C(CC(C=O)(C)O1)=O)O)=O,4,1,0,1,45,4.7e-05
G5,C(C1(C)CC(C(C)(O1)O)=O)=O,4,1,0,1,45,4.7e-05
G5,C(C)(CC1CC(C(O)O1)=O)=O,4,1,0,1,23,4.7e-05
G5,C1(C(O)OC2(COC(C2)O)C1)=O,8,2,0,2,51,9.499999999999999e-05
G5,C1(COC2C1C(C(C)(O)O2)O)=O,16,1,0,1,35,4.7e-05
G5,C1(COC2C1C(C(O)O2)(C)O)=O,16,1,0,1,45,4.7e-05
G5,C1(C(O)OC(C=CC(CO)=O)C1)=O,8,1,0,1,45,4.7e-05
G5,C1(C(OC(C=CC=O)(CO)C1)O)=O,8,1,0,1,45,4.7e-05
G5,C(C1(CC(C=CC=O)(CO1)O)O)=O,8,1,0,1,45,4.7e-05
G5,C1(C(O)OC(C(C)O)C1)=O,8,1,0,1,11,4.7e-05
G5,C(C1(CC(C(C)O1)O)O)=O,8,1,0,1,11,4.7e-05
G5,C1(C(CC(C=O)(O)O1)(CCO)O)=O,4,1,0,1,29,4.7e-05
G5,C(C1(CC(C(CO)(CO)O1)O)O)=O,4,1,0,1,29,4.7e-05
G5,C1(C(O)OC(C(C=CC(C)=O)=O)C1)=O,8,1,0,1,45,4.7e-05
G5,C(C1(C=CC(C)=O)CC(C(O1)O)=O)=O,8,1,0,1,45,4.7e-05
G5,C1(C(OC(C=CC(C=O)=O)(C)C1)O)=O,8,1,0,1,45,4.7e-05
G5,C(CC=CC(C1CC(C(O)O1)=O)=O)=O,8,1,0,1,45,4.7e-05
G5,C(C1(C=CCC=O)CC(C(O1)O)=O)=O,8,1,0,1,45,4.7e-05
G5,C1(C(O)OC(C1)CC=CC(C=O)=O)=O,8,1,0,1,45,4.7e-05
G5,C1(C(O)OC(C=CC(C(C)=O)=O)C1)=O,8,1,0,1,45,4.7e-05
G5,C(C)(C1(C=CC=O)CC(C(O1)O)=O)=O,8,1,0,1,45,4.7e-05
G5,C1(C(OC(C(C=CC=O)=O)(C)C1)O)=O,8,1,0,1,45,4.7e-05
G5,C1(CC(C(C)=O)OC1(C=CC=O)O)=O,8,1,0,1,45,4.7e-05
G5,C(C1(C)CC(C(C=CC=O)(O1)O)=O)=O,8,1,0,1,45,4.7e-05
G5,C(CC(C=CC1CC(C(O)O1)=O)=O)=O,8,1,0,1,45,4.7e-05
G5,C(CC1(C=CC=O)CC(C(O)O1)=O)=O,8,1,0,1,45,4.7e-05
G5,C1(C(O)OC(CC(C=CC=O)=O)C1)=O,8,1,0,1,45,4.7e-05
G5,C(C1CC(C(O)O1)=O)(CC(C=C)=O)=O,4,1,0,1,45,4.7e-05
G5,C1(C(CC(C=O)=O)OC(C=C)(C1)O)=O,4,1,0,1,45,4.7e-05
G5,C(C1(CC(C(O)O1)=O)CC(C=C)=O)=O,4,1,0,1,45,4.7e-05
G5,C1(C(O)OC(C=C)(CC(C=O)=O)C1)=O,4,1,0,1,45,4.7e-05
G5,C1(C(O)OC(C(C)=O)C1C(C=C)=O)=O,8,1,0,1,45,4.7e-05
G5,C(C1(C)C(C(C(O1)O)=O)C(C=C)=O)=O,8,1,0,1,45,4.7e-05
G5,C1(C(O)OC(C1)CC(C(C=C)=O)=O)=O,4,1,0,1,45,4.7e-05
G5,C1(CC(CC(C=O)=O)OC1(C=C)O)=O,4,1,0,1,45,4.7e-05
G5,C(CC1(C(C=C)=O)CC(C(O)O1)=O)=O,4,1,0,1,45,4.7e-05
G5,C(CC=O)(C1(C=C)CC(C(O1)O)=O)=O,4,1,0,1,45,4.7e-05
G5,C1(CC(OC1(C=C)CC(C=O)=O)O)=O,4,1,0,1,45,4.7e-05
G5,C(C1C(C(C=C)(O)OC1C(C)=O)=O)=O,8,1,0,1,45,4.7e-05
G5,C(C1C(C(C=C)(OC1(C=O)C)O)=O)=O,8,1,0,1,45,4.7e-05
G5,C(C1CC(C(O)O1)=O)(CC=CC=O)=O,8,1,0,1,45,4.7e-05
G5,C(C1(CC(C(O)O1)=O)CC=CC=O)=O,8,1,0,1,45,4.7e-05
G5,C1(C(O)OC(C=CCC(C=O)=O)C1)=O,8,1,0,1,45,4.7e-05
G5,C1(C(O)OC(C(C)=O)C1C=CC=O)=O,16,1,0,1,45,4.7e-05
G5,C(C1(C)C(C(C(O1)O)=O)C=CC=O)=O,16,1,0,1,27,4.7e-05
G5,C1(C(O)OC2(COCC2O)C1)=O,8,1,0,1,10,4.7e-05
G5,C(C1(CC2(COCC2O1)O)O)=O,8,1,0,1,10,4.7e-05
G5,C1(C(O)OC2(C(O)OCC2)C1)=O,8,2,0,2,29,9.499999999999999e-05
G5,C(C1(CC2(C(O1)OCC2)O)O)=O,8,1,0,1,29,4.7e-05
G5,C(C1(COC(C1C(CO)=O)O)O)=O,8,1,0,1,5,4.7e-05
G5,C(C1C(CO)(O)OCC1(C=O)O)=O,8,1,0,1,5,4.7e-05
G5,C(C1(COC(C1O)(CC=O)O)O)=O,8,1,0,1,23,4.7e-05
G5,C(CO)(CC1C(C(C(O)O1)=O)O)=O,8,1,0,1,49,4.7e-05
G5,C(C(C1C(CC(CO)(O1)O)O)=O)=O,8,1,0,1,49,4.7e-05
G5,C(CC1(COC(C=O)(C1O)O)O)=O,8,1,0,1,49,4.7e-05
G5,C(CC1(CO)C(C(C(O)O1)=O)O)=O,8,1,0,1,49,4.7e-05
G5,C(C(C1C(CO)(CC(O1)O)O)=O)=O,8,1,0,1,49,4.7e-05
G5,C1(C(C)(C(C(CO)=O)C(O)O1)O)=O,8,1,0,1,28,4.7e-05
G5,C(C1C(CO)(O)OC(C1(C)O)=O)=O,8,1,0,1,28,4.7e-05
G5,C1(C(C)(C(C(CC=O)(O)O1)O)O)=O,8,1,0,1,28,4.7e-05
G5,C(CO)(C1C(O)OC(C1O)=O)=O,8,1,0,1,33,4.7e-05
G5,C(C1C(CO)(O)OC(C1O)=O)=O,8,1,0,1,33,4.7e-05
G5,C(CC1(C(C(C(O1)=O)O)O)O)=O,8,1,0,1,33,4.7e-05
G5,C1(C(C)(O)OC(C1)CC(CO)=O)=O,4,1,0,1,14,4.7e-05
G5,C(CC1(CO)CC(C(C)(O)O1)=O)=O,4,1,0,1,14,4.7e-05
G5,C(CC(C1C(CC(C)(O1)O)O)=O)=O,8,1,0,1,49,4.7e-05
G5,C(C1C(C)(O)OCC1(CC=O)O)=O,8,1,0,1,49,4.7e-05
G5,C(CC1(COC(C1C(C)=O)O)O)=O,8,1,0,1,49,4.7e-05
G5,C(CO)(C1C(O)OCC1(C=C)O)=O,8,1,0,1,7,4.7e-05
G5,C(C1C(CO)(O)OCC1(C=C)O)=O,8,1,0,1,7,4.7e-05
G5,C(CC1(C(C(C=C)(CO1)O)O)O)=O,8,1,0,1,7,4.7e-05
G5,C=CC(C1C(CC(CO)(O1)O)O)=O,8,1,0,1,49,4.7e-05
G5,C=CC(C1C(CO)(CC(O1)O)O)=O,8,1,0,1,7,4.7e-05
G5,C(CO)(C1C(O)OC(C)C1O)=O,16,1,0,1,49,4.7e-05
G5,C(C1C(CO)(O)OC(C)C1O)=O,16,1,0,1,49,4.7e-05
G5,C(CC1(C(C(C(C)O1)O)O)O)=O,16,1,0,1,11,4.7e-05
G5,C(C1C(C)(C(CO)C(O1)O)O)=O,16,1,0,1,6,4.7e-05
G5,C(C)(C1C(C(C(O1)O)C(C)O)O)=O,32,1,0,1,1,4.7e-05
G5,C(C1C(C)(C(C(O1)O)C(C)O)O)=O,32,1,0,1,1,4.7e-05
G5,C(C1(COC(C1)(C(C=O)O)O)O)=O,8,1,0,1,2,4.7e-05
G5,C(C1(C(C(C(C(C)=O)O1)O)O)O)=O,16,1,0,1,5,4.7e-05
G5,C(C)(C(C1C(C(C(O)O1)=O)O)O)=O,16,1,0,1,5,4.7e-05
G5,C(C(C1C(C(C(C)(O1)O)O)O)=O)=O,16,1,0,1,5,4.7e-05
G5,C(C1C(C)(C(C(C=O)(O1)O)O)O)=O,16,1,0,1,0,4.7e-05
G5,C(C(C1(C)C(C(C(O)O1)=O)O)O)=O,16,1,0,1,0,4.7e-05
G5,C(C(C1C(C)(C(C(O1)O)O)O)=O)=O,16,1,0,1,0,4.7e-05
G5,C1(C(C)(CC(C(C=O)O)(O)O1)O)=O,8,1,0,1,25,4.7e-05
G5,C1(C(CC(C(C=O)O)(O)O1)O)=O,8,1,0,1,33,4.7e-05
G5,C(C)(C1C(CC(C(C)=O)(O1)O)O)=O,8,1,0,1,14,4.7e-05
G5,C1(C(C)(O)OC(C(C(C)=O)O)C1)=O,8,1,0,1,14,4.7e-05
G5,C(C1C(C)(CC(C(C)=O)(O1)O)O)=O,8,1,0,1,14,4.7e-05
G5,C(C(C1(C)CC(C(C)(O)O1)=O)O)=O,8,1,0,1,14,4.7e-05
G5,C(CC1(CC(C(C(C)=O)O1)O)O)=O,8,1,0,1,9,4.7e-05
G5,C(CC1(CC(C)(C(C=O)O1)O)O)=O,8,1,0,1,27,4.7e-05
G5,C(C1C(C(C(C)=O)OC1(C)O)O)=O,16,1,0,1,6,4.7e-05
G5,C(C)(C1C(C(C(C)=O)OC1O)O)=O,16,1,0,1,6,4.7e-05
G5,C(C1C(C)(C(C=O)OC1(C)O)O)=O,16,1,0,1,6,4.7e-05
G5,C(C1C(C)(C(C(C)=O)C(O1)O)O)=O,16,1,0,1,6,4.7e-05
G5,C(C(C1(CC(C=C)(CO1)O)O)O)=O,8,1,0,1,25,4.7e-05
G5,C(C)(C1C(C(C(C=C)(O1)O)O)O)=O,16,1,0,1,1,4.7e-05
G5,C=CC(C1C(C(C(C)(O1)O)O)O)=O,16,1,0,1,1,4.7e-05
G5,C(C1C(C)(C(C(C=C)(O1)O)O)O)=O,16,1,0,1,1,4.7e-05
G5,C=CC(C1C(C)(C(C(O1)O)O)O)=O,16,1,0,1,1,4.7e-05
G5,C(C(C1(CC(C(C)O1)O)O)O)=O,16,1,0,1,11,4.7e-05
G5,C(C1C(C(C=O)=O)C(C(O1)O)O)=O,16,1,0,1,0,4.7e-05
G5,C(C(C1C(C)OC(C1O)O)=O)=O,16,1,0,1,0,4.7e-05
G5,C(C(C(C1COC(C1O)O)=O)O)=O,16,1,0,1,15,4.7e-05
G5,C(C1C(C(CO)(OC1C=O)O)O)=O,16,1,0,1,43,4.7e-05
G5,C(C1C(C(C(C)(O1)O)=O)O)=O,8,1,0,1,25,4.7e-05
G5,C(C(C(C1(CC(CO1)=O)O)O)O)=O,8,1,0,1,0,4.7e-05
G5,C(C(CC1(C(C(CO1)=O)O)O)O)=O,8,1,0,1,0,4.7e-05
G5,C1(COC2C1C(C(O)O2)O)=O,16,1,0,1,0,4.7e-05
G5,C1(COC(C2C1C(C(O)O2)O)O)=O,32,2,0,2,0,9.499999999999999e-05
G5,C1(C(C(C(O)O1)C(C=O)O)O)=O,16,1,0,1,33,4.7e-05
G5,C(C1(COC(C1C(C=O)O)O)O)=O,16,1,0,1,43,4.7e-05
G5,C(C1C(CO)(C(OC1C=O)O)O)=O,16,1,0,1,43,4.7e-05
G5,C(C1CC(C(C=CC=O)(O)O1)=O)=O,8,1,0,1,0,4.7e-05
G5,C(C1C(C(C(O)O1)=O)C(C=C)=O)=O,8,1,0,1,45,4.7e-05
G5,C(C1C(C(C=C)(O)OC1C=O)=O)=O,8,1,0,1,0,4.7e-05
G5,C(C1C(C(C(O)O1)=O)C=CC=O)=O,16,1,0,1,0,4.7e-05
G5,CC1(C(CO)OC(C1CO)O)O,16,1,0,1,18,4.7e-05
G5,CC1(C(CO)OC(C1C(C)O)O)O,32,1,0,1,28,4.7e-05
G5,C(C1(C(C(C)(C(CO)O1)O)O)O)=O,16,1,0,1,5,4.7e-05
G5,C1(C(O)OC(C)(C(CO)O)C1O)=O,16,1,0,1,5,4.7e-05
G5,C1(C(C)(CC(C(CO)O)(O)O1)O)=O,8,1,0,1,28,4.7e-05
G5,C(C)(C1(CC(C)(C(CO)O1)O)O)=O,8,1,0,1,14,4.7e-05
G5,C1(C(C)(O)OC(C)(C(CO)O)C1)=O,8,1,0,1,14,4.7e-05
G5,C(CC1(CC(C)(C(CO)O1)O)O)=O,8,1,0,1,6,4.7e-05
G5,C(C1C(C)(O)OC(CO)C1(C)O)=O,16,1,0,1,6,4.7e-05
G5,C(C)(C1C(O)OC(CO)C1(C)O)=O,16,1,0,1,6,4.7e-05
G5,C=CC1(COC(C1)(C(CO)O)O)O,8,1,0,1,7,4.7e-05
G5,C=CC1(C(C(C)(C(CO)O1)O)O)O,16,1,0,1,7,4.7e-05
G5,CC1C(CC(C(CO)O)(O)O1)O,16,1,0,1,11,4.7e-05
G5,C(C1COC(C1(CCO)O)O)=O,8,1,0,1,3,4.7e-05
G5,C1C(CCO)(C(C(O)O1)CO)O,8,1,0,1,3,4.7e-05
G5,C(C1C(C(CO)C(O1)O)O)=O,16,1,0,1,18,4.7e-05
G5,C1C(C)(C(C(O)O1)CO)O,8,1,0,1,49,4.7e-05
G5,C1C(C(CO)O)(C(C(O)O1)CO)O,16,1,0,1,2,4.7e-05
G5,C(C1(C(CO)OC(C1CO)O)O)O,16,1,0,1,2,4.7e-05
G5,C1(C(C(CO)C(CCO)(O)O1)O)=O,8,1,0,1,2,4.7e-05
G5,C1(C(CC(C(CO)CO)(O)O1)O)=O,4,1,0,1,30,4.7e-05
G5,C(C1CC(CO)C(CO)(O1)O)(O)=O,8,1,0,1,12,4.7e-05
G5,C(C1CCC(C(CO)O)(O1)O)(O)=O,8,1,0,1,12,4.7e-05
G5,C(C1CC(C(CCO)(O1)O)O)(O)=O,8,1,0,1,2,4.7e-05
G5,C(C1(C(C(CO1)C(CO)O)=O)O)=O,8,1,0,1,0,4.7e-05
G5,C(C(C1(C(CO)C(CO1)O)O)=O)=O,8,1,0,1,0,4.7e-05
G5,C(C1(C(C(C(CO)=O)CO1)O)O)=O,8,1,0,1,15,4.7e-05
G5,C(C(C1C(C(CO)C(O1)O)O)=O)=O,16,1,0,1,5,4.7e-05
G5,C1(C(C(CO)C(CO)(O)O1)O)=O,8,1,0,1,33,4.7e-05
G5,C(OC1C(CCO)(O)OCC1O)=O,8,1,0,1,0,4.7e-05
G5,C(OC1COC(CCO)(C1O)O)=O,8,1,0,1,9,4.7e-05
G5,C(OC1COC(C1)(C(CO)O)O)=O,8,1,0,1,2,4.7e-05
G5,C(OC1COC(CO)(C1CO)O)=O,8,1,0,1,2,4.7e-05
G5,C(COC1(COC(C1CO)O)O)=O,8,1,0,1,40,4.7e-05
G5,C1(C(C)OC(C(CO)O)(C1O)O)=O,16,1,0,1,2,4.7e-05
G5,C(C1CC(CO)C(C=O)(O1)O)=O,8,1,0,1,12,4.7e-05
G5,C(C1(C(C(C(C)=O)CO1)O)O)=O,8,1,0,1,17,4.7e-05
G5,C(C(C1CC(CO)C(O1)O)=O)=O,8,1,0,1,5,4.7e-05
G5,C1(C2CC(C(C(CO)O1)(O)O2)O)O,32,2,0,2,2,9.499999999999999e-05
G5,C1C2CC(C(C(CO)O)(O)O2)(O)O1,16,2,0,2,2,9.499999999999999e-05
G5,C(C(C1(C(CO)CCO1)O)O)=O,8,1,0,1,29,4.7e-05
G5,C1(C(CC(C(CO)CO)(O)O1)=O)=O,2,1,0,1,2,4.7e-05
G5,C1(CC(C(C(CO)CO)(O)O1)=O)=O,2,1,0,1,2,4.7e-05
G5,C1(CC(CO)C(C(C=O)O)(O)O1)=O,8,1,0,1,29,4.7e-05
G5,C1(C(C(CO)C(C(C)=O)(O)O1)O)=O,8,1,0,1,14,4.7e-05
G5,C(CC1(C(CO)C(C(O1)=O)O)O)=O,8,1,0,1,2,4.7e-05
G5,C(C1(C(COC1(CCO)O)O)O)=O,8,1,0,1,27,4.7e-05
G5,C1(CC(C2(C(O)OCC12)O)O)=O,16,1,0,1,2,4.7e-05
G5,C(C1(C(C(OC1C=O)O)CO)O)=O,16,1,0,1,0,4.7e-05
G5,C(C1COC(C1(C(C=O)O)O)O)=O,16,1,0,1,0,4.7e-05
G5,C(C1(COC(CO)(C1CO)O)O)=O,8,1,0,1,2,4.7e-05
G5,C(CO)(C1COC(C1(CO)O)O)=O,8,1,0,1,2,4.7e-05
G5,C1(C(C2(C(CO)C1CO2)O)O)=O,16,2,0,2,2,9.499999999999999e-05
G5,C1(CC2(C(CO)(C1CO2)O)O)=O,8,2,0,2,2,9.499999999999999e-05
G5,C1(CC2(C(CO)C1(CO2)O)O)=O,8,2,0,2,2,9.499999999999999e-05
G5,C1(C(O)OC2C(C)(O)OCC12)=O,16,2,0,2,2,9.499999999999999e-05
G5,C(C1COC2(C1OC(C2)O)O)=O,16,2,0,2,23,9.499999999999999e-05
G5,C1(C2(CC(CO)OC1CO2)O)=O,8,1,0,1,2,4.7e-05
G5,C1(C2(COC(CO)C1CO2)O)=O,8,1,0,1,54,4.7e-05
G5,C1(C2(CC(COC1CO2)O)O)=O,8,1,0,1,36,4.7e-05
G5,C1(C2(COCC(C1CO2)O)O)=O,8,1,0,1,36,4.7e-05
G5,C1(COCC2(C(C1CO2)O)O)=O,8,1,0,1,2,4.7e-05
G5,C1(C(O)OCC2(CC1CO2)O)=O,8,2,0,2,12,9.499999999999999e-05
G5,C1(COC(C2(CC1CO2)O)O)=O,8,2,0,2,2,9.499999999999999e-05
G5,C1(C2(CCOC(C1CO2)O)O)=O,8,2,0,2,2,9.499999999999999e-05
G5,C1(C2(CC(O)OCC1CO2)O)=O,8,2,0,2,2,9.499999999999999e-05
G5,C1C2C(CO)C(C(CO)(O)O2)(O)O1,16,2,0,2,0,9.499999999999999e-05
G5,C1C2(C(CO)C(C(CO)O2)(O)O1)O,16,2,0,2,2,9.499999999999999e-05
G5,C(C1COC2(C1OCC2O)O)=O,16,1,0,1,9,4.7e-05
G5,C(C1COC2(C1(O)OCC2)O)=O,8,2,0,2,2,9.499999999999999e-05
G5,C1(C(C)(O)OC2C(O)OCC12)=O,16,2,0,2,14,9.499999999999999e-05
G5,C1C(C2(C(CO)C(CO2)(O)O1)O)O,16,2,0,2,2,9.499999999999999e-05
G5,C1C(CO)C2(C(C(CO2)(O)O1)O)O,16,2,0,2,2,9.499999999999999e-05
G5,C1(CCOC2(C(O)OCC12)O)=O,8,2,0,2,2,9.499999999999999e-05
G5,C1(CC(O)OC2C(O)OCC12)=O,16,2,0,2,2,9.499999999999999e-05
G5,C1(C2(C(CO)C(C(CO)O2)O1)O)=O,16,1,0,1,27,4.7e-05
G5,C1(C2C(C(C(CCO)(O2)O)O1)O)=O,16,1,0,1,2,4.7e-05
G5,C1(C(C2C(C(C(O)O2)CO)O1)O)=O,32,1,0,1,27,4.7e-05
G5,C1(C(C2(C(CO)C(CO2)O1)O)O)=O,16,1,0,1,50,4.7e-05
G5,C1(C2(C(CO)C(C(CO1)O2)O)O)=O,16,1,0,1,27,4.7e-05
G5,C1(C2C(C(CO)C(CO1)(O2)O)O)=O,16,1,0,1,2,4.7e-05
G5,C1(C2C(CC(C(CO)O1)(O2)O)O)=O,16,1,0,1,2,4.7e-05
G5,C(C1C2(CC(C(CO)O2)(O)O1)O)O,10,1,0,1,2,4.7e-05
G5,C(C(C1(C2CC(C(O)O2)O1)O)O)O,32,2,0,2,32,9.499999999999999e-05
G5,C1(C(O)OC(CC(C)O)C1CO)=O,16,1,0,1,3,4.7e-05
G5,C(C1C(C)OC(C1(CCO)O)O)=O,16,1,0,1,3,4.7e-05
G5,C(C(C1COC(C1(CO)O)O)=O)=O,8,1,0,1,2,4.7e-05
G5,C(C1(COC(C=O)(C1CO)O)O)=O,8,1,0,1,2,4.7e-05
G5,C(C(C1COC(CO)(C1O)O)=O)=O,8,1,0,1,5,4.7e-05
G5,C(C1(CCO)C(C(C(O1)O)=O)O)=O,8,1,0,1,1,4.7e-05
G5,C1(C(C)(C(CO)C(C=O)(O)O1)O)=O,8,1,0,1,29,4.7e-05
G5,C1(C(C(C(O)O1)=O)CO)=O,4,1,0,1,17,4.7e-05
G5,C1(C(C(CO)C(C=O)(O)O1)O)=O,8,1,0,1,33,4.7e-05
G5,C(C)(C1(C)C(C(C(O1)O)=O)CO)=O,8,1,0,1,14,4.7e-05
G5,C(C(C1COC(C)(C1(C)O)O)=O)=O,8,1,0,1,14,4.7e-05
G5,C1(CC(C(CCO)=O)OC1(C)O)=O,4,1,0,1,14,4.7e-05
G5,C(C1(CCO)CC(C(C)(O1)O)=O)=O,4,1,0,1,14,4.7e-05
G5,C(CC1(C)C(C(C(O)O1)=O)CO)=O,8,1,0,1,6,4.7e-05
G5,C(C)(CC1C(C(C(O)O1)=O)CO)=O,8,1,0,1,23,4.7e-05
G5,C1(C(OC(C(C=C)=O)C1CO)O)=O,8,1,0,1,7,4.7e-05
G5,C=CC1(C(C(C(C=O)=O)CO1)O)O,8,1,0,1,7,4.7e-05
G5,C(C1(C=C)C(C(C(O1)O)=O)CO)=O,8,1,0,1,7,4.7e-05
G5,C=CC1(C(O)OCC1C(C=O)=O)O,8,1,0,1,7,4.7e-05
G5,C1(C(OC(C=C)(CO)C1CO)O)=O,8,1,0,1,7,4.7e-05
G5,C(C1(C(CO)C(C=C)(CO1)O)O)=O,8,1,0,1,7,4.7e-05
G5,C1(C(OC(C=CC=O)C1CO)O)=O,16,1,0,1,20,4.7e-05
G5,C1(C(O)OC(C(C)O)C1CO)=O,16,1,0,1,11,4.7e-05
G5,C(C1(C(CO)C(C(C)O1)O)O)=O,16,1,0,1,11,4.7e-05
G5,C1C(CCO)(C(C(O)O1)C(C)O)O,16,1,0,1,3,4.7e-05
G5,C(C1(C(C(CO1)(CCO)O)O)O)=O,8,1,0,1,3,4.7e-05
G5,C1(C(C)(C(C(CCO)(O)O1)O)O)=O,8,1,0,1,3,4.7e-05
G5,C1(C(C)(C(CO)C(CO)(O)O1)O)=O,8,1,0,1,3,4.7e-05
G5,C(CO)(C1COC(C)(C1(C)O)O)=O,8,1,0,1,14,4.7e-05
G5,C(C)(C1(CC(CO1)(CCO)O)O)=O,4,1,0,1,14,4.7e-05
G5,C1(C(C)(O)OC(CO)(CCO)C1)=O,4,1,0,1,14,4.7e-05
G5,C(C1C(CC(C)(O1)O)O)(CCO)=O,8,1,0,1,3,4.7e-05
G5,C(C1C(C)(O)OCC1(CCO)O)=O,8,1,0,1,3,4.7e-05
G5,C(C)(C1C(O)OCC1(CCO)O)=O,8,1,0,1,3,4.7e-05
G5,C(CO)(C1COC(C=C)(C1O)O)=O,8,1,0,1,7,4.7e-05
G5,C(CO)(C1COC(C1(C=C)O)O)=O,8,1,0,1,7,4.7e-05
G5,C=CC1(COC(C1O)(CCO)O)O,8,1,0,1,7,4.7e-05
G5,C=CC1(COC(CO)(C1CO)O)O,8,1,0,1,7,4.7e-05
G5,C=CC1(C(C(CO1)(CCO)O)O)O,8,1,0,1,7,4.7e-05
G5,CC1C(C(C(CCO)(O)O1)O)O,16,1,0,1,11,4.7e-05
G5,CC1C(C(CO)C(CO)(O)O1)O,16,1,0,1,11,4.7e-05
G5,C(C1C(C(C(O1)O)C(C)O)O)=O,32,1,0,1,0,4.7e-05
G5,C(C1C(C(C(C=O)(O1)O)O)O)=O,16,1,0,1,5,4.7e-05
G5,C(C(C1C(C(C(O)O1)=O)O)O)=O,16,1,0,1,5,4.7e-05
G5,C(C1C(C(C(C(C)=O)(O1)O)O)O)=O,16,1,0,1,25,4.7e-05
G5,C(C(C1C(C(C(C)(O)O1)=O)O)O)=O,16,1,0,1,25,4.7e-05
G5,C(C(C)=O)(C1C(C(C(O1)O)O)O)=O,16,1,0,1,25,4.7e-05
G5,C(C1C(C(C=O)C(C=O)(O1)O)O)=O,16,1,0,1,23,4.7e-05
G5,C(C1C(C(C(C=O)=O)C(O1)O)O)=O,16,1,0,1,23,4.7e-05
G5,C(C(C1C(C=O)C(C(O)O1)=O)O)=O,16,1,0,1,23,4.7e-05
G5,C(C1C(C(C(C)=O)C(O1)O)O)=O,16,1,0,1,1,4.7e-05
G5,C(C1C(C2C(O)OCC2(O1)O)O)=O,32,2,0,2,40,9.499999999999999e-05
G5,C(C1C(C2C(CC(O)O2)(O1)O)O)=O,32,2,0,2,1,9.499999999999999e-05
G5,C(C1C(C2C(C(CO2)O)(O1)O)O)=O,32,1,0,1,10,4.7e-05
G5,C(C1C(C2COC(C2(O1)O)O)O)=O,32,2,0,2,15,9.499999999999999e-05
G5,C(C1(C(C(C)O)C(CO1)(C)O)O)=O,16,1,0,1,49,4.7e-05
G5,C(CO)(CC1(C)C(CC(O)O1)O)=O,8,1,0,1,4,4.7e-05
G5,C(CC1C(C)(CC(CO)(O)O1)O)=O,8,1,0,1,4,4.7e-05
G5,C(C)(C(C1(C)C(CC(O)O1)O)O)=O,16,1,0,1,45,4.7e-05
G5,C(CC1C(C)(C(C(C)(O)O1)O)O)=O,16,1,0,1,45,4.7e-05
G5,C(CO)(CC1CC(C(C)(O)O1)O)=O,8,1,0,1,49,4.7e-05
G5,C(C)(C(C1CC(C(C)(O)O1)O)O)=O,16,1,0,1,45,4.7e-05
G5,C(C)(C(C1C(C)(CC(O)O1)O)O)=O,16,1,0,1,45,4.7e-05
G5,C(CC1(C)C(C(C(C)(O)O1)O)O)=O,16,1,0,1,45,4.7e-05
G5,C(CO)(CC1CC(C(O)O1)(C)O)=O,8,1,0,1,49,4.7e-05
G5,C(C)(C(C1CC(C(O)O1)(C)O)O)=O,16,1,0,1,45,4.7e-05
G5,CC(CC1(COC(CO)(C1)O)O)O,8,1,0,1,49,4.7e-05
G5,CC1(C(C(CO1)(CC(C)O)O)O)O,16,1,0,1,11,4.7e-05
G5,C1C(C)(C(C(C)O)C(CO)(O)O1)O,16,1,0,1,49,4.7e-05
G5,CC(CC1(C(C(C)(CO1)O)O)O)O,16,1,0,1,11,4.7e-05
G5,CC(C1C(C)(CC(CO)(O)O1)O)O,16,1,0,1,49,4.7e-05
G5,CC1(C(C(C)(C(C(C)O)O1)O)O)O,32,1,0,1,49,4.7e-05
G5,CC(C(C1(CC(C)(CO1)O)O)O)O,16,1,0,1,49,4.7e-05
G5,C1C(C)(C(C(O)O1)C(C)(CO)O)O,16,1,0,1,49,4.7e-05
G5,C1C(C)(C(C(O)O1)C(C)O)O,16,1,0,1,49,4.7e-05
G5,CC(C1C(CC(CO)(O)O1)O)O,16,1,0,1,49,4.7e-05
G5,CC(C1C(C(C(C)(O)O1)O)O)O,32,1,0,1,28,4.7e-05
G5,C(C1(C(C(CO1)(C)O)O)O)=O,8,1,0,1,49,4.7e-05
G5,C1(C(O)OC(CO)(C)C1O)=O,8,1,0,1,49,4.7e-05
G5,C1(C(C)(O)OC(CO)(C)C1O)=O,8,1,0,1,49,4.7e-05
G5,CC(C1(COC(CO)(C1)O)O)O,8,1,0,1,29,4.7e-05
G5,C1C(C(C)O)(C(C(C)(O)O1)O)O,16,1,0,1,25,4.7e-05
G5,C1C(C)(C(C(C(C)O)(O)O1)O)O,16,1,0,1,25,4.7e-05
G5,C(C(C1(C(C(CO1)(C)O)O)O)O)=O,16,1,0,1,49,4.7e-05
G5,C1(C(C)(CC(CO)(O)O1)O)=O,4,1,0,1,28,4.7e-05
G5,C1(C(C)(C(C(C)(O)O1)O)O)=O,8,1,0,1,28,4.7e-05
G5,C(CC1C(CC(C)(O1)O)=O)(CO)=O,4,1,0,1,26,4.7e-05
G5,C(C(C1C(CC(C)(O1)O)=O)O)(C)=O,8,1,0,1,26,4.7e-05
G5,C(C1(CC(C)(OC1C(C)=O)O)O)=O,8,1,0,1,26,4.7e-05
G5,C(CO)(CC1(C)CC(C(O)O1)=O)=O,4,1,0,1,26,4.7e-05
G5,C(C)(C(C1(C)CC(C(O)O1)=O)O)=O,8,1,0,1,49,4.7e-05
G5,C(C1(CC(C)(C(C(C)=O)O1)O)O)=O,8,1,0,1,49,4.7e-05
G5,C(C)(C1C(COC1(C=O)O)(C)O)=O,8,1,0,1,26,4.7e-05
G5,C(C(C1C(C)(O)OCC1(C)O)=O)=O,8,1,0,1,26,4.7e-05
G5,C(C)(C1C(C(O)OC1(CO)C)=O)=O,8,1,0,1,26,4.7e-05
G5,C(C(CC1(CC(CO1)(C)O)O)=O)=O,4,1,0,1,49,4.7e-05
G5,C(C1C(COC1(C=O)O)(C)O)=O,8,1,0,1,49,4.7e-05
G5,C(C)(C1(CC(OC1C(C)=O)O)O)=O,8,1,0,1,14,4.7e-05
G5,C1(C(C)(CC(CO)=O)OC(C1)O)=O,4,1,0,1,14,4.7e-05
G5,C1(C(C)(C(C(C)=O)O)OC(C1)O)=O,8,1,0,1,14,4.7e-05
G5,C(C(C)=O)(C1C(O)OCC1(C)O)=O,8,1,0,1,14,4.7e-05
G5,C(C1C(COC1(C(C)=O)O)(C)O)=O,8,1,0,1,14,4.7e-05
G5,C(C1C(C(C)(O)OC1(CO)C)=O)=O,8,1,0,1,14,4.7e-05
G5,C(CC(C1(CC(CO1)(C)O)O)=O)=O,4,1,0,1,49,4.7e-05
G5,C(CC1(C(CC(CO)(C)O1)=O)O)=O,4,1,0,1,49,4.7e-05
G5,C1(C(C)(O)OC(CO)(C)C1)=O,4,1,0,1,49,4.7e-05
G5,C(C)(C1C(C)(CC(O1)O)O)=O,8,1,0,1,6,4.7e-05
G5,C(C)(C1C(CC(C)(O1)O)O)=O,8,1,0,1,49,4.7e-05
G5,C(C)(C1C(O)OCC1(C)O)=O,8,1,0,1,49,4.7e-05
G5,C1C(C)(C2C(O)OCC2(O)O1)O,16,2,0,2,49,9.499999999999999e-05
G5,C1C(C)(C2C(CC(O)O2)(O)O1)O,16,2,0,2,49,9.499999999999999e-05
G5,C(C1(COC(CO)(C1)O)O)=CC=O,8,1,0,1,49,4.7e-05
G5,C(C1(COC(C)(C1O)O)O)=CC=O,16,1,0,1,49,4.7e-05
G5,C(C1(C(C(CO1)(C)O)O)O)=CC=O,16,1,0,1,49,4.7e-05
G5,CC1C(CC(CO)(O)O1)O,8,1,0,1,11,4.7e-05
G5,CC1(C(C(C(C)O1)O)O)O,16,1,0,1,11,4.7e-05
G5,C1(C(CCO)(CC(CO)(O)O1)O)=O,4,1,0,1,29,4.7e-05
G5,C1(C(CCO)(C(C(C)(O)O1)O)O)=O,8,1,0,1,7,4.7e-05
G5,C1C2(C(CO1)OC(CO)(C2)O)O,8,1,0,1,10,4.7e-05
G5,CC1(C(C2(COCC2O1)O)O)O,16,1,0,1,10,4.7e-05
G5,C1C(C2(C(C(CO2)(C)O)O1)O)O,16,1,0,1,10,4.7e-05
G5,C12C(CCO1)(CC(CO)(O)O2)O,8,1,0,1,34,4.7e-05
G5,CC1(C(C2(C(OCC2)O1)O)O)O,16,1,0,1,34,4.7e-05
G5,C1C(C)(C2COC(C2(O)O1)O)O,16,2,0,2,49,9.499999999999999e-05
G5,C(C1C(CCO)OC(C1O)O)=O,16,1,0,1,43,4.7e-05
G5,C(C1C(CC(C)O)OC(C1O)O)=O,32,1,0,1,43,4.7e-05
G5,C(CC1C(C(C(O)O1)C(C)O)O)=O,32,1,0,1,43,4.7e-05
G5,C(CC1C(C(C(C=O)(O)O1)O)O)=O,16,1,0,1,43,4.7e-05
G5,C(C(C(C1C(CC(O)O1)O)O)=O)=O,16,1,0,1,43,4.7e-05
G5,C(CC(C1C(C(C(O)O1)=O)O)O)=O,16,1,0,1,43,4.7e-05
G5,C(C(C(C1CC(C(O)O1)O)O)=O)=O,16,1,0,1,5,4.7e-05
G5,C(C(CC1C(C(C(O)O1)=O)O)O)=O,16,1,0,1,5,4.7e-05
G5,C1(C(C)(C(C(O)O1)C(C=O)O)O)=O,16,1,0,1,28,4.7e-05
G5,C1(C(C=O)C(C(O)O1)O)=O,8,1,0,1,43,4.7e-05
G5,C(C1C(C)(C(C)(OC1C=O)O)O)=O,16,1,0,1,14,4.7e-05
G5,C(C1C(C(OC1(C(C)=O)C)O)O)=O,16,1,0,1,14,4.7e-05
G5,C(C(C)=O)(CC1CC(C(O)O1)O)=O,8,1,0,1,21,4.7e-05
G5,C(C(CC1CC(C(C)(O)O1)=O)O)=O,8,1,0,1,21,4.7e-05
G5,C(C1C(C)(CC=O)OC(C1O)O)=O,16,1,0,1,6,4.7e-05
G5,C(C1C(CC(C)=O)OC(C1O)O)=O,16,1,0,1,6,4.7e-05
G5,C(CC(CC1CC(C(O)O1)O)=O)=O,8,1,0,1,6,4.7e-05
G5,C(C1C(C)(O)OC(C1O)CC=O)=O,16,1,0,1,6,4.7e-05
G5,C(CC1C(C(C(C)=O)C(O)O1)O)=O,16,1,0,1,6,4.7e-05
G5,C(C(C(C)=O)C1C(CC(O)O1)O)=O,16,1,0,1,6,4.7e-05
G5,C(C(C(C)=O)C1CC(C(O)O1)O)=O,16,1,0,1,6,4.7e-05
G5,C(C1C(C(C=C)(OC1C=O)O)O)=O,16,1,0,1,7,4.7e-05
G5,C(C1C(C(OC1C(C=C)=O)O)O)=O,16,1,0,1,7,4.7e-05
G5,C(C1C(C=O)C(C=C)(C(O1)O)O)=O,16,1,0,1,7,4.7e-05
G5,C(C1(C=C)C(C=O)C(C(O1)O)O)=O,16,1,0,1,7,4.7e-05
G5,C(C1C(C(OC1(C=C)CO)O)O)=O,16,1,0,1,7,4.7e-05
G5,C(C(C1C(O)OCC1(C=C)O)O)=O,16,1,0,1,7,4.7e-05
G5,C=CC(C(C1CC(C(O)O1)O)O)=O,16,1,0,1,7,4.7e-05
G5,C(C1C(C(OC1C=CC=O)O)O)=O,32,1,0,1,43,4.7e-05
G5,C(C1C(C(C)O)OC(C1O)O)=O,32,1,0,1,43,4.7e-05
G5,C(C(C1C(O)OC(C)C1O)O)=O,32,1,0,1,43,4.7e-05
G5,C(C1C(O)OC(C1O)C(C=O)O)=O,32,1,0,1,0,4.7e-05
G5,C(C(C=O)C1C(C(C(O)O1)O)O)=O,16,1,0,1,0,4.7e-05
G5,C1(CC2(C(C(C(C2)O)O)O1)O)O,32,1,0,1,4,4.7e-05
G5,C(CC12CCC(C(O)O1)(C2O)O)=O,16,2,0,2,29,9.499999999999999e-05
G5,C(C1(C2C(CC1)(CC(O)O2)O)O)=O,16,1,0,1,29,4.7e-05
G5,C(CC12CC(C(O)O1)(CC2O)O)=O,16,2,0,2,22,9.499999999999999e-05
G5,C(C1(CC2(CC(O)OC2C1)O)O)=O,16,1,0,1,22,4.7e-05
G5,C(CC1C2C(C(CC2O)(O)O1)O)=O,32,2,0,2,4,9.499999999999999e-05
G5,C(CC1C2CC(C(C2O)O)(O)O1)=O,32,2,0,2,18,9.499999999999999e-05
G5,C1C2(C(C(C(C=1)O)O)OC(C2)O)O,32,1,0,1,32,4.7e-05
G5,CC(C1C(CO)(CC(O)O1)O)O,16,1,0,1,4,4.7e-05
G5,CC(C(C1(COC(C1)O)O)O)O,16,1,0,1,4,4.7e-05
G5,C(C1(CC(C)(C(O1)O)O)CC=O)=O,8,1,0,1,4,4.7e-05
G5,C(C1(CC(C(O1)O)O)CC=O)=O,8,1,0,1,20,4.7e-05
G5,C(C)(C(CC1(COC(C1)O)O)O)=O,8,1,0,1,29,4.7e-05
G5,C(CC1(CO)CC(C)(C(O)O1)O)=O,8,1,0,1,4,4.7e-05
G5,C(C(C)(CC1(COC(C1)O)O)O)=O,8,1,0,1,4,4.7e-05
G5,C(CC1(C)C(C(C)(C(O)O1)O)O)=O,16,1,0,1,11,4.7e-05
G5,C(C(C)(C1C(C)(CC(O)O1)O)O)=O,16,1,0,1,11,4.7e-05
G5,C(CC1(C)C(CC(O)O1)O)=O,8,1,0,1,45,4.7e-05
G5,C(CC1C(C)(CC(O)O1)O)=O,8,1,0,1,45,4.7e-05
G5,C(CC1CC(C(C)(O)O1)O)=O,8,1,0,1,45,4.7e-05
G5,C(CC1CC(C)(C(O)O1)O)=O,8,1,0,1,18,4.7e-05
G5,C(C1C(CC(O1)O)(CCO)O)=O,8,1,0,1,0,4.7e-05
G5,C(C1C(CC(C)O)(CC(O1)O)O)=O,16,1,0,1,4,4.7e-05
G5,C1(CC(CCO)(C(CO)O1)O)O,8,1,0,1,29,4.7e-05
G5,CC(CC1(C(CO)OC(C1)O)O)O,16,1,0,1,4,4.7e-05
G5,C(CC1C(CO)C(C(O)O1)O)=O,16,1,0,1,43,4.7e-05
G5,C(C(C1(CC(O)OC1CO)O)O)O,16,1,0,1,4,4.7e-05
G5,CC(C1C(CCO)(CC(O)O1)O)O,16,1,0,1,4,4.7e-05
G5,C1C(CC(O)O1)(CC(C)(CO)O)O,8,1,0,1,4,4.7e-05
G5,CC1(CC(O)OC1C(C)(CO)O)O,16,1,0,1,4,4.7e-05
G5,CC(CC1(COC(C1)O)O)O,8,1,0,1,11,4.7e-05
G5,CC(C1C(C)(CC(O)O1)O)O,16,1,0,1,4,4.7e-05
G5,C(CC1C(C(C)O)C(C(O)O1)O)=O,32,1,0,1,4,4.7e-05
G5,C(CC1C(C(C)(C(O)O1)O)O)=O,16,1,0,1,45,4.7e-05
G5,C(C(C)(C1C(CC(O)O1)O)O)=O,16,1,0,1,45,4.7e-05
G5,CC(CO)(C1C(CC(O)O1)O)O,16,1,0,1,4,4.7e-05
G5,CC(C1C(CC(O)O1)O)O,16,1,0,1,28,4.7e-05
G5,C(CC1CC(C(CO)(O)O1)O)=O,8,1,0,1,41,4.7e-05
G5,C(CC1(CO)C(CC(O)O1)O)=O,8,1,0,1,29,4.7e-05
G5,C(CC1C(CO)(CC(O)O1)O)=O,8,1,0,1,29,4.7e-05
G5,C1(C(C)(O)OC(C)C1O)=O,8,1,0,1,4,4.7e-05
G5,C1(COC(C(C(C)O)O)(C1)O)=O,8,1,0,1,4,4.7e-05
G5,C1(COC(CC(C)O)(C1O)O)=O,8,1,0,1,11,4.7e-05
G5,CC(C1(COC(C1)O)O)O,8,1,0,1,25,4.7e-05
G5,C1(C(C)(CC(O)O1)O)=O,4,1,0,1,28,4.7e-05
G5,C(C1C(CC(O1)O)(C(C)O)O)=O,16,1,0,1,45,4.7e-05
G5,C(C(C1(C(C)OC(C1)O)O)O)=O,16,1,0,1,45,4.7e-05
G5,CC1C(CC(O)O1)O,8,1,0,1,11,4.7e-05
G5,C(C(CCC1C(CC(O)O1)O)=O)=O,8,2,0,2,7,9.499999999999999e-05
G5,C(C1CC(C(C)O)C(C=O)(O1)O)=O,16,1,0,1,12,4.7e-05
G5,C(CC1C(CC(C(C)O)(O1)O)=O)=O,8,1,0,1,45,4.7e-05
G5,C(CC1(C(C)O)CC(C(O)O1)=O)=O,8,1,0,1,45,4.7e-05
G5,C(C(CC1(CC(O)OC1C)O)=O)=O,8,1,0,1,45,4.7e-05
G5,C(CC1CC(C(C(C)=O)(O)O1)O)=O,8,1,0,1,9,4.7e-05
G5,C(C)(C1(C(CC(O1)O)O)CC=O)=O,8,1,0,1,45,4.7e-05
G5,C(CC1C(C(C)=O)(CC(O)O1)O)=O,8,1,0,1,45,4.7e-05
G5,C(C1C(C(C(C)=O)(O)OC1C)O)=O,16,1,0,1,25,4.7e-05
G5,C(C1C(C(C(C)O)(O)OC1C)=O)=O,16,1,0,1,4,4.7e-05
G5,C1(C(CO)(CC=O)OC(C)(C1)O)=O,4,1,0,1,26,4.7e-05
G5,C(C1(COC(C1)O)O)(CC(C)=O)=O,4,1,0,1,26,4.7e-05
G5,C(CC1(C(C(C(C)O1)O)=O)O)(C)=O,8,1,0,1,26,4.7e-05
G5,C1(C(CO)(O)OC(C)C1C(C)=O)=O,8,1,0,1,26,4.7e-05
G5,C(C1(C(CC(C)(O1)O)O)CC=O)=O,8,1,0,1,6,4.7e-05
G5,C(C1(C(CC(C)=O)OC(C1)O)O)=O,8,1,0,1,6,4.7e-05
G5,C(CC1(C)CC(C(C=O)(O)O1)O)=O,8,1,0,1,6,4.7e-05
G5,C(C1(C(C(C(C)=O)C(C)O1)O)O)=O,16,1,0,1,17,4.7e-05
G5,C(CCC=O)(C1(COC(C1)O)O)=O,4,1,0,1,4,4.7e-05
G5,C(CCC1(C(C(C(C)O1)O)=O)O)=O,8,1,0,1,17,4.7e-05
G5,C1(C(CO)(O)OC(C)C1CC=O)=O,8,1,0,1,4,4.7e-05
G5,C(C1(C(CCC=O)OC(C1)O)O)=O,8,2,0,2,27,9.499999999999999e-05
G5,C(C(C1CC(C(O1)O)C(C)O)=O)=O,16,1,0,1,46,4.7e-05
G5,C1(C(C)(CC=O)OC(CO)(C1)O)=O,4,1,0,1,21,4.7e-05
G5,C(CO)=CC(C1(COC(C1)O)O)=O,8,1,0,1,4,4.7e-05
G5,C1(C(C(C)OC1(C=CCO)O)O)=O,16,1,0,1,55,4.7e-05
G5,C(C1(CC(OC1C=CCO)O)O)=O,16,1,0,1,28,4.7e-05
G5,C(C1C(CO)(CC(O1)O)O)=CC=O,16,1,0,1,32,4.7e-05
G5,C(C(C1(COC(C1)O)O)O)=CC=O,16,1,0,1,32,4.7e-05
G5,C(C1C(CC(O1)O)(C(C=C)O)O)=O,16,1,0,1,27,4.7e-05
G5,C(C(C1(CC(OC1C=C)O)O)O)=O,16,1,0,1,27,4.7e-05
G5,C(C(C1(C(C(C)O)CCO1)O)O)=O,16,1,0,1,4,4.7e-05
G5,C(C)(C1(C(C(C)O)C(CO1)O)O)=O,16,1,0,1,14,4.7e-05
G5,C(CC1(C(C(CO1)O)C(C)O)O)=O,16,1,0,1,44,4.7e-05
G5,C1C2(CC(O)OC2(CO)C(C=1)O)O,16,1,0,1,4,4.7e-05
G5,C1C(C2(C(CC(O)O2)O)C(C=1)O)O,12,1,0,1,43,4.7e-05
G5,C(C1(CO)C(CC(O)O1)O)O,4,1,0,1,18,4.7e-05
G5,CC(C1(CO)C(CC(O)O1)O)O,16,1,0,1,4,4.7e-05
G5,C(C1(C(CC=O)OC(C1O)O)O)=O,16,1,0,1,0,4.7e-05
G5,CC1(CC(O)OC1(CO)CO)O,4,1,0,1,29,4.7e-05
G5,CC1(CC(O)OC1(CO)C(C)O)O,16,1,0,1,4,4.7e-05
G5,C(C(C1(CO)C(CC(O)O1)O)O)O,16,1,0,1,29,4.7e-05
G5,C(CC1C2(CC(CC2O)(O)O1)O)=O,16,2,0,2,26,9.499999999999999e-05
G5,C1(CC2(C(C1)O)C(CC(O)O2)O)=O,16,1,0,1,26,4.7e-05
G5,C(CC12CC(C(C(O)O1)(C2)O)O)=O,16,2,0,2,4,9.499999999999999e-05
G5,C1(CC(C2(C(O)OC(C)C12)O)O)=O,32,1,0,1,17,4.7e-05
G5,C(C(C1(C)C(CC(O)O1)O)O)(O)=O,16,1,0,1,25,4.7e-05
G5,C(CC1CC(C(O)O1)(CO)O)=O,8,1,0,1,43,4.7e-05
G5,C(CC1C(CC(O)O1)(C(C)O)O)=O,16,1,0,1,4,4.7e-05
G5,C(CC1(C(CC(O)O1)O)C(C)O)=O,16,1,0,1,4,4.7e-05
G5,C(CC1CC(C(O)O1)(C(C)O)O)=O,16,1,0,1,4,4.7e-05
G5,C1(CC2C(CC(O)O2)(C1CO)O)=O,16,1,0,1,30,4.7e-05
G5,C1(C2C(C)OC(C2O)(C1CO)O)=O,32,2,0,2,2,9.499999999999999e-05
G5,C1(C2C(CC1CO)(CC(O2)O)O)=O,16,1,0,1,47,4.7e-05
G5,C1(C2C(CC(O2)O)(C(CO)C1)O)=O,16,2,0,2,11,9.499999999999999e-05
G5,C1(C(C2(C(CO)C1C(C)O2)O)O)=O,32,2,0,2,4,9.499999999999999e-05
G5,C1(C(C2(C(C(C)O)C1CO2)O)O)=O,32,2,0,2,4,9.499999999999999e-05
G5,C1(CCC2(CC(OC12CO)O)O)=O,8,1,0,1,21,4.7e-05
G5,C1(C(CO)(C2(CC1C(C)O2)O)O)=O,16,2,0,2,2,9.499999999999999e-05
G5,C1(CC2(CO)C(CC(O)O2)(C1)O)=O,8,1,0,1,4,4.7e-05
G5,C1(CC2(C(CO)(C1C(C)O2)O)O)=O,16,2,0,2,4,9.499999999999999e-05
G5,C1(CC2(C(C(C)O)C1(CO2)O)O)=O,16,2,0,2,4,9.499999999999999e-05
G5,C1(CC2C(C(C(O)O2)C(C)O)O1)=O,32,1,0,1,48,4.7e-05
G5,C(CC12COC(C1O)C(C)(O)O2)=O,16,1,0,1,17,4.7e-05
G5,C(C)(C1C2C(CO1)(CC(O)O2)O)=O,16,1,0,1,17,4.7e-05
G5,C(CC1(C)C2C(C(CO2)(O)O1)O)=O,16,1,0,1,17,4.7e-05
G5,C(CC1C2C(CO1)(CC(O)O2)O)=O,16,1,0,1,4,4.7e-05
G5,C1(COC2C(C(OC12)O)C(C)O)=O,32,1,0,1,9,4.7e-05
G5,C(CC12C(O)OC(C1)C(C)(O)O2)=O,16,2,0,2,22,9.499999999999999e-05
G5,C(C)(C1CC2(C(O1)OC(C2)O)O)=O,16,1,0,1,22,4.7e-05
G5,C(CC1(C)C2CC(C(O)O2)(O)O1)=O,16,2,0,2,22,9.499999999999999e-05
G5,C1(C(O)OC2C(C)(O)OC(C)C12)=O,32,2,0,2,22,9.499999999999999e-05
G5,C(CC1CC2(C(O1)OC(C2)O)O)=O,16,1,0,1,13,4.7e-05
G5,C(CC12C(CC(O)O1)OC(C2)O)=O,16,2,0,2,13,9.499999999999999e-05
G5,C(CC1CC2C(CC(O)O2)(O)O1)=O,16,2,0,2,13,9.499999999999999e-05
G5,C(C1C(C)OC2(C1OC(C2)O)O)=O,32,2,0,2,4,9.499999999999999e-05
G5,C1(CC2(C(C(CO2)O1)C(C)O)O)=O,16,1,0,1,19,4.7e-05
G5,C1(C2(CC(CO)OC1C(C)O2)O)=O,16,1,0,1,54,4.7e-05
G5,C1(C2(COC(CO)C1C(C)O2)O)=O,16,1,0,1,54,4.7e-05
G5,C1(COC2COC1(C2C(C)O)O)=O,16,1,0,1,54,4.7e-05
G5,C1(CCC2(CC(O)OC2CO1)O)=O,8,1,0,1,4,4.7e-05
G5,C1(CC2C(CCO1)(CC(O)O2)O)=O,8,1,0,1,19,4.7e-05
G5,C1(C2(CC(COC1C(C)O2)O)O)=O,16,1,0,1,36,4.7e-05
G5,C1(C2(C(C(C)O)OCC(C1)O2)O)=O,16,1,0,1,36,4.7e-05
G5,C1(C2(COCC(C1C(C)O2)O)O)=O,16,1,0,1,36,4.7e-05
G5,C1(COCC2C(CC(O)O2)(C1)O)=O,8,1,0,1,36,4.7e-05
G5,C1(C2COC(C(C1)(O2)O)C(C)O)=O,16,1,0,1,36,4.7e-05
G5,C1(C2C(COCC1)(CC(O2)O)O)=O,8,1,0,1,36,4.7e-05
G5,C1(COCCC2(CC(OC12)O)O)=O,8,1,0,1,36,4.7e-05
G5,C(CC12COCC(CC1O)(O)O2)=O,8,1,0,1,36,4.7e-05
G5,C1(COCC2(C(C1)OC(C2)O)O)=O,8,1,0,1,36,4.7e-05
G5,C(CC12COCC(C(C1)O)(O)O2)=O,8,1,0,1,36,4.7e-05
G5,C1(COCC2(C(C1C(C)O2)O)O)=O,16,1,0,1,4,4.7e-05
G5,C1(CC2(C(OC(C2)O)OCC1)O)=O,8,1,0,1,23,4.7e-05
G5,C1(C2OCC(C(C1)(O2)O)C(C)O)=O,16,1,0,1,4,4.7e-05
G5,C(CC12C(O)OCC(CC1)(O)O2)=O,8,2,0,2,29,9.499999999999999e-05
G5,C1(COC2C(CC1)(CC(O)O2)O)=O,8,1,0,1,29,4.7e-05
G5,C(CC12COC(C(CC1)(O)O2)O)=O,8,2,0,2,29,9.499999999999999e-05
G5,C1(C(O)OCC2(CC1C(C)O2)O)=O,16,2,0,2,12,9.499999999999999e-05
G5,C1(COC(C2(CC1C(C)O2)O)O)=O,16,2,0,2,12,9.499999999999999e-05
G5,C1(C2(CCOC(C1C(C)O2)O)O)=O,16,2,0,2,7,9.499999999999999e-05
G5,C1(C2(CC(O)OCC1C(C)O2)O)=O,16,2,0,2,4,9.499999999999999e-05
G5,C1(C2(C(COC(C1)O2)C(C)O)O)=O,16,1,0,1,4,4.7e-05
G5,C1C2(C(CO1)OC(C2)O)O,8,1,0,1,10,4.7e-05
G5,C12C(CCO1)(CC(O)O2)O,8,1,0,1,34,4.7e-05
G5,C(CC1CC2C(C(CO2)O)(O)O1)=O,16,1,0,1,9,4.7e-05
G5,C(CC12C(CC(O)O1)OCC2O)=O,16,1,0,1,9,4.7e-05
G5,C(CC1C2(C(CO1)OC(C2)O)O)=O,16,1,0,1,9,4.7e-05
G5,C(C1C(C)OC2(C1OCC2O)O)=O,32,1,0,1,9,4.7e-05
G5,C(CC1CC2(C(CCO2)(O)O1)O)=O,8,2,0,2,53,9.499999999999999e-05
G5,C(CC12CCOC1(CC(O)O2)O)=O,8,2,0,2,53,9.499999999999999e-05
G5,C(CC12C(CCO1)(CC(O)O2)O)=O,8,1,0,1,53,4.7e-05
G5,C(C1C(C)OC2(C1(O)OCC2)O)=O,16,2,0,2,7,9.499999999999999e-05
G5,C(CC1C2CC(C(C)(O)O2)(O)O1)=O,16,2,0,2,21,9.499999999999999e-05
G5,C(CC12CC(C(O)O1)OC2(C)O)=O,16,2,0,2,21,9.499999999999999e-05
G5,C(C1CC2(CC(O)OC2(C)O1)O)=O,16,1,0,1,21,4.7e-05
G5,C1(C(C)(O)OC2C(O)OC(C)C12)=O,32,2,0,2,14,9.499999999999999e-05
G5,C(CC1C2C(C(C(C)O2)(O)O1)O)=O,32,1,0,1,29,4.7e-05
G5,C(CC12C(C)OC(C(O)O1)C2O)=O,32,1,0,1,29,4.7e-05
G5,C(C1C2C(CC(O)O2)(C(C)O1)O)=O,32,1,0,1,29,4.7e-05
G5,C(CC1C2(CC(CCO2)(O)O1)O)=O,8,2,0,2,30,9.499999999999999e-05
G5,C1(CC2(C(CC(O)O2)O)OCC1)=O,8,1,0,1,30,4.7e-05
G5,C(CC12CC(C(O)O1)(O)OCC2)=O,8,2,0,2,30,9.499999999999999e-05
G5,C1(CCOC2(C(O)OC(C)C12)O)=O,16,2,0,2,30,9.499999999999999e-05
G5,C1(COC2(CC1)C(CC(O)O2)O)=O,8,1,0,1,7,4.7e-05
G5,C(CC1C2CC(CC(O)O2)(O)O1)=O,16,2,0,2,6,9.499999999999999e-05
G5,C(CC12CC(C(O)O1)OC(C2)O)=O,16,2,0,2,4,9.499999999999999e-05
G5,C1(CC(O)OC2C(O)OC(C)C12)=O,32,2,0,2,37,9.499999999999999e-05
G5,C1C(C2C(C=1CO)(CC(O)O2)O)O,16,1,0,1,2,4.7e-05
G5,C=C1C(C(C2C1(CC(O)O2)O)O)O,32,1,0,1,47,4.7e-05
G5,C=CC(C(C1C(CC(O)O1)O)O)O,32,1,0,1,4,4.7e-05
G5,C1C2(C(C(C=1)O)O)C(CC(O2)O)O,32,1,0,1,29,4.7e-05
G5,C1C2(C(OC(C=1)CO)OC(C2)O)O,16,1,0,1,46,4.7e-05
G5,C1OC(CO)C2C(C=1)(CC(O)O2)O,16,1,0,1,9,4.7e-05
G5,C1C2(C(OCC(C=1)O)OC(C2)O)O,16,1,0,1,41,4.7e-05
G5,C1OCC(C2C(C=1)(CC(O)O2)O)O,16,1,0,1,38,4.7e-05
G5,C1C2(C(C(OCC=1)O)OC(C2)O)O,16,1,0,1,19,4.7e-05
G5,C1C2(C(COC(C=1)O)OC(C2)O)O,16,1,0,1,38,4.7e-05
G5,C1C(CO)OC2(C=1)C(CC(O2)O)O,16,1,0,1,41,4.7e-05
G5,C1C(COC=1C2C(CC(O2)O)O)O,16,1,0,1,36,4.7e-05
G5,C1C(C2C(CC(O)O2)O)(OCC=1)O,16,1,0,1,39,4.7e-05
G5,C1C(C2C(CC(O)O2)O)OC(C=1)O,32,1,0,1,43,4.7e-05
G5,C1OC(C2C(CC(O)O2)O)C(C=1)O,32,1,0,1,36,4.7e-05
G5,C1C(COC2(C=1)C(CC(O2)O)O)O,16,1,0,1,30,4.7e-05
G5,C(C1C(O)OCC1(C(CO)O)O)=O,16,1,0,1,45,4.7e-05
G5,C(C1C(O)OC(CO)C1(CO)O)=O,16,1,0,1,45,4.7e-05
G5,C1(C(C(C(C(CO)O)(O)O1)O)O)=O,16,1,0,1,33,4.7e-05
G5,CC1C(C(C(C(CO)O)(O)O1)O)O,32,1,0,1,2,4.7e-05
G5,C(CCO)(C1C(OC(C1=O)O)=O)=O,4,1,0,1,30,4.7e-05
G5,C1(C(C(C(O)O1)=O)CC(CO)=O)=O,4,1,0,1,12,4.7e-05
G5,C1(C(C(C=O)=O)CC(CO)(O)O1)=O,4,1,0,1,12,4.7e-05
G5,C(C1(CC(C(O1)=O)C(CO)=O)O)=O,4,1,0,1,12,4.7e-05
G5,C1(C(C(C(O)O1)=O)C(C(C)=O)O)=O,8,1,0,1,45,4.7e-05
G5,C1(C(C(C=O)=O)C(C(C)(O)O1)O)=O,8,1,0,1,45,4.7e-05
G5,C(CC(C1C(OC(C1=O)O)=O)O)=O,8,1,0,1,17,4.7e-05
G5,C1(C(C=O)C(C(CCO)(O)O1)=O)=O,4,1,0,1,17,4.7e-05
G5,C(CC1(C(C(C(O1)=O)CO)=O)O)=O,4,1,0,1,17,4.7e-05
G5,C1(C(C=O)C(C(CC=O)(O)O1)O)=O,8,1,0,1,17,4.7e-05
G5,C(C1C(CC(CC(O)=O)(O1)O)=O)=O,4,1,0,1,17,4.7e-05
G5,C1(C(C(C(C=O)O)=O)CC(O)O1)=O,8,1,0,1,17,4.7e-05
G5,C1(C(C=O)CC(C(C=O)O)(O)O1)=O,8,1,0,1,17,4.7e-05
G5,C1(C(C(C(C)=O)=O)C(C(O)O1)O)=O,8,1,0,1,17,4.7e-05
G5,C1(C(C)(O)OC(C1C(C=O)O)=O)=O,8,1,0,1,17,4.7e-05
G5,C(CC1(C(CC(C=O)O1)=O)O)(O)=O,4,1,0,1,17,4.7e-05
G5,C(C(CC1(C(CC(O1)=O)=O)O)O)=O,4,1,0,1,17,4.7e-05
G5,C1(C(C(CC=O)=O)C(C(O)O1)O)=O,8,1,0,1,17,4.7e-05
G5,C(C1CC(C)(C(O1)O)O)(O)=O,8,1,0,1,29,4.7e-05
G5,C(C1CC(C(O1)O)(CCO)O)(O)=O,8,1,0,1,29,4.7e-05
G5,C(C1C(CO)C(C(C)(O1)O)O)(O)=O,16,1,0,1,29,4.7e-05
G5,C(C1C(CO)C(C)(C(O1)O)O)(O)=O,16,1,0,1,29,4.7e-05
G5,C(C1C(CO)C(C(O1)O)O)(O)=O,16,1,0,1,29,4.7e-05
G5,C(C1C(CO)CC(CO)(O1)O)(O)=O,8,1,0,1,29,4.7e-05
G5,C1(C(CC(O)O1)(C(CO)CO)O)=O,4,1,0,1,29,4.7e-05
G5,C(C1(C)C(CO)C(C(O1)O)O)(O)=O,16,1,0,1,29,4.7e-05
G5,C(C1(CCO)CC(C(O1)O)O)(O)=O,8,1,0,1,29,4.7e-05
G5,C1(C(CC(C)(O)O1)O)=O,4,1,0,1,26,4.7e-05
G5,C1(C(CC(C(C)O)(O)O1)O)=O,8,1,0,1,24,4.7e-05
G5,C(C1(C)C(CC(O1)O)O)(O)=O,8,1,0,1,25,4.7e-05
G5,C1(C(CO)(CC(C)(O)O1)O)=O,4,1,0,1,33,4.7e-05
G5,C(C1C(CC(C)(O1)O)O)(O)=O,8,1,0,1,17,4.7e-05
G5,C(C1(CO)CCC(O1)O)(O)=O,4,1,0,1,29,4.7e-05
G5,C(C1CC(CO)(C(C)(O1)O)O)(O)=O,8,1,0,1,45,4.7e-05
G5,C(C1(C)CC(CO)(C(O1)O)O)(O)=O,8,1,0,1,14,4.7e-05
G5,C1(C(C(OC1CCO)O)=O)=O,4,1,0,1,31,4.7e-05
G5,C(C1CC(C(C=O)(O1)O)O)=O,8,1,0,1,43,4.7e-05
G5,C1(C(C(C=O)(OC1C)O)O)=O,8,1,0,1,1,4.7e-05
G5,C(C1(C2(CC(CO2)O1)O)O)=O,8,2,0,2,0,9.499999999999999e-05
G5,C1(C(O)OC2CC(OC12)O)=O,16,2,0,2,5,9.499999999999999e-05
G5,C(CC1(C(C(O)OC1)=O)O)=O,4,1,0,1,29,4.7e-05
G5,C1(C(OC(C=O)C1(C)O)O)=O,8,1,0,1,0,4.7e-05
G5,C1(C(O)OC(CO)C1(C)O)=O,8,1,0,1,0,4.7e-05
G5,C(C1(CCOC1(C=O)O)O)=O,4,1,0,1,29,4.7e-05
G5,C1(C(O)OCC1(CCO)O)=O,4,1,0,1,29,4.7e-05
G5,C1(C(O)OC(CO)C1(CO)O)=O,8,1,0,1,0,4.7e-05
G5,C(C1(C(CO)(C(CO1)O)O)O)=O,8,1,0,1,0,4.7e-05
G5,C(C1(C(CCO1)O)O)=O,4,1,0,1,27,4.7e-05
G5,C1CC(C(CO)(O)O1)O,4,1,0,1,31,4.7e-05
G5,C1(CC(C(CO)(O)O1)O)=O,4,1,0,1,2,4.7e-05
G5,C(OC1(CO)C(COC1(C)O)O)=O,8,1,0,1,35,4.7e-05
G5,C(OC1COC(C)(C1(CO)O)O)=O,8,1,0,1,9,4.7e-05
G5,C(COC1COC(C1O)O)=O,8,1,0,1,26,4.7e-05
G5,C1C2(C(C(CO2)O1)O)O,8,1,0,1,27,4.7e-05
G5,C1C2CC(C(O)O2)(O)O1,8,2,0,2,0,9.499999999999999e-05
G5,C1C2(CC(CO2)(O)O1)O,3,1,0,1,27,4.7e-05
G5,C(C(O)OC1COC(C1O)O)=O,16,1,0,1,0,4.7e-05
G5,C(C(O)OC1COC(C1)O)=O,8,1,0,1,41,4.7e-05
G5,C(OC1CCOC1(CO)O)=O,4,1,0,1,2,4.7e-05
G5,C(COC1C(CC(O)O1)O)=O,8,1,0,1,37,4.7e-05
G5,C1(C2CCC(C1O)(O2)O)=O,8,1,0,1,32,4.7e-05
G5,C1(C2CCC1(C(O2)O)O)=O,8,2,0,2,12,9.499999999999999e-05
G5,C(C1C2C(C(C(C1O)(O)O2)O)O)O,64,1,0,1,5,4.7e-05
G5,C1C2C(C(C(C(C2O)(O)O1)O)O)O,64,2,0,2,5,9.499999999999999e-05
G5,C1(C(CO)OC(C1(C)O)O)=O,8,1,0,1,2,4.7e-05
G5,C(C1C(C(C)(C(O1)O)O)O)=O,16,1,0,1,11,4.7e-05
G5,C(C1(C(CC(CO)(CO)O1)O)O)=O,4,1,0,1,5,4.7e-05
G5,CC1(C(COC1(C(CO)O)O)O)O,16,1,0,1,0,4.7e-05
G5,C1(C(CCO)OC(CO)(C1O)O)=O,8,1,0,1,5,4.7e-05
G5,C1(COC(C(CCO)O)(C1O)O)=O,8,1,0,1,5,4.7e-05
G5,C(CO)(C(C1(C(CCO1)O)O)O)=O,8,1,0,1,5,4.7e-05
G5,C1(C(CO)OC(C1(CCO)O)O)=O,8,1,0,1,55,4.7e-05
G5,C(C1(CCOC1(C(CO)O)O)O)=O,8,1,0,1,55,4.7e-05
G5,C1C(C(C(O)O1)O)C(CO)(CO)O,8,1,0,1,29,4.7e-05
G5,C1(C(CC(CO)(CO)O1)O)O,4,1,0,1,29,4.7e-05
G5,C(C1(C(CC(C(CO)O)O1)O)O)=O,16,1,0,1,20,4.7e-05
G5,C(C1(C(CC(C(CO)O)O1)O)O)O,16,1,0,1,41,4.7e-05
G5,C1CC(C(C(C(CO)O)O)(O)O1)O,16,1,0,1,31,4.7e-05
G5,C1C(C(C(O)O1)O)C(C(CO)O)O,32,1,0,1,29,4.7e-05
G5,C1(C(C)OC(C1C(CO)=O)O)=O,8,1,0,1,11,4.7e-05
G5,C(C1C(C(C)OC1(CO)O)=O)=O,8,1,0,1,11,4.7e-05
G5,C(C1C(COC1(C(C)O)O)=O)=O,8,1,0,1,11,4.7e-05
G5,C(CC1(C(C(C(C)O1)=O)O)O)=O,8,1,0,1,9,4.7e-05
G5,C(CC1C(C(C(C)(O1)O)O)=O)=O,8,1,0,1,0,4.7e-05
G5,C(CC1C(C(C(O1)O)(C)O)=O)=O,8,1,0,1,9,4.7e-05
G5,C(C1C(CC(C(C)O)(O1)O)=O)=O,8,1,0,1,5,4.7e-05
G5,C(C(C1(CC(C(C)O1)=O)O)O)=O,8,1,0,1,5,4.7e-05
G5,C(C(C1CC(C(C)(O1)O)O)=O)=O,8,1,0,1,45,4.7e-05
G5,C(C1(C(CC(C(C)=O)O1)O)O)=O,8,1,0,1,45,4.7e-05
G5,C(C(C1CC(C)(C(O1)O)O)=O)=O,8,1,0,1,16,4.7e-05
G5,C(C1(C)CC(C(C=O)(O1)O)O)=O,8,1,0,1,16,4.7e-05
G5,C1(C(C)OC(C(CO)O)(C1)O)=O,8,1,0,1,24,4.7e-05
G5,C1(C(CO)OC(C(C)O)(C1)O)=O,8,1,0,1,24,4.7e-05
G5,C(C)(C1CC(C(CO)(O1)O)O)=O,8,1,0,1,49,4.7e-05
G5,C(CO)(C1CC(C(C)(O1)O)O)=O,8,1,0,1,49,4.7e-05
G5,C(C1(C)CC(C(CO)(O1)O)O)=O,8,1,0,1,16,4.7e-05
G5,C(CO)(C1CC(C(O1)O)(C)O)=O,8,1,0,1,16,4.7e-05
G5,C1(CC(C=O)(OC1CCO)O)=O,4,1,0,1,29,4.7e-05
G5,C(C(CC1(C(CCO1)O)O)=O)=O,4,1,0,1,29,4.7e-05
G5,C1(C(C)OC(CCO)(C1O)O)=O,8,1,0,1,25,4.7e-05
G5,C1(C(CCO)OC(C)(C1O)O)=O,8,1,0,1,31,4.7e-05
G5,C(C)(C(C1(C(CCO1)O)O)O)=O,8,1,0,1,31,4.7e-05
G5,C1(C(CCO)OC(C1(C)O)O)=O,8,1,0,1,45,4.7e-05
G5,C(C(C)(C1(C(CCO1)O)O)O)=O,8,1,0,1,45,4.7e-05
G5,C1(COC(C(C)O)(C1CO)O)=O,8,1,0,1,24,4.7e-05
G5,C1(C(C)OC(CO)(C1CO)O)=O,8,1,0,1,24,4.7e-05
G5,C(C)(C(C1COC(C1O)O)O)=O,16,1,0,1,29,4.7e-05
G5,C(C(C)(C1COC(C1O)O)O)=O,16,1,0,1,29,4.7e-05
G5,C(C1CC(C(C)(O1)O)O)=O,8,1,0,1,29,4.7e-05
G5,C(C1(C)CC(C(O1)O)O)=O,8,1,0,1,16,4.7e-05
G5,C(C1CC(C)(C(O1)O)O)=O,8,1,0,1,16,4.7e-05
G5,C1(C(C)OC(C)(C1O)O)=O,8,1,0,1,25,4.7e-05
G5,C1(C(C)OC(C1(C)O)O)=O,8,1,0,1,49,4.7e-05
G5,C1(C(C)OC(C1C(C=O)O)O)=O,16,1,0,1,45,4.7e-05
G5,C1(C(C)OC(C1)O)=O,4,1,0,1,45,4.7e-05
G5,C(C1(C)C(C(C(CO)(O1)O)O)O)=O,16,1,0,1,5,4.7e-05
G5,C(CO)(C1C(C(C(O1)O)(C)O)O)=O,16,1,0,1,5,4.7e-05
G5,C(C1C(COC1(CO)O)=O)=O,4,1,0,1,2,4.7e-05
G5,C(CC1(C(C(CO1)=O)O)O)=O,4,1,0,1,2,4.7e-05
G5,C(C(C1CC(C(C=O)(O)O1)O)O)=O,16,1,0,1,0,4.7e-05
G5,C(C1(C(CC(CO)(C)O1)O)O)=O,8,1,0,1,49,4.7e-05
G5,C(C(C1(C)CC(C(O)O1)O)O)=O,16,1,0,1,0,4.7e-05
G5,C(C1(C(CC(C)O1)O)O)=O,8,1,0,1,33,4.7e-05
G5,C(C(C1(C(CC(C=O)O1)O)O)O)=O,16,1,0,1,0,4.7e-05
G5,C(C(C(C1CC(C(O1)O)O)=O)O)=O,16,1,0,1,0,4.7e-05
G5,C(C(CC1C(C(C(O1)O)O)=O)O)=O,16,1,0,1,0,4.7e-05
G5,C1(COC(C=O)(C1CO)O)=O,4,1,0,1,51,4.7e-05
G5,C1(COC(C(CO)O)(C1O)O)=O,8,1,0,1,5,4.7e-05
G5,C1(C(CO)OC(CO)(C1O)O)=O,8,1,0,1,5,4.7e-05
G5,CC1(CO)CC(C(CO)(O)O1)O,8,1,0,1,49,4.7e-05
G5,CC1(CC(C(O)O1)O)C(CO)O,16,1,0,1,52,4.7e-05
G5,CC1(C(COC1(C(C)O)O)O)O,16,1,0,1,49,4.7e-05
G5,CC1CC(C(CO)(O)O1)O,8,1,0,1,11,4.7e-05
G5,C(C1C(C(C(O1)O)O)C(C)O)=O,32,1,0,1,11,4.7e-05
G5,C(C1CC(C(C(C)O)(O1)O)O)=O,16,1,0,1,49,4.7e-05
G5,C(CO)(C1(C(C(CO)CO1)O)O)=O,8,1,0,1,30,4.7e-05
G5,C(CO)(C1C(CO)C(C(O1)O)O)=O,16,1,0,1,5,4.7e-05
G5,C(C1C(CO)C(C(CO)(O1)O)O)=O,16,1,0,1,5,4.7e-05
G5,C(CO)(C1CC(C(CO)(O1)O)O)=O,8,1,0,1,2,4.7e-05
G5,C1C(C(CO)O)C(C(CO)(O)O1)O,16,1,0,1,5,4.7e-05
G5,C(C1(C(C(CO)C(CO)O1)O)O)O,16,1,0,1,5,4.7e-05
G5,C(C(CC1COC(C1O)O)=O)=O,8,1,0,1,12,4.7e-05
G5,C(C1C(CO)CC(C=O)(O1)O)=O,8,1,0,1,12,4.7e-05
G5,C(C1(CCC(C(CO)=O)O1)O)=O,4,1,0,1,20,4.7e-05
G5,C(CC(C1(C(CCO1)O)O)=O)=O,4,1,0,1,31,4.7e-05
G5,C(C(C1C(CO)CC(O1)O)=O)=O,8,1,0,1,43,4.7e-05
G5,C(CC1COC(C=O)(C1O)O)=O,8,1,0,1,43,4.7e-05
G5,C1C2C(C(C(C(CO)O)O2)(O)O1)O,32,1,0,1,27,4.7e-05
G5,C1C(C2C(C(C(CO)O2)O)(O)O1)O,32,1,0,1,27,4.7e-05
G5,C1C2C(C(C(C(CO)O2)O)(O)O1)O,32,1,0,1,2,4.7e-05
G5,C1C2C(O)OC(CO)C(C2O)(O)O1,32,2,0,2,2,9.499999999999999e-05
G5,C1C2C(CO)OC(C(C2O)(O)O1)O,32,1,0,1,19,4.7e-05
G5,C1C(C(C2(C(C(CO2)O1)O)O)O)O,32,1,0,1,36,4.7e-05
G5,C1C2C(O)OCC(C(C2O)(O)O1)O,32,2,0,2,5,9.499999999999999e-05
G5,C12C(CO)C(C(C(CO1)O)(O)O2)O,32,1,0,1,5,4.7e-05
G5,C1C2C(COC(C(C2O)(O)O1)O)O,32,1,0,1,19,4.7e-05
G5,C1C2C(CO)C(C(C(O)O1)(O)O2)O,32,1,0,1,19,4.7e-05
G5,C1C2(C(C(CO)C(C(O)O1)O2)O)O,32,1,0,1,2,4.7e-05
G5,C1C2C(C(O)OCC(C2O)(O)O1)O,32,1,0,1,2,4.7e-05
G5,C1C2COC(C(C(C2O)(O)O1)O)O,32,1,0,1,30,4.7e-05
G5,C(CO)(CC1(C(CCO1)O)O)=O,4,1,0,1,29,4.7e-05
G5,C1(C(CCO)OC(CO)(C1)O)=O,4,1,0,1,29,4.7e-05
G5,C1(COC(C(CCO)O)(C1)O)=O,4,1,0,1,29,4.7e-05
G5,C(C1CC(C(O1)O)O)(CCO)=O,8,1,0,1,3,4.7e-05
G5,C(C1CC(C(CCO)(O1)O)O)=O,8,1,0,1,3,4.7e-05
G5,C(C1(CCO)CC(C(O1)O)O)=O,8,1,0,1,29,4.7e-05
G5,C(C1CC(C(O1)O)(CCO)O)=O,8,1,0,1,29,4.7e-05
G5,C(C1(CCOC1(C(C)O)O)O)=O,8,1,0,1,29,4.7e-05
G5,C1(C(C)OC(C1(CCO)O)O)=O,8,1,0,1,29,4.7e-05
G5,C(C(C(C1(C(CCO1)O)O)O)O)=O,16,1,0,1,31,4.7e-05
G5,CC(CO)(C1(C(CCO1)O)O)O,8,1,0,1,3,4.7e-05
G5,CC(CO)(C1COC(C1O)O)O,16,1,0,1,29,4.7e-05
G5,CC(C1(C(CO)(CCO1)O)O)O,8,1,0,1,3,4.7e-05
G5,CC(C1(C(CCO1)O)O)O,8,1,0,1,3,4.7e-05
G5,C1C(C(C)O)C(C(O)O1)O,16,1,0,1,29,4.7e-05
G5,C1(C(CC(C)O)OC(C1O)O)=O,16,1,0,1,11,4.7e-05
G5,C(C(C1(C(CC(C)O1)O)O)O)=O,16,1,0,1,11,4.7e-05
G5,CC1(CO)CC(C(O)O1)O,8,1,0,1,49,4.7e-05
G5,CC1CC(C(O)O1)O,8,1,0,1,11,4.7e-05
G5,C1C(C(CO)(C(C(C)O)(O)O1)O)O,16,1,0,1,2,4.7e-05
G5,CC1(CO)C(C(C(CO)(O)O1)O)O,16,1,0,1,5,4.7e-05
G5,C(CC1C(CC(O1)O)=O)(CCO)=O,4,1,0,1,30,4.7e-05
G5,C(CC(C1CCC(CO)(O1)O)=O)=O,4,1,0,1,7,4.7e-05
G5,C(C(CC1C(C)OC(C1O)O)=O)=O,16,1,0,1,12,4.7e-05
G5,C(C1C(CC(C=O)(O1)O)C(C)O)=O,16,1,0,1,12,4.7e-05
G5,C(C(C)O)(C1CCC(C=O)(O1)O)=O,8,1,0,1,12,4.7e-05
G5,C1(C(CC(C(C)=O)O)OC(C1)O)=O,8,1,0,1,45,4.7e-05
G5,C(CC(C1CC(C(C)(O1)O)O)=O)=O,8,1,0,1,45,4.7e-05
G5,C(CC1(C(CC(C(C)=O)O1)O)O)=O,8,1,0,1,45,4.7e-05
G5,C1(CC(C=O)(OC1CC(C)O)O)=O,8,1,0,1,22,4.7e-05
G5,C(C(CC1(C(CC(C)O1)O)O)=O)=O,8,1,0,1,22,4.7e-05
G5,C(CC(C1(C(CC(C)O1)O)O)=O)=O,8,1,0,1,9,4.7e-05
G5,C(C(C1C(CC(O1)O)C(C)O)=O)=O,16,1,0,1,46,4.7e-05
G5,C(CC1C(C(C=O)(O)OC1C)O)=O,16,1,0,1,46,4.7e-05
G5,C1(CC(OC1C=CC(CO)O)O)=O,16,1,0,1,29,4.7e-05
G5,C1(COC(C1(C)O)O)=O,4,1,0,1,0,4.7e-05
G5,C(C1C(C(C(O1)O)O)C(CO)O)=O,32,1,0,1,0,4.7e-05
G5,C1(COC(C1(CCO)O)O)=O,4,1,0,1,55,4.7e-05
G5,C(C1(C(CO)(O)OCC1)O)=O,4,1,0,1,55,4.7e-05
G5,C1C(C(C(O)O1)O)C(CO)O,16,1,0,1,29,4.7e-05
G5,C(C1C(C(C)(C(CO)(O1)O)O)O)=O,16,1,0,1,26,4.7e-05
G5,C1(C(CC(CO)O)OC(C1O)O)=O,16,1,0,1,29,4.7e-05
G5,C(C(C1(C(CC(CO)O1)O)O)O)=O,16,1,0,1,29,4.7e-05
G5,C(C1(C(C(CO1)C(CO)O)O)O)=O,16,1,0,1,19,4.7e-05
G5,C(C1(C(C(CO)C(CO)O1)O)O)=O,16,1,0,1,19,4.7e-05
G5,C1(C(C(CO)CO)OC(C1O)O)=O,8,1,0,1,30,4.7e-05
G5,C(C(C1(C(C(CO1)CO)O)O)O)=O,16,1,0,1,30,4.7e-05
G5,C(C1C(C(C(C)(O1)O)O)=O)=O,8,1,0,1,1,4.7e-05
G5,C(OCC1CC(C(O)O1)O)=O,8,1,0,1,19,4.7e-05
G5,C1(C(CO)(O)OC(CO)C1O)=O,8,1,0,1,5,4.7e-05
G5,C1C2(CO)C(C(C(C2O)O)(O)O1)O,32,2,0,2,30,9.499999999999999e-05
G5,C1(C(C)OC(C1(C(C)=O)O)O)=O,8,1,0,1,0,4.7e-05
G5,C(C1(C(C(C)OC1(C)O)=O)O)=O,8,1,0,1,0,4.7e-05
G5,C1(C(C)OC(C)(C1(CO)O)O)=O,8,1,0,1,2,4.7e-05
G5,C(C1(C(C(C)OC1O)=O)O)=O,8,1,0,1,1,4.7e-05
G5,C(C)(C1(C(COC1O)=O)O)=O,4,1,0,1,0,4.7e-05
G5,C(C1(C(COC1(C)O)=O)O)=O,4,1,0,1,0,4.7e-05
G5,C1(COC(CO)(C1(CO)O)O)=O,4,1,0,1,5,4.7e-05
G5,C(C1(C(CO)(O)OCC1O)O)(O)=O,8,1,0,1,17,4.7e-05
G5,C(C(C=O)(C1(C(CCO1)O)O)O)=O,4,1,0,1,3,4.7e-05
G5,C(C1(C(C(CCO)OC1O)=O)O)=O,8,1,0,1,3,4.7e-05
G5,C(C1(C(CO)(O)OCC1(C)O)O)=O,8,1,0,1,49,4.7e-05
G5,C(C1(C(COC1(C(C)O)O)O)O)=O,16,1,0,1,0,4.7e-05
G5,C(C)(C1(C(CO)(O)OCC1O)O)=O,8,1,0,1,0,4.7e-05
G5,C(C1(C(CO)(O)OCC1O)O)=O,8,1,0,1,0,4.7e-05
G5,C1(C(C(OC1C)O)(CC=O)O)=O,8,1,0,1,29,4.7e-05
G5,C1(C(C(C)(C(CO)(O)O1)O)O)=O,8,1,0,1,0,4.7e-05
G5,C(CC1(C(COC1O)=O)O)(CO)=O,4,1,0,1,51,4.7e-05
G5,C1(COC(C1(CC=O)O)O)=O,4,1,0,1,0,4.7e-05
G5,C(C1CC(CO)(C(O1)O)O)=O,8,1,0,1,2,4.7e-05
G5,C(C1CC(C(O1)O)(C(C)O)O)=O,16,1,0,1,4,4.7e-05
G5,C1(C(CO)(O)OCC1(CCO)O)=O,4,1,0,1,2,4.7e-05
G5,C1(COC(C(CO)(C)O)(C1O)O)=O,8,1,0,1,2,4.7e-05
G5,C(C1CC(C(O1)O)(C(CO)O)O)=O,16,1,0,1,0,4.7e-05
G5,C1(C2C(C)(OC1CO2)O)=O,8,1,0,1,4,4.7e-05
G5,C1(C2CC(C(C)(O2)O)O1)=O,8,2,0,2,45,9.499999999999999e-05
G5,C1(C2CCC(CO1)(O2)O)=O,4,2,0,2,12,9.499999999999999e-05
G5,C1(C2C(C)OC1C(O2)O)=O,16,1,0,1,17,4.7e-05
G5,C1(C2(C(CC(CO1)O2)O)O)=O,8,2,0,2,29,9.499999999999999e-05
G5,C1(C2CC(C(CO1)(O2)O)O)=O,8,2,0,2,29,9.499999999999999e-05
G5,C1C(C2C(C(C(O)O2)O)(O)O1)O,32,2,0,2,5,9.499999999999999e-05
G5,C1C(C2(C(CCO2)(O)O1)O)O,8,2,0,2,2,9.499999999999999e-05
G5,C1C2C(C(C(C(O)O2)O)(O)O1)O,32,2,0,2,5,9.499999999999999e-05
G5,C(CC1C(OC(C(CO)=O)C1)O)=O,8,1,0,1,25,4.7e-05
G5,C(CCCC1(C(C(CO1)=O)O)O)=O,4,2,0,2,32,9.499999999999999e-05
G5,C(CCCC1C(C(C(O1)O)O)=O)=O,8,2,0,2,27,9.499999999999999e-05
G5,C1C2C(C(CC2O)(O)O1)O,16,2,0,2,4,9.499999999999999e-05
G5,C1C2CC(C(C2O)O)(O)O1,16,2,0,2,55,9.499999999999999e-05
G5,CC1(C(CCO1)O)O,4,1,0,1,45,4.7e-05
G5,CC1(C(O)OCC1)O,4,1,0,1,29,4.7e-05
G5,C(CC1(C(CCO1)O)O)(CCO)=O,4,1,0,1,29,4.7e-05
G5,C(CO)(CCC1(C(CCO1)O)O)=O,4,2,0,2,7,9.499999999999999e-05
G5,C(CO)(CCC1(C(O)OCC1)O)=O,4,2,0,2,29,9.499999999999999e-05
G5,C(C)(C(CC1(C(CCO1)O)O)O)=O,8,1,0,1,45,4.7e-05
G5,C(C)(C(CC1(C(O)OCC1)O)O)=O,8,1,0,1,29,4.7e-05
G5,C(CC1(C(C(CO1)C(C)O)O)O)=O,16,1,0,1,29,4.7e-05
G5,C(C(C1(CC(CO1)C(C)O)O)O)=O,16,1,0,1,46,4.7e-05
G5,C(C(CC1(CCOC1(C)O)O)O)=O,8,1,0,1,29,4.7e-05
G5,C(C(CC1(C(C)(CCO1)O)O)O)=O,8,1,0,1,29,4.7e-05
G5,C(C(CO)O)=CC1(C(CCO1)O)O,16,1,0,1,29,4.7e-05
G5,C(C1(C(O)OCC1)O)=CC(CO)O,16,1,0,1,29,4.7e-05
G5,CC1(C(O)OCC1O)O,8,1,0,1,0,4.7e-05
G5,C1C(C(C(C)O)(C(C)(O)O1)O)O,16,1,0,1,4,4.7e-05
G5,C=CC1(C(C(C)O)(C(CO1)O)O)O,16,1,0,1,7,4.7e-05
G5,C1C2(CC(CC2O)(O)O1)O,8,2,0,2,17,9.499999999999999e-05
G5,C(CC1(COC(C1(C)O)O)O)=O,8,1,0,1,29,4.7e-05
G5,C1CC(C(O)O1)(CO)O,4,1,0,1,29,4.7e-05
G5,C(CC1(C(CO)(CCO1)O)O)=O,4,1,0,1,2,4.7e-05
G5,CC(C1(C(O)OCC1)O)O,8,1,0,1,4,4.7e-05
G5,C(CC1(C(CCO1)(C(C)O)O)O)=O,8,1,0,1,4,4.7e-05
G5,C1CC2C(CC(O)O2)(O)O1,8,2,0,2,4,9.499999999999999e-05
G5,C1C(C2(C(CCO2)O1)O)O,8,1,0,1,29,4.7e-05
G5,C1CC2(C(CCO2)(O)O1)O,3,1,0,1,2,4.7e-05
G5,CC1(C2(CC(CO2)O1)O)O,8,2,0,2,14,9.499999999999999e-05
G5,C1C2C(C(C(C)O2)(O)O1)O,16,1,0,1,29,4.7e-05
G5,C1C2(CC(CCO2)(O)O1)O,4,2,0,2,30,9.499999999999999e-05
G5,C1C2CC(CC(O)O2)(O)O1,8,2,0,2,44,9.499999999999999e-05
G5,C(C(CO)O)(CC1C(O)OCC1)=O,8,1,0,1,46,4.7e-05
G5,C(CC1CCOC1(C(CO)O)O)=O,8,1,0,1,46,4.7e-05
G5,C(CCCC1(C(C(CO1)O)O)O)=O,8,2,0,2,27,9.499999999999999e-05
G5,C1(C2CC(C(C2O)O)(O)O1)=O,16,2,0,2,29,9.499999999999999e-05
G5,C1(C(C(C(C)(O)O1)O)C(C=O)O)=O,16,1,0,1,45,4.7e-05
G5,C1(C(C(C)(C(O)O1)O)C(C=O)O)=O,16,1,0,1,29,4.7e-05
G5,C1(CC(C(C)(O)O1)O)=O,4,1,0,1,27,4.7e-05
G5,C1(CC(C)(C(O)O1)O)=O,4,1,0,1,29,4.7e-05
G5,C1(C(CO)CC(C(C=O)O)(O)O1)=O,8,1,0,1,29,4.7e-05
G5,C1(CC(C(O)O1)(CCO)O)=O,4,1,0,1,29,4.7e-05
G5,C1(C(CC(C(CO)O)(O)O1)=O)=O,4,1,0,1,29,4.7e-05
G5,C1(C(C(C(CCO)(O)O1)O)=O)=O,4,1,0,1,29,4.7e-05
G5,C1(C(C(CO)(C(C)(O)O1)O)O)=O,8,1,0,1,33,4.7e-05
G5,C1(C(C)(C(CO)(C(O)O1)O)O)=O,8,1,0,1,28,4.7e-05
G5,C1(C(C(CO)(C(O)O1)O)O)=O,8,1,0,1,33,4.7e-05
G5,C1(C(C(C)=O)(C(C(C)(O)O1)O)O)=O,8,1,0,1,0,4.7e-05
G5,C1(C(C)(C(C(C)=O)(C(O)O1)O)O)=O,8,1,0,1,1,4.7e-05
G5,C1(C(C)(C(C=O)(C(C)(O)O1)O)O)=O,8,1,0,1,1,4.7e-05
G5,C1(C(C(C)=O)(C(C)(C(O)O1)O)O)=O,8,1,0,1,45,4.7e-05
G5,C1(C(C)(C(CO)(C(C)(O)O1)O)O)=O,8,1,0,1,28,4.7e-05
G5,C1(C(C=O)(C(C(C)(O)O1)O)O)=O,8,1,0,1,17,4.7e-05
G5,C1(C(C)(C(C=O)(C(O)O1)O)O)=O,8,1,0,1,1,4.7e-05
G5,C1(C(C=O)(C(C)(C(O)O1)O)O)=O,8,1,0,1,45,4.7e-05
G5,C(C)(C1(C(O)OC(C1O)=O)O)=O,8,1,0,1,33,4.7e-05
G5,C(C1(C(C)(O)OC(C1O)=O)O)=O,8,1,0,1,33,4.7e-05
G5,C(C1(C(O)OC(C1O)=O)O)=O,8,1,0,1,1,4.7e-05
G5,C1(C(C=O)(C(C(O)O1)O)O)=O,8,1,0,1,17,4.7e-05
G5,C1(C(C(C(O)O1)(C(C=O)O)O)O)=O,16,1,0,1,33,4.7e-05
G5,C1(C(C(CO)(C(CO)(O)O1)O)O)=O,8,1,0,1,33,4.7e-05
G5,C1(C(C(CO)(C(C=C)(O)O1)O)O)=O,8,1,0,1,33,4.7e-05
G5,C1(C(C(C(C)O)(C(C)(O)O1)O)O)=O,16,1,0,1,33,4.7e-05
G5,C1(C(C(C(O)O1)(C(C)O)O)O)=O,16,1,0,1,33,4.7e-05
G5,C1(C(C(C(O)O1)(C(CO)O)O)O)=O,16,1,0,1,33,4.7e-05
G5,C1(C(C(C(C)(O)O1)O)(CC=O)O)=O,8,1,0,1,49,4.7e-05
G5,C1(CC(C(O)O1)(C(C(C)=O)O)O)=O,8,1,0,1,17,4.7e-05
G5,C1(C(C)(C(C(O)O1)(CC=O)O)O)=O,8,1,0,1,43,4.7e-05
G5,C1(C(C(C)(C(O)O1)O)(CC=O)O)=O,8,1,0,1,11,4.7e-05
G5,C(C(C)(C1(C(O)OC(C1)=O)O)O)=O,8,1,0,1,29,4.7e-05
G5,C(CC1(C(O)OC(C1O)=O)O)=O,8,1,0,1,33,4.7e-05
G5,C1(CC(C(O)O1)(C(C=O)O)O)=O,8,1,0,1,0,4.7e-05
G5,C1(CC(CO)(C(O)O1)O)=O,4,1,0,1,29,4.7e-05
G5,C1(CC(CO)(C(CC=O)(O)O1)O)=O,4,1,0,1,29,4.7e-05
G5,C1(CC(C(O)O1)(C(C)(CO)O)O)=O,8,1,0,1,29,4.7e-05
G5,C1(CC(C(O)O1)(C(C)O)O)=O,8,1,0,1,29,4.7e-05
G5,C1(CC(C(O)O1)(C(CO)O)O)=O,8,1,0,1,29,4.7e-05
G5,C1(CC2C(CC(O)O2)(O)O1)=O,8,2,0,2,29,9.499999999999999e-05
G5,C1(CC2C(C(CO2)O)(O)O1)=O,8,1,0,1,29,4.7e-05
G5,C1(CC2(C(CCO2)(O)O1)O)=O,4,2,0,2,2,9.499999999999999e-05
G5,C1(C2CC(C(C)(O2)O)(O)O1)=O,8,2,0,2,14,9.499999999999999e-05
G5,C1(C2C(C(C(C)O2)(O)O1)O)=O,16,1,0,1,29,4.7e-05
G5,C1(C2(CC(CCO2)(O)O1)O)=O,4,2,0,2,2,9.499999999999999e-05
G5,C1(C2CC(CC(O2)O)(O)O1)=O,8,2,0,2,2,9.499999999999999e-05
G5,C(C1(C2(C(CC(C2O)O1)O)O)O)O,32,2,0,2,51,9.499999999999999e-05
G5,C(C1(CC2C(C1(C(O)O2)O)O)O)=O,32,2,0,2,0,9.499999999999999e-05
G5,C1C2C(C(C(CO)(C2O)O)(O)O1)O,32,2,0,2,2,9.499999999999999e-05
G5,C(C1(C2(C(CC(C1O)O2)O)O)O)O,32,1,0,1,32,4.7e-05
G5,C1C2(CC(C(C2(CO)O)(O)O1)O)O,16,2,0,2,32,9.499999999999999e-05
G5,C1C2(C(CC(C2(CO)O)(O)O1)O)O,16,2,0,2,2,9.499999999999999e-05
G5,C1(CCC2(C(O)OCC12O)O)=O,8,2,0,2,12,9.499999999999999e-05
G5,CC1(C2(C(CC(C2O)O1)O)O)O,32,2,0,2,49,9.499999999999999e-05
G5,CC12CC(C(C(O)O1)(C2O)O)O,32,2,0,2,16,9.499999999999999e-05
G5,C(C1(CC2C(C1(C(O)O2)O)O)O)O,32,2,0,2,20,9.499999999999999e-05
G5,C1C2(CC(C(C2(C(O)O1)O)O)O)O,32,1,0,1,20,4.7e-05
G5,CC1(C2(C(C(C(C2O)O1)O)O)O)O,64,2,0,2,49,9.499999999999999e-05
G5,CC1(C(C2C(C1(C(O)O2)O)O)O)O,64,2,0,2,49,9.499999999999999e-05
G5,CC1(C2C(C(C1(C(O)O2)O)O)O)O,64,2,0,2,49,9.499999999999999e-05
G5,C1(CCC2(C(O)OC(C)C12O)O)=O,16,2,0,2,12,9.499999999999999e-05
G5,C1(C2C(C(C(O2)O)(C(C)O)C1)O)=O,32,2,0,2,46,9.499999999999999e-05
G5,C=CC1(C2(C(C(CC2O)O1)O)O)O,32,2,0,2,7,9.499999999999999e-05
G5,C=CC12C(C(C(O1)O)(C(C2)O)O)O,32,2,0,2,7,9.499999999999999e-05
G5,C1C2C(C(C(C)O)(C(C=1)(O2)O)O)O,32,1,0,1,32,4.7e-05
G5,CC12C(C(C(C(O)O1)(C2O)O)O)O,64,2,0,2,16,9.499999999999999e-05
G5,CC1(C2C(C(C(O)O2)(C1O)O)O)O,64,2,0,2,16,9.499999999999999e-05
G5,C1(C2(C(C(C(C2O)O1)O)O)O)O,64,2,0,2,15,9.499999999999999e-05
G5,C1(C2(C(C(C(CO)C2O)O1)O)O)O,64,2,0,2,43,9.499999999999999e-05
G5,C1C2(COC(C2(CO1)O)O)O,8,1,0,1,36,4.7e-05
G5,C12C(C)(C(CO1)(C(O)O2)O)O,16,1,0,1,41,4.7e-05
G5,C1C2(C(C)(O)OC(C2O)O1)O,16,1,0,1,2,4.7e-05
G5,C1(C2(C(CC(CO)(C2O)O1)O)O)O,32,2,0,2,43,9.499999999999999e-05
G5,C(C1(C(C2(C(O)OC1C2)O)O)O)=O,32,2,0,2,1,9.499999999999999e-05
G5,C1(CC2C(O)OC(C2)C1(CO)O)=O,16,2,0,2,43,9.499999999999999e-05
G5,C1(CC2C(C1(CO)O)OC(C2)O)=O,16,1,0,1,43,4.7e-05
G5,C(C1(C(C2(CCCC1O2)O)O)O)=O,16,2,0,2,7,9.499999999999999e-05
G5,C1(CCCC2C1(C(C(O)O2)O)O)=O,16,2,0,2,12,9.499999999999999e-05
G5,C1(C2(C(CC(C2O)(O)O1)=O)CO)=O,8,2,0,2,30,9.499999999999999e-05
G5,C1(C2(C(CCC(C2O)(O)O1)=O)O)=O,8,2,0,2,12,9.499999999999999e-05
G5,C1(C2(C(CCC2(C(O)O1)O)=O)O)=O,8,1,0,1,12,4.7e-05
G5,C1(C2(C=O)C(C(CC2O)(O)O1)O)=O,16,2,0,2,17,9.499999999999999e-05
G5,C1(C2(C(C(CC2O)(O)O1)=O)CO)=O,8,2,0,2,17,9.499999999999999e-05
G5,C(C12C(C(C(C1)=O)OC2O)O)(O)=O,16,2,0,2,17,9.499999999999999e-05
G5,C1(C2(C=O)CC(C(C2O)O)(O)O1)=O,16,2,0,2,17,9.499999999999999e-05
G5,C(C1(C(C2C=CC1(O2)O)O)O)(O)=O,16,1,0,1,32,4.7e-05
G5,C1(C(C(CO)=O)(C(C(O)O1)O)O)=O,8,1,0,1,17,4.7e-05
G5,C1(C(C=O)(C(C(CO)(O)O1)O)O)=O,8,1,0,1,5,4.7e-05
G5,C1(C(C(C(O)O1)=O)(CO)CO)=O,2,1,0,1,17,4.7e-05
G5,C1(C(C=O)(CO)C(C(O)O1)O)=O,8,1,0,1,17,4.7e-05
G5,C(C1C(CCO)OC(C1O)O)(O)=O,16,1,0,1,29,4.7e-05
G5,C1(C(C(C(O)O1)=O)(CO)C(C)O)=O,8,1,0,1,4,4.7e-05
G5,CC1(C(C(C(C)O1)O)(C(C)O)O)O,32,1,0,1,11,4.7e-05
G5,C1(C(C=O)(C(C(O)O1)O)C(C)O)=O,16,1,0,1,4,4.7e-05
G5,C(C1(C(C)OC(C1(CO)O)O)O)=O,16,1,0,1,25,4.7e-05
G5,C(C1(COC(C1(C(C)O)O)O)O)=O,16,1,0,1,25,4.7e-05
G5,C1(C(C)(C(C(O)O1)(C(C)O)O)O)=O,16,1,0,1,28,4.7e-05
G5,C(C1(C(C)OC(C)(C1(C)O)O)O)=O,16,1,0,1,14,4.7e-05
G5,C(C1(C(C)O)C(CC(C)(O1)O)O)=O,16,1,0,1,6,4.7e-05
G5,C(C1(C(C)OC(C1(C=C)O)O)O)=O,16,1,0,1,7,4.7e-05
G5,C=CC1(COC(C1(C(C)O)O)O)O,16,1,0,1,7,4.7e-05
G5,CC(C1(C(O)OC(C)C1O)O)O,32,1,0,1,11,4.7e-05
G5,C1(C(C(C(O)O1)=O)(CO)O)=O,4,1,0,1,17,4.7e-05
G5,C1(C(OC(C(O)=O)C1(CO)O)O)=O,8,1,0,1,33,4.7e-05
G5,C1(C(C(CO)(C(C=O)(O)O1)O)O)=O,8,1,0,1,33,4.7e-05
G5,C1(C(O)OC(C(C)O)C1(CO)O)=O,16,1,0,1,11,4.7e-05
G5,C(C1(C(CO)(C(C(C)O1)O)O)O)=O,16,1,0,1,11,4.7e-05
G5,C(C1(C(O)OCC1(C=O)O)O)(O)=O,8,1,0,1,17,4.7e-05
G5,C1(C(C=O)(C(CO)(C(O)O1)O)O)=O,8,1,0,1,17,4.7e-05
G5,C1(C2C(CO1)OC(C2(CO)O)O)=O,16,1,0,1,8,4.7e-05
G5,C1(C2C(CO1)OC(CO)(C2O)O)=O,16,1,0,1,8,4.7e-05
G5,C1(C(CO)(C(CO)(C(O)O1)O)O)=O,8,1,0,1,33,4.7e-05
G5,C(C1(COC(C1(CO)O)O)O)(O)=O,8,1,0,1,33,4.7e-05
G5,C1(C(CO)(C(C(CO)(O)O1)O)O)=O,8,1,0,1,5,4.7e-05
G5,C(C1(COC(CO)(C1O)O)O)(O)=O,8,1,0,1,5,4.7e-05
G5,C(C1(COC2(COCC21O)O)O)=O,8,1,0,1,10,4.7e-05
G5,C(C1(C(CO)=O)C(CC(O1)O)O)=O,8,1,0,1,5,4.7e-05
G5,C(C1C(CC=O)OC(C1O)O)(O)=O,16,1,0,1,43,4.7e-05
G5,C1(C2(C(CO1)O)C(CC(O2)O)O)=O,16,1,0,1,40,4.7e-05
G5,C(C1(CO)C(CC(O1)O)O)(O)=O,8,1,0,1,17,4.7e-05
G5,C(C1(C(C)O)C(CC(O1)O)O)(O)=O,16,1,0,1,4,4.7e-05
G5,C1(COCC21C(CC(O2)O)O)=O,8,1,0,1,10,4.7e-05
G5,C(C1(C(CO)(O)OC(C1O)=O)O)=O,8,1,0,1,33,4.7e-05
G5,C(CO)(C1(C(O)OC(C1O)=O)O)=O,8,1,0,1,33,4.7e-05
G5,C(C1(C(CO)(O)OC(C)C1O)O)=O,16,1,0,1,11,4.7e-05
G5,C(CO)(C1(C(O)OC(C)C1O)O)=O,16,1,0,1,11,4.7e-05
G5,C1(C(C)(C(C(O)=O)(C(O)O1)O)O)=O,8,1,0,1,17,4.7e-05
G5,C1(C(C)(C2(COCC2(O)O1)O)O)=O,8,1,0,1,10,4.7e-05
G5,C(C1(C(C)(O)OC(C1O)=O)O)(O)=O,8,1,0,1,33,4.7e-05
G5,C(C1(C(O)OC(C1O)=O)O)(O)=O,8,1,0,1,33,4.7e-05
G5,C(C1(C(COC1(C=C)O)O)O)(O)=O,8,1,0,1,17,4.7e-05
G5,C1(C(C=O)(C(C=O)(C(O)O1)O)O)=O,8,1,0,1,17,4.7e-05
G5,C1(C2(C(C(C(C2)(O)O1)O)=O)CO)=O,8,2,0,2,17,9.499999999999999e-05
G5,C1(C2(C(COC2C(C)(O)O1)=O)O)=O,8,1,0,1,17,4.7e-05
G5,C1(C2(C(C)=O)C(C(CO2)(O)O1)O)=O,8,1,0,1,17,4.7e-05
G5,C1(C2C(OC(C2O)(CCO1)O)=O)=O,8,1,0,1,19,4.7e-05
G5,C1(C2(C=O)C(C(C(C)O2)(O)O1)O)=O,16,1,0,1,17,4.7e-05
G5,C1(C2(C(C(C)OC2C(O)O1)=O)O)=O,16,1,0,1,29,4.7e-05
G5,C(C1(C(OC(C=C)C1O)O)O)(O)=O,16,1,0,1,28,4.7e-05
G5,C(C12C(COC1(C=CO2)O)O)(O)=O,8,1,0,1,17,4.7e-05
G5,C(C1(C2COC1(C=CO2)O)O)(O)=O,8,1,0,1,9,4.7e-05
G5,C(C12C(C(C(O1)=C)OC2O)O)(O)=O,16,1,0,1,26,4.7e-05
G5,C(C1(C(OC2C=COC21)O)O)(O)=O,16,1,0,1,36,4.7e-05
G5,C(C12C(C(C=CO1)OC2O)O)(O)=O,16,1,0,1,37,4.7e-05
G5,C(C1(C(C)(O)OC(C)C1O)O)(O)=O,16,1,0,1,11,4.7e-05
G5,C(C1C(C(OC1C(O)=O)O)O)(O)=O,16,1,0,1,33,4.7e-05
G5,C1(C(C2(COCC2(O)O1)O)O)=O,8,1,0,1,10,4.7e-05
G5,C1(C(C=O)(C(C)(C(C)(O)O1)O)O)=O,8,1,0,1,17,4.7e-05
G5,C(C1(C=O)C(CC(C)(O1)O)O)(O)=O,8,1,0,1,17,4.7e-05
G5,C1(C(C=O)(C(C(C=C)(O)O1)O)O)=O,8,1,0,1,17,4.7e-05
G5,C1(C(C=O)(C(C=C)(C(O)O1)O)O)=O,8,1,0,1,17,4.7e-05
G5,C(C1(C(O)OCC1(C=C)O)O)(O)=O,8,1,0,1,17,4.7e-05
G5,C(C1(C(O)OC(C)C1O)O)(O)=O,16,1,0,1,11,4.7e-05
G5,C(C1C(C(C)O)OC(C1O)O)(O)=O,32,1,0,1,11,4.7e-05
G5,C1(C2C(CO1)OC(C)(C2(C)O)O)=O,16,1,0,1,8,4.7e-05
G5,C1(C(CO)(C(C)(C(C)(O)O1)O)O)=O,8,1,0,1,14,4.7e-05
G5,C(C1(COC(C)(C1(C)O)O)O)(O)=O,8,1,0,1,14,4.7e-05
G5,C(C1(CO)C(C)(CC(O1)O)O)(O)=O,8,1,0,1,33,4.7e-05
G5,C(C1(CO)C(CC(C)(O1)O)O)(O)=O,8,1,0,1,6,4.7e-05
G5,C1(COCC21C(C)(CC(O2)O)O)=O,8,1,0,1,10,4.7e-05
G5,C1(COCC21C(CC(C)(O2)O)O)=O,8,1,0,1,10,4.7e-05
G5,C1(C2C(C(C=C)(O)OC2CO1)O)=O,16,1,0,1,8,4.7e-05
G5,C1(C2C(CO1)OC(C2(C=C)O)O)=O,16,1,0,1,8,4.7e-05
G5,C1(C(CO)(C(C=C)(C(O)O1)O)O)=O,8,1,0,1,7,4.7e-05
G5,C(C1(COC(C1(C=C)O)O)O)(O)=O,8,1,0,1,7,4.7e-05
G5,C=CC1(COC2(COCC21O)O)O,8,1,0,1,10,4.7e-05
G5,C1C2(C(CO1)(C(C(C)O2)O)O)O,16,1,0,1,10,4.7e-05
G5,C1C(C(C(C)O)(C(CO)(O)O1)O)O,16,1,0,1,2,4.7e-05
G5,C(C1(C(CO)(CO)C(CO1)O)O)=O,4,1,0,1,0,4.7e-05
G5,C1C(C(CO)(CO)C(CO)(O)O1)O,4,1,0,1,2,4.7e-05
G5,C(C(C1(C(O)OCC1O)CO)O)=O,16,1,0,1,0,4.7e-05
G5,C1C2(C(CO1)(O)OCC2O)O,8,1,0,1,0,4.7e-05
G5,CC1C(C(C(O)O1)(C(CO)O)O)O,32,1,0,1,11,4.7e-05
G5,C1C(CO)(C(C(O)O1)(C(C)O)O)O,16,1,0,1,5,4.7e-05
G5,C1C2(C(CO1)(O)OCC2(CO)O)O,8,1,0,1,10,4.7e-05
G5,CC(C1(C(O)OC(CO)C1O)O)O,32,1,0,1,41,4.7e-05
G5,CC(C1C(C(C(O)O1)(CO)O)O)O,32,1,0,1,28,4.7e-05
G5,C(C1(COC(C)(C1(CO)O)O)O)=O,8,1,0,1,2,4.7e-05
G5,C(C)(C1(COC(C1(CO)O)O)O)=O,8,1,0,1,2,4.7e-05
G5,C1C(C(C)O)(C(C(O)O1)(CO)O)O,16,1,0,1,25,4.7e-05
G5,CC1C(CO)(C(C(O)O1)(CO)O)O,16,1,0,1,25,4.7e-05
G5,C(C1(COC(C1(CC=O)O)O)O)=O,8,1,0,1,23,4.7e-05
G5,C(C1(COC(C)(C1(C)O)O)O)=O,8,1,0,1,14,4.7e-05
G5,C(C1(CO)C(CC(C)(O1)O)O)=O,8,1,0,1,41,4.7e-05
G5,CC1C(C(C(O)O1)(CO)O)O,16,1,0,1,11,4.7e-05
G5,C1C2(C(CO1)(C(C(CO)O2)O)O)O,16,1,0,1,10,4.7e-05
G5,C1C2(C(CO1)OC(C2(CO)O)O)O,16,1,0,1,10,4.7e-05
G5,C12C(CCO1)(C(C(O)O2)(CO)O)O,16,1,0,1,34,4.7e-05
G5,C(C)(C1(C(C)OC(C)(C1O)O)O)=O,16,1,0,1,45,4.7e-05
G5,C(C)(C1(C(C)OC(C1(C)O)O)O)=O,16,1,0,1,45,4.7e-05
G5,C(C1(C(C)OC(C1(C)O)O)O)=O,16,1,0,1,45,4.7e-05
G5,C(C(C1(COC(C)(C1O)O)O)=O)=O,8,1,0,1,1,4.7e-05
G5,C(C1(C)C(C(C(O1)O)=O)(CO)O)=O,8,1,0,1,45,4.7e-05
G5,C(C(C1(COC(C1(C)O)O)O)=O)=O,8,1,0,1,45,4.7e-05
G5,C1(C2(C(CO1)OC(C)(C2O)O)O)=O,16,1,0,1,45,4.7e-05
G5,C1(C2(C(CO1)OC(C2(C)O)O)O)=O,16,1,0,1,45,4.7e-05
G5,C1(C2C(CO1)OC(C)(C2O)O)=O,16,1,0,1,8,4.7e-05
G5,C1(C2C(CO1)OC(C2(C)O)O)=O,16,1,0,1,8,4.7e-05
G5,C(C1(C(C)OC(C1(C)O)O)O)(O)=O,16,1,0,1,4,4.7e-05
G5,C(C1(COC(C1(C(C)=O)O)O)O)=O,8,1,0,1,1,4.7e-05
G5,C(C1(C(C)(O)OCC1(C=O)O)O)=O,8,1,0,1,1,4.7e-05
G5,C(C1(C(C)=O)C(CC(O1)O)O)=O,8,1,0,1,1,4.7e-05
G5,C(C1(C(C)=O)C(C)(CC(O1)O)O)=O,8,1,0,1,1,4.7e-05
G5,C(C1(C(C)=O)C(CC(C)(O1)O)O)=O,8,1,0,1,6,4.7e-05
G5,C(C)(C1(C(O)OCC1(C=C)O)O)=O,8,1,0,1,1,4.7e-05
G5,C(C1(C(C)(O)OCC1(C=C)O)O)=O,8,1,0,1,1,4.7e-05
G5,C(C)(C1(C(O)OC(C)C1O)O)=O,16,1,0,1,11,4.7e-05
G5,C(C1(C(C)(O)OC(C)C1O)O)=O,16,1,0,1,11,4.7e-05
G5,C(CO)(C1(C(C)OC(C1O)O)O)=O,16,1,0,1,5,4.7e-05
G5,C(C1(C(CO)=O)COC(C1O)O)=O,8,1,0,1,2,4.7e-05
G5,C(CC(C1(COC(C1O)O)O)=O)=O,8,1,0,1,2,4.7e-05
G5,C1(C(OC(C=O)C1(CO)O)O)=O,8,1,0,1,0,4.7e-05
G5,C(C(C1(COC(C1O)O)O)=O)=O,8,1,0,1,0,4.7e-05
G5,C1(C2(C(CO1)OC(C2O)O)O)=O,16,2,0,2,0,9.499999999999999e-05
G5,C1(C2C(CO1)OC(C2O)O)=O,16,1,0,1,8,4.7e-05
G5,C(C)(C1(COC(C)(C1(C)O)O)O)=O,8,1,0,1,14,4.7e-05
G5,C(C)(C1(CO)C(C)(CC(O1)O)O)=O,8,1,0,1,6,4.7e-05
G5,C(C)(C1(CO)C(CC(C)(O1)O)O)=O,8,1,0,1,6,4.7e-05
G5,C(C)(C1(COC(C1(C=C)O)O)O)=O,8,1,0,1,7,4.7e-05
G5,C=CC1(COC(C)(C1(CO)O)O)O,8,1,0,1,7,4.7e-05
G5,CC1(C(CO)(C(C(C)O1)O)O)O,16,1,0,1,11,4.7e-05
G5,C(CCO)(C1(C(C(O)OC1)=O)O)=O,4,1,0,1,2,4.7e-05
G5,C1C(C2C(C(CO2)(CO)O)(O)O1)O,16,1,0,1,10,4.7e-05
G5,C1C(C2(CO)C(C(CO2)O)(O)O1)O,16,1,0,1,10,4.7e-05
G5,C1C(CO)(C2(C(C(CO2)O1)O)O)O,16,1,0,1,2,4.7e-05
G5,C1C(C2(C(CO)(C(CO2)O1)O)O)O,16,1,0,1,2,4.7e-05
G5,C1C(CO)(C2(C(CC(O1)O2)O)O)O,16,1,0,1,38,4.7e-05
G5,C(C1(C(O)OCC1(C(C)=O)O)O)=O,8,1,0,1,1,4.7e-05
G5,C(C1(C(O)OCC1(C=O)O)O)=O,8,1,0,1,1,4.7e-05
G5,C1(C(C)(O)OCC1(C(CO)O)O)=O,8,1,0,1,0,4.7e-05
G5,C(C)(C1(C(CO)(C(CO1)O)O)O)=O,8,1,0,1,0,4.7e-05
G5,C1(COC2C(C)(O)OCC12O)=O,8,1,0,1,17,4.7e-05
G5,C(C)(C12COC(C1O)(CO2)O)=O,8,1,0,1,17,4.7e-05
G5,C1(C2COC(C2O)(CCO1)O)=O,8,1,0,1,48,4.7e-05
G5,C1(C2(CO)C(C(C(CO)O2)O1)O)O,32,1,0,1,26,4.7e-05
G5,C1C2C(C(C(CO)(CO)O2)(O)O1)O,8,1,0,1,2,4.7e-05
G5,C1C2C(CO)(C(C(CO)O2)(O)O1)O,16,1,0,1,2,4.7e-05
G5,C1C2(CC(C(CO)(CO)O2)(O)O1)O,4,2,0,2,2,9.499999999999999e-05
G5,C(C12COC(C1O)(C(C)O2)O)=O,16,1,0,1,29,4.7e-05
G5,C1(C(C)OC2C(O)OCC12O)=O,16,1,0,1,29,4.7e-05
G5,C1C(C2C(C(C(O)O2)(CO)O1)O)O,32,1,0,1,37,4.7e-05
G5,C1C2(CC(C(CO2)(CO)O)(O)O1)O,8,2,0,2,2,9.499999999999999e-05
G5,C1C2(C(CO)(C(CCO2)(O)O1)O)O,8,2,0,2,2,9.499999999999999e-05
G5,C1(CC2(C(CO)(C(CO2)O)O1)O)=O,8,1,0,1,2,4.7e-05
G5,C1(C2C(C(CO)(C(C)(O2)O)O1)O)=O,16,1,0,1,2,4.7e-05
G5,C1(CC2(C(CO)(C(CO2)O1)O)O)=O,8,1,0,1,2,4.7e-05
G5,C1(C2(COC(C2O)(CCO1)O)O)=O,8,1,0,1,2,4.7e-05
G5,C1CC2C(C(C(O)O2)(CO)O)(O)O1,16,2,0,2,2,9.499999999999999e-05
G5,C1(CC2C(C(C(O)O2)(CO)O)O1)=O,16,1,0,1,8,4.7e-05
G5,C1(CC2C(C(C(O)O2)(CO)O1)O)=O,16,1,0,1,8,4.7e-05
G5,C(C1(C(O)OC(C1O)C(C)O)O)=O,32,1,0,1,1,4.7e-05
G5,C(C1(C(C)OC(C1(C=O)O)O)O)=O,16,1,0,1,1,4.7e-05
G5,C(C1(C(O)OCC1(C(C)O)O)O)=O,16,1,0,1,1,4.7e-05
G5,C(C1(C(O)OC(C)C1(CO)O)O)=O,16,1,0,1,1,4.7e-05
G5,C(C1(C=O)C(CC(O1)O)O)=O,4,1,0,1,1,4.7e-05
G5,C(C1(C=O)C(C=O)(CC(O1)O)O)=O,4,1,0,1,1,4.7e-05
G5,C(C(C=O)(C1CC(C(O)O1)=O)O)=O,4,1,0,1,1,4.7e-05
G5,C(C1(C=O)C(CC(C=O)(O1)O)O)=O,4,1,0,1,1,4.7e-05
G5,C(C1(C=O)C(C)(CC(O1)O)O)=O,4,1,0,1,1,4.7e-05
G5,C(C1(C=O)C(CC(C)(O1)O)O)=O,4,1,0,1,1,4.7e-05
G5,C(C1(C(O)OC(C)C1O)O)=O,16,1,0,1,11,4.7e-05
G5,C(C1C(C2(COCC2(O1)O)O)O)=O,16,1,0,1,10,4.7e-05
G5,C1(COCC21C(C(C(O2)O)O)O)=O,16,1,0,1,10,4.7e-05
G5,C(C1(C(O)OC2COCC21O)O)=O,16,1,0,1,10,4.7e-05
G5,C(C1(C(O)OC2C1(CCO2)O)O)=O,16,1,0,1,34,4.7e-05
G5,C1C(C)(C(C(C)O)(C(C)(O)O1)O)O,16,1,0,1,4,4.7e-05
G5,C1C(C)(C(C(O)O1)(C(C)O)O)O,16,1,0,1,49,4.7e-05
G5,C(C1(C(CO)(C(CO1)(C)O)O)O)=O,8,1,0,1,49,4.7e-05
G5,C1(C(O)OC(CO)(C)C1(CO)O)=O,8,1,0,1,49,4.7e-05
G5,C1C2(C(CO1)(O)OCC2(C)O)O,8,1,0,1,10,4.7e-05
G5,C(C1(C(C(O)OC1CCO)O)O)=O,16,1,0,1,0,4.7e-05
G5,C(C1(C(C(O)OC1C(C)O)O)O)=O,32,1,0,1,11,4.7e-05
G5,C(C(C1(C(O)OC(C)C1O)O)O)=O,32,1,0,1,11,4.7e-05
G5,C1(C(O)OC(C)C1(CO)O)=O,8,1,0,1,0,4.7e-05
G5,C1(C(C2(CC1(CO)C(C)O2)O)O)=O,16,2,0,2,47,9.499999999999999e-05
G5,C1(COC2C(C)(O)OC(C)C12O)=O,16,1,0,1,17,4.7e-05
G5,C(C)(C12C(C)OC(C1O)(CO2)O)=O,16,1,0,1,4,4.7e-05
G5,C1(C2C(C)OC(C2O)(CCO1)O)=O,16,1,0,1,19,4.7e-05
G5,C(C12C(C)OC(C1O)(C(C)O2)O)=O,32,1,0,1,29,4.7e-05
G5,C1(C(C)OC2C(O)OC(C)C12O)=O,32,1,0,1,29,4.7e-05
G5,C=CC1C(C(C(O1)O)(C(C)O)O)O,32,1,0,1,28,4.7e-05
G5,C1OC2(C(C)O)C(COC2(C=1)O)O,16,1,0,1,4,4.7e-05
G5,C1OC2COC(C=1)(C2(C(C)O)O)O,16,1,0,1,9,4.7e-05
G5,C=C1C2C(C(C(O2)O)(C(C)O)O1)O,32,1,0,1,26,4.7e-05
G5,C1OC2C(C(OC2C=1)O)(C(C)O)O,32,1,0,1,36,4.7e-05
G5,C1OC2(C(C(C=1)OC2O)O)C(C)O,32,1,0,1,37,4.7e-05
G5,CC1C(C(CO)(C(CO)(O)O1)O)O,16,1,0,1,11,4.7e-05
G5,C1(C(C(C=C)=O)(C(C(O)O1)O)O)=O,8,1,0,1,17,4.7e-05
G5,C(C1(C(C2CC1(C(O)O2)O)O)O)O,32,2,0,2,51,9.499999999999999e-05
G5,C(C1(C2C(CC1(C(O)O2)O)O)O)O,32,2,0,2,51,9.499999999999999e-05
G5,C1C2(C(C(CC2(C(O)O1)O)O)O)O,32,1,0,1,51,4.7e-05
G5,C1(C2C(C(C(C)(O2)O)(C1)O)O)=O,16,2,0,2,25,9.499999999999999e-05
G5,C1(C2(CC(CO)(CC2O)O1)O)O,16,2,0,2,21,9.499999999999999e-05
G5,C(C1(CC2CC1(C(O)O2)O)O)O,16,2,0,2,21,9.499999999999999e-05
G5,C1C2(CC(CC2(C(O)O1)O)O)O,16,1,0,1,21,4.7e-05
G5,CC1(C(C2CC1(C(O)O2)O)O)O,32,2,0,2,49,9.499999999999999e-05
G5,CC1(C2C(CC1(C(O)O2)O)O)O,32,2,0,2,49,9.499999999999999e-05
G5,C1(C2(CC(CC2O)O1)O)O,16,2,0,2,43,9.499999999999999e-05
G5,C1(CCC2(CO)C1(CC(O)O2)O)=O,8,1,0,1,7,4.7e-05
G5,C(CC1(C2(CCC1(CO2)O)O)O)=O,8,2,0,2,7,9.499999999999999e-05
G5,C1(CC(C2(C)C1(CC(O)O2)O)O)=O,16,1,0,1,45,4.7e-05
G5,C(C)(C1(CC2(C(CC1O2)O)O)O)=O,16,1,0,1,45,4.7e-05
G5,C(C12CC(C(C1)O)(C(C)(O2)O)O)=O,16,2,0,2,22,9.499999999999999e-05
G5,C(C)(C1(CC2(C(O)OC1C2)O)O)=O,16,2,0,2,22,9.499999999999999e-05
G5,C1(CC(CC2C1(CC(O)O2)O)O)=O,16,1,0,1,13,4.7e-05
G5,C(CC1(C2(CC(CC2O)O1)O)O)=O,16,2,0,2,13,9.499999999999999e-05
G5,C(C)(C12CC(C(O1)O)(C(C2)O)O)=O,16,2,0,2,21,9.499999999999999e-05
G5,C(C1(CC2(CC1OC2(C)O)O)O)=O,16,2,0,2,21,9.499999999999999e-05
G5,C(C1(C2CC(C)(C(C1)(O)O2)O)O)=O,16,1,0,1,21,4.7e-05
G5,C(C1(CC2(CC(CC1O2)O)O)O)=O,16,2,0,2,26,9.499999999999999e-05
G5,C1(C2(CC(CO)(C(C2O)O)O1)O)O,32,2,0,2,20,9.499999999999999e-05
G5,C(C1(C2C(C(C(O)O2)(C1)O)O)O)O,32,2,0,2,20,9.499999999999999e-05
G5,CC1(C2(C(C(CO2)O1)O)O)O,16,2,0,2,0,9.499999999999999e-05
G5,CC1(C2COC1(C(O)O2)O)O,16,1,0,1,2,4.7e-05
G5,C1C2(CCOC2(C(O)O1)O)O,8,1,0,1,30,4.7e-05
G5,C1C(C2(C(O)OC(C2)O1)O)O,16,1,0,1,37,4.7e-05
G5,C(C1(C2CC(C(O)O2)(C1O)O)O)O,32,2,0,2,43,9.499999999999999e-05
G5,C1(C2(CC(C(CO)(C2O)O1)O)O)O,32,2,0,2,43,9.499999999999999e-05
G5,CC1(C2(C(C(CO2)(C1O)O)O)O)O,32,2,0,2,5,9.499999999999999e-05
G5,C1(C2(C(CC(C2CO)(O)O1)=O)O)=O,8,2,0,2,17,9.499999999999999e-05
G5,C1(C2COC(C2(C(O)=O)O)(C1)O)=O,8,2,0,2,17,9.499999999999999e-05
G5,C1(C2(C(CC(C(C2)(O)O1)O)=O)O)=O,8,2,0,2,17,9.499999999999999e-05
G5,C1(C2(C(CC(C2C(O)O1)O)=O)O)=O,16,1,0,1,17,4.7e-05
G5,C1(C(C=O)(CC(C=O)(O)O1)O)=O,4,1,0,1,29,4.7e-05
G5,C1(C(C(C)=O)(CC(CO)(O)O1)O)=O,4,1,0,1,17,4.7e-05
G5,C(C)(C1(CC(O)OC1CCO)O)=O,8,1,0,1,45,4.7e-05
G5,C1(C(C(C)=O)(CC(O)O1)O)=O,4,1,0,1,29,4.7e-05
G5,C(C)(C1(CC(OC1C(O)=O)O)O)=O,8,1,0,1,45,4.7e-05
G5,C(CC1(C(C)(O)OC(C1O)=O)O)=O,8,1,0,1,45,4.7e-05
G5,C(CC1C(C)(C(C)(C(O)O1)O)O)=O,16,1,0,1,11,4.7e-05
G5,C(C(C)(C1(C)C(CC(O)O1)O)O)=O,16,1,0,1,11,4.7e-05
G5,C(C(C)(C1CC(C(C)(O)O1)O)O)=O,16,1,0,1,11,4.7e-05
G5,C(C)(C1(CC(O)OC1C(C)O)O)=O,16,1,0,1,45,4.7e-05
G5,C(CC1(C(C(C)OC1(C)O)O)O)=O,16,1,0,1,45,4.7e-05
G5,C(C(C)(C1CC(C(O)O1)(C)O)O)=O,16,1,0,1,11,4.7e-05
G5,C1(C(C=O)(C(CO)C(O)O1)O)=O,8,1,0,1,17,4.7e-05
G5,C(C1COC(C1(C(O)=O)O)O)=O,8,1,0,1,17,4.7e-05
G5,C1(C(O)OC(CCO)C1(C)O)=O,8,1,0,1,18,4.7e-05
G5,C1CC(C(O)O1)(C(CCO)O)O,8,1,0,1,29,4.7e-05
G5,C1(CC(C(O)O1)(C(CCO)O)O)=O,8,1,0,1,29,4.7e-05
G5,C(C1(CC(O)OC1CCO)O)(O)=O,8,1,0,1,29,4.7e-05
G5,C1(C(C(CCO)=O)(CC(O)O1)O)=O,4,1,0,1,4,4.7e-05
G5,C1C(CC(C)O)(C(C)(C(O)O1)O)O,16,1,0,1,11,4.7e-05
G5,CC1(C(C(C)O)OC(C1(C)O)O)O,32,1,0,1,11,4.7e-05
G5,C1(C(C=O)(C(C(O)O1)C(C)O)O)=O,16,1,0,1,17,4.7e-05
G5,C(C1C(C)OC(C1(C(O)=O)O)O)=O,16,1,0,1,17,4.7e-05
G5,C(C1(C(O)OC(C1)CC=O)O)(O)=O,8,1,0,1,17,4.7e-05
G5,C1(C(O)OC(CC(C)O)C1(C)O)=O,16,1,0,1,25,4.7e-05
G5,CC(CC(C1(C(O)OCC1)O)O)O,16,1,0,1,29,4.7e-05
G5,CC(C1C(C(C)(C(O)O1)O)O)O,32,1,0,1,11,4.7e-05
G5,C1(C(C)(C(C)(C(CO)(O)O1)O)O)=O,8,1,0,1,25,4.7e-05
G5,C(C1(C)C(CC(C=O)(O1)O)O)(O)=O,8,1,0,1,25,4.7e-05
G5,C(C(C)(C1CC(C(O)O1)=O)O)(O)=O,8,1,0,1,25,4.7e-05
G5,C1(C(C)(C(C)(C(C)(O)O1)O)O)=O,8,1,0,1,25,4.7e-05
G5,C(C1(C)C(C)(CC(O1)O)O)(O)=O,8,1,0,1,25,4.7e-05
G5,C(C1(C)C(CC(C)(O1)O)O)(O)=O,8,1,0,1,25,4.7e-05
G5,C1(C(C)(C(C=C)(C(O)O1)O)O)=O,8,1,0,1,28,4.7e-05
G5,C(C1(CCO)C(CC(O1)O)O)(O)=O,8,1,0,1,45,4.7e-05
G5,C(C1(COC(C=O)(C1(C)O)O)O)=O,8,1,0,1,25,4.7e-05
G5,C(C1(CO)C(C(C(O1)O)=O)(C)O)=O,8,1,0,1,25,4.7e-05
G5,C(C1C(C(C(O1)O)=O)(C)O)(CO)=O,8,1,0,1,5,4.7e-05
G5,C(C1(COC2(C1(O)OCC2)O)O)=O,8,1,0,1,34,4.7e-05
G5,C1(C(C(CO)=O)(CC(O)O1)O)=O,4,1,0,1,17,4.7e-05
G5,C(CC1C(C(C(O)O1)=O)(C)O)=O,8,1,0,1,25,4.7e-05
G5,C(C(C1(C)C(CC(O1)O)O)=O)=O,8,1,0,1,25,4.7e-05
G5,C(C1(C)C(C(C(O1)O)=O)(C)O)(O)=O,8,1,0,1,25,4.7e-05
G5,C1(C(C)(C(C)(C(C=O)(O)O1)O)O)=O,8,1,0,1,25,4.7e-05
G5,C1(C(C(C(O)O1)=O)(C)O)=O,4,1,0,1,28,4.7e-05
G5,C1(C(OC(C(O)=O)C1(C)O)O)=O,8,1,0,1,33,4.7e-05
G5,C1(C(C(C)(C(C=O)(O)O1)O)O)=O,8,1,0,1,33,4.7e-05
G5,C(C)(C1(C)C(C(C(O1)O)=O)(C)O)=O,8,1,0,1,25,4.7e-05
G5,C(CC1(C)C(C(C(O)O1)=O)(C)O)=O,8,1,0,1,25,4.7e-05
G5,C(C(C1(C)C(C)(CC(O1)O)O)=O)=O,8,1,0,1,25,4.7e-05
G5,C(C)(CC1C(C(C(O)O1)=O)(C)O)=O,8,1,0,1,25,4.7e-05
G5,C(C(C1(C)C(CC(C)(O1)O)O)=O)=O,8,1,0,1,25,4.7e-05
G5,C1(C(OC(C(C=C)=O)C1(C)O)O)=O,8,1,0,1,25,4.7e-05
G5,C(C1(C=C)C(C(C(O1)O)=O)(C)O)=O,8,1,0,1,25,4.7e-05
G5,C1(C(OC(C=C)(CO)C1(C)O)O)=O,8,1,0,1,25,4.7e-05
G5,C(C1(C(C)(C(C=C)(CO1)O)O)O)=O,8,1,0,1,25,4.7e-05
G5,C1(C(OC(C=CC=O)C1(C)O)O)=O,16,1,0,1,25,4.7e-05
G5,C1(C(O)OC(C(C)O)C1(C)O)=O,16,1,0,1,11,4.7e-05
G5,C(C1(C(C)(C(C(C)O1)O)O)O)=O,16,1,0,1,11,4.7e-05
G5,C(CO)(C1(C)C(CC(O1)O)O)=O,8,1,0,1,25,4.7e-05
G5,C(CO)(C1(C)C(C)(CC(O1)O)O)=O,8,1,0,1,25,4.7e-05
G5,C(CO)(C1(C)C(CC(C)(O1)O)O)=O,8,1,0,1,25,4.7e-05
G5,C=CC1(COC(CO)(C1(C)O)O)O,8,1,0,1,25,4.7e-05
G5,C1C(C(C)O)(C(C)(C(O)O1)O)O,16,1,0,1,25,4.7e-05
G5,CC1(C(O)OC(C)C1(CO)O)O,16,1,0,1,25,4.7e-05
G5,CC1(C(CO)(O)OC(C)C1O)O,16,1,0,1,11,4.7e-05
G5,C(CC(C1(C(O)OCC1)O)O)=O,8,1,0,1,29,4.7e-05
G5,C(C1(CCO)C(CC(O1)O)O)=O,8,1,0,1,29,4.7e-05
G5,C1(CC(C(O)O1)(C(CC=O)O)O)=O,8,1,0,1,29,4.7e-05
G5,C(C1(C(CC(O1)O)O)CC(O)=O)=O,8,1,0,1,29,4.7e-05
G5,C(C1(C)C(CC(O1)O)O)=O,8,1,0,1,11,4.7e-05
G5,C(C1(C(CC=O)OC(C1)O)O)(O)=O,8,1,0,1,33,4.7e-05
G5,C(C1(C(CC(O1)O)O)CC=O)(O)=O,8,1,0,1,33,4.7e-05
G5,C1(C2(C(CC(O2)O)O)OCC1)=O,8,1,0,1,34,4.7e-05
G5,C1(C(C)(C(C(O)O1)(CCO)O)O)=O,8,1,0,1,25,4.7e-05
G5,C(C1(C(O)OCC1)O)(O)=O,4,1,0,1,17,4.7e-05
G5,C(C)(C(C)(C1(C(O)OCC1)O)O)=O,8,1,0,1,14,4.7e-05
G5,C(CC(C)(C1(C(O)OCC1)O)O)=O,8,1,0,1,29,4.7e-05
G5,C(C1(CCO)C(C)(CC(O1)O)O)=O,8,1,0,1,29,4.7e-05
G5,C(C)(CC(C1(C(O)OCC1)O)O)=O,8,1,0,1,29,4.7e-05
G5,C(C1(CCO)C(CC(C)(O1)O)O)=O,8,1,0,1,29,4.7e-05
G5,C=CC(CO)(C1(C(O)OCC1)O)O,8,1,0,1,7,4.7e-05
G5,C=CC1(COC(C1(CCO)O)O)O,8,1,0,1,7,4.7e-05
G5,C(C(C1(C(O)OCC1)O)O)=CC=O,16,1,0,1,43,4.7e-05
G5,CC1(C(O)OC(CCO)C1O)O,16,1,0,1,29,4.7e-05
G5,CC(C(C1(C(O)OCC1)O)O)O,16,1,0,1,11,4.7e-05
G5,CC1C(C(C(O)O1)(CCO)O)O,16,1,0,1,11,4.7e-05
G5,C1(C(C)(C(C)(C(O)O1)O)O)=O,8,1,0,1,11,4.7e-05
G5,C1(C(C)(C2(C(CCO2)(O)O1)O)O)=O,8,1,0,1,28,4.7e-05
G5,C(C1(C(O)OC(C1)=O)O)(O)=O,4,1,0,1,29,4.7e-05
G5,C(C1(C(OC(C=O)C1)O)O)(O)=O,8,1,0,1,17,4.7e-05
G5,C1(C(C(C(C)=O)=O)(CC(O)O1)O)=O,4,1,0,1,17,4.7e-05
G5,C1(C(C)(O)OC(C1(CC=O)O)=O)=O,4,1,0,1,17,4.7e-05
G5,C(CC1(C(C(C(O1)=O)(C)O)=O)O)=O,4,1,0,1,17,4.7e-05
G5,C1(C(C(C(O)O1)=O)(CC(C)=O)O)=O,4,1,0,1,17,4.7e-05
G5,C1(C(C(C=O)=O)(CC(C)(O)O1)O)=O,4,1,0,1,17,4.7e-05
G5,C(CCC1(C(OC(C1=O)O)=O)O)=O,4,1,0,1,17,4.7e-05
G5,C1(C(C(C(O)O1)=O)(C=CCO)O)=O,8,1,0,1,29,4.7e-05
G5,C(C1(C(CC=O)(O)OCC1)O)(O)=O,4,1,0,1,17,4.7e-05
G5,C1(C(C=O)(CC(CCO)(O)O1)O)=O,4,1,0,1,29,4.7e-05
G5,C1(C2(C(C(CO)C(C2)(O)O1)=O)O)=O,8,2,0,2,17,9.499999999999999e-05
G5,C1(C2(C(C)=O)CC(C(O2)O)(O)O1)=O,8,1,0,1,17,4.7e-05
G5,C1(C2(C(CC(O2)O)=O)CC(O)O1)=O,8,1,0,1,17,4.7e-05
G5,C1(C2(C(COCC(C2)(O)O1)=O)O)=O,4,1,0,1,17,4.7e-05
G5,C1(C2(C(C(CO2)O)=O)CC(O)O1)=O,8,1,0,1,17,4.7e-05
G5,C1(C2(C(C(O)O1)=O)CC(CO2)O)=O,8,1,0,1,17,4.7e-05
G5,C(C12CC(CO1)OC2(C=O)O)(O)=O,8,1,0,1,17,4.7e-05
G5,C(C12C(O)OC(C1)C(C=O)O2)(O)=O,16,1,0,1,40,4.7e-05
G5,C1(C2(C=O)CC(C(C)(O2)O)(O)O1)=O,8,1,0,1,14,4.7e-05
G5,C1(C2(C=O)CC(CC(O2)O)(O)O1)=O,8,1,0,1,37,4.7e-05
G5,C(CC1(COC(C1(C)O)O)O)(O)=O,8,1,0,1,29,4.7e-05
G5,C(C1C(C)(C(C)(C(O1)O)O)O)(O)=O,16,1,0,1,11,4.7e-05
G5,C(CC1(C(O)OC(C1O)=O)O)(O)=O,8,1,0,1,33,4.7e-05
G5,C1(CC(C(O)O1)(C(C(O)=O)O)O)=O,8,1,0,1,33,4.7e-05
G5,C(C1(CC(OC1C(O)=O)O)O)(O)=O,8,1,0,1,33,4.7e-05
G5,C1(C(C2(C(CCO2)(O)O1)O)O)=O,8,1,0,1,34,4.7e-05
G5,C(C1C(C(C)(C(O1)O)O)O)(O)=O,16,1,0,1,29,4.7e-05
G5,C(CC1C(C(C)(C(O)O1)O)O)(O)=O,16,1,0,1,29,4.7e-05
G5,C1(CC(C(O)O1)(C(C(C)O)O)O)=O,16,1,0,1,29,4.7e-05
G5,C(CC1(C(O)OC(C)C1O)O)(O)=O,16,1,0,1,29,4.7e-05
G5,C(C(C)(C1C(CC(C)(O1)O)=O)O)=O,8,1,0,1,26,4.7e-05
G5,C(C1(CC(C)(OC1(C=O)C)O)O)=O,8,1,0,1,27,4.7e-05
G5,C(C(C)(C1(C)CC(C(O)O1)=O)O)=O,8,1,0,1,11,4.7e-05
G5,C(C1(C)C(C)(CC(C=O)(O1)O)O)=O,8,1,0,1,11,4.7e-05
G5,C(C(C)(C1CC(C(O)O1)=O)O)=O,8,1,0,1,11,4.7e-05
G5,C(C1(C)C(CC(C=O)(O1)O)O)=O,8,1,0,1,11,4.7e-05
G5,C(C(C1CC(C(C)(O)O1)=O)(C)O)=O,8,1,0,1,14,4.7e-05
G5,C(C1(C)C(CC(C(C)=O)(O1)O)O)=O,8,1,0,1,14,4.7e-05
G5,C(C1(C)C(C(C)=O)(CC(O1)O)O)=O,8,1,0,1,45,4.7e-05
G5,C(C(C)(C1(C(CC(O1)O)=O)C)O)=O,8,1,0,1,45,4.7e-05
G5,C(C1(C)C(C)(CC(O1)O)O)=O,8,1,0,1,11,4.7e-05
G5,C(C1(C)C(CC(C)(O1)O)O)=O,8,1,0,1,11,4.7e-05
G5,C1(C2(C(C)(CC(O2)O)O)OCC1)=O,8,1,0,1,34,4.7e-05
G5,C1(C2(C(CC(C)(O2)O)O)OCC1)=O,8,1,0,1,34,4.7e-05
G5,C(C1(COC(C1(C)O)O)O)=CC=O,16,1,0,1,11,4.7e-05
G5,C=CC1(COC(C1(C)O)O)O,8,1,0,1,7,4.7e-05
G5,C=CC1(COC2(C1(O)OCC2)O)O,8,1,0,1,34,4.7e-05
G5,CC1(C(O)OC(C)C1O)O,16,1,0,1,11,4.7e-05
G5,C1(C(CCO)(C(C)(C(O)O1)O)O)=O,8,1,0,1,11,4.7e-05
G5,C(C1(CC(O)OC1C(C)O)O)(O)=O,16,1,0,1,11,4.7e-05
G5,CC1(C(O)OC(CO)(CO)C1O)O,8,1,0,1,11,4.7e-05
G5,C(C1(C)C(C(CO)(C(O1)O)O)O)=O,16,1,0,1,11,4.7e-05
G5,C(C1(CO)C(C(C)(C(O1)O)O)O)=O,16,1,0,1,11,4.7e-05
G5,C1C2(C(CO1)OC(C2(C)O)O)O,16,1,0,1,10,4.7e-05
G5,C1CC2(C(C(C(C)O2)O)(O)O1)O,16,1,0,1,34,4.7e-05
G5,C12C(CCO1)(C(C)(C(O)O2)O)O,16,1,0,1,29,4.7e-05
G5,C(CC1(C(C)(O)OCC1O)O)=O,8,1,0,1,0,4.7e-05
G5,C(C)(C1(C(CO)OC(C1)O)O)=O,8,1,0,1,0,4.7e-05
G5,C(CC1(C(CO)(O)OCC1O)O)=O,8,1,0,1,0,4.7e-05
G5,C(CO)(C1(C(CO)OC(C1)O)O)=O,8,1,0,1,0,4.7e-05
G5,C(C(C1(C(C)(C(CO1)O)O)O)O)=O,16,1,0,1,0,4.7e-05
G5,CC1(C(O)OC(C(CO)O)C1O)O,32,1,0,1,45,4.7e-05
G5,C1(C(O)OC(CO)(CO)C1(C)O)=O,4,1,0,1,25,4.7e-05
G5,CC1(C(CO)(O)OCC1(CO)O)O,8,1,0,1,25,4.7e-05
G5,C1C(CO)(C2(C(CCO2)(O)O1)O)O,8,1,0,1,34,4.7e-05
G5,C(C1(C(C)(C(C(CO)O1)O)O)O)=O,16,1,0,1,25,4.7e-05
G5,CC1(C(CO)(O)OC(CO)C1O)O,16,1,0,1,25,4.7e-05
G5,CC1(C(O)OC(CO)C1O)O,16,1,0,1,11,4.7e-05
G5,C1CC2(C(C(C(CO)O2)O)(O)O1)O,16,1,0,1,34,4.7e-05
G5,C(C1C(C(C(O1)O)=O)(C)O)(C)=O,8,1,0,1,49,4.7e-05
G5,C(C1(C)C(C(C(O1)O)=O)(C)O)=O,8,1,0,1,11,4.7e-05
G5,C(C1(C)C(CC(CO)(O1)O)O)(O)=O,8,1,0,1,25,4.7e-05
G5,C(C1(C)C(CO)(CC(O1)O)O)(O)=O,8,1,0,1,29,4.7e-05
G5,C(C1(C)C(CC(CO)(O1)O)O)=O,8,1,0,1,11,4.7e-05
G5,C(C1(C)C(C(C(C)(O1)O)O)O)(O)=O,16,1,0,1,25,4.7e-05
G5,C(C1(C)C(C)(C(C(O1)O)O)O)(O)=O,16,1,0,1,25,4.7e-05
G5,C(C)(C1C(C(C)(C(O1)O)O)O)=O,16,1,0,1,11,4.7e-05
G5,C(C1(C)C(C(C(C)(O1)O)O)O)=O,16,1,0,1,11,4.7e-05
G5,C(C1C(C)(C(C)(C(O1)O)O)O)=O,16,1,0,1,11,4.7e-05
G5,C(C1(C)C(C)(C(C(O1)O)O)O)=O,16,1,0,1,11,4.7e-05
G5,C(C1(CC(C=O)(C(C=O)O1)O)O)=O,8,1,0,1,0,4.7e-05
G5,C(CO)(C1(CC(OC1C=O)O)O)=O,8,1,0,1,0,4.7e-05
G5,CC1(C(CO)OC(C1(C)O)O)O,16,1,0,1,11,4.7e-05
G5,C1(C(C=O)(CC(CO)(O)O1)O)=O,4,1,0,1,17,4.7e-05
G5,C(C1(COC(C1)(CCO)O)O)(O)=O,4,1,0,1,33,4.7e-05
G5,C(CC1(C(C(O)OC1)=O)O)(CO)=O,4,1,0,1,49,4.7e-05
G5,C(C(C1(COC(CO)(C1)O)O)=O)=O,4,1,0,1,49,4.7e-05
G5,C(COC1CC(C(O)O1)(CO)O)=O,8,1,0,1,37,4.7e-05
G5,C1C2C(C(C(C2(CO)O)(O)O1)O)O,32,2,0,2,2,9.499999999999999e-05
G5,C1(C(C)(O)OCC1(CC=O)O)=O,4,1,0,1,2,4.7e-05
G5,C(CC1(C(C(CO1)(C)O)=O)O)=O,4,1,0,1,4,4.7e-05
G5,C(C(C1(COC(C)(C1)O)O)=O)=O,4,1,0,1,17,4.7e-05
G5,C1C(C2(C(CO)(CC(O1)O2)O)O)O,16,1,0,1,38,4.7e-05
G5,C1C2CC(C(C(CO)(O)O1)(O)O2)O,16,1,0,1,41,4.7e-05
G5,C1C2CC(CO)(C(C(O)O1)(O)O2)O,16,2,0,2,0,9.499999999999999e-05
G5,C1C2(C(CO)(CC(C(O)O1)O2)O)O,16,2,0,2,32,9.499999999999999e-05
G5,C(C)(C12COC(C1)(C(O2)O)O)=O,8,2,0,2,22,9.499999999999999e-05
G5,C1(CC(OC21COC(C2)O)O)=O,8,2,0,2,2,9.499999999999999e-05
G5,C1(COCC2(CC1(CO2)O)O)=O,4,1,0,1,2,4.7e-05
G5,C1(C(COC21COC(C2)O)O)=O,8,1,0,1,9,4.7e-05
G5,C1(C(O)OCC21CC(CO2)O)=O,8,1,0,1,39,4.7e-05
G5,C(C1(C2(CO)CC(CO2)O1)O)=O,8,1,0,1,39,4.7e-05
G5,C(C1C2CC(C(O)O2)(CO)O1)=O,16,1,0,1,40,4.7e-05
G5,C(C12COC(C1)(C(C)(O2)O)O)=O,8,2,0,2,14,9.499999999999999e-05
G5,C(C12COC(C1)(CC(O2)O)O)=O,8,2,0,2,37,9.499999999999999e-05
G5,C1(C2(COC(C2)(C(CO)O1)O)O)=O,8,1,0,1,2,4.7e-05
G5,C1(C2(COC(C2)(C(CO1)O)O)O)=O,8,1,0,1,2,4.7e-05
G5,C(C1(C2CC(C(O)O2)(CO)O1)O)O,16,2,0,2,43,9.499999999999999e-05
G5,C(C1(C2(CO)CC(C(O)O2)O1)O)O,16,2,0,2,32,9.499999999999999e-05
G5,C1CC2(CO)C(C(C(O)O2)O)(O)O1,16,2,0,2,2,9.499999999999999e-05
G5,C1(C(C2CC(C(O)O2)(CO)O1)O)O,32,2,0,2,43,9.499999999999999e-05
G5,C1C(CCO)(C(C)(C(O)O1)O)O,8,1,0,1,3,4.7e-05
G5,C(C1(C)C(C(C(O1)O)O)O)(O)=O,16,1,0,1,25,4.7e-05
G5,C(C1C(C(C)(C(C=O)(O1)O)O)O)=O,16,1,0,1,0,4.7e-05
G5,C(C(C1C(C(C(O)O1)=O)(C)O)O)=O,16,1,0,1,0,4.7e-05
G5,C(C(C1(C)C(C(C(O1)O)O)O)=O)=O,16,1,0,1,0,4.7e-05
G5,C(C1C(C2(C(CCO2)(O1)O)O)O)=O,16,1,0,1,34,4.7e-05
G5,C1(C2(C(C(C(O2)O)O)O)OCC1)=O,16,1,0,1,34,4.7e-05
G5,C(CC1(C(C)(O)OCC1(C)O)O)=O,8,1,0,1,45,4.7e-05
G5,C(C)(C1(CC(O)OC1(CO)C)O)=O,8,1,0,1,45,4.7e-05
G5,C(C1(C(C)(C(CO1)(C)O)O)O)=O,8,1,0,1,49,4.7e-05
G5,C1(C(O)OC(CO)(C)C1(C)O)=O,8,1,0,1,49,4.7e-05
G5,CC1(C(CO)(O)OCC1(C)O)O,8,1,0,1,25,4.7e-05
G5,C1C(C)(C(C)(C(O)O1)O)O,8,1,0,1,11,4.7e-05
G5,C1C(C)(C2(C(CCO2)(O)O1)O)O,8,1,0,1,49,4.7e-05
G5,C(C1(CC(O)OC1CCO)O)=O,8,1,0,1,43,4.7e-05
G5,C(C1(CC(O)OC1CC(C)O)O)=O,16,1,0,1,43,4.7e-05
G5,C(C(C)(C1C(CC(O)O1)O)O)(O)=O,16,1,0,1,25,4.7e-05
G5,C(C(C)(C1CC(C(O)O1)O)O)(O)=O,16,1,0,1,25,4.7e-05
G5,C(C1(C(CC(O1)O)O)CC=O)=O,8,1,0,1,43,4.7e-05
G5,C1(C(C=O)(CC(O)O1)O)=O,4,1,0,1,17,4.7e-05
G5,C(C1(CC(OC1(C(C)=O)C)O)O)=O,8,1,0,1,14,4.7e-05
G5,C(C1(CC(O)OC1(C)CC=O)O)=O,8,1,0,1,6,4.7e-05
G5,C(C1(C(C)(CC(O1)O)O)CC=O)=O,8,1,0,1,6,4.7e-05
G5,C(C1(C=C)C(C=O)(CC(O1)O)O)=O,8,1,0,1,28,4.7e-05
G5,C(C1(CC(OC1(C=C)CO)O)O)=O,8,1,0,1,7,4.7e-05
G5,C(CC1(C(O)OCC1(C=C)O)O)=O,8,1,0,1,7,4.7e-05
G5,C(C1(CC(OC1C=CC=O)O)O)=O,16,1,0,1,43,4.7e-05
G5,C(C(C)(C1CC(C(O)O1)O)O)=O,16,1,0,1,11,4.7e-05
G5,C(C1(CC(O)OC1C(C)O)O)=O,16,1,0,1,11,4.7e-05
G5,C(CC1(C(O)OC(C)C1O)O)=O,16,1,0,1,11,4.7e-05
G5,C1(CC2(C(CO)C1(C(C)O2)O)O)=O,16,2,0,2,30,9.499999999999999e-05
G5,C1(CC2(C(C(C)O)(C1CO2)O)O)=O,16,2,0,2,30,9.499999999999999e-05
G5,C(C)(C1(C(C)OC(C1)O)O)=O,8,1,0,1,4,4.7e-05
G5,C(CO)(C1(C(C)OC(C1)O)O)=O,8,1,0,1,4,4.7e-05
G5,C1(C(O)OC(C)C1(C)O)=O,8,1,0,1,4,4.7e-05
G5,C(C(C)=O)(C1(C(C)OC(C1)O)O)=O,8,1,0,1,25,4.7e-05
G5,C1(C(C)(O)OC(C)C1(CC=O)O)=O,8,1,0,1,25,4.7e-05
G5,C(CC1(C(C(C)(C(C)O1)O)=O)O)=O,8,1,0,1,4,4.7e-05
G5,C(CC1(C(C(O)OC1C)=O)O)(C)=O,8,1,0,1,17,4.7e-05
G5,C(C(C1(C(C)OC(C)(C1)O)O)=O)=O,8,1,0,1,17,4.7e-05
G5,C(CCC1(C(C(O)OC1C)=O)O)=O,8,1,0,1,27,4.7e-05
G5,C1(C(O)OC(C)C1(C=CCO)O)=O,16,1,0,1,29,4.7e-05
G5,C1(C2(C(C)OC(C2)(C1CO)O)O)=O,16,2,0,2,4,9.499999999999999e-05
G5,C(C)(C12C(C)OC(C1)(C(O2)O)O)=O,16,2,0,2,4,9.499999999999999e-05
G5,C1(CC(OC21C(C)OC(C2)O)O)=O,16,2,0,2,4,9.499999999999999e-05
G5,C1(COCC2(CC1(C(C)O2)O)O)=O,8,1,0,1,17,4.7e-05
G5,C1(C(COC21C(C)OC(C2)O)O)=O,16,1,0,1,9,4.7e-05
G5,C1(C(O)OC(C)C21CC(CO2)O)=O,16,1,0,1,4,4.7e-05
G5,C(C1(C2(CC(CO2)O1)C(C)O)O)=O,16,1,0,1,4,4.7e-05
G5,C(C1C2CC(C(O)O2)(C(C)O)O1)=O,32,1,0,1,40,4.7e-05
G5,C(C12C(C)OC(C1)(C(C)(O2)O)O)=O,16,2,0,2,14,9.499999999999999e-05
G5,C(C12C(C)OC(C1)(CC(O2)O)O)=O,16,2,0,2,25,9.499999999999999e-05
G5,C1(C(C(C(O)O1)(CC(C)O)O)O)=O,16,1,0,1,33,4.7e-05
G5,C(C(C1CC(C(C)(O)O1)O)O)(O)=O,16,1,0,1,45,4.7e-05
G5,C(C(C1CC(C(O)O1)(C)O)O)(O)=O,16,1,0,1,16,4.7e-05
G5,C(C1C(CO)(C(C(O1)O)O)O)(O)=O,16,1,0,1,33,4.7e-05
G5,C1(C(C(C(CC(C)=O)(O)O1)O)O)=O,8,1,0,1,26,4.7e-05
G5,C(C(C1C(CC(C)(O1)O)=O)O)(O)=O,8,1,0,1,26,4.7e-05
G5,C1(C(C(C(O)O1)(CC(C)=O)O)O)=O,8,1,0,1,27,4.7e-05
G5,C(C1(CC(C)(OC1C(O)=O)O)O)=O,8,1,0,1,27,4.7e-05
G5,C(CC1(C(C)(C(C(O1)=O)O)O)O)=O,8,1,0,1,14,4.7e-05
G5,C1(C(C)(C(C(O)=O)O)OC(C1)O)=O,8,1,0,1,14,4.7e-05
G5,C1(C(C(C)(C(C)(O)O1)O)O)=O,8,1,0,1,14,4.7e-05
G5,C(C1(CC(C(O1)=O)(C(C)=O)O)O)=O,4,1,0,1,17,4.7e-05
G5,C1(C(C(CC=O)=O)(CC(O)O1)O)=O,4,1,0,1,17,4.7e-05
G5,C1(C(C=O)(CC(C(C)=O)(O)O1)O)=O,4,1,0,1,14,4.7e-05
G5,C1(C(C=O)(CC(CC=O)(O)O1)O)=O,4,1,0,1,37,4.7e-05
G5,C(CCO)(OC1C(O)OCC1O)=O,8,1,0,1,48,4.7e-05
G5,C(CCO)(OC1COC(C1O)O)=O,8,1,0,1,48,4.7e-05
G5,C(CO)(OC1(C(O)OCC1)O)=O,4,1,0,1,2,4.7e-05
G5,C(CO)(OC1(COC(C1)O)O)=O,4,1,0,1,17,4.7e-05
G5,C(CO)(OC1CC(C(O)O1)O)=O,8,1,0,1,43,4.7e-05
G5,C(CO)(CC1(CC(CO1)=O)O)=O,2,1,0,1,5,4.7e-05
G5,C(C)(C(C1(CC(CO1)=O)O)O)=O,4,1,0,1,5,4.7e-05
G5,C(C)(CC1(C(C(CO1)=O)O)O)=O,4,1,0,1,5,4.7e-05
G5,C(CO)(C1(C(C)C(CO1)O)O)=O,8,1,0,1,42,4.7e-05
G5,C(C1CCOC1(C(CO)=O)O)=O,4,1,0,1,5,4.7e-05
G5,C(C(C1COC(C1CO)O)=O)=O,8,1,0,1,55,4.7e-05
G5,C(CO)(C1(C(CO)CCO1)O)=O,4,1,0,1,55,4.7e-05
G5,C(CO)(C(C1C(O)OCC1)O)=O,8,1,0,1,55,4.7e-05
G5,C(CO)(C1COC(C1CO)O)=O,8,1,0,1,55,4.7e-05
G5,C(CC(C1(CC(CO1)=O)O)O)=O,4,1,0,1,51,4.7e-05
G5,C(CCC1(C(C(CO1)=O)O)O)=O,4,2,0,2,51,9.499999999999999e-05
G5,C(C1CCC(C(CO)=O)(O1)O)=O,4,1,0,1,12,4.7e-05
G5,C(C1C(CO)C(OC1C=O)O)=O,16,1,0,1,29,4.7e-05
G5,C(C1CC(CO)(OC1C=O)O)=O,8,1,0,1,12,4.7e-05
G5,C(C(CC1C(O)OCC1)=O)=O,4,1,0,1,29,4.7e-05
G5,C(C(CC1C(O)OCC1O)=O)=O,8,1,0,1,0,4.7e-05
G5,C(C(C)C1(C(C(CO1)O)=O)O)=O,8,1,0,1,42,4.7e-05
G5,C(CC1(C(C=O)C(CO1)=O)O)=O,4,1,0,1,1,4.7e-05
G5,C(C)(CC1(CC(CO1)=O)O)=O,2,1,0,1,49,4.7e-05
G5,C(CC1(C(C(CO1)O)=O)O)=O,4,1,0,1,2,4.7e-05
G5,C(C)(C1(C(C)C(CO1)O)O)=O,8,1,0,1,28,4.7e-05
G5,C1(CC(C=O)OC1(CC)O)=O,4,1,0,1,0,4.7e-05
G5,C(CCC1(CC(CO1)=O)O)=O,2,2,0,2,21,9.499999999999999e-05
G5,C(CC1CC(C=O)OC1O)=O,8,1,0,1,21,4.7e-05
G5,C(C(CC1C(CC(O1)O)=O)O)=O,8,1,0,1,32,4.7e-05
G5,C(C1(CC(C(C=O)=O)CO1)O)=O,4,1,0,1,29,4.7e-05
G5,C(C(C1COC(C1C)O)=O)=O,8,1,0,1,29,4.7e-05
G5,C(C1CCOC1(C(C)=O)O)=O,4,1,0,1,29,4.7e-05
G5,C1(C(C(CO)C)(O)OCC1)=O,4,1,0,1,2,4.7e-05
G5,C(CO)(C1COC(C1C)O)=O,8,1,0,1,55,4.7e-05
G5,C(CO)(CC1C(O)OCC1)=O,4,1,0,1,46,4.7e-05
G5,C(C)(C(C1C(O)OCC1)O)=O,8,1,0,1,3,4.7e-05
G5,C(C)(C1(C(CO)CCO1)O)=O,4,1,0,1,29,4.7e-05
G5,C1(C(CC)(O)OCC1)=O,2,1,0,1,27,4.7e-05
G5,C(CC1C(O)OCC1)=O,4,1,0,1,46,4.7e-05
G5,C(C1CC(C=O)(OC1C=O)O)=O,8,1,0,1,29,4.7e-05
G5,C(C1CCC(C(C)=O)(O1)O)=O,4,1,0,1,49,4.7e-05
G5,C(C1C(C)C(OC1C=O)O)=O,16,1,0,1,28,4.7e-05
G5,C(CO)(CC1C(O)OCC1O)=O,8,1,0,1,46,4.7e-05
G5,C1(C(C(CO)C)(O)OCC1O)=O,8,1,0,1,42,4.7e-05
G5,C(CC1C(O)OCC1O)=O,8,1,0,1,46,4.7e-05
G5,C1(C(CC)(O)OCC1O)=O,4,1,0,1,42,4.7e-05
G5,C(C1(C(C)C(CO1)O)O)=O,8,1,0,1,28,4.7e-05
G5,C(C(C1C(OC(C=O)C1)O)O)=O,16,1,0,1,29,4.7e-05
G5,C(CO)(C1CC(OC1C=O)O)=O,8,1,0,1,0,4.7e-05
G5,C(C1(C(CO)CCO1)O)=O,4,1,0,1,55,4.7e-05
G5,C(C(C1C(O)OCC1)O)=O,8,1,0,1,3,4.7e-05
G5,C(C1C(C(C)C(C=O)(O1)O)O)=O,16,1,0,1,49,4.7e-05
G5,C(CO)(CC1(CC(CO1)O)O)=O,4,1,0,1,0,4.7e-05
G5,C1(COC(CC(CO)O)(C1)O)=O,4,1,0,1,0,4.7e-05
G5,C(C)(C(C1(CC(CO1)O)O)O)=O,8,1,0,1,49,4.7e-05
G5,C(C)(CC1(C(C(CO1)O)O)O)=O,8,1,0,1,0,4.7e-05
G5,C(C1C(O)OC(C1)CO)(O)=O,8,1,0,1,29,4.7e-05
G5,C(C1(CCC(CO)O1)O)(O)=O,4,1,0,1,29,4.7e-05
G5,C(C(C1(CCCO1)O)=O)=O,2,1,0,1,55,4.7e-05
G5,C(C(C1CCC(O)O1)O)=O,8,1,0,1,27,4.7e-05
G5,C1(CC2C(CC(O)O2)O1)O,10,1,0,1,43,4.7e-05
G5,C1C(C2CC(C(O)O2)O1)O,16,1,0,1,29,4.7e-05
G5,C1(CC(C2C(C1C(O)O2)O)O)=O,32,2,0,2,0,9.499999999999999e-05
G5,C(C1(COC(C1CC=O)O)O)=O,8,1,0,1,29,4.7e-05
G5,C(C1(COC(C=O)(C1C)O)O)=O,8,1,0,1,28,4.7e-05
G5,C(C1(COC(CO)(C1C)O)O)=O,8,1,0,1,28,4.7e-05
G5,C(C1(COC(C1CCO)O)O)=O,8,1,0,1,3,4.7e-05
G5,C(C(CO)(C1C(O)OCC1)O)=O,8,1,0,1,3,4.7e-05
G5,C(C1(COC(C1C)O)O)=O,8,1,0,1,49,4.7e-05
G5,C(C(C=O)C1(CC(CO1)=O)O)=O,2,1,0,1,1,4.7e-05
G5,C(C)(C1(COC(C1C)O)O)=O,8,1,0,1,29,4.7e-05
G5,C(CCO)(C1C(O)OCC1O)=O,8,1,0,1,2,4.7e-05
G5,C1(COC2C(CO)OC(C12)O)=O,16,1,0,1,29,4.7e-05
G5,C1(C2COC(C2)(C(CO)O1)O)=O,8,1,0,1,48,4.7e-05
G5,C1(CC(O)OC2COC(C12)O)=O,16,1,0,1,9,4.7e-05
G5,C1(C2COC(C2)(C(CO1)O)O)=O,8,1,0,1,46,4.7e-05
G5,C1(COCC2C(C1C(O)O2)O)=O,16,1,0,1,29,4.7e-05
G5,C1(CCOC2C(C1C(O)O2)O)=O,16,1,0,1,30,4.7e-05
G5,C(C(C=O)(C1C(O)OCC1)O)=O,4,1,0,1,29,4.7e-05
G5,C(C1(C(C(OC1C=O)O)C)O)=O,16,1,0,1,49,4.7e-05
G5,C(CO)(C1(COC(C1C)O)O)=O,8,1,0,1,49,4.7e-05
G5,C(C1C(C)(O)OCC1O)(O)=O,8,1,0,1,0,4.7e-05
G5,C(C1(C(CO)OC(C1C)O)O)=O,16,1,0,1,49,4.7e-05
G5,C(CC(C1C(O)OCC1O)=O)=O,8,1,0,1,9,4.7e-05
G5,C(CC1C(O)OC(C1O)=O)=O,8,1,0,1,33,4.7e-05
G5,C1(C(C(C)C(C=O)(O)O1)O)=O,8,1,0,1,28,4.7e-05
G5,C1(C(C(C)C(CO)(O)O1)O)=O,8,1,0,1,28,4.7e-05
G5,C(C1(C(C)C(CO1)O)O)(O)=O,8,1,0,1,0,4.7e-05
G5,C(C(C1C(O)OC(C1)CO)=O)=O,8,1,0,1,29,4.7e-05
G5,C(C1CC(C(CO)=O)C(O1)O)=O,8,1,0,1,32,4.7e-05
G5,C(C(CC1C(COC1O)=O)O)=O,8,1,0,1,32,4.7e-05
G5,C(C1C(C(C(O1)O)CCO)=O)=O,8,1,0,1,29,4.7e-05
G5,C(C(C(C1C(O)OCC1)=O)O)=O,8,1,0,1,29,4.7e-05
G5,C(C(C1C(C(C(O1)O)C)=O)O)=O,16,1,0,1,49,4.7e-05
G5,C(C1CCOC1(C(O)=O)O)=O,4,1,0,1,29,4.7e-05
G5,C(C(C1C(O)OCC1)O)(O)=O,8,1,0,1,29,4.7e-05
G5,C1(C(C(C(O)O1)CCO)O)=O,8,1,0,1,29,4.7e-05
G5,C(C1(C(CO)CCO1)O)(O)=O,4,1,0,1,29,4.7e-05
G5,C1(C(C(C)C(O)O1)O)=O,8,1,0,1,49,4.7e-05
G5,C12C3CC(C(C1)(O)O3)(O)O2,10,1,0,1,14,4.7e-05
G5,C12C3CC(C(C1O)(O)O3)O2,32,1,0,1,9,4.7e-05
G5,C(C1C2(C(C(CO2)O1)O)O)=O,16,1,0,1,2,4.7e-05
G5,C(C1C2CC(CO2)(O1)O)=O,8,1,0,1,4,4.7e-05
G5,C1(C2CC(C(CO)(O2)O)O1)=O,8,2,0,2,29,9.499999999999999e-05
G5,C1(C(C2(C(CCO2)O1)O)O)=O,8,2,0,2,29,9.499999999999999e-05
G5,C1C(C2(C(O1)OC(C2)O)O)O,16,1,0,1,0,4.7e-05
G5,C1C2C(C(O)O1)(CC(O)O2)O,16,2,0,2,0,9.499999999999999e-05
G5,C1C2C3C(C(CO3)O2)(O)O1,16,1,0,1,17,4.7e-05
G5,C12C3CC(C(CO1)(O)O3)O2,16,1,0,1,4,4.7e-05
G5,C1(C(O)OC2COC1(C2)O)=O,8,2,0,2,29,9.499999999999999e-05
G5,C1(CC2(CC(CO2)(O)O1)O)=O,4,2,0,2,17,9.499999999999999e-05
G5,C1(C(C2CC(C(O)O2)O1)O)=O,16,2,0,2,29,9.499999999999999e-05
G5,C1(C2OCC(C(C1)(O2)O)O)=O,8,1,0,1,2,4.7e-05
G5,C1(C2OCCC(C1O)(O2)O)=O,8,1,0,1,2,4.7e-05
G5,C1(COC2CCC1(O)O2)=O,4,1,0,1,17,4.7e-05
G5,C1CC2(C(CC(O2)O1)O)O,8,1,0,1,4,4.7e-05
G5,C1C(C2(CCC(O2)O1)O)O,8,1,0,1,7,4.7e-05
G5,C1CC2(CC(C(O2)O1)O)O,8,1,0,1,29,4.7e-05
G5,C1(CC2(C(CC(O2)O1)O)O)=O,8,1,0,1,45,4.7e-05
G5,C1(C(C2(CCC(O2)O1)O)O)=O,8,1,0,1,17,4.7e-05
G5,C1(CC2(CC(C(O2)O1)O)O)=O,8,1,0,1,17,4.7e-05
G5,C12CC3C(CC(O3)O1)(O)O2,16,1,0,1,17,4.7e-05
G5,CC(C1(C(CO)OC(C1O)O)O)O,32,1,0,1,0,4.7e-05
G5,C1(C(O)OC(C(CO)CO)C1O)=O,8,1,0,1,18,4.7e-05
G5,C1CC2C(C(C(O)O2)(O)O1)O,16,2,0,2,30,9.499999999999999e-05
G5,C1C2(CO)CC(C(O)O2)(O)O1,8,2,0,2,5,9.499999999999999e-05
G5,C1C2(CC(O)OC2C(CO)(O)O1)O,16,2,0,2,5,9.499999999999999e-05
G5,C1C2(COC(C2C(CO)(O)O1)O)O,16,2,0,2,5,9.499999999999999e-05
G5,CC1(C2C(C(C(CO)(O)O2)O1)O)O,32,2,0,2,5,9.499999999999999e-05
G5,CC1(C2C(O)OC1C(CO)(O)O2)O,32,2,0,2,5,9.499999999999999e-05
G5,C1C2(CO)C(CO)C(C(O)O2)(O)O1,16,2,0,2,5,9.499999999999999e-05
G5,C(C1(C2C(C(C(O)O2)O1)O)O)O,32,2,0,2,15,9.499999999999999e-05
G5,C(C1(C(C2C(CC(O)O2)O1)O)O)O,32,2,0,2,38,9.499999999999999e-05
G5,C1C(CO)(C2C(O1)OC(C2O)O)O,32,1,0,1,5,4.7e-05
G5,C1C2(CO)C(C(O)O1)C(C(O)O2)O,32,2,0,2,5,9.499999999999999e-05
G5,C12C(C(C(O)O1)C(CO)(CO)O2)O,16,1,0,1,5,4.7e-05
G5,C12C(C(C(O)O1)O)C(C(CO)O2)O,64,1,0,1,41,4.7e-05
G5,C1(C(C2C(O)OC(CO)C2O1)O)O,64,2,0,2,41,9.499999999999999e-05
G5,C12C(C(C(O)O1)C(C(CO)O)O2)O,64,1,0,1,41,4.7e-05
G5,C(CC12COC(C(O)O1)(C2)O)=O,8,2,0,2,51,9.499999999999999e-05
G5,C(C)(C1C2CC(C(O)O2)(O1)O)=O,16,2,0,2,20,9.499999999999999e-05
G5,C(C1C2(C)CC(C(O)O2)(O1)O)=O,16,2,0,2,26,9.499999999999999e-05
G5,CC12C(CO)OC(C(O)O1)(C2)O,16,2,0,2,16,9.499999999999999e-05
G5,C(C1(C2COC(C)(C2O)O1)O)=O,16,1,0,1,45,4.7e-05
G5,C1(C(O)OC2(C(O)OCC12)C)=O,16,2,0,2,4,9.499999999999999e-05
G5,C(C1(C2COC(C2(C)O)O1)O)=O,16,1,0,1,42,4.7e-05
G5,C1C2(CCO)CC(C(O)O2)(O)O1,8,2,0,2,29,9.499999999999999e-05
G5,C1C2C(CO)(O)OC(C)(C2O)O1,16,1,0,1,45,4.7e-05
G5,C12C(C)(C(CO1)C(CO)(O)O2)O,16,1,0,1,42,4.7e-05
G5,C(C1C2CC(C(O)O2)(O1)O)=O,16,2,0,2,15,9.499999999999999e-05
G5,C1C2(C)CC(C(O)O2)(O)O1,8,2,0,2,49,9.499999999999999e-05
G5,C(CC1C2CC(C(O)O2)(O)O1)=O,16,2,0,2,20,9.499999999999999e-05
G5,C(C1(CC2C(CC(O)O2)O1)O)=O,16,2,0,2,20,9.499999999999999e-05
G5,C(C1C2C(O)OC(C)(C2O)O1)=O,32,1,0,1,45,4.7e-05
G5,C(C1C2C(O)OC1C(C)(O)O2)=O,32,2,0,2,45,9.499999999999999e-05
G5,C(C)(C1C2C(O)OC(C2O)O1)=O,32,1,0,1,45,4.7e-05
G5,C(C1C2C(O)OC(C2(C)O)O1)=O,32,1,0,1,45,4.7e-05
G5,C(C1C2C(O)OC1(C)C(O)O2)=O,32,2,0,2,45,9.499999999999999e-05
G5,C(C1(C)C2C(O)OC(C2O)O1)=O,32,1,0,1,45,4.7e-05
G5,C(C(C1C2CC(C(O)O2)(O)O1)O)=O,32,2,0,2,0,9.499999999999999e-05
G5,C(C1(CC2C(C(C(O)O2)O)O1)O)=O,32,2,0,2,0,9.499999999999999e-05
G5,C1C2(CC(C(O)O2)(O)O1)C(CO)O,16,2,0,2,51,9.499999999999999e-05
G5,C1(C2(CC(CO)(C(CO)O2)O1)O)O,16,2,0,2,51,9.499999999999999e-05
G5,C(CC1(C2C(C(C(O)O2)O1)O)O)=O,32,2,0,2,1,9.499999999999999e-05
G5,CC1(C2C(CO1)(CC(O)O2)O)O,16,2,0,2,49,9.499999999999999e-05
G5,CC1(C2C(C(C(C)(O)O2)O1)O)O,10,1,0,1,49,4.7e-05
G5,CC1(C2C(C)(C(C(O)O2)O1)O)O,32,2,0,2,49,9.499999999999999e-05
G5,C(C1C2C(C(O1)OC2(CO)O)O)=O,32,1,0,1,0,4.7e-05
G5,C(CO)(C1C2C(O)OC1C(O)O2)=O,10,1,0,1,0,4.7e-05
G5,C1(C(O)OC2C(O)OCC12)=O,16,2,0,2,0,9.499999999999999e-05
G5,C(C1(C2COC(C2O)O1)O)=O,16,1,0,1,0,4.7e-05
G5,C(C1C2C(O)OC(C2O)O1)=O,32,1,0,1,43,4.7e-05
G5,C(C1C2C(O)OC1C(O)O2)=O,10,1,0,1,43,4.7e-05
G5,C12C(C(C(C)O1)C(CO)(O)O2)O,32,1,0,1,11,4.7e-05
G5,C1(CC2C(CC(CO)(O)O2)O1)O,16,2,0,2,21,9.499999999999999e-05
G5,C1C2(CC(O)O1)CC(C(O)O2)O,16,2,0,2,21,9.499999999999999e-05
G5,C1C2C(O)OC(C2O)O1,16,1,0,1,27,4.7e-05
G5,C1C2C(O)OC(C(CO)O)(C2O)O1,32,1,0,1,2,4.7e-05
G5,C1C(C2(C(CC(CO)O2)(O)O1)O)O,16,2,0,2,0,9.499999999999999e-05
G5,C1C2C(COC2(C(CO)(O)O1)O)O,16,2,0,2,0,9.499999999999999e-05
G5,C1C2C(CO)(O)OC(CO)(C2O)O1,16,1,0,1,30,4.7e-05
G5,C1(C2OC(CCO)(C1CO2)O)=O,8,1,0,1,2,4.7e-05
G5,C(C1(C2COC(CO)(C2)O1)O)=O,8,1,0,1,12,4.7e-05
G5,C(C12CC(CO1)C(CO)(O2)O)=O,8,1,0,1,12,4.7e-05
G5,C1(C2(CCO)OC(C1CO2)O)=O,8,1,0,1,2,4.7e-05
G5,C(CC12C(C(CO1)C(O)O2)O)=O,16,1,0,1,23,4.7e-05
G5,C(C(C1(C2COC(C2)O1)O)O)=O,16,1,0,1,43,4.7e-05
G5,C(C(C12CC(C(O)O1)CO2)O)=O,16,1,0,1,55,4.7e-05
G5,C(C)(C1(C2COC(C2O)O1)O)=O,16,1,0,1,30,4.7e-05
G5,C(C1CC2(C(CCO2)(O1)O)O)=O,8,2,0,2,14,9.499999999999999e-05
G5,C1(C2(CC(C(O2)O)O)OCC1)=O,8,1,0,1,14,4.7e-05
G5,C(CC1(C2COC(C2O)O1)O)=O,16,1,0,1,30,4.7e-05
G5,C(C1C2C(CO)C(C(O)O2)(O1)O)=O,32,2,0,2,15,9.499999999999999e-05
G5,C1C2(C)C(CO)C(C(O)O2)(O)O1,16,2,0,2,49,9.499999999999999e-05
G5,CC1(C(C2C(CC(O)O2)O1)O)O,32,2,0,2,49,9.499999999999999e-05
G5,CC12CC(O)OC1C(C(O)O2)O,32,2,0,2,16,9.499999999999999e-05
G5,C(C1C(C2C(O1)OC(C2O)O)O)=O,64,1,0,1,43,4.7e-05
G5,C(C1C2C(C(O1)O)C(C(O)O2)O)=O,64,2,0,2,43,9.499999999999999e-05
G5,C(C(C1C2C(O)OC(C2O)O1)O)=O,64,1,0,1,43,4.7e-05
G5,C1C(C)(C2C(O1)OC(C2O)O)O,32,1,0,1,49,4.7e-05
G5,C1C2(C)C(C(O)O1)C(C(O)O2)O,32,2,0,2,49,9.499999999999999e-05
G5,CC1(CO)C2C(O)OC(C2O)O1,32,1,0,1,49,4.7e-05
G5,C1(C(C2C(CC(CO)(O)O2)O1)O)O,32,2,0,2,20,9.499999999999999e-05
G5,CC1(C(C2C(C(C(O)O2)O)O1)O)O,64,2,0,2,20,9.499999999999999e-05
G5,C12C(C(C(O)O1)C(C)O2)O,32,1,0,1,4,4.7e-05
G5,C1(C2OC(CCO)(C1C(C)O2)O)=O,16,1,0,1,30,4.7e-05
G5,C(C1(CCC2(COC(C2)O)O1)O)=O,8,2,0,2,29,9.499999999999999e-05
G5,C(C1(C2CC(CO)(O1)OC2C)O)=O,16,1,0,1,12,4.7e-05
G5,C(C12CC(C(CO)(O1)O)C(C)O2)=O,16,1,0,1,12,4.7e-05
G5,C(C1(CC2C(C)(CC(O)O2)O1)O)=O,16,2,0,2,22,9.499999999999999e-05
G5,C(C1(C2C(C(C)(O1)OC2C)O)O)=O,32,1,0,1,45,4.7e-05
G5,C1(C2(CCO)OC(C)C1C(O2)O)=O,16,1,0,1,7,4.7e-05
G5,C(CC12C(C(C(O)O1)C(C)O2)O)=O,32,1,0,1,4,4.7e-05
G5,C(C1C2(CCC(O)O2)CC(O1)O)=O,16,2,0,2,29,9.499999999999999e-05
G5,C(C(C1(C2C(C)OC(C2)O1)O)O)=O,32,1,0,1,46,4.7e-05
G5,C(C(C12CC(C(O)O1)C(C)O2)O)=O,32,1,0,1,46,4.7e-05
G5,C(C)(C1(CC2C(CC(O)O2)O1)O)=O,16,2,0,2,21,9.499999999999999e-05
G5,C(C)(C1(C2C(C(O1)OC2C)O)O)=O,32,1,0,1,14,4.7e-05
G5,C(C1CC2(C(CC(C)O2)(O1)O)O)=O,16,2,0,2,14,9.499999999999999e-05
G5,C1(C2(CC(C(O2)O)O)OC(C)C1)=O,16,1,0,1,14,4.7e-05
G5,C(CC1(CC2C(CC(O)O2)O1)O)=O,16,2,0,2,6,9.499999999999999e-05
G5,C(CC1(C2C(C)OC(C2O)O1)O)=O,32,1,0,1,37,4.7e-05
G5,C=CC1(C(C2C(CC(O)O2)O1)O)O,32,2,0,2,7,9.499999999999999e-05
G5,C=CC12CC(O)OC1C(C(O2)O)O,32,2,0,2,7,9.499999999999999e-05
G5,C1C2(CC(C(O)O2)O)C(C(O)O1)O,32,2,0,2,20,9.499999999999999e-05
G5,C1C(C2C(CO)(OC(C2O)O)O1)O,32,1,0,1,0,4.7e-05
G5,C1C2C(C(CO)(O)O1)C(C(O)O2)O,32,2,0,2,0,9.499999999999999e-05
G5,C12C(C(C(CO)O1)C(CO)(O)O2)O,32,1,0,1,0,4.7e-05
G5,C1C(C(C2(CC(C(O)O2)O)O1)O)O,32,1,0,1,0,4.7e-05
G5,C1C2C(CO)C(C(O)O2)(O)O1,16,2,0,2,0,9.499999999999999e-05
G5,CC12C(C(C(O)O1)O)OC(C2O)O,64,2,0,2,26,9.499999999999999e-05
G5,C1C(CC2(C(C(C(O)O2)O)O)O1)O,32,1,0,1,0,4.7e-05
G5,C1(C2C(C(C(O)O2)O1)O)O,10,1,0,1,1,4.7e-05
G5,C12C(C(CO1)O)C(C(O)O2)O,32,1,0,1,38,4.7e-05
G5,C1C2C(C(O)O1)C(C(O)O2)O,32,2,0,2,38,9.499999999999999e-05
G5,C12C(C(C(O)O1)C(CO)O2)O,32,1,0,1,41,4.7e-05
G5,C1(C(C2C(C(C(O)O2)O)O1)O)O,36,1,0,1,15,4.7e-05
G5,C(C(C1C2CC(C(O)O2)(O)O1)O)O,32,2,0,2,20,9.499999999999999e-05
G5,C1C2C(C(O1)OC2(C(CO)O)O)O,32,1,0,1,30,4.7e-05
G5,C1(C2CC(C(O)O2)O1)O,10,1,0,1,27,4.7e-05
G5,C1C2(C(C(C(C)O2)(O)O1)O)O,16,2,0,2,2,9.499999999999999e-05
G5,C1C2(COC(C2(C(C)(O)O1)O)O)O,16,2,0,2,5,9.499999999999999e-05
G5,C1C2(COC(C2(C(O)O1)O)O)O,3,1,0,1,5,4.7e-05
G5,C1C2(C(O)OC(C)(C2O)O1)O,16,1,0,1,24,4.7e-05
G5,C1C2(CC(O)OC2(C(O)O1)CO)O,16,2,0,2,29,9.499999999999999e-05
G5,CC1(C2C(O)OC1(C(O)O2)CO)O,32,2,0,2,19,9.499999999999999e-05
G5,C1C2(C(O)OC(C2O)O1)O,16,1,0,1,34,4.7e-05
G5,C1C2(C(O)OC(CCO)(C2O)O1)O,16,1,0,1,7,4.7e-05
G5,C12C(CCO)(C(CO1)(C(O)O2)O)O,16,1,0,1,41,4.7e-05
G5,C1(C2(CO)C(C(C(O)O2)O1)O)O,32,2,0,2,1,9.499999999999999e-05
G5,CC1(C2(COC(C)(C2O)O1)O)O,16,1,0,1,0,4.7e-05
G5,C1C2(C(C)(O)OC(C2(C)O)O1)O,16,1,0,1,45,4.7e-05
G5,C(C)(C1C2(C(O)OC(C2O)O1)O)=O,32,1,0,1,0,4.7e-05
G5,C(C1(C2C(O)OC1C(C)(O)O2)O)=O,32,2,0,2,0,9.499999999999999e-05
G5,C(C1C2(C(O)OC(C)(C2O)O1)O)=O,32,1,0,1,0,4.7e-05
G5,C(C1(C)C2(C(O)OC(C2O)O1)O)=O,32,1,0,1,45,4.7e-05
G5,C(C1(C2C(O)OC1(C(O)O2)C)O)=O,32,2,0,2,45,9.499999999999999e-05
G5,C(C1C2(C(O)OC(C2(C)O)O1)O)=O,32,1,0,1,45,4.7e-05
G5,C1C2(C(CO)(O)OC(C)(C2O)O1)O,16,1,0,1,0,4.7e-05
G5,C1C2(C(CO)(O)OC(C2(C)O)O1)O,16,1,0,1,42,4.7e-05
G5,C(C12C(O)OCC1(CC(O2)O)O)=O,16,2,0,2,1,9.499999999999999e-05
G5,C(C12C(O)OC(C1O)C(C)(O2)O)=O,32,2,0,2,1,9.499999999999999e-05
G5,C(C12C(O)OC(C(O1)O)C2(C)O)=O,32,2,0,2,1,9.499999999999999e-05
G5,C(C)(C12C(O)OC(C1O)C(O2)O)=O,32,2,0,2,1,9.499999999999999e-05
G5,C(C12C(C)(O)OC(C1O)C(O2)O)=O,32,2,0,2,1,9.499999999999999e-05
G5,C(C1C2(C(C(O1)OC2(C)O)O)O)=O,32,1,0,1,0,4.7e-05
G5,C(C)(C1(C2C(O)OC1C(O)O2)O)=O,10,1,0,1,0,4.7e-05
G5,C(C1C2(C(O)OC(C2O)O1)O)=O,32,1,0,1,0,4.7e-05
G5,C(C1(C2C(O)OC1C(O)O2)O)=O,10,1,0,1,0,4.7e-05
G5,C1C2(C(C(O1)OC2(CO)O)O)O,16,1,0,1,5,4.7e-05
G5,CC1(C2(COC(CO)(C2O)O1)O)O,16,1,0,1,2,4.7e-05
G5,CC(C12C(C(CO1)(C(O)O2)O)O)O,32,1,0,1,25,4.7e-05
G5,C1C2(C(C(O1)OC2(C(C)O)O)O)O,32,1,0,1,12,4.7e-05
G5,C=CC12C(C(C(O1)O)(CO2)O)O,16,1,0,1,7,4.7e-05
G5,C=CC1(C2(COC(C2O)O1)O)O,16,1,0,1,12,4.7e-05
G5,CC12C(C(C(O)O1)(C(C)O2)O)O,32,1,0,1,0,4.7e-05
G5,C12C(C(C(C)O1)(C(C)(O)O2)O)O,32,1,0,1,11,4.7e-05
G5,C(C12C(O)OC(C1O)C(O2)O)=O,32,2,0,2,1,9.499999999999999e-05
G5,C(C1(C(O)OC2C1OC(C2)O)O)=O,32,2,0,2,43,9.499999999999999e-05
G5,C12C(C(C(O)O1)O)(C(CO2)(C)O)O,32,1,0,1,49,4.7e-05
G5,C1C2(C)C(C(O)O1)(C(C(O)O2)O)O,32,2,0,2,49,9.499999999999999e-05
G5,CC1(CO)C2(C(O)OC(C2O)O1)O,32,1,0,1,49,4.7e-05
G5,C12C(C(C(O)O1)(C(C)O2)O)O,32,1,0,1,25,4.7e-05
G5,C=CC12C(C(C(O1)O)(C(C)O2)O)O,32,1,0,1,7,4.7e-05
G5,C=CC1(C2(C(C(O1)OC2C)O)O)O,32,1,0,1,12,4.7e-05
G5,C12C(C(CO1)O)(C(C(C)(O)O2)O)O,32,1,0,1,0,4.7e-05
G5,CC1(C(C2(C(O)OCC2O1)O)O)O,32,2,0,2,0,9.499999999999999e-05
G5,CC12C(C(C(O)O1)(C(CO)O2)O)O,32,1,0,1,0,4.7e-05
G5,C1C(C2(C(C)(O1)OC(C2O)O)O)O,32,1,0,1,0,4.7e-05
G5,CC1(C2(C(CO1)OC(C2O)O)O)O,32,2,0,2,0,9.499999999999999e-05
G5,C12C(C(C(CO)O1)(C(C)(O)O2)O)O,32,1,0,1,0,4.7e-05
G5,C12C(C(CO1)O)(C(C(O)O2)O)O,32,1,0,1,0,4.7e-05
G5,C1C2C(C(O)O1)(C(C(O)O2)O)O,32,2,0,2,0,9.499999999999999e-05
G5,C12C(C(C(O)O1)(C(CO)O2)O)O,32,1,0,1,0,4.7e-05
G5,C12C(C)(C(C(O)O1)(C(CO)O2)O)O,32,1,0,1,45,4.7e-05
G5,CC1(C(O)OC2COC(C21O)O)O,32,2,0,2,45,9.499999999999999e-05
G5,C12C(C(CO1)O)(C(C)(C(O)O2)O)O,32,1,0,1,45,4.7e-05
G5,C12C(C(CO1)(C(CCO)(O)O2)O)O,16,1,0,1,2,4.7e-05
G5,C12C(CC(O)O1)(C(CO2)(CO)O)O,16,1,0,1,43,4.7e-05
G5,C1C2(CO)C(C(O)O1)(CC(O)O2)O,16,2,0,2,43,9.499999999999999e-05
G5,C12CC(C(O)O1)(C(CO)(CO)O2)O,8,1,0,1,43,4.7e-05
G5,C12C(CC(O)O1)(C(C(CO)O2)O)O,32,1,0,1,41,4.7e-05
G5,C1(C2(CC(O)OC2C(CO)O1)O)O,32,2,0,2,41,9.499999999999999e-05
G5,C12CC(C(O)O1)(C(C(CO)O)O2)O,32,1,0,1,41,4.7e-05
G5,C(C)(C1C2(C(O)OC(C2)O1)O)=O,16,1,0,1,49,4.7e-05
G5,C(C1(C)C2(C(O)OC(C2)O1)O)=O,16,1,0,1,49,4.7e-05
G5,C(C1C2(C(O)OC(CO)(C2)O1)O)=O,16,1,0,1,51,4.7e-05
G5,C(C1C2(C(O)OC(C2)O1)O)=O,16,1,0,1,2,4.7e-05
G5,C1C2(C(O)OC(CO)(C2)O1)O,8,1,0,1,2,4.7e-05
G5,CC1C2(C(O)OC(CO)(C2)O1)O,16,1,0,1,41,4.7e-05
G5,C1C2(C(O)OC(C2)O1)O,8,1,0,1,27,4.7e-05
G5,C1C2(CC(O1)OC2(C(CO)O)O)O,16,1,0,1,2,4.7e-05
G5,C1C2(CC(CO)OC2(C(O)O1)O)O,16,2,0,2,0,9.499999999999999e-05
G5,C1C2(CC(CO)(OC2(CO)O)O1)O,8,1,0,1,32,4.7e-05
G5,C(C12CC(CO1)(C(C)(O2)O)O)=O,8,1,0,1,45,4.7e-05
G5,C(CC1(C2(COC(C2)O1)O)O)=O,8,1,0,1,2,4.7e-05
G5,C(C)(C12CC(C(O1)O)(CO2)O)=O,8,1,0,1,14,4.7e-05
G5,C(CC12CC(CO1)(C(O)O2)O)=O,8,1,0,1,14,4.7e-05
G5,C(C1C(C2(C(O1)OC(C2)O)O)O)=O,32,1,0,1,1,4.7e-05
G5,C(C1C2C(C(O1)O)(CC(O)O2)O)=O,32,2,0,2,1,9.499999999999999e-05
G5,C(CC12C(O)OC(C(O)O1)C2O)=O,32,2,0,2,1,9.499999999999999e-05
G5,C(C(C1C2(C(O)OC(C2)O1)O)O)=O,32,1,0,1,1,4.7e-05
G5,C(C12CC(O)OC1C(C(O2)O)O)=O,32,2,0,2,1,9.499999999999999e-05
G5,C12C(CC(O)O1)(C(CO2)(C)O)O,16,1,0,1,49,4.7e-05
G5,C1C2(C)C(C(O)O1)(CC(O)O2)O,16,2,0,2,29,9.499999999999999e-05
G5,CC1(CO)C2(C(O)OC(C2)O1)O,16,1,0,1,29,4.7e-05
G5,C12CC(C(O)O1)(C(C)O2)O,16,1,0,1,4,4.7e-05
G5,C(C12CC(C(C)(O1)O)(C(C)O2)O)=O,16,1,0,1,45,4.7e-05
G5,C(CC1(C2(C(C)OC(C2)O1)O)O)=O,16,1,0,1,4,4.7e-05
G5,C(C)(C12CC(C(O1)O)(C(C)O2)O)=O,16,1,0,1,14,4.7e-05
G5,C(CC12CC(C(O)O1)(C(C)O2)O)=O,16,1,0,1,25,4.7e-05
G5,C1C(C2(C(O1)OC(CO)(C2)O)O)O,16,1,0,1,51,4.7e-05
G5,C1C2C(C(O)O1)(CC(CO)(O)O2)O,16,2,0,2,51,9.499999999999999e-05
G5,C1(C2(C(CO)OC(CO)(C2)O1)O)O,16,1,0,1,51,4.7e-05
G5,C12CC(C(O)O1)(C(CO)O2)O,16,1,0,1,0,4.7e-05
G5,C1C2(C(O)OC(C2)(C(CO)O)O1)O,16,1,0,1,14,4.7e-05
G5,C1C2(COC(C(C2)(O)O1)O)O,8,2,0,2,5,9.499999999999999e-05
G5,C1C2(CO)C(C(CC(O)O2)(O)O1)O,16,2,0,2,2,9.499999999999999e-05
G5,C1C2(CO)CC(C(C(O)O2)O)(O)O1,16,2,0,2,5,9.499999999999999e-05
G5,C1CC2(C(O)OC(CO)(C2O)O1)O,16,1,0,1,5,4.7e-05
G5,C1C2(COC(C(C2CO)(O)O1)O)O,16,2,0,2,5,9.499999999999999e-05
G5,C(C1(C2C(C(CC(O)O2)O1)O)O)O,32,2,0,2,51,9.499999999999999e-05
G5,C(C1(C(C2CC(C(O)O2)O1)O)O)O,32,2,0,2,51,9.499999999999999e-05
G5,C1C(CO)(C2C(O)OC(C2O)O1)O,32,1,0,1,51,4.7e-05
G5,C1C2(COC(C2C(C(O)O1)O)O)O,32,2,0,2,51,9.499999999999999e-05
G5,C1C2C(C(C(O)O1)C(CO)(O)O2)O,32,2,0,2,41,9.499999999999999e-05
G5,C1C2C(C(C(O)O2)C(CO)(O)O1)O,32,2,0,2,38,9.499999999999999e-05
G5,C1C(C(C2C(O)OCC2(O)O1)O)O,32,2,0,2,30,9.499999999999999e-05
G5,C1C(C(C2C(CC(O)O2)(O)O1)O)O,32,2,0,2,3,9.499999999999999e-05
G5,C1(CC2(C(C(C(CO)O2)O1)O)O)O,32,2,0,2,49,9.499999999999999e-05
G5,C1(C(C2(CC(C(CO)O2)O1)O)O)O,32,2,0,2,29,9.499999999999999e-05
G5,C1C2C(C(O)O1)(O)OCC(C2O)O,32,2,0,2,41,9.499999999999999e-05
G5,C12C(C(C(O)O1)C(C(CO)O2)O)O,64,1,0,1,37,4.7e-05
G5,C12C(C(C(O)O1)O)C(C(CO2)O)O,64,1,0,1,41,4.7e-05
G5,C1C(C2C(C(O)O1)C(C(O)O2)O)O,64,2,0,2,41,9.499999999999999e-05
G5,C1(COC2(C)C(C1C(O)O2)O)=O,16,1,0,1,24,4.7e-05
G5,C1(COC2C(C)(C1C(O)O2)O)=O,16,1,0,1,16,4.7e-05
G5,C1C(C2(C)CC(C(O)O2)(O)O1)O,16,2,0,2,16,9.499999999999999e-05
G5,C(C12CCOC(C1)(C(O2)O)O)=O,8,2,0,2,29,9.499999999999999e-05
G5,C(C12CC(C(O1)O)(CCO2)O)=O,8,1,0,1,29,4.7e-05
G5,C1CC2(CO)CC(C(O)O2)(O)O1,8,2,0,2,29,9.499999999999999e-05
G5,C1(C(O)OC2C(C1)OC(C2)O)=O,16,2,0,2,20,9.499999999999999e-05
G5,C(C1CC2CC(C(O)O2)(O1)O)=O,16,2,0,2,20,9.499999999999999e-05
G5,C(C1(CC2CC(C(O)O2)O1)O)=O,16,2,0,2,20,9.499999999999999e-05
G5,C1(C(O)OC2C(C1)OC(C2O)O)=O,32,2,0,2,0,9.499999999999999e-05
G5,C(C1C(C2CC(C(O)O2)(O1)O)O)=O,32,2,0,2,0,9.499999999999999e-05
G5,C(C1(CC2C(C(C(O)O2)O1)O)O)=O,32,2,0,2,0,9.499999999999999e-05
G5,C1C2(C(CO)OC(C(O)O1)(C2)O)O,16,2,0,2,51,9.499999999999999e-05
G5,C1C2(C(CO)OC(C(C2)(O)O1)O)O,16,2,0,2,51,9.499999999999999e-05
G5,C1C(C2(CO)CC(C(O)O2)(O)O1)O,16,2,0,2,51,9.499999999999999e-05
G5,C1(COC2C(C1C(O)O2)O)=O,16,1,0,1,15,4.7e-05
G5,C1(C2C(C(C(O2)O)O)OC(C1)O)=O,32,2,0,2,1,9.499999999999999e-05
G5,C(C1C2C(C(CC(O)O2)(O1)O)O)=O,32,2,0,2,1,9.499999999999999e-05
G5,C1C2(C)C(C(CC(O)O2)(O)O1)O,16,2,0,2,49,9.499999999999999e-05
G5,C(C1C2CC(C(C(O)O2)O)(O1)O)=O,32,2,0,2,1,9.499999999999999e-05
G5,C1C2(C)CC(C(C(O)O2)O)(O)O1,16,2,0,2,49,9.499999999999999e-05
G5,C(C12CC(O)OC(C(O)O1)C2)O,16,2,0,2,21,9.499999999999999e-05
G5,C1C(CC2(C(C(CO2)O)(O)O1)O)O,16,2,0,2,0,9.499999999999999e-05
G5,C1C(C2(CC(C(CO)O2)(O)O1)O)O,16,2,0,2,2,9.499999999999999e-05
G5,C1CC2(C(C(C(CO)O2)(O)O1)O)O,16,2,0,2,2,9.499999999999999e-05
G5,C1C2C(CO)(O)OCC(C2O)(O)O1,16,2,0,2,2,9.499999999999999e-05
G5,C1C2C(O)OC(C(CO)(O)O1)C2O,32,2,0,2,5,9.499999999999999e-05
G5,C1(COC2(C(O)OCC2C1)O)=O,8,2,0,2,12,9.499999999999999e-05
G5,C(C1(C2COC(CO1)(C2)O)O)=O,8,2,0,2,12,9.499999999999999e-05
G5,C1(C(O)OC2CC(O)OCC12)=O,16,2,0,2,2,9.499999999999999e-05
G5,C(C1COC2(C(O)OC1C2)O)=O,16,2,0,2,23,9.499999999999999e-05
G5,C(C1COC2(COC1(C2)O)O)=O,8,2,0,2,48,9.499999999999999e-05
G5,C1(COC2(CC(O)OCC12)O)=O,8,2,0,2,12,9.499999999999999e-05
G5,C1(C2C(C)(O)OCC1C(O2)O)=O,16,2,0,2,26,9.499999999999999e-05
G5,C1(C2C(CC(O2)O)(O)OCC1)=O,8,2,0,2,9,9.499999999999999e-05
G5,C1(C2C(O)OCC1C(C)(O2)O)=O,16,2,0,2,12,9.499999999999999e-05
G5,C(C1C2(CC(CCO2)(O1)O)O)=O,8,2,0,2,30,9.499999999999999e-05
G5,C(C1C2(CC(CO2)C(O1)O)O)=O,16,2,0,2,55,9.499999999999999e-05
G5,C1(C(O)OC2C(C(O)OCC12)O)=O,32,2,0,2,15,9.499999999999999e-05
G5,C(C1(C2COC(C(C2O)O1)O)O)=O,32,2,0,2,15,9.499999999999999e-05
G5,C1CC2(C(O)OC(CO)(C2)O1)O,8,1,0,1,3,4.7e-05
G5,C1CC2(C(O)OC(C)(C2O)O1)O,16,1,0,1,3,4.7e-05
G5,C12CC(C(O)O1)(CCO2)O,8,1,0,1,3,4.7e-05
G5,C1C2C(CO)(O)OC(C(O)O1)C2O,32,2,0,2,12,9.499999999999999e-05
G5,CC1(C2C(C(CC(O)O2)O1)O)O,32,2,0,2,43,9.499999999999999e-05
G5,CC12CC(O)OC(C(O)O1)C2O,32,2,0,2,16,9.499999999999999e-05
G5,C(C1C(C2C(O)OC(C2O)O1)O)=O,64,1,0,1,43,4.7e-05
G5,C(C1C2C(O)OC(C(O1)O)C2O)=O,64,2,0,2,43,9.499999999999999e-05
G5,C(C1C2C(O)OC1C(C(O)O2)O)=O,64,2,0,2,43,9.499999999999999e-05
G5,C1(C2CC(CC(CO)(O)O2)O1)O,16,2,0,2,21,9.499999999999999e-05
G5,CC1(C(C2CC(C(O)O2)O1)O)O,32,2,0,2,49,9.499999999999999e-05
G5,C1C(C)(C2C(O)OC(C2O)O1)O,32,1,0,1,49,4.7e-05
G5,C(C1(CC2C(C(C(O)O2)O1)O)O)O,32,2,0,2,20,9.499999999999999e-05
G5,CC1(C2C(C(C(C(O)O2)O)O1)O)O,64,2,0,2,49,9.499999999999999e-05
G5,CC1(C(C2C(C(C(O)O2)O1)O)O)O,64,2,0,2,20,9.499999999999999e-05
G5,C1(CC2CC(C(O)O2)O1)O,16,2,0,2,43,9.499999999999999e-05
G5,C1(C(O)OC2(CCOC(C2)O)C1)=O,8,2,0,2,30,9.499999999999999e-05
G5,C1(C(O)OC2(COC(C2)O)CC1)=O,8,2,0,2,29,9.499999999999999e-05
G5,C1(COC2(C(O)OC(C)C2C1)O)=O,16,2,0,2,12,9.499999999999999e-05
G5,C(C1(C2CC(CO1)(O)OC2C)O)=O,16,2,0,2,12,9.499999999999999e-05
G5,C(C12CC(O)OC(C1)C(C)(O2)O)=O,16,2,0,2,22,9.499999999999999e-05
G5,C(C)(C1CC2(C(O)OC(C2)O1)O)=O,16,1,0,1,22,4.7e-05
G5,C1(C(O)OC2(C)C(C1)OC(C2)O)=O,16,2,0,2,22,9.499999999999999e-05
G5,C(CC12C(O)OC(C1)CC(O)O2)=O,16,2,0,2,13,9.499999999999999e-05
G5,C(CC1CC2(C(O)OC(C2)O1)O)=O,16,1,0,1,13,4.7e-05
G5,C(CC1CC2CC(C(O)O2)(O)O1)=O,16,2,0,2,13,9.499999999999999e-05
G5,C1(C(O)OC2CC(O)OC(C)C12)=O,32,2,0,2,4,9.499999999999999e-05
G5,C(C1C(C)OC2(C(O)OC1C2)O)=O,32,2,0,2,23,9.499999999999999e-05
G5,C1(CC(OC21CC(O)OCC2)O)=O,8,2,0,2,53,9.499999999999999e-05
G5,C(CC1(C2(CC(OCC2)O1)O)O)=O,8,1,0,1,53,4.7e-05
G5,C(CC1CC2(CC(CO2)(O)O1)O)=O,8,2,0,2,26,9.499999999999999e-05
G5,C1(CC2(COC(C2)O)OC(C1)O)=O,8,2,0,2,26,9.499999999999999e-05
G5,C(CC12COC(C1)(CC(O)O2)O)=O,8,2,0,2,26,9.499999999999999e-05
G5,C(C1C(C)OC2(COC1(C2)O)O)=O,16,2,0,2,4,9.499999999999999e-05
G5,C1(COC2(CC(O)OC(C)C12)O)=O,16,2,0,2,4,9.499999999999999e-05
G5,C1(C2C(C)(CC(O2)O)OC(C1)O)=O,16,2,0,2,6,9.499999999999999e-05
G5,C1(C2C(C)(O)OC(C)C1C(O2)O)=O,32,2,0,2,9,9.499999999999999e-05
G5,C1(C2C(CC(O2)O)(O)OC(C)C1)=O,16,2,0,2,9,9.499999999999999e-05
G5,C(CC1(C2CC(CC(O)O2)O1)O)=O,16,2,0,2,13,9.499999999999999e-05
G5,C1(C2C(CC(O2)O)OC(C)(C1)O)=O,16,2,0,2,26,9.499999999999999e-05
G5,C1(C2C(O)OC(C)C1C(C)(O2)O)=O,32,2,0,2,2,9.499999999999999e-05
G5,C(C1C2(CC(CC(C)O2)(O1)O)O)=O,16,2,0,2,4,9.499999999999999e-05
G5,C(C1C2(CC(C(O1)O)C(C)O2)O)=O,32,2,0,2,46,9.499999999999999e-05
G5,C1(C(C)(O)OC2C(C1)OC(C2)O)=O,16,2,0,2,21,9.499999999999999e-05
G5,C(C)(C12CC(O)OC(C1)C(O2)O)=O,16,2,0,2,21,9.499999999999999e-05
G5,C(C1CC2(CC(O1)OC2(C)O)O)=O,16,1,0,1,21,4.7e-05
G5,C=CC1(C2C(C(CC(O)O2)O1)O)O,32,2,0,2,7,9.499999999999999e-05
G5,C=CC12CC(O)OC(C1O)C(O2)O,32,2,0,2,7,9.499999999999999e-05
G5,C1C2(C(C(O)O1)OC(C(C2)O)O)O,32,2,0,2,20,9.499999999999999e-05
G5,C1(C(C2(CO)CC(C(O)O2)O1)O)O,32,2,0,2,20,9.499999999999999e-05
G5,C12C(C(C(CO1)O)C(CO)(O)O2)O,32,1,0,1,20,4.7e-05
G5,C12C(C(C(O)O1)(CCO2)O)O,16,1,0,1,30,4.7e-05
G5,CC1(C2C(O)OC1C(C(O)O2)O)O,64,2,0,2,5,9.499999999999999e-05
G5,CC12C(C(O)OC(C(O)O1)C2O)O,64,2,0,2,26,9.499999999999999e-05
G5,C12C(C(C(O)O1)C(CO2)O)O,32,1,0,1,30,4.7e-05
G5,C1(C(C2C(C(C(O)O2)O1)O)O)O,64,2,0,2,15,9.499999999999999e-05
G5,C1(C2(CC(C(C(CO)O2)O)O1)O)O,32,2,0,2,20,9.499999999999999e-05
G5,C1C2C(COC2(C(C(O)O1)O)O)O,32,2,0,2,54,9.499999999999999e-05
G5,C1CC2CC(C(O)O2)(O)O1,8,2,0,2,4,9.499999999999999e-05
G5,C1(CC2CC(C(O)O2)(O)O1)=O,8,2,0,2,28,9.499999999999999e-05
G5,C1C2(CC(O)OCC2(C(O)O1)O)O,16,2,0,2,41,9.499999999999999e-05
G5,CC1(C2(C(O)OCC(C2O)O1)O)O,32,2,0,2,1,9.499999999999999e-05
G5,CC1(C2(C(O)OC(CO1)C2O)O)O,32,2,0,2,26,9.499999999999999e-05
G5,CC1(C2C(C(CO1)(C(O)O2)O)O)O,32,2,0,2,26,9.499999999999999e-05
G5,CC1(C2C(O)OCC1(C(O)O2)O)O,32,2,0,2,19,9.499999999999999e-05
G5,C1C2(C(O)OCCC2(C(O)O1)O)O,16,2,0,2,3,9.499999999999999e-05
G5,C12C(CO)(C(C(O)O1)(CCO2)O)O,16,1,0,1,3,4.7e-05
G5,C1C2C(C(C(O)O2)(C(O)O1)O)O,32,2,0,2,1,9.499999999999999e-05
G5,C1C2(C(O)OC(C(O)O1)C2O)O,32,2,0,2,1,9.499999999999999e-05
G5,C1(C(CO)(C2CC(C(O)O2)O1)O)O,32,2,0,2,43,9.499999999999999e-05
G5,CC1(C2COC(C1(C(O)O2)O)O)O,32,2,0,2,35,9.499999999999999e-05
G5,CC1(C2(COC(C(C2O)O1)O)O)O,32,2,0,2,12,9.499999999999999e-05
G5,C1C2(C(C)(O)OCC(C2O)(O)O1)O,16,2,0,2,5,9.499999999999999e-05
G5,C1C2(C(O)OC(C)C(C2O)(O)O1)O,32,2,0,2,25,9.499999999999999e-05
G5,C(C1(C2OC(C1(CCO2)O)O)O)=O,16,1,0,1,3,4.7e-05
G5,C1C2(CCOC(C2(C(O)O1)O)O)O,16,2,0,2,1,9.499999999999999e-05
G5,C(C12C(O)OC(C1O)CC(O2)O)=O,32,2,0,2,43,9.499999999999999e-05
G5,C(C1(C(O)OC2C(O)OC1C2)O)=O,32,2,0,2,1,9.499999999999999e-05
G5,C1C(C)(C2(C(O)OC(C2O)O1)O)O,32,1,0,1,27,4.7e-05
G5,C1C(C2(C(O)OC(C)(C2O)O1)O)O,32,1,0,1,24,4.7e-05
G5,C12C(C(C(C)(O)O1)(C(CO2)O)O)O,32,1,0,1,26,4.7e-05
G5,C12C(C(C(O)O1)(C(CO2)O)O)O,32,1,0,1,15,4.7e-05
G5,C12C(C)(C(C(O)O1)(C(CO2)O)O)O,32,1,0,1,16,4.7e-05
G5,C1C(C2(COC(CC2(O)O1)O)O)O,16,2,0,2,9,9.499999999999999e-05
G5,C1C(CO)(C2(C(O)OC(C2)O1)O)O,16,1,0,1,43,4.7e-05
G5,C1C2(COC(C2(CC(O)O1)O)O)O,16,2,0,2,43,9.499999999999999e-05
G5,C12CC(C(O)O1)(C(C(CO)O2)O)O,32,1,0,1,37,4.7e-05
G5,C1C(C(C2(C(O1)OC(C2)O)O)O)O,32,1,0,1,41,4.7e-05
G5,C1C(C2C(C(O)O1)(CC(O)O2)O)O,32,2,0,2,41,9.499999999999999e-05
G5,C(C1C2(C(O)OCC(C2)(O1)O)O)=O,16,2,0,2,51,9.499999999999999e-05
G5,C1(COC2C(C(C(O)O2)O)(C1)O)=O,16,1,0,1,51,4.7e-05
G5,C1C2(CC(CO2)(C(O)O1)O)O,8,2,0,2,2,9.499999999999999e-05
G5,C1C2(CC(C(O)O1)(C(C)O2)O)O,16,2,0,2,41,9.499999999999999e-05
G5,C1C(CC2(COC(C2(O)O1)O)O)O,16,2,0,2,20,9.499999999999999e-05
G5,C1C2(C(O)OC(C2)C(CO)(O)O1)O,16,2,0,2,43,9.499999999999999e-05
G5,C1C2(CC(C(O)O1)OC2(CO)O)O,16,2,0,2,32,9.499999999999999e-05
G5,C1C2(CCOC2(C(C(O)O1)O)O)O,16,2,0,2,2,9.499999999999999e-05
G5,C1C2(CC(CO2)(C(CO)(O)O1)O)O,8,2,0,2,32,9.499999999999999e-05
G5,C(C1C(C2(C(O)OC(C2)O1)O)O)=O,32,1,0,1,1,4.7e-05
G5,C(C12CC(O)OC(C1O)C(O2)O)=O,32,2,0,2,1,9.499999999999999e-05
G5,C1C(C)(C2(C(O)OC(C2)O1)O)O,16,1,0,1,43,4.7e-05
G5,C1C(C2(C(O)OC(CO)(C2)O1)O)O,16,1,0,1,51,4.7e-05
G5,C1C2(CC(C(O)O1)(C(CO)O2)O)O,16,2,0,2,51,9.499999999999999e-05
G5,C1C2(C(O)OC(CO)C(C2)(O)O1)O,16,2,0,2,2,9.499999999999999e-05
G5,C(C1(CC2CC(O)OCC2O1)O)=O,16,2,0,2,46,9.499999999999999e-05
G5,C(C1(CC2CC(O)OC2CO1)O)=O,16,2,0,2,46,9.499999999999999e-05
G5,C1(C(CO)OC2C(CC(O)O2)C1)=O,16,1,0,1,43,4.7e-05
G5,C(C1C2C(CC(O)O2)CC(O1)O)=O,32,2,0,2,43,9.499999999999999e-05
G5,C1C2(CC(C(C(CO)(O)O1)O2)O)O,16,2,0,2,12,9.499999999999999e-05
G5,C1C2(C(C(CO2)(CC(O)O1)O)O)O,16,2,0,2,5,9.499999999999999e-05
G5,C1C2(COC(CC(C2O)(O)O1)O)O,16,2,0,2,5,9.499999999999999e-05
G5,C1C2(C(C(C(C(C)(O)O1)O2)O)O)O,32,2,0,2,5,9.499999999999999e-05
G5,C1C2(C(C(C)(C(C(O)O1)O2)O)O)O,32,2,0,2,5,9.499999999999999e-05
G5,C1C2(COC(C(C(C2)(O)O1)O)O)O,16,2,0,2,5,9.499999999999999e-05
G5,C1CC2(C(C(C(CO)(O2)O1)O)O)O,16,1,0,1,30,4.7e-05
G5,C1C2(C(C(C(C(O)O1)O2)O)O)O,32,2,0,2,5,9.499999999999999e-05
G5,C1C2C(C(C(O)O2)C(C(O)O1)O)O,64,2,0,2,30,9.499999999999999e-05
G5,C12C(C(C(O)O1)C(C(CO2)O)O)O,64,1,0,1,30,4.7e-05
G5,C1(COC2(C(O)OC(C2)C1)O)=O,8,2,0,2,20,9.499999999999999e-05
G5,CC1(C2COC(C(C1)(O)O2)O)O,16,2,0,2,29,9.499999999999999e-05
G5,C1C(C2(CC(C(C)(O2)O1)O)O)O,16,1,0,1,45,4.7e-05
G5,C1C(C2(CC(C(O1)O2)(C)O)O)O,16,1,0,1,16,4.7e-05
G5,C1(C2CC(C(O2)O)(O)OCC1)=O,8,2,0,2,2,9.499999999999999e-05
G5,C(C12CC(C(CCO1)(O2)O)O)=O,8,1,0,1,20,4.7e-05
G5,C1C2(CCOC(C(C2)(O)O1)O)O,8,2,0,2,29,9.499999999999999e-05
G5,C1CC2(C(C(C(C)(O2)O1)O)O)O,16,1,0,1,45,4.7e-05
G5,C12C(C)(C(C(CCO1)(O)O2)O)O,16,1,0,1,45,4.7e-05
G5,C1(C(O)OC2C(O)OC(C2)C1)=O,16,2,0,2,20,9.499999999999999e-05
G5,C1(C(O)OC2C(O)OC(C2O)C1)=O,32,2,0,2,0,9.499999999999999e-05
G5,C(C1C2C(CC(C(O1)O)(O)O2)O)=O,32,2,0,2,0,9.499999999999999e-05
G5,C1C(C2(COC(C(O)O1)(C2)O)O)O,16,2,0,2,51,9.499999999999999e-05
G5,C1C2C(CO)(CC(C(O)O1)(O)O2)O,16,2,0,2,51,9.499999999999999e-05
G5,C1C(C2(C(C(C(C)(O2)O1)O)O)O)O,32,1,0,1,0,4.7e-05
G5,C12C(C)(C(C(C(CO1)O)(O)O2)O)O,32,1,0,1,42,4.7e-05
G5,C1(COC(C2C(C1C(O)O2)O)O)=O,32,2,0,2,1,9.499999999999999e-05
G5,C(C1C2(COC(C(C1O)O2)O)O)=O,32,2,0,2,1,9.499999999999999e-05
G5,C1(C2C(C(C(O2)O)OC(C1)O)O)=O,32,2,0,2,1,9.499999999999999e-05
G5,C1C2(CC(CO2)(CC(O)O1)O)O,8,2,0,2,49,9.499999999999999e-05
G5,C1C2(CC(C(C(C)(O)O1)O2)O)O,16,2,0,2,49,9.499999999999999e-05
G5,C(C1C2(CC(C(C(O1)O)O2)O)O)=O,32,2,0,2,1,9.499999999999999e-05
G5,C1C2(CC(C)(C(C(O)O1)O2)O)O,16,2,0,2,55,9.499999999999999e-05
G5,C(C1CC2(C(C(C(O1)O2)O)O)O)=O,32,1,0,1,0,4.7e-05
G5,C(C1C(C2(CC(C(O1)O2)O)O)O)=O,32,1,0,1,0,4.7e-05
G5,C1C(C2(C(C(C(O2)O1)O)O)O)O,32,1,0,1,5,4.7e-05
G5,CC1C(C2(CC(C(O2)O1)O)O)O,32,1,0,1,11,4.7e-05
G5,C1C(C2(C(CC(CO)(O2)O1)O)O)O,16,1,0,1,32,4.7e-05
G5,C1C(C2(CC(C(CO)(O2)O1)O)O)O,16,1,0,1,2,4.7e-05
G5,C(C12CCC(C(CO1)O)(O2)O)=O,8,1,0,1,12,4.7e-05
G5,C(C1COC2CC(C1(O)O2)O)=O,16,1,0,1,38,4.7e-05
G5,C1(C2CC(O)OCC1C(O2)O)=O,16,2,0,2,38,9.499999999999999e-05
G5,C1CC2(C(CC(CO)(O2)O1)O)O,8,1,0,1,20,4.7e-05
G5,CC1CC2(C(C(C(O2)O1)O)O)O,32,1,0,1,11,4.7e-05
G5,C1(C2OC(C(CO)C(C)O2)(C1)O)=O,16,1,0,1,4,4.7e-05
G5,C(C12CCC(C(C(C)O1)O)(O2)O)=O,16,1,0,1,12,4.7e-05
G5,C(C)(C1CC2(C(CC(O1)O2)O)O)=O,16,1,0,1,45,4.7e-05
G5,C1(C2CC(C(O2)O)(O)OC(C)C1)=O,16,2,0,2,22,9.499999999999999e-05
G5,C(C12CC(C(CC(C)O1)(O2)O)O)=O,16,1,0,1,22,4.7e-05
G5,C(CC1CC2(C(CC(O1)O2)O)O)=O,16,1,0,1,13,4.7e-05
G5,C1(C2(C(CO)C(C)OC(C1)O2)O)=O,16,1,0,1,4,4.7e-05
G5,C1(C2(CC(O)OC(C)C1CO2)O)=O,16,2,0,2,4,9.499999999999999e-05
G5,C(C1C(C)OC2CC(C1(O)O2)O)=O,32,1,0,1,4,4.7e-05
G5,C1(C2CC(O)OC(C)C1C(O2)O)=O,32,2,0,2,4,9.499999999999999e-05
G5,C(CC1C(C2(CCC(O1)O2)O)O)=O,16,1,0,1,45,4.7e-05
G5,C1(C2C(CC(O2)O)OC(CC1)O)=O,16,2,0,2,45,9.499999999999999e-05
G5,C(C1CC2(C(C)(CC(O1)O2)O)O)=O,16,1,0,1,21,4.7e-05
G5,C1(CC2C(CC(O)O2)OC(C1)O)=O,16,2,0,2,6,9.499999999999999e-05
G5,C(CC1CC2(CC(C(O1)O2)O)O)=O,16,1,0,1,26,4.7e-05
G5,C(C1C(C)OC2C(CC1(O)O2)O)=O,32,1,0,1,37,4.7e-05
G5,C1C2C(C(CC(C(O)O2)O)(O)O1)O,32,2,0,2,0,9.499999999999999e-05
G5,C12C(CC(C(C(CO)O1)O)(O)O2)O,32,1,0,1,0,4.7e-05
G5,C1C2CC(C(C(C(O)O2)O)O)(O)O1,32,2,0,2,0,9.499999999999999e-05
G5,C12C(C(C(CC(CO)O1)(O)O2)O)O,32,1,0,1,0,4.7e-05
G5,C1(C2(CC(C(C(CO)O1)O2)O)O)O,32,2,0,2,12,9.499999999999999e-05
G5,C1C(C(C2CC(C(O)O2)(O)O1)O)O,32,2,0,2,20,9.499999999999999e-05
G5,C1C2C(O)OC(C(C(O)O1)O)C2O,64,2,0,2,43,9.499999999999999e-05
G5,C1C2(C(O)OCCC(C2O)(O)O1)O,16,2,0,2,2,9.499999999999999e-05
G5,C12C(CO)(C(C(CCO1)(O)O2)O)O,16,1,0,1,2,4.7e-05
G5,C1C2(C(O)OC(CC(O)O1)C2O)O,32,2,0,2,43,9.499999999999999e-05
G5,C(C12C(O)OCC(CC1O)(O2)O)=O,16,2,0,2,40,9.499999999999999e-05
G5,C(C1(COC2CCC1(O)O2)O)=O,8,1,0,1,38,4.7e-05
G5,C(C1(C2OCCC(C1O)(O)O2)O)=O,16,1,0,1,3,4.7e-05
G5,C(C1(C(C)OC2CCC1(O)O2)O)=O,16,1,0,1,4,4.7e-05
G5,C1C2C(C(C(O)O2)(CC(O)O1)O)O,32,2,0,2,41,9.499999999999999e-05
G5,C1C(C(C2(C(O)OC(C2)O1)O)O)O,32,1,0,1,41,4.7e-05
G5,C(C1(C2C(O)OCC(C1)(O)O2)O)=O,16,2,0,2,51,9.499999999999999e-05
G5,C1(COC2C(C(C(O)O2)(C1)O)O)=O,16,1,0,1,51,4.7e-05
G5,C1C2(C(CC(C(O)O1)(CO)O2)O)O,16,2,0,2,43,9.499999999999999e-05
G5,C1C2(C(O)OC(C2)C(C(O)O1)O)O,32,2,0,2,43,9.499999999999999e-05
G5,C1C(C)(C2(C(C(C(O1)O2)O)O)O)O,32,1,0,1,30,4.7e-05
G5,C1C(C2(CC(CO2)(C(O)O1)O)O)O,16,2,0,2,43,9.499999999999999e-05
G5,C1C(C2(CC(C(O1)O2)(CO)O)O)O,16,1,0,1,43,4.7e-05
G5,C1(C(O)OCC2C(CC(O)O2)C1)=O,16,2,0,2,46,9.499999999999999e-05
G5,C(CC1CC2(C(O)OCC1O2)O)=O,16,2,0,2,46,9.499999999999999e-05
G5,C(C1C2(CC(CO2)CC(O1)O)O)=O,16,2,0,2,55,9.499999999999999e-05
G5,C1(C(CO)OC2CC(C(O)O2)C1)=O,16,1,0,1,43,4.7e-05
G5,C1(C(COC2C(CC(O)O2)C1)O)=O,16,1,0,1,38,4.7e-05
G5,C(CC1C2OC(C1)(C(CO2)O)O)=O,16,1,0,1,38,4.7e-05
G5,C(CC1CC2OC1(C(CO2)O)O)=O,16,1,0,1,46,4.7e-05
G5,C(C1C2CC(COC(C2)O)(O1)O)=O,16,2,0,2,32,9.499999999999999e-05
G5,C1(COC(C2C(CC(O)O2)C1)O)=O,16,2,0,2,32,9.499999999999999e-05
G5,C(CC1C2C(O)OCC(C1)(O)O2)=O,16,2,0,2,32,9.499999999999999e-05
G5,C1(C2(C)CC(C(O2)O)O1)=O,8,2,0,2,14,9.499999999999999e-05
G5,C1(C2(C(C(C(CO)O2)O1)O)O)=O,16,2,0,2,29,9.499999999999999e-05
G5,C1(C2C(CO1)(CC(O2)O)O)=O,8,2,0,2,29,9.499999999999999e-05
G5,C1(C2C(C)(C(C(O2)O)O1)O)=O,16,2,0,2,2,9.499999999999999e-05
G5,C1(C2C(C(C(O2)O)O1)O)=O,16,2,0,2,17,9.499999999999999e-05
G5,C1(C(C2C(C(C(O)O2)O)O1)O)=O,32,2,0,2,29,9.499999999999999e-05
G5,C1(C(C2C(C(C(O)O2)O1)O)O)=O,32,2,0,2,29,9.499999999999999e-05
G5,C1(C2(C(C(C(CO1)O2)O)O)O)=O,16,2,0,2,29,9.499999999999999e-05
G5,C(C1C2C(C(C(C2)(O1)O)O)O)=O,32,2,0,2,12,9.499999999999999e-05
G5,C1(C(C2C(C(C(O)O2)O)C1)O)=O,32,1,0,1,12,4.7e-05
G5,C(C1C2CC(C(C2(C)O)O)(O1)O)=O,32,2,0,2,32,9.499999999999999e-05
G5,C1(C(C2(C)C(C(C(O)O2)O)C1)O)=O,32,1,0,1,32,4.7e-05
G5,C12CCC(C(C1O)O)(O)O2,16,1,0,1,7,4.7e-05
G5,C(C1(C(C2(CCC1O2)O)O)O)=O,16,1,0,1,20,4.7e-05
G5,C1(CCC2C1(C(C(O)O2)O)O)=O,16,2,0,2,12,9.499999999999999e-05
G5,C(C1(C2(CC(CO2)C1(C)O)O)O)=O,16,2,0,2,29,9.499999999999999e-05
G5,C1(CC2C(OC1(CO)C2(C)O)O)=O,16,3,0,3,41,0.00014199999999999998
G5,C(C1(C(C2(CCC1(C)O2)O)O)O)=O,16,1,0,1,7,4.7e-05
G5,C1(CCC2(C)C1(C(C(O)O2)O)O)=O,16,2,0,2,12,9.499999999999999e-05
G5,C(C1C2C(C(C(C1)(O)O2)O)O)O,32,1,0,1,55,4.7e-05
G5,C1C2CC(C(C(C2O)O)O)(O)O1,32,2,0,2,55,9.499999999999999e-05
G5,C(CC1C2C(C(C(C1)(O)O2)O)O)O,32,1,0,1,46,4.7e-05
G5,CC(C1C2C(C(C(C1)(O)O2)O)O)O,64,1,0,1,46,4.7e-05
G5,CC1C2CC(C(C(C2O)O)O)(O)O1,64,2,0,2,46,9.499999999999999e-05
G5,C(C1C(CC=O)OC(C1)(CO)O)=O,8,1,0,1,18,4.7e-05
G5,C(C1COC(C1CC(CO)=O)O)=O,8,1,0,1,18,4.7e-05
G5,C(CC1C(C(CO)=O)CC(O)O1)=O,8,1,0,1,18,4.7e-05
G5,C(C1COC(C1CC=O)(CO)O)=O,8,1,0,1,46,4.7e-05
G5,C(CC1CCC(C=O)(O)O1)=O,4,1,0,1,7,4.7e-05
G5,C(CC1CCC(CO)(O)O1)=O,4,1,0,1,7,4.7e-05
G5,C(C1C(CC=O)OC(C1)O)=O,8,1,0,1,18,4.7e-05
G5,C(C1COC(C1CC=O)O)=O,8,1,0,1,18,4.7e-05
G5,C(CC1(C)CCC(C=O)(O)O1)=O,4,1,0,1,7,4.7e-05
G5,C(CC1(C)CCC(CO)(O)O1)=O,4,1,0,1,7,4.7e-05
G5,C(C1C(C)OC(C1CC=O)O)=O,16,1,0,1,28,4.7e-05
G5,C(CC1CC(C(O)O1)CC=O)=O,8,1,0,1,43,4.7e-05
G5,C(C1CC(O)OC1(C)CC=O)=O,8,1,0,1,28,4.7e-05
G5,C(C(C1(C)CCC(C=O)(O)O1)O)=O,8,1,0,1,7,4.7e-05
G5,C(C1(C(C)O)CCC(CO)(O1)O)=O,8,1,0,1,7,4.7e-05
G5,C(C(C1(C)CCC(CO)(O)O1)O)=O,8,1,0,1,7,4.7e-05
G5,C(C1(C(C)OC(C1CC=O)O)O)=O,16,1,0,1,43,4.7e-05
G5,C(C1CC(OC1(C=O)C(C)O)O)=O,16,1,0,1,43,4.7e-05
G5,C(CC1C(O)OC(C1)C(C=O)O)=O,16,1,0,1,43,4.7e-05
G5,C(C1CC(O)OC1(C)C(C=O)O)=O,16,1,0,1,45,4.7e-05
G5,C(CC1C(OC(C=O)C1(C)O)O)=O,16,1,0,1,45,4.7e-05
G5,C(C(CCC1C(O)OCC1O)=O)=O,8,2,0,2,7,9.499999999999999e-05
G5,C(CO)(CCC1C(CC(O)O1)O)=O,8,2,0,2,7,9.499999999999999e-05
G5,C(CC(C1CCC(CO)(O)O1)O)=O,8,1,0,1,7,4.7e-05
G5,C(CO)(CCC1C(O)OCC1O)=O,8,2,0,2,7,9.499999999999999e-05
G5,C(CC1(COC(C1CC=O)O)O)=O,8,1,0,1,29,4.7e-05
G5,C(C1CC(O)OC1(CO)CC=O)=O,8,1,0,1,29,4.7e-05
G5,C(C(C1C(CC(O)O1)O)CC=O)=O,16,2,0,2,43,9.499999999999999e-05
G5,C(C1C(C(CC=O)O)OC(C1)O)=O,16,1,0,1,43,4.7e-05
G5,C(CC1C(C(C(O)O1)CC=O)O)=O,16,1,0,1,43,4.7e-05
G5,C(C(C1C(O)OCC1O)CC=O)=O,16,2,0,2,43,9.499999999999999e-05
G5,C(C1C(CO)OC(C1CC=O)O)=O,16,1,0,1,46,4.7e-05
G5,C(C1(C)CCC(C=O)(O1)O)(O)=O,4,1,0,1,25,4.7e-05
G5,C(C1(C)CCC(CO)(O1)O)(O)=O,4,1,0,1,25,4.7e-05
G5,C1(C(C)(C(C(O)O1)CC=O)O)=O,8,1,0,1,29,4.7e-05
G5,C(C1CC(OC1(C(O)=O)C)O)=O,8,1,0,1,29,4.7e-05
G5,C(CC1CC(C(O)=O)OC1O)=O,8,1,0,1,25,4.7e-05
G5,C(C1(CCC(C(C=O)=O)O1)O)=O,4,1,0,1,20,4.7e-05
G5,C(C(C1CCC(CO)(O1)O)=O)=O,4,1,0,1,20,4.7e-05
G5,C(C1CC(OC1C(C=O)=O)O)=O,8,1,0,1,43,4.7e-05
G5,C(C1(CCC(C(C(C)=O)=O)O1)O)=O,4,1,0,1,25,4.7e-05
G5,C(C(C)=O)(C1CCC(CO)(O1)O)=O,4,1,0,1,25,4.7e-05
G5,C(C1CC(OC1C(C(C)=O)=O)O)=O,8,1,0,1,25,4.7e-05
G5,C(C1(CCC(C(C=O)=O)(C)O1)O)=O,4,1,0,1,25,4.7e-05
G5,C(C(C1(C)CCC(CO)(O1)O)=O)=O,4,1,0,1,7,4.7e-05
G5,C(C1CC(OC1(C(C=O)=O)C)O)=O,8,1,0,1,25,4.7e-05
G5,C(CC1CC(C(C=O)=O)OC1O)=O,8,1,0,1,43,4.7e-05
G5,C(C1(CCC(C(CO)=O)(C)O1)O)=O,4,1,0,1,7,4.7e-05
G5,C(C1CCC(CO)(O1)O)(C(C)O)=O,8,1,0,1,7,4.7e-05
G5,C(CO)(C1(C)CCC(CO)(O1)O)=O,4,1,0,1,7,4.7e-05
G5,C(C1CC(OC1C(C(C)O)=O)O)=O,16,1,0,1,25,4.7e-05
G5,C(C1CC(OC1(C(CO)=O)C)O)=O,8,1,0,1,25,4.7e-05
G5,C(C(CCC1(C(O)OCC1)O)=O)=O,4,2,0,2,7,9.499999999999999e-05
G5,C(C1(CCO)CCC(C=O)(O1)O)=O,4,1,0,1,7,4.7e-05
G5,C(C(CCC1COC(C1O)O)=O)=O,8,2,0,2,7,9.499999999999999e-05
G5,C(C(CCC1CC(C(O)O1)O)=O)=O,8,2,0,2,28,9.499999999999999e-05
G5,C(C(CC1CCC(C=O)(O)O1)O)=O,8,1,0,1,7,4.7e-05
G5,C(CO)(CCC1COC(C1O)O)=O,8,2,0,2,7,9.499999999999999e-05
G5,C(CO)(CCC1CC(C(O)O1)O)=O,8,2,0,2,28,9.499999999999999e-05
G5,C(C(CC1CCC(CO)(O)O1)O)=O,8,1,0,1,7,4.7e-05
G5,C(C1CC(OC1(C=O)CCO)O)=O,8,1,0,1,29,4.7e-05
G5,C(C(C1COC(C1O)O)CC=O)=O,16,2,0,2,29,9.499999999999999e-05
G5,C(CC1C(O)OCC1C(C=O)O)=O,16,1,0,1,29,4.7e-05
G5,C(CC1C(OC(C=O)C1CO)O)=O,16,1,0,1,29,4.7e-05
G5,C(C(C1CC(C(O)O1)O)CC=O)=O,16,2,0,2,28,9.499999999999999e-05
G5,C(C1C(CC(C=O)O)OC(C1)O)=O,16,1,0,1,43,4.7e-05
G5,C(C1(C=O)CCC(CO)(O1)O)(O)=O,4,1,0,1,7,4.7e-05
G5,C1(C(C=O)(C(C(O)O1)CC=O)O)=O,8,1,0,1,17,4.7e-05
G5,C(C1(C=O)C(C=O)CC(O1)O)(O)=O,8,1,0,1,17,4.7e-05
G5,C(C1(CCC2(CC(CO2)=O)O1)O)=O,4,1,0,1,35,4.7e-05
G5,C1(COC2(CCC(CO)(O)O2)C1)=O,4,1,0,1,35,4.7e-05
G5,C(C1C2(CC(CO2)=O)OC(C1)O)=O,8,1,0,1,35,4.7e-05
G5,C(CC1C(O)OC2C1C(CO2)=O)=O,16,1,0,1,35,4.7e-05
G5,C(C1(CCC(C(C=CC=O)=O)O1)O)=O,8,1,0,1,7,4.7e-05
G5,C(C1CC(OC1C(C=CC=O)=O)O)=O,16,1,0,1,43,4.7e-05
G5,C(C1CC(C(O1)O)CC(CO)=O)=O,8,1,0,1,11,4.7e-05
G5,C(CC1CC(C=O)OC1(CO)O)=O,8,1,0,1,11,4.7e-05
G5,C(C1CC(CO)(OC1(C=O)C)O)=O,8,1,0,1,11,4.7e-05
G5,C(C1(C)C(C(CO)=O)CC(O1)O)=O,8,1,0,1,7,4.7e-05
G5,C(CC1CCOC1(CO)O)=O,4,1,0,1,46,4.7e-05
G5,C(C1C(C)OC(C1)(CO)O)=O,8,1,0,1,46,4.7e-05
G5,C(CO)(C1C(C)OC(C1)O)=O,8,1,0,1,46,4.7e-05
G5,C1(CC(C(O)O1)CC(CO)=O)=O,4,1,0,1,18,4.7e-05
G5,C1(CC(C(CO)(O)O1)CC=O)=O,4,1,0,1,18,4.7e-05
G5,C(C1(CCC(C(C=C)=O)O1)O)=O,4,1,0,1,7,4.7e-05
G5,C1(CC2(CO1)CCC(C=O)(O)O2)=O,4,1,0,1,8,4.7e-05
G5,C(C1(C)CCC(C=O)(O1)O)=O,4,1,0,1,29,4.7e-05
G5,C(C1(CCC(C(CO)O)O1)O)=O,8,1,0,1,29,4.7e-05
G5,C(C1(CCC(CO)(CO)O1)O)=O,2,1,0,1,7,4.7e-05
G5,C(C1(CCCO1)O)=O,2,1,0,1,55,4.7e-05
G5,C(C1(CCC(C)O1)O)=O,4,1,0,1,27,4.7e-05
G5,C(C1(CO)CCC(C=O)(O1)O)(O)=O,4,1,0,1,7,4.7e-05
G5,C(C(C1CCC(C=O)(O)O1)O)(O)=O,8,1,0,1,20,4.7e-05
G5,C(C1(CCC2(C(COC2)=O)O1)O)=O,4,1,0,1,10,4.7e-05
G5,C1(C2(CCC(C=O)(O2)O)OCC1)=O,4,1,0,1,34,4.7e-05
G5,C=CC(C1CCC(CO)(O1)O)=O,4,1,0,1,7,4.7e-05
G5,C(C1CC(OC1C(C=C)=O)O)=O,8,1,0,1,7,4.7e-05
G5,C1(CC2(CO1)CCC(CO)(O)O2)=O,4,1,0,1,8,4.7e-05
G5,C(C1(C)CCC(CO)(O1)O)=O,4,1,0,1,11,4.7e-05
G5,C(C(C1CCC(CO)(O)O1)O)O,8,1,0,1,29,4.7e-05
G5,C(C1(CCC(CO)(CO)O1)O)O,2,1,0,1,7,4.7e-05
G5,C1CCC(CO)(O)O1,2,1,0,1,55,4.7e-05
G5,CC1CCC(CO)(O)O1,4,1,0,1,27,4.7e-05
G5,C(C(C1CCC(CO)(O)O1)O)(O)=O,8,1,0,1,20,4.7e-05
G5,C1(COCC21CCC(CO)(O2)O)=O,4,1,0,1,10,4.7e-05
G5,C1(C2(CCC(CO)(O2)O)OCC1)=O,4,1,0,1,34,4.7e-05
G5,C1(C2C(CO1)OC(C2CC=O)O)=O,16,1,0,1,8,4.7e-05
G5,C(C1CC(O)OC21COC(C2)=O)=O,8,1,0,1,8,4.7e-05
G5,C1(CC2C(C(C(O)O2)CC=O)O1)=O,16,1,0,1,8,4.7e-05
G5,C(C1CC(OC1(C=O)C)O)=O,8,1,0,1,29,4.7e-05
G5,C(C1CC(O)OC1C(CO)O)=O,16,1,0,1,29,4.7e-05
G5,C(CC1C(O)OC(CO)C1O)=O,16,1,0,1,29,4.7e-05
G5,C(CC1C(O)OCC1(CO)O)=O,8,1,0,1,29,4.7e-05
G5,C(C1CC(O)OC1(CO)CO)=O,4,1,0,1,29,4.7e-05
G5,C(C1C(C)OC(C1)O)=O,8,1,0,1,27,4.7e-05
G5,C1(C(CO)(C(C(O)O1)CC=O)O)=O,8,1,0,1,33,4.7e-05
G5,C(C1CC(OC1(C(O)=O)CO)O)=O,8,1,0,1,33,4.7e-05
G5,C(C1(COC(C1CC=O)O)O)(O)=O,8,1,0,1,33,4.7e-05
G5,C(CC1C(C(C(O)=O)OC1O)O)=O,16,1,0,1,43,4.7e-05
G5,C(C1C(C(C(O)=O)O)OC(C1)O)=O,16,1,0,1,43,4.7e-05
G5,C1(CC(C(O)O1)CC=O)=O,4,1,0,1,18,4.7e-05
G5,C(C1CC(OC21C(COC2)=O)O)=O,8,1,0,1,10,4.7e-05
G5,C(CC1C(OC2C(COC12)=O)O)=O,16,1,0,1,10,4.7e-05
G5,C(C1CC(OC21C(CCO2)=O)O)=O,8,1,0,1,34,4.7e-05
G5,C(CO)(C1(CC(CO)CO1)O)=O,4,1,0,1,55,4.7e-05
G5,C(CO)(C1(CC(CO1)CCO)O)=O,4,1,0,1,46,4.7e-05
G5,C(CO)(C1(CC(CO1)C(C)O)O)=O,8,1,0,1,46,4.7e-05
G5,C(CO)(C1(CC(CO)C(C)O1)O)=O,8,1,0,1,46,4.7e-05
G5,C(CO)(C1C(CO)CC(O1)O)=O,8,1,0,1,5,4.7e-05
G5,C(CO)(C(C1COC(C1)O)O)=O,8,1,0,1,5,4.7e-05
G5,C(CC1COC(CO)(C1O)O)=O,8,1,0,1,5,4.7e-05
G5,C(CO)(C1C(CCO)CC(O1)O)=O,8,1,0,1,46,4.7e-05
G5,C(CO)(C1C(C(C)O)CC(O1)O)=O,16,1,0,1,46,4.7e-05
G5,C(CO)(C(C1C(C)OC(C1)O)O)=O,16,1,0,1,46,4.7e-05
G5,C(CC1C(C)OC(CO)(C1O)O)=O,16,1,0,1,46,4.7e-05
G5,C1(COC(CCCO)(C1O)O)=O,4,1,0,1,29,4.7e-05
G5,C(CO)(C(C1(CCCO1)O)O)=O,4,1,0,1,29,4.7e-05
G5,C1(COC(CCCCO)(C1O)O)=O,4,1,0,1,46,4.7e-05
G5,C1(COC(CCC(C)O)(C1O)O)=O,8,1,0,1,46,4.7e-05
G5,C(CO)(C(C1(CCC(C)O1)O)O)=O,8,1,0,1,46,4.7e-05
G5,C(CO)(CC1C(CO)(O)OCC1)=O,4,1,0,1,46,4.7e-05
G5,C1C(CC(CO)(O)O1)C(CO)O,8,1,0,1,29,4.7e-05
G5,C(C1(CC(CO)C(CO)O1)O)O,8,1,0,1,29,4.7e-05
G5,C1C(CO)CC(C(CO)O)(O)O1,8,1,0,1,29,4.7e-05
G5,C1CCC(C(C(CO)O)O)(O)O1,8,1,0,1,55,4.7e-05
G5,C1C(C(C(CCCO)(O)O1)O)O,8,1,0,1,55,4.7e-05
G5,C1C(CC(O)O1)C(C(CO)O)O,16,1,0,1,29,4.7e-05
G5,C(C(C1C(CO)CC(O)O1)O)O,16,1,0,1,29,4.7e-05
G5,C(C1(CC(CO1)C(CO)O)O)(O)=O,8,1,0,1,29,4.7e-05
G5,C(C1(CC(CO)C(CO)O1)O)(O)=O,8,1,0,1,29,4.7e-05
G5,C(C(C1(CC(CO1)CO)O)O)(O)=O,8,1,0,1,55,4.7e-05
G5,C(C1COC(C1)(C(CO)O)O)(O)=O,8,1,0,1,29,4.7e-05
G5,C1(C(CO)CC(C(CO)O)(O)O1)=O,8,1,0,1,29,4.7e-05
G5,C1(CC(CO)C(C(CO)O)(O)O1)=O,8,2,0,2,29,9.499999999999999e-05
G5,C(C(C(C1(CCCO1)O)O)O)(O)=O,8,1,0,1,55,4.7e-05
G5,C1(C(C(C(CCCO)(O)O1)O)O)=O,8,1,0,1,55,4.7e-05
G5,C(C(C(C1COC(C1)O)O)O)(O)=O,16,1,0,1,29,4.7e-05
G5,C(C(C1C(CO)CC(O)O1)O)(O)=O,16,1,0,1,29,4.7e-05
G5,C1C2CC(C(CO)(C2O)O)(O)O1,16,2,0,2,55,9.499999999999999e-05
G5,C(C(C1COC(C)(C1)O)=O)=O,4,1,0,1,55,4.7e-05
G5,C(C1(CC(C(C)=O)CO1)O)=O,4,1,0,1,55,4.7e-05
G5,C(CC1COC(C=O)(C1)O)=O,4,1,0,1,55,4.7e-05
G5,C(C(CC1COC(C1)O)=O)=O,4,1,0,1,55,4.7e-05
G5,C(C1COC(C(C)=O)(C1)O)=O,4,1,0,1,55,4.7e-05
G5,C(C1COC(C1)(CC=O)O)=O,4,1,0,1,55,4.7e-05
G5,C(CC(C1COC(C1)O)=O)=O,4,1,0,1,29,4.7e-05
G5,C(C(CC1(CCCO1)O)=O)=O,2,1,0,1,55,4.7e-05
G5,C(CC(C1(CCCO1)O)=O)=O,2,1,0,1,55,4.7e-05
G5,C1C2C(C(C(C2CO)(O)O1)O)O,32,2,0,2,55,9.499999999999999e-05
G5,C1CC2C(C(C(C2O)O)O)(O)O1,32,1,0,1,55,4.7e-05
G5,C1C2C(C(C(C2C(O)O1)O)O)O,64,1,0,1,55,4.7e-05
G5,C(C1C2C(C(C1C(O)O2)O)O)O,64,2,0,2,55,9.499999999999999e-05
G5,C(C1C(C2C(C1C(O)O2)O)O)O,64,2,0,2,55,9.499999999999999e-05
G5,C1C2C(CO)OC(C(C2)(O)O1)O,16,1,0,1,46,4.7e-05
G5,C1C2C(O)OC(CO)C(C2)(O)O1,16,1,0,1,55,4.7e-05
G5,C1C(C2COC(C(O)O1)(C2)O)O,16,1,0,1,41,4.7e-05
G5,C1C2C(CO)CC(C(O)O1)(O)O2,16,1,0,1,41,4.7e-05
G5,C1C2COC(C(C(C2)(O)O1)O)O,16,1,0,1,55,4.7e-05
G5,C1C(C2(CC(CO2)C(O)O1)O)O,16,1,0,1,38,4.7e-05
G5,C1C(C2(CC(C(O1)O2)CO)O)O,16,1,0,1,38,4.7e-05
G5,C1C2(CC(CO2)C(C(O)O1)O)O,16,1,0,1,55,4.7e-05
G5,C1C2(CC(CO)C(C(O)O1)O2)O,16,1,0,1,55,4.7e-05
G5,C(C1C(CC(CO)(O)O1)CCO)O,8,1,0,1,46,4.7e-05
G5,CC1C(CC(CO)(O)O1)C(CO)O,16,1,0,1,46,4.7e-05
G5,CC(C1C(CO)OC(CO)(C1)O)O,16,1,0,1,46,4.7e-05
G5,C1C(CC(C(CO)O)(O)O1)CCO,8,1,0,1,46,4.7e-05
G5,CC1C(CO)CC(C(CO)O)(O)O1,16,1,0,1,46,4.7e-05
G5,CC(C1COC(C1)(C(CO)O)O)O,16,1,0,1,46,4.7e-05
G5,C1C(C(C(CCCCO)(O)O1)O)O,8,1,0,1,46,4.7e-05
G5,CC1CCC(C(C(CO)O)O)(O)O1,16,1,0,1,27,4.7e-05
G5,CC(CCC1(C(C(CO1)O)O)O)O,16,1,0,1,27,4.7e-05
G5,C(CC1C(C(CO)O)OC(C1)O)O,16,1,0,1,46,4.7e-05
G5,CC1C(CC(O)O1)C(C(CO)O)O,32,1,0,1,46,4.7e-05
G5,CC(C1C(C(CO)O)OC(C1)O)O,32,1,0,1,46,4.7e-05
G5,CC1C2CC(C(CO)(C2O)O)(O)O1,32,2,0,2,46,9.499999999999999e-05
G5,C(C1(C(CCO1)CC(C)=O)O)=O,4,1,0,1,46,4.7e-05
G5,C(CC1C(C(O)OC1C)=O)(C)=O,8,1,0,1,46,4.7e-05
G5,C(C(C1C(C)OC(C)(C1)O)=O)=O,8,1,0,1,46,4.7e-05
G5,C(C(CC1CCOC1(C)O)=O)=O,4,1,0,1,29,4.7e-05
G5,C(C1(CC(C(C)=O)C(C)O1)O)=O,8,1,0,1,46,4.7e-05
G5,C(CC1CC(C=O)(O)OC1C)=O,8,1,0,1,46,4.7e-05
G5,C(C(CC1CC(O)OC1C)=O)=O,8,1,0,1,46,4.7e-05
G5,C(C(C)=O)(CC1C(O)OCC1)=O,4,1,0,1,29,4.7e-05
G5,C(C1CC(C(C)=O)(O)OC1C)=O,8,1,0,1,46,4.7e-05
G5,C(CC1CCOC1(C(C)=O)O)=O,4,1,0,1,46,4.7e-05
G5,C(C(C)=O)(C1C(C)OC(C1)O)=O,8,1,0,1,46,4.7e-05
G5,C1(C(C)(O)OC(C)C1CC=O)=O,8,1,0,1,46,4.7e-05
G5,C(CC(CC1C(O)OCC1)=O)=O,4,1,0,1,29,4.7e-05
G5,C(C1C(C)OC(C1)(CC=O)O)=O,8,1,0,1,46,4.7e-05
G5,C(CC1C(CC=O)(O)OCC1)=O,4,1,0,1,29,4.7e-05
G5,C(CC(C1C(C)OC(C1)O)=O)=O,8,1,0,1,46,4.7e-05
G5,C(C(CC1(CCC(C)O1)O)=O)=O,4,1,0,1,46,4.7e-05
G5,C(CC(C1(CCC(C)O1)O)=O)=O,4,1,0,1,46,4.7e-05
G5,CC1C2C(C(C(C2CO)(O)O1)O)O,64,2,0,2,46,9.499999999999999e-05
G5,CC1CC2C(C(C(C2O)O)O)(O)O1,64,1,0,1,46,4.7e-05
G5,C(CC1C2C(C(C1C(O)O2)O)O)O,64,2,0,2,46,9.499999999999999e-05
G5,C(CC1C(C2C(C1C(O)O2)O)O)O,64,2,0,2,46,9.499999999999999e-05
G5,CC1C2C(C(C(C2C(O)O1)O)O)O,128,1,0,1,46,4.7e-05
G5,CC(C1C2C(C(C1C(O)O2)O)O)O,128,2,0,2,46,9.499999999999999e-05
G5,CC(C1C(C2C(C1C(O)O2)O)O)O,128,2,0,2,46,9.499999999999999e-05
G5,CC1C2C(CO)OC(C(C2)(O)O1)O,32,1,0,1,46,4.7e-05
G5,CC1C2C(O)OC(CO)C(C2)(O)O1,32,1,0,1,46,4.7e-05
G5,C1C2C(CCO)CC(C(O)O1)(O)O2,16,1,0,1,46,4.7e-05
G5,C1C(C2CC(C(O)O1)(O)OC2C)O,32,1,0,1,46,4.7e-05
G5,CC(C1CC2(C(O)OCC1O2)O)O,32,1,0,1,46,4.7e-05
G5,CC1C2COC(C(C(C2)(O)O1)O)O,32,1,0,1,46,4.7e-05
G5,C1C(C2(CC(C(O2)O1)CCO)O)O,16,1,0,1,38,4.7e-05
G5,C1C(C2(CC(C(O)O1)C(C)O2)O)O,32,1,0,1,38,4.7e-05
G5,C1C(C2(CC(C(O2)O1)C(C)O)O)O,32,1,0,1,38,4.7e-05
G5,C1C2(CC(C(C(O)O1)O2)CCO)O,16,1,0,1,46,4.7e-05
G5,C1C2(CC(C(C)O2)C(C(O)O1)O)O,32,1,0,1,46,4.7e-05
G5,CC(C1C2C(O)OCC(C1)(O)O2)O,32,1,0,1,46,4.7e-05
G5,C1(CC(C(C=O)(O)O1)CC(C)=O)=O,4,1,0,1,18,4.7e-05
G5,C1(CC(C(C)(O)O1)CC(C=O)=O)=O,4,1,0,1,18,4.7e-05
G5,C1(CC(C(O)O1)CC(C(C)=O)=O)=O,4,1,0,1,18,4.7e-05
G5,C1(CC(C(C(C)=O)(O)O1)CC=O)=O,4,1,0,1,29,4.7e-05
G5,C(CC(CC1C(O)OC(C1)=O)=O)=O,4,1,0,1,18,4.7e-05
G5,C1(CC(C(CC=O)(O)O1)CC=O)=O,4,1,0,1,18,4.7e-05
G5,C(C1C(C(C(O)O1)=O)CC(C)=O)=O,8,1,0,1,0,4.7e-05
G5,C(C1C(C(C=O)=O)CC(C)(O1)O)=O,8,1,0,1,0,4.7e-05
G5,C(C)(C1CC(C=O)(OC1C=O)O)=O,8,1,0,1,0,4.7e-05
G5,C(CC1CC(C=O)(OC1C=O)O)=O,8,1,0,1,0,4.7e-05
G5,C(C1C(CC(O1)O)CC(C=O)=O)=O,8,1,0,1,0,4.7e-05
G5,C(C)(C1(CC(C=O)C(C=O)O1)O)=O,8,1,0,1,0,4.7e-05
G5,C(C1C(C(C(C)=O)=O)CC(O1)O)=O,8,1,0,1,46,4.7e-05
G5,C(C1C(C(C(C)(O1)O)=O)CC=O)=O,8,1,0,1,46,4.7e-05
G5,C(CC1(CC(C=O)C(C=O)O1)O)=O,8,1,0,1,0,4.7e-05
G5,C(C1CC(OC1C=O)O)(CC=O)=O,8,1,0,1,0,4.7e-05
G5,C(C1CCC(CC(C=O)=O)(O1)O)=O,4,1,0,1,0,4.7e-05
G5,C(C1CCC(C(CC=O)=O)(O1)O)=O,4,1,0,1,0,4.7e-05
G5,C(CO)(C1CCC(CO)(O1)O)=O,4,1,0,1,7,4.7e-05
G5,C(C(C1CCC(C=O)(O)O1)O)=O,8,1,0,1,20,4.7e-05
G5,C(C1(CO)CCC(CO)(O1)O)=O,4,1,0,1,7,4.7e-05
G5,C(C(C1CCC(CO)(O)O1)O)=O,8,1,0,1,7,4.7e-05
G5,C(CC1C(C(C=O)OC1O)O)=O,16,1,0,1,43,4.7e-05
G5,C(C1C(C(C=O)O)OC(C1)O)=O,16,1,0,1,43,4.7e-05
G5,C(C1CCC(C=O)(O1)O)(CC=O)=O,4,1,0,1,7,4.7e-05
G5,C(C1CC(OC1C(CC=O)=O)O)=O,8,1,0,1,43,4.7e-05
G5,C(C1(CCC(C=O)(C(C)=O)O1)O)=O,4,1,0,1,1,4.7e-05
G5,C(C1(C(C)=O)CCC(CO)(O1)O)=O,4,1,0,1,1,4.7e-05
G5,C(C1CC(OC1(C=O)C(C)=O)O)=O,8,1,0,1,1,4.7e-05
G5,C(C1(CCC(C(C)=O)(CO)O1)O)=O,4,1,0,1,7,4.7e-05
G5,C(C1(CCC(C(C(C)=O)O)O1)O)=O,8,1,0,1,20,4.7e-05
G5,C(C)(C1(CO)CCC(CO)(O1)O)=O,4,1,0,1,7,4.7e-05
G5,C(C)(C(C1CCC(CO)(O)O1)O)=O,8,1,0,1,7,4.7e-05
G5,C(C1CC(OC1(C(C)=O)CO)O)=O,8,1,0,1,43,4.7e-05
G5,C(CC1C(O)OCC1(C(C)=O)O)=O,8,1,0,1,43,4.7e-05
G5,C(CC1C(C(C(C)=O)OC1O)O)=O,16,1,0,1,43,4.7e-05
G5,C(C1C(C(C(C)=O)O)OC(C1)O)=O,16,1,0,1,43,4.7e-05
G5,C(C1(CCC(CC(C=O)=O)O1)O)=O,4,1,0,1,7,4.7e-05
G5,C(C(CC1CCC(CO)(O)O1)=O)=O,4,1,0,1,7,4.7e-05
G5,C(CC1C(O)OCC1C(C=O)=O)=O,8,1,0,1,43,4.7e-05
G5,C(C1C(CC(C=O)=O)OC(C1)O)=O,8,1,0,1,43,4.7e-05
G5,C(C1CCC(C=O)(O1)O)(CCO)=O,4,1,0,1,7,4.7e-05
G5,C(C1(CCC(CC(CO)=O)O1)O)=O,4,1,0,1,7,4.7e-05
G5,C(C1CCC(CO)(O1)O)(CCO)=O,4,1,0,1,7,4.7e-05
G5,C(CO)(CC1CCC(CO)(O)O1)=O,4,1,0,1,7,4.7e-05
G5,C(C1CC(OC1C(CCO)=O)O)=O,8,1,0,1,3,4.7e-05
G5,C(CC1C(O)OCC1C(CO)=O)=O,8,1,0,1,43,4.7e-05
G5,C(C1C(CC(CO)=O)OC(C1)O)=O,8,1,0,1,43,4.7e-05
G5,C(C1(C=O)CCC(C=O)(O1)O)=O,2,1,0,1,29,4.7e-05
G5,C(C1(C=O)CCC(CO)(O1)O)=O,2,1,0,1,29,4.7e-05
G5,C(C1CC(CO)(OC1C(C)=O)O)=O,8,1,0,1,49,4.7e-05
G5,C(CO)(C1CC(OC1C(C)=O)O)=O,8,1,0,1,11,4.7e-05
G5,C(C1(CCC(C(C)=O)O1)O)=O,4,1,0,1,7,4.7e-05
G5,C(C)(C1CCC(CO)(O1)O)=O,4,1,0,1,7,4.7e-05
G5,C(C1(CCC(C=O)(O1)O)CC=O)=O,4,1,0,1,7,4.7e-05
G5,C(CC1(C=O)C(C=O)CC(O1)O)=O,8,1,0,1,43,4.7e-05
G5,C(CC1C(OC(C=O)C1C=O)O)=O,16,1,0,1,43,4.7e-05
G5,C1(C(C2C(CC(O)O2)C1CO)O)=O,32,1,0,1,43,4.7e-05
G5,C1(CC2C(C(CO)O1)OC(C2)O)=O,16,1,0,1,4,4.7e-05
G5,C1(CC2C(C(CO1)O)OC(C2)O)=O,16,1,0,1,4,4.7e-05
G5,C(CO)(C1C(CO)OC(C1)O)=O,8,1,0,1,46,4.7e-05
G5,C(CC1C(CO)(O)OCC1O)=O,8,1,0,1,46,4.7e-05
G5,C(C1CCC(CO)(O)O1)O,4,1,0,1,46,4.7e-05
G5,C(CC1C(C(O)OC1CO)=O)(C)=O,8,1,0,1,46,4.7e-05
G5,C(C(C1C(CO)OC(C)(C1)O)=O)=O,8,1,0,1,46,4.7e-05
G5,C(C1(C(C(CO1)O)CC(C)=O)O)=O,8,1,0,1,46,4.7e-05
G5,C(C1(CC(C(C)=O)C(CO)O1)O)=O,8,1,0,1,46,4.7e-05
G5,C(C(CC1C(C)(O)OCC1O)=O)=O,8,1,0,1,46,4.7e-05
G5,C(C1CC(C(C)=O)(O)OC1CO)=O,8,1,0,1,46,4.7e-05
G5,C(C(C)=O)(CC1C(O)OCC1O)=O,8,1,0,1,46,4.7e-05
G5,C(C(C)=O)(C1C(CO)OC(C1)O)=O,8,1,0,1,46,4.7e-05
G5,C1(C(C)(O)OC(CO)C1CC=O)=O,8,1,0,1,46,4.7e-05
G5,C(CC1C(COC1(C(C)=O)O)O)=O,8,1,0,1,46,4.7e-05
G5,C(C1C(CO)OC(C1)(CC=O)O)=O,8,1,0,1,46,4.7e-05
G5,C(CC(CC1C(O)OCC1O)=O)=O,8,1,0,1,46,4.7e-05
G5,C(CC(C1C(CO)OC(C1)O)=O)=O,8,1,0,1,46,4.7e-05
G5,C(CC1(C(C(CO1)O)CC=O)O)=O,8,1,0,1,46,4.7e-05
G5,C(C(CC1(CCC(CO)O1)O)=O)=O,4,1,0,1,46,4.7e-05
G5,C(CC(C1(CCC(CO)O1)O)=O)=O,4,1,0,1,46,4.7e-05
G5,C1(C(C(C(O)O1)CC(CO)=O)O)=O,8,1,0,1,33,4.7e-05
G5,C(C1CC(CO)(OC1C(O)=O)O)=O,8,1,0,1,33,4.7e-05
G5,C(CC1C(CO)(O)OC(C1O)=O)=O,8,1,0,1,33,4.7e-05
G5,C(CO)(C1CC(OC1C(O)=O)O)=O,8,1,0,1,33,4.7e-05
G5,C(C1(CC(CO)C(CO)O1)O)=O,8,1,0,1,55,4.7e-05
G5,C(C1(CC(CO1)C(CO)O)O)=O,8,1,0,1,55,4.7e-05
G5,C(C1(CC(C(C)O)C(CO)O1)O)=O,16,1,0,1,46,4.7e-05
G5,C(C1(CC(C(CO)O)C(C)O1)O)=O,16,1,0,1,46,4.7e-05
G5,C(C(C(C1(CCCO1)O)O)O)=O,8,1,0,1,55,4.7e-05
G5,C(C(C(C1(CCC(C)O1)O)O)O)=O,16,1,0,1,46,4.7e-05
G5,C(C1C(CO)CC(CO)(O1)O)=O,8,1,0,1,55,4.7e-05
G5,C(CO)(CC1COC(C1O)O)=O,8,1,0,1,55,4.7e-05
G5,C(C(C1COC(CO)(C1)O)O)=O,8,1,0,1,55,4.7e-05
G5,C(C1C(CC(CO)(O1)O)C(C)O)=O,16,1,0,1,46,4.7e-05
G5,C(CO)(CC1C(C)OC(C1O)O)=O,16,1,0,1,46,4.7e-05
G5,C(C(C1CC(CO)(O)OC1C)O)=O,16,1,0,1,46,4.7e-05
G5,C(C(C1C(CO)CC(O)O1)O)=O,16,1,0,1,55,4.7e-05
G5,C(C(C(C1COC(C1)O)O)O)=O,16,1,0,1,55,4.7e-05
G5,C(C(C1C(C(C)O)CC(O)O1)O)=O,32,1,0,1,46,4.7e-05
G5,C(C(C(C1CC(O)OC1C)O)O)=O,32,1,0,1,46,4.7e-05
G5,C1CC2(C(C(C(C2O)O)(O)O1)O)O,32,2,0,2,5,9.499999999999999e-05
G5,C1C(C2(CC(C(C2)O)(O)O1)O)O,16,2,0,2,45,9.499999999999999e-05
G5,C1CC2(CC(C(C2O)O)(O)O1)O,16,2,0,2,3,9.499999999999999e-05
G5,C1C(C2(CC(C(C2O)O)(O)O1)O)O,32,2,0,2,51,9.499999999999999e-05
G5,C1C(C2(C(C(CC2O)(O)O1)O)O)O,32,2,0,2,32,9.499999999999999e-05
G5,C1C(C2(CC(C(C2O)(O)O1)O)O)O,32,2,0,2,2,9.499999999999999e-05
G5,C1C2C(C(C(C(C2O)O)(O)O1)O)O,10,1,0,1,5,4.7e-05
G5,C1(C(C2C(O)OCC1C2O)O)=O,32,2,0,2,2,9.499999999999999e-05
G5,C1CC2(C(C(CC2O)(O)O1)O)O,16,2,0,2,3,9.499999999999999e-05
G5,C1(C(C2C(O)OCCC2(C1)O)O)=O,16,1,0,1,30,4.7e-05
G5,C1(COC2(C(CC(C2C1)O)O)O)=O,16,1,0,1,7,4.7e-05
G5,C1(C2CC(C(C(CO)(O2)O)C1)O)=O,16,1,0,1,7,4.7e-05
G5,C1(C2CC(C(C(CC1)(O2)O)O)O)=O,16,1,0,1,7,4.7e-05
G5,C1(C2C(CC1)(C(CC(O2)O)O)O)=O,16,2,0,2,7,9.499999999999999e-05
G5,C1(C2C(C(CC1)(CC(O2)O)O)O)=O,16,2,0,2,7,9.499999999999999e-05
G5,C(C1(C2C(CC(CO1)(C2)O)O)O)=O,16,2,0,2,29,9.499999999999999e-05
G5,C1(C2CC(CC(C(C1)O)(O2)O)O)=O,16,1,0,1,22,4.7e-05
G5,C1(C(CC2C1C(CC(O)O2)O)O)=O,32,1,0,1,13,4.7e-05
G5,C1(C2CC(C(C(C1)O)C(O2)O)O)=O,32,2,0,2,13,9.499999999999999e-05
G5,C1(C(C2C(O)OC(CC2O)C1)O)=O,32,2,0,2,13,9.499999999999999e-05
G5,C(C12CC(C(C(O1)O)C(C2)O)O)=O,6,1,0,1,13,4.7e-05
G5,C(C1(CC2CC(C1C(O)O2)O)O)=O,32,1,0,1,13,4.7e-05
G5,C(C1(C2C(CC(CC2O)O1)O)O)=O,6,1,0,1,13,4.7e-05
G5,C1(C(C2C(O)OC(C)C1C2O)O)=O,64,2,0,2,4,9.499999999999999e-05
G5,C1(CC(C2C(O)OCCC12O)O)=O,16,1,0,1,53,4.7e-05
G5,C1(C2(CC(C1CO)OC(C2)O)O)=O,16,2,0,2,4,9.499999999999999e-05
G5,C1(CC2(C(C(CC(C1)O2)O)O)O)=O,16,1,0,1,26,4.7e-05
G5,C1(C(C2CC(CC(C1)(O)O2)O)O)=O,16,1,0,1,26,4.7e-05
G5,C1(C(C2CC(CC(O)O2)(C1)O)O)=O,16,1,0,1,32,4.7e-05
G5,C1(C(C2(CC(CC(C1)O2)O)O)O)=O,16,1,0,1,9,4.7e-05
G5,C1(C(C2(CC(O)OC(C2)C1)O)O)=O,16,1,0,1,49,4.7e-05
G5,C1(CC2(CC(C1)OC(C2O)O)O)=O,16,1,0,1,27,4.7e-05
G5,C1(CC2(CC(O)OC(C2O)C1)O)=O,16,1,0,1,27,4.7e-05
G5,C1(C(C2CC(C(C(O)O2)C1)O)O)=O,32,2,0,2,18,9.499999999999999e-05
G5,C1(C2C(CC(C(C(O2)O)C1)O)O)=O,32,2,0,2,18,9.499999999999999e-05
G5,C(C1C2(CC(C(C(O1)O)C2)O)O)=O,32,2,0,2,44,9.499999999999999e-05
G5,C(C1CC2(CC1OC(C2O)O)O)=O,32,2,0,2,44,9.499999999999999e-05
G5,C(C1C2C(C(C1)(CC(O)O2)O)O)=O,32,2,0,2,44,9.499999999999999e-05
G5,C1(C(C(O)OC2CC(CC12)O)O)=O,32,1,0,1,44,4.7e-05
G5,C1(C2(CC(CC(C(C1)O)O2)O)O)=O,16,1,0,1,21,4.7e-05
G5,C1(CC(O)OC2CC(C(C12)O)O)=O,32,1,0,1,6,4.7e-05
G5,C1(CC(C2C1C(CC(O)O2)O)O)=O,32,1,0,1,26,4.7e-05
G5,C1C2(C(COC(C2C(C=1)O)O)O)O,32,1,0,1,21,4.7e-05
G5,C1C(C2CC(C(C(C=1)(O)O2)O)O)O,32,1,0,1,32,4.7e-05
G5,C1C(C2C(OC(C=1)C(C2O)O)O)O,64,1,0,1,43,4.7e-05
G5,C1C2(C(C(C(CC2O)(O)O1)O)O)O,32,1,0,1,2,4.7e-05
G5,C1C2(C(C(C(C(O)O1)C2O)O)O)O,64,2,0,2,2,9.499999999999999e-05
G5,C1(CC2C(O)OCC1(C2O)O)=O,16,3,0,3,2,0.00014199999999999998
G5,C1(CC2C(O)OC(C)C1(C2O)O)=O,32,2,0,2,4,9.499999999999999e-05
G5,C1C2(CC(C(C(C2O)O)(O)O1)O)O,32,1,0,1,43,4.7e-05
G5,C1(C2(CC(C(CO2)(C1)O)O)O)=O,8,1,0,1,5,4.7e-05
G5,C1C2(COC(C=1)(C(C2O)O)O)O,16,1,0,1,43,4.7e-05
G5,C1(C2(CC(C(C(C)O2)(C1)O)O)O)=O,16,1,0,1,14,4.7e-05
G5,C1C2(C(C(C(C=1)(O)OC2C)O)O)O,32,1,0,1,32,4.7e-05
G5,C1(C(C2C(O)OCC(C2C1)O)O)=O,32,1,0,1,46,4.7e-05
G5,C1(C2C(C(C(CC1)C(O2)O)O)O)=O,32,3,0,3,7,0.00014199999999999998
G5,C1(C(C(C2C1CCC(O)O2)O)O)=O,32,1,0,1,4,4.7e-05
G5,C1(C(C2CC(C(C(O)O2)O)C1)O)=O,32,1,0,1,32,4.7e-05
G5,C1(C(C2C(C(CC(O)O2)C1)O)O)=O,32,1,0,1,32,4.7e-05
G5,C(C1C2C(C(C1CC(O)O2)O)O)=O,64,2,0,2,4,9.499999999999999e-05
G5,C1(C2C(C(C(C(O)O1)(C2)O)O)=O)=O,16,2,0,2,12,9.499999999999999e-05
G5,C1(C2C(C(C(C(O)O1)C2O)O)=O)=O,32,2,0,2,17,9.499999999999999e-05
G5,C1(C2C(CC(C(C2O)O)(O)O1)=O)=O,16,1,0,1,17,4.7e-05
G5,C1(C2C(C(C(CC2O)(O)O1)O)=O)=O,16,1,0,1,17,4.7e-05
G5,C1(C2C(C(C(O)O1)C(C2O)O)=O)=O,32,2,0,2,17,9.499999999999999e-05
G5,C(C1C(O)OCC(C1O)O)(O)=O,16,1,0,1,17,4.7e-05
G5,C(CC1(C(CC(CO1)=O)O)O)(O)=O,4,1,0,1,29,4.7e-05
G5,C(C1(C(C(CCO1)O)C(C)O)O)=O,16,1,0,1,4,4.7e-05
G5,C(C1(CC(C)OC(C1CO)O)O)=O,16,1,0,1,4,4.7e-05
G5,C(C1C(O)OC(C)CC1(C=O)O)=O,16,1,0,1,45,4.7e-05
G5,C1(C(O)OC(C(C1C(C)O)O)=O)=O,16,1,0,1,4,4.7e-05
G5,C1(C(O)OC(C)C(C1C(C)O)O)=O,32,1,0,1,4,4.7e-05
G5,C(C)(C(C1C(O)OCCC1O)O)=O,16,1,0,1,45,4.7e-05
G5,C(C)(C1CC(C(CO)C(O1)O)O)=O,16,1,0,1,45,4.7e-05
G5,C(C1C(CC(OC1C(C)=O)O)O)=O,16,1,0,1,45,4.7e-05
G5,C(C1C(OC(C(C)=O)CC1O)O)=O,16,1,0,1,45,4.7e-05
G5,C(C1C(C(C)(O)OC(C1O)=O)O)=O,16,1,0,1,45,4.7e-05
G5,C(C1C(C(C)(O)OC(C)C1O)O)=O,32,1,0,1,45,4.7e-05
G5,C(C(C)(C1C(O)OCCC1O)O)=O,16,1,0,1,45,4.7e-05
G5,C(C1(C)CC(C(CO)C(O1)O)O)=O,16,1,0,1,18,4.7e-05
G5,C(C1C(CC(OC1(C=O)C)O)O)=O,16,1,0,1,45,4.7e-05
G5,C(C1C(OC(C=O)(C)CC1O)O)=O,16,1,0,1,45,4.7e-05
G5,C(C1C(C)(C(O)OC(C1O)=O)O)=O,16,1,0,1,45,4.7e-05
G5,C(C1C(C(C)OC(C1(C)O)O)O)=O,32,1,0,1,11,4.7e-05
G5,C1(C(C(C(CO)C(O)O1)=O)O)=O,8,1,0,1,17,4.7e-05
G5,C1(C(C(C(C(O)O1)C(C)O)=O)O)=O,16,1,0,1,17,4.7e-05
G5,C1(C(C(CO)=O)C(CC(O)O1)O)=O,8,1,0,1,17,4.7e-05
G5,C1(C(C=O)C(CC(CO)(O)O1)O)=O,8,1,0,1,49,4.7e-05
G5,C1(C(C=O)C(CO)(CC(O)O1)O)=O,8,1,0,1,49,4.7e-05
G5,C1(C(C(C(C(O)O1)O)=O)CO)=O,8,1,0,1,17,4.7e-05
G5,C1(C(C(C(C(O)O1)O)=O)C(C)O)=O,16,1,0,1,4,4.7e-05
G5,C1(C(C=O)C(C(C(C)(O)O1)O)O)=O,16,1,0,1,17,4.7e-05
G5,C1(C(C=O)C(C)(C(C(O)O1)O)O)=O,16,1,0,1,17,4.7e-05
G5,C(C1C(O)OCC(C1(C)O)O)(O)=O,16,1,0,1,17,4.7e-05
G5,C1CC(C(C(O)O1)CO)O,8,1,0,1,18,4.7e-05
G5,CC1CC(CO)(C(C(O)O1)CO)O,16,1,0,1,11,4.7e-05
G5,CC(C1C(CO)(O)OCCC1O)O,16,1,0,1,11,4.7e-05
G5,CC(CC1(C(C(CCO1)O)O)O)O,16,1,0,1,11,4.7e-05
G5,CC1(C(C(C)OC(C1CO)O)O)O,32,1,0,1,4,4.7e-05
G5,CC(C(C1(CC(CCO1)O)O)O)O,16,1,0,1,18,4.7e-05
G5,CC1(CO)CC(C(C(O)O1)CO)O,16,1,0,1,18,4.7e-05
G5,CC(CO)(C1C(O)OCCC1O)O,16,1,0,1,49,4.7e-05
G5,CC1CC(C(C(O)O1)CO)O,16,1,0,1,28,4.7e-05
G5,CC(C1C(O)OCCC1O)O,16,1,0,1,18,4.7e-05
G5,CC1C(C(C(C(O)O1)CO)O)O,32,1,0,1,28,4.7e-05
G5,C1(C(CO)C(CC(CO)O1)O)O,16,1,0,1,6,4.7e-05
G5,C1CC(C(C(O)O1)C(CO)O)O,16,1,0,1,18,4.7e-05
G5,C(C1(C(COC(C1CO)O)O)O)=O,16,1,0,1,0,4.7e-05
G5,C1(COC(C(CO)C1(C)O)O)=O,8,1,0,1,25,4.7e-05
G5,C(C)(C1(C(C(CCO1)O)O)O)=O,8,1,0,1,25,4.7e-05
G5,C(CO)(C1(CC(CCO1)O)O)=O,4,1,0,1,18,4.7e-05
G5,C1(C(C)OC(C(CO)C1O)O)=O,16,1,0,1,25,4.7e-05
G5,CC(C1(C(C(CCO1)O)O)O)O,16,1,0,1,25,4.7e-05
G5,C(C1COC(CC1O)O)=O,8,1,0,1,18,4.7e-05
G5,C(C1C(O)OCCC1O)=O,8,1,0,1,18,4.7e-05
G5,C(C1COC(C(C1(CO)O)O)O)=O,16,1,0,1,2,4.7e-05
G5,C1(C(C(CCO)OC(C1O)O)O)=O,16,1,0,1,5,4.7e-05
G5,C1(CC(CO)(C(CO)C(O)O1)O)=O,8,1,0,1,29,4.7e-05
G5,C(C1C(CO)(O)OCCC1O)(O)=O,8,1,0,1,0,4.7e-05
G5,C(CC1(C(C(CCO1)O)O)O)(O)=O,8,1,0,1,17,4.7e-05
G5,C1(C(C(C)(C(CO)C(O)O1)O)O)=O,16,1,0,1,33,4.7e-05
G5,C(C(C1(CC(CCO1)O)O)O)(O)=O,8,1,0,1,18,4.7e-05
G5,C1(C(C(C(CO)C(O)O1)O)O)=O,16,1,0,1,18,4.7e-05
G5,C(C1COC(C)(CC1(C=O)O)O)=O,8,1,0,1,23,4.7e-05
G5,C(C1COC(C=O)(CC1(C)O)O)=O,8,1,0,1,6,4.7e-05
G5,C(C)(C1C(CCOC1(C=O)O)O)=O,8,1,0,1,26,4.7e-05
G5,C(C(C1C(C)(O)OCCC1O)=O)=O,8,1,0,1,26,4.7e-05
G5,C(C(CC1(CC(CCO1)O)O)=O)=O,4,1,0,1,18,4.7e-05
G5,C1(CC(C=O)(O)OC(CCO)C1)=O,4,1,0,1,18,4.7e-05
G5,C(C1C(CCOC1(C=O)O)O)=O,8,1,0,1,23,4.7e-05
G5,C(C(C1C(O)OCCC1O)=O)=O,8,1,0,1,23,4.7e-05
G5,C(C1COC(C(C)=O)(CC1O)O)=O,8,1,0,1,14,4.7e-05
G5,C(C1COC(CC1(C(C)=O)O)O)=O,8,1,0,1,4,4.7e-05
G5,C(C(C)=O)(C1C(O)OCCC1O)=O,8,1,0,1,14,4.7e-05
G5,C(C1C(CCOC1(C(C)=O)O)O)=O,8,1,0,1,14,4.7e-05
G5,C(CC(C1(CC(CCO1)O)O)=O)=O,4,1,0,1,18,4.7e-05
G5,C(C)(C1(CC(CCO1)O)O)=O,4,1,0,1,18,4.7e-05
G5,C(C1COC(CC1(C)O)O)=O,8,1,0,1,6,4.7e-05
G5,C(C1COC(C)(CC1O)O)=O,8,1,0,1,18,4.7e-05
G5,C(CC1(CC(CCO1)O)O)=O,4,1,0,1,18,4.7e-05
G5,C1(CC(CCO)OC(C1)O)=O,4,1,0,1,18,4.7e-05
G5,C(C1C(C)(O)OCCC1O)=O,8,1,0,1,18,4.7e-05
G5,C(C)(C1C(O)OCCC1O)=O,8,1,0,1,18,4.7e-05
G5,C1C2(CC(O1)OC(C2CO)O)O,16,1,0,1,35,4.7e-05
G5,C1C2(C(C(O)O1)C(CCO2)O)O,16,1,0,1,35,4.7e-05
G5,C1CC(C2C(CC(O)O2)(O)O1)O,16,1,0,1,35,4.7e-05
G5,C(C1(C(C(CCO1)O)O)O)=CC=O,16,1,0,1,18,4.7e-05
G5,C=CC1(C(C(CCO1)O)O)O,8,1,0,1,7,4.7e-05
G5,C(C1(C(CO)C(CCO1)O)O)(O)=O,8,1,0,1,18,4.7e-05
G5,C(C1CC(C(CO)C(O1)O)O)(O)=O,16,1,0,1,33,4.7e-05
G5,C(C(C1C(O)OCCC1O)O)(O)=O,16,1,0,1,33,4.7e-05
G5,C1C(CO)(C(C(C(O)O1)CO)O)O,16,1,0,1,18,4.7e-05
G5,C(C1COC(C(CO)(C1O)O)O)=O,16,1,0,1,18,4.7e-05
G5,C(C1(COC(C(CO)C1O)O)O)=O,16,1,0,1,18,4.7e-05
G5,C1C(C2(C(C(CCO2)O)O1)O)O,16,1,0,1,10,4.7e-05
G5,C1C2C(C(O)O1)(O)OCCC2O,16,1,0,1,34,4.7e-05
G5,C(C1C(O)OCCC1(C=O)O)(O)=O,8,1,0,1,3,4.7e-05
G5,C(C1C(O)OCCC1(CO)O)(O)=O,8,1,0,1,3,4.7e-05
G5,C1(C(C=O)C(C(C(O)O1)O)O)=O,16,1,0,1,0,4.7e-05
G5,C(C1C(O)OC(C)CC1(CO)O)=O,16,1,0,1,45,4.7e-05
G5,C(C1C(O)OC(C)C(C1(C)O)O)=O,32,1,0,1,45,4.7e-05
G5,C(C1C(CC(O)OC1(C)CO)O)=O,16,1,0,1,49,4.7e-05
G5,C(C1C(O)OC(C)(CO)CC1O)=O,16,1,0,1,45,4.7e-05
G5,C(C1C(OC(C=O)CC1O)O)(O)=O,16,1,0,1,43,4.7e-05
G5,CC(C1C(O)OC(C)CC1O)O,32,1,0,1,28,4.7e-05
G5,CC(C1C(O)OC(C)C(C1O)O)O,64,1,0,1,28,4.7e-05
G5,CC(C1C(O)OC(CO)CC1O)O,32,1,0,1,6,4.7e-05
G5,CC1CC(C(C(O)O1)C(CO)O)O,32,1,0,1,6,4.7e-05
G5,C1(COC(C(C(C)O)C1O)O)=O,16,1,0,1,28,4.7e-05
G5,C(C1(C(C(CC(C)O1)O)O)O)=O,16,1,0,1,5,4.7e-05
G5,C1(COC(C(C(C)O)C1(C)O)O)=O,16,1,0,1,25,4.7e-05
G5,C(C)(C1(C(C(CC(C)O1)O)O)O)=O,16,1,0,1,25,4.7e-05
G5,C(CO)(C1(CC(CC(C)O1)O)O)=O,8,1,0,1,25,4.7e-05
G5,C1(C(C)OC(C(C(C)O)C1O)O)=O,32,1,0,1,25,4.7e-05
G5,CC(C1(C(C(CC(C)O1)O)O)O)O,32,1,0,1,25,4.7e-05
G5,C(C1C(C)OC(CC1O)O)=O,16,1,0,1,4,4.7e-05
G5,C(C1C(O)OC(C)CC1O)=O,16,1,0,1,28,4.7e-05
G5,C(C1(CC(CC(C)O1)O)O)(O)=O,8,1,0,1,28,4.7e-05
G5,C1(C(C(C(C(O)O1)C(C)O)O)O)=O,32,1,0,1,17,4.7e-05
G5,C(C1C(C)OC(CC1(C=O)O)O)=O,16,1,0,1,23,4.7e-05
G5,C(C1C(CC(C)OC1(C=O)O)O)=O,16,1,0,1,23,4.7e-05
G5,C(C(C1C(O)OC(C)CC1O)=O)=O,16,1,0,1,23,4.7e-05
G5,C(C)(C1(CC(CC(C)O1)O)O)=O,8,1,0,1,14,4.7e-05
G5,C(C1C(C)OC(CC1(C)O)O)=O,16,1,0,1,6,4.7e-05
G5,C(C1C(C)OC(C)(CC1O)O)=O,16,1,0,1,6,4.7e-05
G5,C(CC1(CC(CC(C)O1)O)O)=O,8,1,0,1,28,4.7e-05
G5,C1(CC(CC(C)O)OC(C1)O)=O,8,1,0,1,28,4.7e-05
G5,C(C1C(C)(O)OC(C)CC1O)=O,16,1,0,1,6,4.7e-05
G5,C(C)(C1C(O)OC(C)CC1O)=O,16,1,0,1,6,4.7e-05
G5,C1C2(CC(O1)OC(C2C(C)O)O)O,32,1,0,1,35,4.7e-05
G5,C1C2(C(C(O)O1)C(CC(C)O2)O)O,32,1,0,1,35,4.7e-05
G5,CC1CC(C2C(CC(O)O2)(O)O1)O,32,1,0,1,35,4.7e-05
G5,C=CC1(C(C(CC(C)O1)O)O)O,16,1,0,1,7,4.7e-05
G5,C1C(C2(C(C(CC(C)O2)O)O1)O)O,32,1,0,1,10,4.7e-05
G5,CC1CC(C2COC(C2(O)O1)O)O,32,1,0,1,34,4.7e-05
G5,C(C1(C(C(C(C(C)O1)O)O)O)O)=O,32,1,0,1,5,4.7e-05
G5,C1(C(O)OC(C(C1O)O)C(C)O)=O,32,1,0,1,5,4.7e-05
G5,C(C1C(O)OC(C)C(C1O)O)=O,32,1,0,1,28,4.7e-05
G5,C(C1(CC(C(C(C)O1)O)O)O)(O)=O,16,1,0,1,28,4.7e-05
G5,C(C)(C1(CC(C(C(C)O1)O)O)O)=O,16,1,0,1,14,4.7e-05
G5,C1(C(C)(O)OC(C(C1)O)C(C)O)=O,16,1,0,1,14,4.7e-05
G5,C(CC1(CC(C(C(C)O1)O)O)O)=O,16,1,0,1,6,4.7e-05
G5,C1(CC(C(C(C)O)O)OC(C1)O)=O,16,1,0,1,6,4.7e-05
G5,C(C1C(C)(O)OC(C)C(C1O)O)=O,32,1,0,1,6,4.7e-05
G5,C(C)(C1C(O)OC(C)C(C1O)O)=O,32,1,0,1,6,4.7e-05
G5,C=CC1(C(C(C(C(C)O1)O)O)O)O,32,1,0,1,7,4.7e-05
G5,C(C1C(COC(C1(CO)O)O)O)=O,16,1,0,1,43,4.7e-05
G5,C(C1C(COC(CO)(C1O)O)O)=O,16,1,0,1,0,4.7e-05
G5,C1(COC(C(C(CO)O)C1O)O)=O,16,1,0,1,0,4.7e-05
G5,C(C1(C(C(CC(CO)O1)O)O)O)=O,16,1,0,1,6,4.7e-05
G5,C(C1C(CO)OC(CC1O)O)=O,16,1,0,1,6,4.7e-05
G5,C(C1C(O)OC(CO)CC1O)=O,16,1,0,1,6,4.7e-05
G5,C(C1(CC(CC(CO)O1)O)O)(O)=O,8,1,0,1,29,4.7e-05
G5,C(C1C(COC(C)(C1(C)O)O)O)=O,16,1,0,1,14,4.7e-05
G5,C(C)(C1(CC(CC(CO)O1)O)O)=O,8,1,0,1,14,4.7e-05
G5,C(C1C(CO)OC(CC1(C)O)O)=O,16,1,0,1,6,4.7e-05
G5,C(C1C(CO)OC(C)(CC1O)O)=O,16,1,0,1,6,4.7e-05
G5,C(CC1(CC(CC(CO)O1)O)O)=O,8,1,0,1,6,4.7e-05
G5,C1(CC(CC(CO)O)OC(C1)O)=O,8,1,0,1,6,4.7e-05
G5,C(C1C(C)(O)OC(CO)CC1O)=O,16,1,0,1,6,4.7e-05
G5,C(C)(C1C(O)OC(CO)CC1O)=O,16,1,0,1,6,4.7e-05
G5,C(C1C(C(C=C)(O)OCC1O)O)=O,16,1,0,1,7,4.7e-05
G5,C(C1C(COC(C1(C=C)O)O)O)=O,16,1,0,1,7,4.7e-05
G5,C=CC1(C(C(CC(CO)O1)O)O)O,16,1,0,1,7,4.7e-05
G5,C(C1C(O)OCC(C1(C=O)O)O)=O,16,1,0,1,0,4.7e-05
G5,C(C1C(OC(C(C1O)=O)CO)O)=O,16,1,0,1,5,4.7e-05
G5,C(C1(COC(C(C1O)=O)O)O)=O,8,1,0,1,1,4.7e-05
G5,C(C1(C(C(C(CO1)=O)O)O)O)=O,8,1,0,1,5,4.7e-05
G5,C(C)(C1(COC(C(C1O)=O)O)O)=O,8,1,0,1,1,4.7e-05
G5,C(C1(C(C(C(CO1)=O)(C)O)O)O)=O,8,1,0,1,25,4.7e-05
G5,C(C1(COC(C(C1O)=O)(C)O)O)=O,8,1,0,1,25,4.7e-05
G5,C(C)(C1(C(C(C(CO1)=O)O)O)O)=O,8,1,0,1,5,4.7e-05
G5,C(C1(COC(C(C1)=O)(CO)O)O)=O,4,1,0,1,5,4.7e-05
G5,C1(COC(C(CO)=O)(CC1O)O)=O,4,1,0,1,1,4.7e-05
G5,C1(C(C(C(C=O)(OC1C)O)O)O)=O,16,1,0,1,25,4.7e-05
G5,C(C1(C(C)OC(C(C1O)=O)O)O)=O,16,1,0,1,1,4.7e-05
G5,C1(C(O)OCC(C(C)O)(C1O)O)=O,16,1,0,1,25,4.7e-05
G5,C1(C(O)OC(C)C(CO)(C1O)O)=O,16,1,0,1,25,4.7e-05
G5,C1(COC(C(C1O)O)(C(C)O)O)=O,16,1,0,1,5,4.7e-05
G5,C1(C(C)OC(C(C1O)O)(CO)O)=O,16,1,0,1,5,4.7e-05
G5,C(C1C(OCC(C1O)=O)O)=O,8,1,0,1,5,4.7e-05
G5,C1(C(O)OC(C(C1O)O)CCO)=O,16,1,0,1,5,4.7e-05
G5,C1(C(C)(C(C(C(O)O1)=O)O)O)=O,8,1,0,1,5,4.7e-05
G5,C1(C(CC(CO)(C(O)O1)O)=O)=O,4,1,0,1,17,4.7e-05
G5,C(C1(CC(C(CO1)=O)O)O)(O)=O,4,1,0,1,5,4.7e-05
G5,C1(C(CC(C(CO)(O)O1)O)=O)=O,4,1,0,1,5,4.7e-05
G5,C1(C(C(C(C(O)O1)=O)O)O)=O,8,1,0,1,33,4.7e-05
G5,C1(C(C(C(C(C=O)(O)O1)O)O)O)=O,16,1,0,1,5,4.7e-05
G5,C(C1C(C(C(C(O1)O)=O)O)O)(O)=O,16,1,0,1,5,4.7e-05
G5,C1(C(C(C(C=O)=O)OC(C1)O)O)=O,8,1,0,1,1,4.7e-05
G5,C1(C(OC(C(C=O)=O)C(C1)O)O)=O,8,1,0,1,23,4.7e-05
G5,C(C1(COC(C(C1C=O)=O)O)O)=O,8,1,0,1,23,4.7e-05
G5,C(C1(C(C=O)C(C(CO1)=O)O)O)=O,8,1,0,1,23,4.7e-05
G5,C1(C(C(C(C=O)=O)C(OC1)O)O)=O,8,1,0,1,23,4.7e-05
G5,C(C)(C1C(OCC(C1O)=O)O)=O,8,1,0,1,5,4.7e-05
G5,C(C1(C(C2(COC(C2)O1)O)O)O)=O,16,1,0,1,35,4.7e-05
G5,C1(COC2(COC(C2C1O)O)O)=O,16,1,0,1,5,4.7e-05
G5,C1(COC2(C(C1O)OC(C2)O)O)=O,16,1,0,1,5,4.7e-05
G5,C1(C(O)OCC(C=C)(C1O)O)=O,8,1,0,1,7,4.7e-05
G5,C1(C(O)OC2COCC2(C1O)O)=O,16,1,0,1,10,4.7e-05
G5,C1(C2C(CO)(C(OC1CO2)O)O)=O,16,1,0,1,10,4.7e-05
G5,C1(COC2(C(C1O)OCC2O)O)=O,16,1,0,1,10,4.7e-05
G5,C1(C2C(C(CO)(OC1CO2)O)O)=O,16,1,0,1,10,4.7e-05
G5,C1(C(O)OC2C(CCO2)(C1O)O)=O,16,1,0,1,34,4.7e-05
G5,C1(C2OC(C(CO)(C1CO2)O)O)=O,16,1,0,1,34,4.7e-05
G5,C1(COC2(C(O)OCC2C1O)O)=O,16,1,0,1,34,4.7e-05
G5,C1(C2OC(CO)(C(C1CO2)O)O)=O,16,1,0,1,34,4.7e-05
G5,C(C1C(OCC(C1O)=O)O)(O)=O,8,1,0,1,28,4.7e-05
G5,C(C1C(OCC(C1(C)O)=O)O)=O,8,1,0,1,25,4.7e-05
G5,C1(C(C)(C(C(C(C)(O)O1)=O)O)O)=O,8,1,0,1,25,4.7e-05
G5,C1(C(C)(CC(C(CO)(O)O1)=O)O)=O,4,1,0,1,25,4.7e-05
G5,C1(C(CC(CO)(C(C)(O)O1)O)=O)=O,4,1,0,1,29,4.7e-05
G5,C(C1(CC(C(CO1)=O)(C)O)O)(O)=O,4,1,0,1,0,4.7e-05
G5,C1(C(CC(C)(C(CO)(O)O1)O)=O)=O,4,1,0,1,0,4.7e-05
G5,C1(C(C(C(OC1(C)O)=O)O)O)=O,8,1,0,1,33,4.7e-05
G5,C1(CC(C(OC1(CO)O)=O)O)=O,4,1,0,1,33,4.7e-05
G5,C(C)(C1(COC(C(C1)=O)(C)O)O)=O,4,1,0,1,14,4.7e-05
G5,C(C)(C1(CC(C(CO1)=O)(C)O)O)=O,4,1,0,1,14,4.7e-05
G5,C(C)(C1(CO)CC(CC(O1)O)=O)=O,4,1,0,1,25,4.7e-05
G5,C(CC1(CC(C(CO1)=O)(C)O)O)=O,4,1,0,1,25,4.7e-05
G5,C(CO)(C1(C)CC(CC(O1)O)=O)=O,4,1,0,1,25,4.7e-05
G5,C(C1C(C)(OCC(C1(C)O)=O)O)=O,8,1,0,1,25,4.7e-05
G5,C(C)(C1C(OCC(C1(C)O)=O)O)=O,8,1,0,1,25,4.7e-05
G5,C1(C(C(C=C)(COC1(C)O)O)O)=O,8,1,0,1,25,4.7e-05
G5,C1(CC(C=C)(COC1(CO)O)O)=O,4,1,0,1,25,4.7e-05
G5,C1(COC(C=C)(C(C1(C)O)O)O)=O,8,1,0,1,25,4.7e-05
G5,C1(C(C)(O)OC(C(C1O)O)C)=O,16,1,0,1,25,4.7e-05
G5,C1(C(CO)(O)OC(C(C1)O)C)=O,8,1,0,1,11,4.7e-05
G5,C1(C(C(CC(CO)(O)O1)=O)O)=O,4,1,0,1,27,4.7e-05
G5,C1(C(C(C(C(C)(O)O1)O)=O)O)=O,8,1,0,1,0,4.7e-05
G5,C1(CC(C(C(CO)(O)O1)O)=O)=O,4,1,0,1,17,4.7e-05
G5,C1(C(CC(C(O)=O)(OC1C)O)O)=O,8,1,0,1,49,4.7e-05
G5,C1(C(CC(C(C(C)O)(O)O1)O)=O)=O,8,1,0,1,49,4.7e-05
G5,C1(C(CC(C(O)O1)(C(C)O)O)=O)=O,8,1,0,1,17,4.7e-05
G5,C1(C(CC(C(C)=O)(OC1C)O)O)=O,8,1,0,1,14,4.7e-05
G5,C1(CC(C(C(C)O)=O)OC(C1)O)=O,8,1,0,1,9,4.7e-05
G5,C(C1C(C)(OC(C(C1O)=O)C)O)=O,16,1,0,1,25,4.7e-05
G5,C(C)(C1C(OC(C(C1O)=O)C)O)=O,16,1,0,1,25,4.7e-05
G5,C1(C(C(C(C=C)(OC1C)O)O)O)=O,16,1,0,1,25,4.7e-05
G5,C1(C(C)OC(C)(C(C)(C1O)O)O)=O,16,1,0,1,25,4.7e-05
G5,C1(C(C)(O)OCC(C(C)O)(C1)O)=O,8,1,0,1,29,4.7e-05
G5,C1(C(C(C=C)(C(OC1C)O)O)O)=O,16,1,0,1,7,4.7e-05
G5,C(CC1C(C(C(C(O)O1)O)=O)O)=O,16,1,0,1,5,4.7e-05
G5,C(C1C(O)OC(CC1(CO)O)=O)=O,8,1,0,1,45,4.7e-05
G5,C(C1C(O)OC(C(C1(C)O)O)=O)=O,16,1,0,1,45,4.7e-05
G5,C(C1C(O)OC(C(C1O)O)=O)=O,16,1,0,1,45,4.7e-05
G5,C1(CC(C=O)(O)OC(C1)CC=O)=O,4,1,0,1,26,4.7e-05
G5,C(CC1CC(CC(O)O1)=O)=O,4,1,0,1,45,4.7e-05
G5,C(C1C(O)OC2CC1(CO2)O)=O,16,1,0,1,35,4.7e-05
G5,C1(COC2C1C(CC(O)O2)O)=O,16,1,0,1,35,4.7e-05
G5,C(C1C(O)OCCC1(C(O)=O)O)=O,8,1,0,1,7,4.7e-05
G5,C(C1C(OC(C(O)=O)CC1O)O)=O,16,1,0,1,33,4.7e-05
G5,C(C1C(CC(OC1C(O)=O)O)O)=O,16,1,0,1,33,4.7e-05
G5,C(C1C(O)OCC(CO)(C1O)O)=O,16,1,0,1,45,4.7e-05
G5,C(C1C(O)OCC(C=O)(C1O)O)=O,16,1,0,1,1,4.7e-05
G5,C1(C(C(C(C(O)O1)O)=O)O)=O,8,1,0,1,17,4.7e-05
G5,C1(C(C(C(O)=O)OC(C1O)O)O)=O,16,1,0,1,5,4.7e-05
G5,C1(C(C(C(C)O)OC(C1O)O)O)=O,32,1,0,1,5,4.7e-05
G5,C1(C(C(CC(C(O)=O)(O)O1)O)O)=O,8,1,0,1,29,4.7e-05
G5,C(CC1(C(CC(C(O1)=O)=O)O)O)=O,4,1,0,1,23,4.7e-05
G5,C(CC1(C(O)OC(C(C1)=O)=O)O)=O,4,1,0,1,29,4.7e-05
G5,C1(C(C)(C(C=O)C(C(O)O1)=O)O)=O,8,1,0,1,23,4.7e-05
G5,C1(C(CC(C)(C(C)(O)O1)O)=O)=O,4,1,0,1,14,4.7e-05
G5,C1(C(C)(CC(C(C)(O)O1)=O)O)=O,4,1,0,1,28,4.7e-05
G5,C(C1(C)CC(CC(O1)O)=O)(O)=O,4,1,0,1,29,4.7e-05
G5,C(C1(CC2(COC(C2)O1)O)O)(O)=O,8,1,0,1,28,4.7e-05
G5,C=CC1(C(CC(C(O1)=O)=O)O)O,4,1,0,1,7,4.7e-05
G5,C(C1(C(O)OC(C(C1)=O)=O)O)=C,4,1,0,1,29,4.7e-05
G5,C1(CC(CC(C=O)(O)O1)=O)=O,2,1,0,1,30,4.7e-05
G5,C1(CC(CC(O)O1)=O)=O,2,1,0,1,17,4.7e-05
G5,C1(C(C(C=O)=O)CC(C(O)O1)O)=O,8,1,0,1,12,4.7e-05
G5,C1(C(C=O)C(C(C(C)(O)O1)=O)O)=O,8,1,0,1,25,4.7e-05
G5,C(CC1(CC(C(CO1)=O)=O)O)(O)=O,2,1,0,1,17,4.7e-05
G5,C1(CC(CC(C(CO)=O)(O)O1)=O)=O,2,1,0,1,17,4.7e-05
G5,C1(C(C(C)=O)C(C(C(O)O1)=O)O)=O,8,1,0,1,17,4.7e-05
G5,C1(C(C=O)CC(C(CO)(O)O1)=O)=O,4,1,0,1,17,4.7e-05
G5,C1(C(C=O)CC(C(C=O)(O)O1)O)=O,8,1,0,1,17,4.7e-05
G5,C1(C(C(CC(C(C)=O)(O)O1)=O)O)=O,4,1,0,1,24,4.7e-05
G5,C(CC1(C(CC(CO1)=O)=O)O)(O)=O,2,1,0,1,17,4.7e-05
G5,C1(C(C(C(C(C=C)(O)O1)O)=O)O)=O,8,1,0,1,17,4.7e-05
G5,C1(C(C(CC(CCO)(O)O1)=O)O)=O,4,1,0,1,30,4.7e-05
G5,C(C(C1(CCC(CO1)=O)O)O)(O)=O,4,1,0,1,29,4.7e-05
G5,C(C1C(CO)(OCC(C1)=O)O)(O)=O,4,1,0,1,29,4.7e-05
G5,C(C1C(CCOC1(C=O)O)O)(O)=O,8,1,0,1,17,4.7e-05
G5,C1(CC(C(C(CCO)(O)O1)O)=O)=O,4,1,0,1,29,4.7e-05
G5,C1(CC(CC(C(CO)O)(O)O1)=O)=O,4,1,0,1,17,4.7e-05
G5,C(C1C(OC(C(C1)=O)CO)O)(O)=O,8,1,0,1,29,4.7e-05
G5,C1(C(C(C(C(O)O1)O)=O)CCO)=O,8,1,0,1,17,4.7e-05
G5,C(CC1(C(CC(CO1)O)=O)O)(O)=O,4,1,0,1,17,4.7e-05
G5,C1(C(C(CC(O)O1)=O)C(CO)O)=O,8,1,0,1,17,4.7e-05
G5,C1(C2C(C(C(O)O1)(C(C2)O)O)=O)=O,16,2,0,2,17,9.499999999999999e-05
G5,C1(CC(C(CO)(C(O)O1)O)=O)=O,4,1,0,1,17,4.7e-05
G5,C1(CC(C(C(O)O1)(C(C)O)O)=O)=O,8,1,0,1,4,4.7e-05
G5,C1(C2C(CC(C(O)O1)(C2O)O)=O)=O,16,2,0,2,17,9.499999999999999e-05
G5,C1(C(C=O)C2C(C(CO2)(O)O1)O)=O,16,1,0,1,9,4.7e-05
G5,C1(C2C(C(O)OC2CC(O)O1)=O)=O,16,1,0,1,23,4.7e-05
G5,C1(C(C=O)C2CC(C(O)O2)(O)O1)=O,16,1,0,1,23,4.7e-05
G5,C1(C2C(C(C(C)(O)O1)OC2O)=O)=O,16,1,0,1,17,4.7e-05
G5,C1(CC(C2C(CC(O2)O)(O)O1)=O)=O,8,1,0,1,17,4.7e-05
G5,C(C1C2(C(CC(CO2)O1)=O)O)(O)=O,8,1,0,1,54,4.7e-05
G5,C1(C2C(CC(C(CO)O2)(O)O1)=O)=O,8,1,0,1,54,4.7e-05
G5,C1(C2COC(C(C(O)=O)O2)(C1)O)=O,8,1,0,1,54,4.7e-05
G5,C1(C2C(CC(C(CO2)O)(O)O1)=O)=O,8,1,0,1,36,4.7e-05
G5,C1(C2C(C(C(CCO2)(O)O1)O)=O)=O,8,1,0,1,36,4.7e-05
G5,C1(C2C(C(C(COC2)(O)O1)O)=O)=O,8,1,0,1,36,4.7e-05
G5,C1(C2C(CC(C(O)OC2)(O)O1)=O)=O,8,1,0,1,30,4.7e-05
G5,C1(C2C(CC(COC2O)(O)O1)=O)=O,8,1,0,1,17,4.7e-05
G5,C1(C2C(CC(CC(O2)O)(O)O1)=O)=O,8,1,0,1,38,4.7e-05
G5,C(C1C(OC2C(C1OC2)=O)O)(O)=O,16,1,0,1,9,4.7e-05
G5,C1(C(C=O)C2(CC(CO2)(O)O1)O)=O,8,1,0,1,48,4.7e-05
G5,C1(C2C(COC2(CC(O)O1)O)=O)=O,8,1,0,1,48,4.7e-05
G5,C1(C2C(C(C(O)O1)OC2(C)O)=O)=O,16,1,0,1,17,4.7e-05
G5,C1(C2C(COC(C(O)O1)(C2)O)=O)=O,8,1,0,1,17,4.7e-05
G5,C1(C2C(C(C(O)O1)OC(C2)O)=O)=O,16,1,0,1,17,4.7e-05
G5,C1(C(C(C(C(O)O1)=O)C(C)=O)O)=O,8,1,0,1,26,4.7e-05
G5,C(C1CC(CC(C=O)(O)O1)=O)(O)=O,4,1,0,1,33,4.7e-05
G5,C(C1C(C(O)OC(C1O)=O)=O)=O,8,1,0,1,33,4.7e-05
G5,C1(C(C)(O)OC(C(C1C=O)O)=O)=O,8,1,0,1,14,4.7e-05
G5,C1(C(CC(C(CC=O)(O)O1)=O)O)=O,4,1,0,1,33,4.7e-05
G5,C1(C(C(CC(C(C)=O)(O)O1)O)O)=O,8,1,0,1,14,4.7e-05
G5,C(C1C(CC(C(C)(O1)O)=O)O)(O)=O,8,1,0,1,14,4.7e-05
G5,C(CC1(CC(C(C(O1)=O)O)O)O)=O,8,1,0,1,9,4.7e-05
G5,C1(CC(O)OC(C(C(O)=O)O)C1)=O,8,1,0,1,9,4.7e-05
G5,C(C1C(C(C(OC1(C)O)=O)O)O)=O,16,1,0,1,6,4.7e-05
G5,C1(C(C(C(C(C)=O)C(O)O1)O)O)=O,16,1,0,1,6,4.7e-05
G5,C1(C(C(C(C(C=C)(O)O1)O)O)O)=O,16,1,0,1,7,4.7e-05
G5,C(C1(CC(CC(C(C=C)=O)O1)=O)O)=O,4,1,0,1,7,4.7e-05
G5,C(C1(C=C)CC(CC(C=O)(O1)O)=O)=O,4,1,0,1,7,4.7e-05
G5,C(C1(CC(CC(C=CC=O)O1)=O)O)=O,8,1,0,1,43,4.7e-05
G5,C(C)(C1C(C(O)OC(C)C1O)=O)=O,16,1,0,1,26,4.7e-05
G5,C1(CC(C=O)(O)OC(C(C)O)C1)=O,8,1,0,1,11,4.7e-05
G5,C1(CC(C(CC=O)=O)OC(C1)O)=O,4,1,0,1,23,4.7e-05
G5,C1(CC(C=O)(CC=O)OC(C1)O)=O,4,1,0,1,26,4.7e-05
G5,C1(CC(CC(C=O)=O)OC(C1)O)=O,4,1,0,1,23,4.7e-05
G5,C(C1C(C(O)OCC1(C=C)O)=O)=O,8,1,0,1,23,4.7e-05
G5,C1(C(C(C(C=C)=O)OC(C1)O)O)=O,8,1,0,1,23,4.7e-05
G5,C1(C(OC(C(C=C)=O)C(C1)O)O)=O,8,1,0,1,23,4.7e-05
G5,C(C1C(C(O)OC(C)C1O)=O)=O,16,1,0,1,23,4.7e-05
G5,C(C1C(C(C)(O)OC(C)C1O)=O)=O,16,1,0,1,14,4.7e-05
G5,C(CC1(C(CC(C(C)O1)O)=O)O)=O,8,1,0,1,11,4.7e-05
G5,C(C)(C1(C)CC(CC(O1)O)=O)=O,4,1,0,1,14,4.7e-05
G5,C(C)(C1(CC2(COC(C2)O1)O)O)=O,8,1,0,1,14,4.7e-05
G5,C1(CC(C=C)(COC1(C)O)O)=O,4,1,0,1,14,4.7e-05
G5,C1(C(C)(O)OC(C(C1)O)C)=O,8,1,0,1,11,4.7e-05
G5,C1(C(C)(O)OC2COCC2(C1)O)=O,8,1,0,1,10,4.7e-05
G5,C1(C2C(C)(C(C)(OC1CO2)O)O)=O,16,1,0,1,10,4.7e-05
G5,C1(C(C)(O)OC2C(CCO2)(C1)O)=O,8,1,0,1,14,4.7e-05
G5,C1(C2OC(C)(C(C)(C1CO2)O)O)=O,16,1,0,1,34,4.7e-05
G5,C(CC1(C)CC(CC(O)O1)=O)=O,4,1,0,1,6,4.7e-05
G5,C1(CC(CC(C)=O)OC(C1)O)=O,4,1,0,1,6,4.7e-05
G5,C(CC1(CC2(COC(C2)O1)O)O)=O,8,1,0,1,35,4.7e-05
G5,C(C1C(C)(O)OC2CC1(CO2)O)=O,16,1,0,1,35,4.7e-05
G5,C(C)(C1C(O)OC2CC1(CO2)O)=O,16,1,0,1,35,4.7e-05
G5,C1(COC2C1C(C)(CC(O)O2)O)=O,16,1,0,1,35,4.7e-05
G5,C1(COC2C1C(CC(C)(O)O2)O)=O,16,1,0,1,6,4.7e-05
G5,C1(CC(C=C)(CO)OC(C1)O)=O,4,1,0,1,29,4.7e-05
G5,C1(CC(C(C)O)OC(C1)O)=O,8,1,0,1,11,4.7e-05
G5,C1(CC2(COCC2O)OC(C1)O)=O,8,1,0,1,10,4.7e-05
G5,C1(CC2(C(O)OCC2)OC(C1)O)=O,8,1,0,1,34,4.7e-05
G5,C=CC1(C(C2(COC(C2)O1)O)O)O,16,1,0,1,7,4.7e-05
G5,C1(C2C(C(C=C)(OC1CO2)O)O)=O,16,1,0,1,10,4.7e-05
G5,C1(C2C(C=C)(C(OC1CO2)O)O)=O,16,1,0,1,10,4.7e-05
G5,C1(C2OC(C=C)(C(C1CO2)O)O)=O,16,1,0,1,7,4.7e-05
G5,C1(C2OCC1C(C=C)(C(O2)O)O)=O,16,1,0,1,34,4.7e-05
G5,C1(C(C2(CC(C(C2O)O)O1)O)O)O,64,2,0,2,0,9.499999999999999e-05
G5,C1(C(C2(CC(C(C2O)O1)O)O)O)O,64,2,0,2,0,9.499999999999999e-05
G5,CC1C(C(CO)(C(C(O)O1)O)O)O,32,1,0,1,0,4.7e-05
G5,C(C(C1CC(C(C(O)O1)O)O)O)O,32,1,0,1,41,4.7e-05
G5,C(C1(CC(C(OC1C=O)O)O)O)=O,16,1,0,1,0,4.7e-05
G5,C(C1(CC(C=O)OC(C1O)O)O)=O,16,1,0,1,0,4.7e-05
G5,C(C(C1C(C(O)OCC1O)O)=O)=O,16,1,0,1,0,4.7e-05
G5,C(C1(C(C(O)OC(C)C1)O)O)=O,16,1,0,1,0,4.7e-05
G5,C(C1C(C)(C(CC(O1)O)O)O)=O,16,1,0,1,0,4.7e-05
G5,C(C1C(CC(C(C)(O1)O)O)O)=O,16,1,0,1,0,4.7e-05
G5,C(C)(C1CC(C(C(O1)O)O)O)=O,16,1,0,1,0,4.7e-05
G5,C(C1C(CC(C)(C(O1)O)O)O)=O,16,1,0,1,16,4.7e-05
G5,C(C1(C)CC(C(C(O1)O)O)O)=O,16,1,0,1,16,4.7e-05
G5,C(C1C(COC(C1(C)O)O)O)=O,16,1,0,1,29,4.7e-05
G5,C(CC1(C(C(O)OCC1O)O)O)=O,16,1,0,1,0,4.7e-05
G5,C1CC(C(C(O)O1)O)(C(CO)O)O,16,1,0,1,0,4.7e-05
G5,C1C(C(CCO)(C(C(O)O1)O)O)O,16,1,0,1,0,4.7e-05
G5,C(C1(C(C(O)OCC1CO)O)O)=O,16,1,0,1,2,4.7e-05
G5,C1C(CO)C(CO)(C(C(O)O1)O)O,16,1,0,1,2,4.7e-05
G5,C1CC(C(C(O)O1)O)O,8,1,0,1,0,4.7e-05
G5,C(C(C1CC(C(C(O)O1)O)O)O)=O,32,1,0,1,0,4.7e-05
G5,CC1CC(CO)(C(C(O)O1)O)O,16,1,0,1,0,4.7e-05
G5,CC1(C(C(O)OC(C)C1O)O)O,32,1,0,1,0,4.7e-05
G5,CC1(CO)CC(C(C(O)O1)O)O,16,1,0,1,49,4.7e-05
G5,CC1CC(C(C(O)O1)O)O,16,1,0,1,28,4.7e-05
G5,C(C1(C(C(O)OC(CO)C1)O)O)=O,16,1,0,1,0,4.7e-05
G5,C(C1C(CC(C(CO)(O1)O)O)O)=O,16,1,0,1,0,4.7e-05
G5,C(CO)(C1CC(C(C(O1)O)O)O)=O,16,1,0,1,0,4.7e-05
G5,C1(CC(CO)(C(C(O)O1)O)O)=O,8,1,0,1,0,4.7e-05
G5,C1C2(CC(O1)OC(C2O)O)O,16,1,0,1,35,4.7e-05
G5,C1C2(CC(C(O)O1)OC(C2O)O)O,32,2,0,2,20,9.499999999999999e-05
G5,CC1C(CO)(C(C(C(O)O1)O)O)O,32,1,0,1,0,4.7e-05
G5,C1C(C(C)O)(C(C(C(O)O1)O)O)O,32,1,0,1,0,4.7e-05
G5,C(C1(C(C)OC(C(C1O)O)O)O)=O,32,1,0,1,1,4.7e-05
G5,C1(CC(COC1(C=CC=O)O)O)=O,8,1,0,1,0,4.7e-05
G5,C(C1C(C(CC(C=C)(O)O1)=O)O)=O,8,1,0,1,27,4.7e-05
G5,C(C1C(C=C)(CC(C(O)O1)=O)O)=O,8,1,0,1,45,4.7e-05
G5,C1(C(O)OCC(C1C(C=C)=O)O)=O,8,1,0,1,0,4.7e-05
G5,C1(CC(C(C=O)OC1(C=C)O)O)=O,8,1,0,1,0,4.7e-05
G5,C1(CC(OC(C=O)C1(C=C)O)O)=O,8,1,0,1,0,4.7e-05
G5,C(C1C(C(C=C)(O)OCC1O)=O)=O,8,1,0,1,0,4.7e-05
G5,C1(C(O)OCC(C1C=CC=O)O)=O,16,1,0,1,27,4.7e-05
G5,CC1CC(C(C(CO)(O)O1)O)O,16,1,0,1,5,4.7e-05
G5,CC1C(C(C(C(CO)(O)O1)O)O)O,32,1,0,1,11,4.7e-05
G5,C1(COC(C(CO)(C1O)O)O)=O,8,1,0,1,5,4.7e-05
G5,C1(COC(CO)(C(C1O)O)O)=O,8,1,0,1,5,4.7e-05
G5,C1(C(O)OCC(CO)(C1O)O)=O,8,1,0,1,5,4.7e-05
G5,C1(COC(CO)(C(C)(C1O)O)O)=O,8,1,0,1,5,4.7e-05
G5,C1(COC(CO)(C(C1(C)O)O)O)=O,8,1,0,1,5,4.7e-05
G5,C1(C(C)(O)OCC(CO)(C1O)O)=O,8,1,0,1,25,4.7e-05
G5,C1(COC(C(C(C)O)(C1O)O)O)=O,16,1,0,1,5,4.7e-05
G5,C1(C(C(C(C(CO)(O)O1)O)O)O)=O,16,1,0,1,5,4.7e-05
G5,C(CC1(C(C(C(CO1)=O)O)O)O)=O,8,1,0,1,5,4.7e-05
G5,C(CC1(C(OCC(C1O)=O)O)O)=O,8,1,0,1,5,4.7e-05
G5,C(C1C(C(O)OCC1(CO)O)=O)=O,8,1,0,1,23,4.7e-05
G5,C1(COC(C)(C(C)(C1O)O)O)=O,8,1,0,1,5,4.7e-05
G5,C1C2(CC(O1)OC(CO)(C2O)O)O,16,1,0,1,35,4.7e-05
G5,C1C(C(C(C(O)O1)CO)O)O,16,1,0,1,41,4.7e-05
G5,C1C(C(C(C(O)O1)C(C)O)O)O,32,1,0,1,41,4.7e-05
G5,C1(C(C)(O)OC(C(C1O)O)CO)=O,16,1,0,1,25,4.7e-05
G5,C(C)(C1(C(C(C(CO1)O)O)O)O)=O,16,1,0,1,25,4.7e-05
G5,CC(C1(C(C(C(CO1)O)O)O)O)O,32,1,0,1,25,4.7e-05
G5,C(C1C(C(O)OC(CO)C1O)=O)=O,16,1,0,1,23,4.7e-05
G5,C(C1C(C(COC1(C=O)O)O)O)=O,16,1,0,1,23,4.7e-05
G5,C(C(C1C(O)OCC(C1O)O)=O)=O,16,1,0,1,23,4.7e-05
G5,C1(CC(C(CO)O)OC(C1)O)=O,8,1,0,1,41,4.7e-05
G5,C(C)(C1C(O)OCC(C1O)O)=O,16,1,0,1,41,4.7e-05
G5,C1C(C(C2C(C(CO2)O)(O)O1)O)O,32,1,0,1,10,4.7e-05
G5,C(C1(CC(C=O)(O)OC(C)C1)O)=O,8,1,0,1,45,4.7e-05
G5,C(CC1C(C)(CC(C(O)O1)=O)O)=O,8,1,0,1,4,4.7e-05
G5,C(C1(CC(CC(C(C)=O)O1)O)O)=O,8,1,0,1,22,4.7e-05
G5,C(CC1C(CC(C)(C(O1)O)O)=O)=O,8,1,0,1,4,4.7e-05
G5,C(C1(C)CC(CC(C=O)(O1)O)O)=O,8,1,0,1,22,4.7e-05
G5,C(C1(CC(CO)(CC(C)O1)O)O)=O,8,1,0,1,45,4.7e-05
G5,C1(C(O)OCC(CC(C)O)(C1)O)=O,8,1,0,1,45,4.7e-05
G5,C(C1(CC(C)(C(C(C)O1)O)O)O)=O,16,1,0,1,45,4.7e-05
G5,C1(C(O)OC(C(C)O)C(C)(C1)O)=O,16,1,0,1,45,4.7e-05
G5,C(C1(CC(CC(CO)(C)O1)O)O)=O,8,1,0,1,45,4.7e-05
G5,C(C1C(C(C)(O)OCC1(C)O)O)=O,16,1,0,1,49,4.7e-05
G5,C(C1C(COC(C1(C)O)O)(C)O)=O,16,1,0,1,49,4.7e-05
G5,C(C1(CC(CC(C)O1)O)O)=O,8,1,0,1,3,4.7e-05
G5,C(C1(CC(C(C(C)O1)O)O)O)=O,16,1,0,1,45,4.7e-05
G5,C1(C(O)OC(C(C1)O)C(C)O)=O,16,1,0,1,45,4.7e-05
G5,C(C1(C(CO)OC(C(C1)=O)O)O)=O,8,1,0,1,0,4.7e-05
G5,C(C1(CC(C=O)(O)OCC1O)O)=O,8,1,0,1,0,4.7e-05
G5,C1(C(CC(C=O)(OC1CO)O)O)=O,8,1,0,1,5,4.7e-05
G5,C(C1(CC(C(CO1)=O)(C)O)O)=O,4,1,0,1,26,4.7e-05
G5,C1(C(CC(C=O)(OC1C)O)O)=O,8,1,0,1,29,4.7e-05
G5,C(C1(C(C)OC(C(C1)=O)O)O)=O,8,1,0,1,4,4.7e-05
G5,C1(C(O)OCC(C(C)O)(C1)O)=O,8,1,0,1,29,4.7e-05
G5,C1(C(O)OC(C)C(CO)(C1)O)=O,8,1,0,1,29,4.7e-05
G5,C1(C(C)OC(C(C1O)O)(C)O)=O,16,1,0,1,25,4.7e-05
G5,C1(C(C)OC(C(C)(C1O)O)O)=O,16,1,0,1,25,4.7e-05
G5,C(C(C1(COC(C(C1)=O)O)O)O)=O,8,1,0,1,51,4.7e-05
G5,C(C1C(CO)(CC(C(O1)O)=O)O)=O,8,1,0,1,51,4.7e-05
G5,C1(C(C(C(C)=O)OC(C1O)O)O)=O,16,1,0,1,5,4.7e-05
G5,C(C1C(C(C(C(C)(O1)O)O)O)=O)=O,16,1,0,1,5,4.7e-05
G5,C(C1(C)C(C(C(C(O1)O)O)=O)O)=O,16,1,0,1,5,4.7e-05
G5,C(C1C(C(C(C(O1)O)(C)O)O)=O)=O,16,1,0,1,5,4.7e-05
G5,C1(C(C)(CC(C(O)O1)=O)O)=O,4,1,0,1,29,4.7e-05
G5,C1(C(CC(C)(C(O)O1)O)=O)=O,4,1,0,1,7,4.7e-05
G5,C1(CC(CO)(CC(C=O)(O)O1)O)=O,4,1,0,1,29,4.7e-05
G5,C1(C(C(C)(CC(C=O)(O)O1)O)O)=O,8,1,0,1,26,4.7e-05
G5,C1(C(C(CC(C=O)(O)O1)O)O)=O,8,1,0,1,29,4.7e-05
G5,C(C1(CC(CC(C(C)=O)O1)=O)O)=O,4,1,0,1,45,4.7e-05
G5,C1(CC(C=O)(C)OC(C=O)(C1)O)=O,4,1,0,1,45,4.7e-05
G5,C(C1(C)CC(CC(O1)O)=O)=O,4,1,0,1,45,4.7e-05
G5,C(C1(CC2(COC(C2)O1)O)O)=O,8,1,0,1,45,4.7e-05
G5,C1(C(O)OCC(C=CC=O)(C1)O)=O,8,1,0,1,45,4.7e-05
G5,C1(C(O)OC(C)C(C1)O)=O,8,1,0,1,11,4.7e-05
G5,C1(C(CCO)(CC(C(O)O1)=O)O)=O,4,1,0,1,29,4.7e-05
G5,C1(C(C(CO)C(C)(C(O)O1)O)=O)=O,8,1,0,1,7,4.7e-05
G5,C(C1(COC(C=O)(CC1O)O)O)=O,8,1,0,1,23,4.7e-05
G5,C1(C(O)OC2COCC2(C1)O)=O,8,1,0,1,10,4.7e-05
G5,C1(C2C(C(C)(OC1CO2)O)O)=O,16,1,0,1,10,4.7e-05
G5,C1(C2C(C)(C(OC1CO2)O)O)=O,16,1,0,1,10,4.7e-05
G5,C1(C(O)OC2C(CCO2)(C1)O)=O,8,1,0,1,29,4.7e-05
G5,C1(C2OC(C)(C(C1CO2)O)O)=O,16,1,0,1,45,4.7e-05
G5,C1(C2OC(C(C)(C1CO2)O)O)=O,16,1,0,1,34,4.7e-05
G5,C(CO)(C1C(O)OCCC1O)=O,8,1,0,1,49,4.7e-05
G5,C(C1C(CO)(O)OCCC1O)=O,8,1,0,1,49,4.7e-05
G5,C1(C(C(CCO)OC(C1)O)O)=O,8,1,0,1,49,4.7e-05
G5,C(CC1(C(C(CCO1)O)O)O)=O,8,1,0,1,49,4.7e-05
G5,C(C1COC(CC1(CO)O)O)=O,8,1,0,1,49,4.7e-05
G5,C(CO)(C1C(O)OC(C)CC1O)=O,16,1,0,1,49,4.7e-05
G5,C(C1C(CO)(O)OC(C)CC1O)=O,16,1,0,1,49,4.7e-05
G5,C1(C(C(CC(C)O)OC(C1)O)O)=O,16,1,0,1,49,4.7e-05
G5,C(CC1(C(C(CC(C)O1)O)O)O)=O,16,1,0,1,49,4.7e-05
G5,C(C1C(C)OC(CC1(CO)O)O)=O,16,1,0,1,4,4.7e-05
G5,C(C1C(COC(C1(CO)O)O)=O)=O,8,1,0,1,5,4.7e-05
G5,C(C1C(COC(CO)(C1O)O)=O)=O,8,1,0,1,49,4.7e-05
G5,C(CO)(C1C(OCC(C1O)=O)O)=O,8,1,0,1,49,4.7e-05
G5,C(C1C(CO)(OCC(C1O)=O)O)=O,8,1,0,1,49,4.7e-05
G5,C(CC1(COC(C(C1O)=O)O)O)=O,8,1,0,1,49,4.7e-05
G5,C(C1C(COC(C)(C1(C)O)O)=O)=O,8,1,0,1,14,4.7e-05
G5,C(C)(C1(C)C(C(CC(O1)O)=O)O)=O,8,1,0,1,14,4.7e-05
G5,C1(C(C(CC(C)=O)OC(C1)O)O)=O,8,1,0,1,49,4.7e-05
G5,C1(CC(O)OC(C1)CC(CO)=O)=O,4,1,0,1,49,4.7e-05
G5,C(C1C(COC(C=C)(C1O)O)=O)=O,8,1,0,1,7,4.7e-05
G5,C(C1C(COC(C1(C=C)O)O)=O)=O,8,1,0,1,7,4.7e-05
G5,C(C1(C=C)C(C(CC(O1)O)=O)O)=O,8,1,0,1,7,4.7e-05
G5,C1(C(C(C=C)(CO)OC(C1)O)O)=O,8,1,0,1,7,4.7e-05
G5,C1(C(C(C=CC=O)OC(C1)O)O)=O,16,1,0,1,43,4.7e-05
G5,C1(C(C(C(C)O)OC(C1)O)O)=O,16,1,0,1,11,4.7e-05
G5,C1(C(C(O)OC(CCO)C1)O)=O,8,1,0,1,18,4.7e-05
G5,C(C(C1(CC(CCO1)O)O)O)=O,8,1,0,1,18,4.7e-05
G5,C(C1COC(C)(C(C1O)O)O)=O,16,1,0,1,18,4.7e-05
G5,C(C1COC(C(C1(C)O)O)O)=O,16,1,0,1,6,4.7e-05
G5,C1(C(C(O)OC(CC(C)O)C1)O)=O,16,1,0,1,1,4.7e-05
G5,C(C(C1(CC(CC(C)O1)O)O)O)=O,16,1,0,1,1,4.7e-05
G5,C(C1C(C)OC(C)(C(C1O)O)O)=O,32,1,0,1,1,4.7e-05
G5,C(C1C(C)OC(C(C1(C)O)O)O)=O,32,1,0,1,1,4.7e-05
G5,C(C1C(CC(CO)(C(O1)O)O)=O)=O,8,1,0,1,2,4.7e-05
G5,C(C1C(CC(C(CO)(O1)O)O)=O)=O,8,1,0,1,1,4.7e-05
G5,C(C(C1(CC(C(CO1)=O)O)O)O)=O,8,1,0,1,1,4.7e-05
G5,C(C)(C1C(C(C(C(O1)O)=O)O)O)=O,16,1,0,1,5,4.7e-05
G5,C(C1C(C)(C(C(C(O1)O)=O)O)O)=O,16,1,0,1,0,4.7e-05
G5,C(C1C(CC(C)(C(C)(O1)O)O)=O)=O,8,1,0,1,14,4.7e-05
G5,C(C)(C1(C)CC(C(C(O1)O)O)=O)=O,8,1,0,1,14,4.7e-05
G5,C1(C(C)(OC(C(C)=O)C(C1)O)O)=O,8,1,0,1,14,4.7e-05
G5,C(C1C(C)(CC(C(C)(O1)O)=O)O)=O,8,1,0,1,14,4.7e-05
G5,C1(C(C(O)OC(C1)CC(C)=O)O)=O,8,1,0,1,6,4.7e-05
G5,C1(CC(O)OC(C(C(C)=O)O)C1)=O,8,1,0,1,9,4.7e-05
G5,C1(CC(C)(C(C=O)O)OC(C1)O)=O,8,1,0,1,27,4.7e-05
G5,C1(CC(C(C=C)(OC1C=O)O)O)=O,8,1,0,1,1,4.7e-05
G5,C1(CC(C(C=C)=O)OC(C1O)O)=O,8,1,0,1,1,4.7e-05
G5,C(C1C(CC(C=C)(C(O1)O)O)=O)=O,8,1,0,1,25,4.7e-05
G5,C(C1(C=C)CC(C(C(O1)O)O)=O)=O,8,1,0,1,25,4.7e-05
G5,C1(CC(C=C)(CO)OC(C1O)O)=O,8,1,0,1,25,4.7e-05
G5,C1(CC(C=CC=O)OC(C1O)O)=O,16,1,0,1,1,4.7e-05
G5,C1(C(C(O)OC(C(C)O)C1)O)=O,16,1,0,1,11,4.7e-05
G5,C(C(C1C(OCC(C1O)=O)O)O)=O,16,1,0,1,43,4.7e-05
G5,C(CC1C(C(C(C(O1)O)O)O)=O)=O,16,1,0,1,0,4.7e-05
G5,C1(C(C(C=O)OC(CO)(C1)O)O)=O,8,1,0,1,0,4.7e-05
G5,C1(C(C(C=O)OC(C)(C1O)O)O)=O,16,1,0,1,0,4.7e-05
G5,C1(C(C(C(OC1C(C)=O)O)O)O)=O,16,1,0,1,0,4.7e-05
G5,C1(CC(C=O)OC(CO)(C1O)O)=O,8,1,0,1,0,4.7e-05
G5,C1(C(C(C=O)OC(C1O)O)O)=O,16,1,0,1,5,4.7e-05
G5,C(C1C(C(C(C(O1)O)O)O)=O)=O,16,1,0,1,5,4.7e-05
G5,C1(COC2C(C1C(C(O)O2)O)O)=O,32,1,0,1,0,4.7e-05
G5,C1(C(C(CO)C(C(O)O1)O)=O)=O,8,1,0,1,29,4.7e-05
G5,C(C1C(C(O)OC(C1O)=O)O)=O,16,1,0,1,33,4.7e-05
G5,C(C1C(C(O)OCC1(C=O)O)O)=O,16,1,0,1,43,4.7e-05
G5,C1(C2C(C(OC1CO2)O)O)=O,16,1,0,1,10,4.7e-05
G5,C1(C2OC(C(C1CO2)O)O)=O,16,1,0,1,34,4.7e-05
G5,C1CC(CC(C(CO)O)(O)O1)O,8,1,0,1,18,4.7e-05
G5,CC1(C(COC(C1CO)O)O)O,16,1,0,1,18,4.7e-05
G5,CC1CC(CC(C(CO)O)(O)O1)O,16,1,0,1,28,4.7e-05
G5,CC1(C(COC(C1C(C)O)O)O)O,32,1,0,1,28,4.7e-05
G5,C1(C(O)OC(CO)C(C)(C1O)O)=O,16,1,0,1,5,4.7e-05
G5,C(C1(C(C(C)(C(CO1)O)O)O)O)=O,16,1,0,1,5,4.7e-05
G5,C1(C(CO)OC(C)(C(C)(C1)O)O)=O,8,1,0,1,14,4.7e-05
G5,C1(C(C)(O)OC(CO)C(C)(C1)O)=O,8,1,0,1,14,4.7e-05
G5,C(C)(C1(CC(C)(C(CO1)O)O)O)=O,8,1,0,1,14,4.7e-05
G5,C(CC1(CC(C)(C(CO1)O)O)O)=O,8,1,0,1,6,4.7e-05
G5,C1(CC(C)(C(CO)O)OC(C1)O)=O,8,1,0,1,6,4.7e-05
G5,C(C1C(C)(O)OCC(C1(C)O)O)=O,16,1,0,1,6,4.7e-05
G5,C(C)(C1C(O)OCC(C1(C)O)O)=O,16,1,0,1,6,4.7e-05
G5,C1(C(CO)OC(C=C)(C(C1)O)O)=O,8,1,0,1,7,4.7e-05
G5,C1(CC(C=C)(C(OC1CO)O)O)=O,8,1,0,1,7,4.7e-05
G5,C=CC1(C(C(C)(C(CO1)O)O)O)O,16,1,0,1,7,4.7e-05
G5,C(C1(CCOC(C1CO)O)O)=O,8,1,0,1,3,4.7e-05
G5,C1CC(CO)(C(C(O)O1)CO)O,8,1,0,1,3,4.7e-05
G5,C(C1COC(C(C1O)O)O)=O,16,1,0,1,18,4.7e-05
G5,C(C1CC(C(CO)C(O1)O)O)=O,16,1,0,1,43,4.7e-05
G5,C1C(C(CO)(C(C(O)O1)CO)O)O,16,1,0,1,2,4.7e-05
G5,C1(C(CC(CO)C(CO)(O)O1)O)=O,8,1,0,1,12,4.7e-05
G5,C1(C(CCC(C(CO)O)(O)O1)O)=O,8,1,0,1,12,4.7e-05
G5,C1(C(CC(C(CCO)(O)O1)O)O)=O,8,1,0,1,2,4.7e-05
G5,C1(C(C(O)OCC1C(CO)O)=O)=O,8,1,0,1,0,4.7e-05
G5,C(CO)(C1COC(C(C1O)=O)O)=O,8,1,0,1,15,4.7e-05
G5,C(C1COC(C=O)(C(C1O)O)O)=O,16,1,0,1,5,4.7e-05
G5,C1(C(C(C(C)O)(O)OCC1O)O)=O,16,1,0,1,2,4.7e-05
G5,C1C(CC(C(C(CO)O)(O)O1)O)O,16,1,0,1,29,4.7e-05
G5,C1CC(C(C(C(CO)O)(O)O1)O)O,16,1,0,1,2,4.7e-05
G5,C(C1COC(C=O)(C(C1)O)O)=O,8,1,0,1,5,4.7e-05
G5,C(C1(C(CO)C(CCO1)O)O)=O,8,1,0,1,18,4.7e-05
G5,C1(C(CC(CO)C(CO)(O)O1)=O)=O,4,1,0,1,29,4.7e-05
G5,C1(C(CCC(C(CO)O)(O)O1)=O)=O,4,1,0,1,29,4.7e-05
G5,C1(C(CC(C(CCO)(O)O1)O)=O)=O,4,1,0,1,29,4.7e-05
G5,C1(CC(C(CO)C(C=O)(O)O1)O)=O,8,1,0,1,28,4.7e-05
G5,C1(CC(C(OC1(CCO)O)=O)O)=O,4,1,0,1,14,4.7e-05
G5,C1(CC2(C(O)OCC1C2O)O)=O,16,2,0,2,17,9.499999999999999e-05
G5,C(C1COC(C(C1(C=O)O)O)O)=O,16,1,0,1,0,4.7e-05
G5,C(C1COC2(COC1C2O)O)=O,16,1,0,1,9,4.7e-05
G5,C1(C2COC(C(CO2)O)(C1)O)=O,8,1,0,1,36,4.7e-05
G5,C1(C2COC(CCO2)(C1O)O)=O,8,1,0,1,36,4.7e-05
G5,C1(C(C2(COCC1CO2)O)O)=O,8,1,0,1,36,4.7e-05
G5,C1(CC2(C(O)OCC1CO2)O)=O,8,2,0,2,30,9.499999999999999e-05
G5,C1(CC2(COC(C1CO2)O)O)=O,8,2,0,2,30,9.499999999999999e-05
G5,C1(C2COC(CC(O2)O)(C1)O)=O,8,2,0,2,2,9.499999999999999e-05
G5,C1C2(C(C(CO)C(CO2)(O)O1)O)O,16,2,0,2,2,9.499999999999999e-05
G5,C1C2(C(CC(C(CO)O2)(O)O1)O)O,16,2,0,2,2,9.499999999999999e-05
G5,C1(COC2(C(O)OCC1C2)O)=O,8,2,0,2,12,9.499999999999999e-05
G5,C1(C2C(O)OCC1CC(O2)O)=O,16,2,0,2,2,9.499999999999999e-05
G5,C1(C2(C(CO)C(C(CO2)O)O1)O)=O,16,1,0,1,27,4.7e-05
G5,C1(C2C(C(C(CO)C(O2)O)O1)O)=O,32,1,0,1,27,4.7e-05
G5,C1(C2(C(CO)C(C(CO2)O1)O)O)=O,16,1,0,1,50,4.7e-05
G5,C1C2(CC(C(C(CO)O2)(O)O1)O)O,16,2,0,2,32,9.499999999999999e-05
G5,C(C1(C(CO)C(CC(C)O1)O)O)=O,16,1,0,1,3,4.7e-05
G5,C(C1(CCOC(C1C(C)O)O)O)=O,16,1,0,1,3,4.7e-05
G5,C(C1(COC(C(C1CO)=O)O)O)=O,8,1,0,1,2,4.7e-05
G5,C(C1(C(CO)C(C(CO1)=O)O)O)=O,8,1,0,1,5,4.7e-05
G5,C(C1(C(C(C=O)(O)OCC1)O)O)=O,8,1,0,1,1,4.7e-05
G5,C1(C(C)(C(C(C(O)O1)=O)CO)O)=O,8,1,0,1,29,4.7e-05
G5,C1(C(CC(C(O)O1)(CCO)O)=O)=O,4,1,0,1,29,4.7e-05
G5,C1(C(O)OC(C(C1CO)O)=O)=O,8,1,0,1,33,4.7e-05
G5,C(C1(CC(C(C)=O)(O)OCC1)O)=O,4,1,0,1,14,4.7e-05
G5,C(C(C1COC(CC1(C)O)O)=O)=O,8,1,0,1,6,4.7e-05
G5,C(C(C1COC(C)(CC1O)O)=O)=O,8,1,0,1,23,4.7e-05
G5,C1(CC(C(CCO)=O)OC(C1)O)=O,4,1,0,1,30,4.7e-05
G5,C(C1(CCOC(C1)(CC=O)O)O)=O,4,1,0,1,34,4.7e-05
G5,C(C1(CCO)CC(CC(O1)O)=O)=O,4,1,0,1,34,4.7e-05
G5,C(C1C(C)(O)OCCC1(C=O)O)=O,8,1,0,1,3,4.7e-05
G5,C(C1(CCOC(C1C(C)=O)O)O)=O,8,1,0,1,3,4.7e-05
G5,C1(C(O)OCC(C=C)(C1CO)O)=O,8,1,0,1,7,4.7e-05
G5,C(C1(C(C(C=C)(O)OCC1)O)O)=O,8,1,0,1,7,4.7e-05
G5,C1(C(O)OC(C)C(C1CO)O)=O,16,1,0,1,11,4.7e-05
G5,C1CC(C(C(CCO)(O)O1)O)O,8,1,0,1,3,4.7e-05
G5,C1CC(C(CO)C(CO)(O)O1)O,8,1,0,1,18,4.7e-05
G5,CC1CC(C(C(CCO)(O)O1)O)O,16,1,0,1,3,4.7e-05
G5,CC1CC(C(CO)C(CO)(O)O1)O,16,1,0,1,3,4.7e-05
G5,CC(C1C(O)OCCC1(CO)O)O,16,1,0,1,3,4.7e-05
G5,C(C1(C(C(CO)(CCO1)O)O)O)=O,8,1,0,1,3,4.7e-05
G5,C1(COC(C)(C(C)(C1CO)O)O)=O,8,1,0,1,14,4.7e-05
G5,C1(C(C)(O)OCC(CCO)(C1)O)=O,4,1,0,1,14,4.7e-05
G5,C(C)(C1(CC(CO)(CCO1)O)O)=O,4,1,0,1,14,4.7e-05
G5,C(CO)(C1COC(CC1(C)O)O)=O,8,1,0,1,3,4.7e-05
G5,C(CO)(C1COC(C)(CC1O)O)=O,8,1,0,1,3,4.7e-05
G5,C(CC1(CC(CO)(CCO1)O)O)=O,4,1,0,1,29,4.7e-05
G5,C(C1C(C)(O)OCCC1(CO)O)=O,8,1,0,1,3,4.7e-05
G5,C(C)(C1C(O)OCCC1(CO)O)=O,8,1,0,1,3,4.7e-05
G5,C1(COC(C=C)(C(C1CO)O)O)=O,8,1,0,1,7,4.7e-05
G5,C1(COC(C(C=C)(C1CO)O)O)=O,8,1,0,1,7,4.7e-05
G5,C=CC1(C(C(CO)(CCO1)O)O)O,8,1,0,1,7,4.7e-05
G5,C(C1C(C)OC(C(C1O)O)O)=O,32,1,0,1,0,4.7e-05
G5,C(C1C(C(C(C(O1)O)=O)O)O)=O,16,1,0,1,5,4.7e-05
G5,C(C1C(C(C(C(C)(O1)O)=O)O)O)=O,16,1,0,1,25,4.7e-05
G5,C(C1C(C(C=O)C(C(O1)O)=O)O)=O,16,1,0,1,23,4.7e-05
G5,C1(CC(O)OC(C(C=O)O)C1)=O,8,1,0,1,0,4.7e-05
G5,C1(COC2C1C(C(C(O)O2)O)O)=O,32,1,0,1,35,4.7e-05
G5,C1(COC(C(C1)O)(CC(C)O)O)=O,8,1,0,1,4,4.7e-05
G5,C1(COC(C(CC(C)O)(C1)O)O)=O,8,1,0,1,49,4.7e-05
G5,C(C1(CC(CO)(O)OC(C)C1)O)=O,8,1,0,1,49,4.7e-05
G5,C(C1(C(C(C)(O)OC(C)C1)O)O)=O,16,1,0,1,4,4.7e-05
G5,C(C)(C1C(C)(C(CC(O1)O)O)O)=O,16,1,0,1,45,4.7e-05
G5,C(C)(C1CC(CC(CO)(O1)O)O)=O,8,1,0,1,49,4.7e-05
G5,C(C)(C1C(CC(C(C)(O1)O)O)O)=O,16,1,0,1,45,4.7e-05
G5,C(C)(C1CC(C(C(C)(O1)O)O)O)=O,16,1,0,1,45,4.7e-05
G5,C(C)(C1C(C(C)(CC(O1)O)O)O)=O,16,1,0,1,45,4.7e-05
G5,C(C1(C)CC(CC(CO)(O1)O)O)=O,8,1,0,1,49,4.7e-05
G5,C(C)(C1C(CC(C)(C(O1)O)O)O)=O,16,1,0,1,45,4.7e-05
G5,C(C1(C)CC(C(C(C)(O1)O)O)O)=O,16,1,0,1,45,4.7e-05
G5,CC1(C(C(CCO1)O)O)O,8,1,0,1,18,4.7e-05
G5,CC1CC(CO)(CC(CO)(O)O1)O,8,1,0,1,49,4.7e-05
G5,CC1(C(C(CO)(CC(C)O1)O)O)O,16,1,0,1,11,4.7e-05
G5,CC1C(C(C)(CC(CO)(O)O1)O)O,16,1,0,1,49,4.7e-05
G5,CC1(C(C(C)(C(C(C)O1)O)O)O)O,32,1,0,1,49,4.7e-05
G5,CC1(CO)CC(CC(CO)(O)O1)O,8,1,0,1,49,4.7e-05
G5,CC1(C(C(CC(C)(CO)O1)O)O)O,16,1,0,1,49,4.7e-05
G5,CC1CC(CC(CO)(O)O1)O,8,1,0,1,28,4.7e-05
G5,CC1(C(C(CC(C)O1)O)O)O,16,1,0,1,28,4.7e-05
G5,CC1C(C(CC(CO)(O)O1)O)O,16,1,0,1,49,4.7e-05
G5,CC1(C(C(C(C(C)O1)O)O)O)O,32,1,0,1,28,4.7e-05
G5,C1(COC(CO)(C(C)(C1)O)O)=O,4,1,0,1,25,4.7e-05
G5,C1(COC(CO)(CC1(C)O)O)=O,4,1,0,1,25,4.7e-05
G5,C1(COC(C)(C(C1(C)O)O)O)=O,8,1,0,1,25,4.7e-05
G5,C1(C(C)(O)OCC(C)(C1O)O)=O,8,1,0,1,49,4.7e-05
G5,C1(COC(C(C1)O)(C(C)O)O)=O,8,1,0,1,49,4.7e-05
G5,C1(C(C)OC(CC1O)(CO)O)=O,8,1,0,1,49,4.7e-05
G5,C1(CC(CO)(CC(CO)(O)O1)O)=O,4,1,0,1,29,4.7e-05
G5,C1(CC(CO)(C(C(C)(O)O1)O)O)=O,8,1,0,1,29,4.7e-05
G5,C1(C(C(C)(CC(CO)(O)O1)O)O)=O,8,1,0,1,33,4.7e-05
G5,C1(C(C(C)(C(C(C)(O)O1)O)O)O)=O,16,1,0,1,49,4.7e-05
G5,C(C)(CC1(C(CC(CO1)=O)O)O)=O,4,1,0,1,26,4.7e-05
G5,C1(C(C(C(C)=O)OC(C)(C1)O)O)=O,8,1,0,1,26,4.7e-05
G5,C(C)(CC1(C(OCC(C1)=O)O)O)=O,4,1,0,1,27,4.7e-05
G5,C(C)(C1C(C)(CC(C(O1)O)=O)O)=O,8,1,0,1,49,4.7e-05
G5,C(C)(C1C(C(O)OCC1(C)O)=O)=O,8,1,0,1,26,4.7e-05
G5,C1(CC(C=O)(O)OC(CO)(C)C1)=O,4,1,0,1,49,4.7e-05
G5,C(CC1(C(C)(CC(CO1)=O)O)O)=O,4,1,0,1,14,4.7e-05
G5,C1(C(C)(C(C(C)=O)OC(C1)O)O)=O,8,1,0,1,14,4.7e-05
G5,C(C1C(C(C)(O)OCC1(C)O)=O)=O,8,1,0,1,14,4.7e-05
G5,C(CC1(C(CC(CO1)(C)O)=O)O)=O,4,1,0,1,49,4.7e-05
G5,C1(COC(C)(C(C)(C1)O)O)=O,4,1,0,1,14,4.7e-05
G5,C1(C(C)(O)OCC(C)(C1)O)=O,4,1,0,1,49,4.7e-05
G5,C1(CC(C)(CO)OC(C1)O)=O,4,1,0,1,49,4.7e-05
G5,C1C2(CC(O1)OC(CO)(C2)O)O,8,1,0,1,49,4.7e-05
G5,CC1(C(C2(COC(C2)O1)O)O)O,16,1,0,1,49,4.7e-05
G5,C(C(C1C(O)OCCC1O)O)=O,16,1,0,1,43,4.7e-05
G5,C(C(C1C(O)OC(C)CC1O)O)=O,32,1,0,1,43,4.7e-05
G5,C(C1CC(C(C(O1)O)C(C)O)O)=O,32,1,0,1,43,4.7e-05
G5,C(CC1C(C(C(C(O)O1)=O)O)O)=O,16,1,0,1,43,4.7e-05
G5,C(C(C1C(C(CC(O1)O)O)O)=O)=O,16,1,0,1,43,4.7e-05
G5,C(C1CC(C(C(C=O)(O1)O)O)O)=O,16,1,0,1,5,4.7e-05
G5,C(C(C1C(CC(C(O1)O)O)O)=O)=O,16,1,0,1,5,4.7e-05
G5,C(C1C(CC(OC1C=O)O)O)=O,16,1,0,1,43,4.7e-05
G5,C(C1C(C(O)OC(C1(C)O)=O)O)=O,16,1,0,1,28,4.7e-05
G5,C(C1CC(CC(C(C)=O)(O1)O)O)=O,8,1,0,1,21,4.7e-05
G5,C(C1C(C)(CC(OC1C=O)O)O)=O,16,1,0,1,6,4.7e-05
G5,C(C1C(CC(C)(OC1C=O)O)O)=O,16,1,0,1,6,4.7e-05
G5,C(CC1(CC(CC(C=O)O1)O)O)=O,8,1,0,1,6,4.7e-05
G5,C1(CC(CC(C=O)O)OC(C1)O)=O,8,1,0,1,6,4.7e-05
G5,C(C1C(CC(C=O)OC1(C)O)O)=O,16,1,0,1,6,4.7e-05
G5,C(C1CC(C(C(C)=O)C(O1)O)O)=O,16,1,0,1,6,4.7e-05
G5,C(C1C(C(O)OCC1(C=C)O)O)=O,16,1,0,1,7,4.7e-05
G5,C(C1CC(C(C(C=C)(O1)O)O)O)=O,16,1,0,1,7,4.7e-05
G5,C=CC(C1C(CC(C(O1)O)O)O)=O,16,1,0,1,7,4.7e-05
G5,C(C1C(C(O)OC(C)C1O)O)=O,32,1,0,1,43,4.7e-05
G5,C(C1C(OC(C=O)C(C1O)O)O)=O,32,1,0,1,0,4.7e-05
G5,C1(CC2(CC(C(C2O)O)O1)O)O,32,2,0,2,4,9.499999999999999e-05
G5,C1(CC2(CC(C(C2O)O1)O)O)O,32,2,0,2,4,9.499999999999999e-05
G5,C1(C2C(CO)C(CC(O2)O)(C1)O)=O,16,2,0,2,30,9.499999999999999e-05
G5,C1(C(C2COC(CC2(C1)O)O)O)=O,16,1,0,1,30,4.7e-05
G5,C(C12C(C(CC1)(CC(O2)O)O)O)=O,16,2,0,2,29,9.499999999999999e-05
G5,C(C12CC(C(C1)O)(CC(O2)O)O)=O,16,2,0,2,22,9.499999999999999e-05
G5,C1(C(C2C(C1)OC(CC2O)O)O)=O,32,1,0,1,4,4.7e-05
G5,C1(C2C(C(C1)O)C(CC(O2)O)O)=O,32,1,0,1,4,4.7e-05
G5,C1(CC2C(CO)C1(CC(O)O2)O)=O,16,2,0,2,4,9.499999999999999e-05
G5,C1(CC(C2COC(CC12O)O)O)=O,16,1,0,1,4,4.7e-05
G5,C1(C(C2C(C(CC(O)O2)O)C1)O)=O,32,1,0,1,18,4.7e-05
G5,C1C2(C(C(C(C=1)O)OC(C2)O)O)O,32,1,0,1,32,4.7e-05
G5,CC1C(C(CO)(CC(O)O1)O)O,16,1,0,1,4,4.7e-05
G5,C(C1(CO)CC(CC(O)O1)O)O,4,1,0,1,4,4.7e-05
G5,C(C(C1CC(CC(O)O1)O)O)O,16,1,0,1,29,4.7e-05
G5,C(C1(CC(C=O)(C)OC(C1)O)O)=O,8,1,0,1,4,4.7e-05
G5,C(C1(CC(C=O)OC(C1)O)O)=O,8,1,0,1,20,4.7e-05
G5,C(C1(CC(O)OC(CO)(C)C1)O)=O,8,1,0,1,4,4.7e-05
G5,C(C1(C)CC(CO)(CC(O1)O)O)=O,8,1,0,1,4,4.7e-05
G5,C(C1(C)C(C(C)(CC(O1)O)O)O)=O,16,1,0,1,11,4.7e-05
G5,C(C1(CC(O)OC(C)C1)O)=O,8,1,0,1,4,4.7e-05
G5,C(C)(C1CC(CC(O1)O)O)=O,8,1,0,1,45,4.7e-05
G5,C(C1(C)CC(CC(O1)O)O)=O,8,1,0,1,18,4.7e-05
G5,C(C(C1(CC(O)OCC1)O)O)=O,8,1,0,1,0,4.7e-05
G5,C(C(C1(CC(C)OC(C1)O)O)O)=O,16,1,0,1,4,4.7e-05
G5,C(CC1(C)C(C(CC(O)O1)O)O)=O,16,1,0,1,4,4.7e-05
G5,C(CC1C(C(C)(CC(O)O1)O)O)=O,16,1,0,1,4,4.7e-05
G5,C(CC1CC(C(C(C)(O)O1)O)O)=O,16,1,0,1,4,4.7e-05
G5,C(C)(C(C1CC(CC(O)O1)O)O)=O,16,1,0,1,4,4.7e-05
G5,C(CC1CC(C)(C(C(O)O1)O)O)=O,16,1,0,1,4,4.7e-05
G5,C(C(C1(C)CC(CC(O)O1)O)O)=O,16,1,0,1,4,4.7e-05
G5,C1CC(CC(O)O1)(C(CO)O)O,8,1,0,1,29,4.7e-05
G5,C1C(C(CC(O)O1)(CCO)O)O,8,1,0,1,29,4.7e-05
G5,CC1CC(CC(O)O1)(C(CO)O)O,16,1,0,1,4,4.7e-05
G5,CC(CC1(CC(O)OCC1O)O)O,16,1,0,1,4,4.7e-05
G5,CC1(CC(CC(O)O1)O)C(CO)O,16,1,0,1,4,4.7e-05
G5,C(C1(CC(O)OCC1CO)O)=O,8,1,0,1,29,4.7e-05
G5,C1C(CO)C(CO)(CC(O)O1)O,8,1,0,1,29,4.7e-05
G5,C(C1C(CO)C(CC(O1)O)O)=O,16,1,0,1,43,4.7e-05
G5,C(C(C1COC(CC1O)O)O)=O,16,1,0,1,43,4.7e-05
G5,C1CC(CC(O)O1)O,4,1,0,1,18,4.7e-05
G5,C1C(C(CC(O)O1)(C(CO)O)O)O,16,1,0,1,4,4.7e-05
G5,C(C1(CC(O)OC(C)C1CO)O)=O,16,1,0,1,4,4.7e-05
G5,C(C1(CC(O)OCC1C(C)O)O)=O,16,1,0,1,4,4.7e-05
G5,CC1C(C(CCO)(CC(O)O1)O)O,16,1,0,1,4,4.7e-05
G5,CC(C(C1(CC(O)OCC1)O)O)O,16,1,0,1,4,4.7e-05
G5,CC1C(CO)C(CO)(CC(O)O1)O,16,1,0,1,4,4.7e-05
G5,CC(C1COC(CC1(CO)O)O)O,16,1,0,1,4,4.7e-05
G5,C(CC1(CO)CC(CC(O)O1)O)O,8,1,0,1,4,4.7e-05
G5,C(CC1C(C(CC(O)O1)O)O)=O,16,1,0,1,4,4.7e-05
G5,C(CC1CC(C(C(O)O1)O)O)=O,16,1,0,1,45,4.7e-05
G5,C(C(C1CC(CC(O)O1)O)O)=O,16,1,0,1,45,4.7e-05
G5,CC1(CO)CC(CO)(CC(O)O1)O,8,1,0,1,4,4.7e-05
G5,CC1(CC(O)OC(C)(CO)C1O)O,16,1,0,1,4,4.7e-05
G5,CC1CC(CO)(CC(O)O1)O,8,1,0,1,11,4.7e-05
G5,CC1(CC(O)OC(C)C1O)O,16,1,0,1,4,4.7e-05
G5,CC1(CO)CC(CC(O)O1)O,8,1,0,1,18,4.7e-05
G5,C(C1C(C(CC(O1)O)O)C(C)O)=O,32,1,0,1,4,4.7e-05
G5,C(C(C1C(CC(O)OC1C)O)O)=O,32,1,0,1,4,4.7e-05
G5,C(C(CC1CC(CC(O)O1)O)O)=O,16,1,0,1,4,4.7e-05
G5,CC1CC(CC(O)O1)O,8,1,0,1,28,4.7e-05
G5,C(C1(C)C(C(CC(O1)O)O)O)=O,16,1,0,1,45,4.7e-05
G5,C(C1(CC(O)OC(CO)C1)O)=O,8,1,0,1,4,4.7e-05
G5,CC1(CO)C(C(CC(O)O1)O)O,16,1,0,1,4,4.7e-05
G5,CC1C(C(CC(O)O1)O)O,16,1,0,1,28,4.7e-05
G5,C(CO)(C1CC(CC(O1)O)O)=O,8,1,0,1,41,4.7e-05
G5,C1(COC(CC1(C)O)O)=O,4,1,0,1,25,4.7e-05
G5,C1(C(C(C)OC(CO)(C1)O)O)=O,8,1,0,1,4,4.7e-05
G5,C1(C(C(C)OC(C)(C1O)O)O)=O,16,1,0,1,0,4.7e-05
G5,C1(C(C(CO)(O)OC(C)C1)O)=O,8,1,0,1,11,4.7e-05
G5,C1(CC(CO)(CC(O)O1)O)=O,4,1,0,1,29,4.7e-05
G5,C1(C(C(C)(CC(O)O1)O)O)=O,8,1,0,1,33,4.7e-05
G5,C1(C(C(CC(O)O1)O)O)=O,8,1,0,1,17,4.7e-05
G5,C1C2(CC(O1)OC(C2)O)O,8,1,0,1,35,4.7e-05
G5,C1C2(CC(O)OC(C(O)O1)C2)O,16,2,0,2,27,9.499999999999999e-05
G5,C(CC1C(CC(C(O)O1)O)O)=O,16,1,0,1,4,4.7e-05
G5,C(C1(CCC(C(O1)O)O)CC=O)=O,8,1,0,1,29,4.7e-05
G5,C(CC1C(CCC(C=O)(O)O1)O)=O,8,1,0,1,7,4.7e-05
G5,C(C(C1C(C)OC(C(C1)O)O)=O)=O,16,1,0,1,12,4.7e-05
G5,C(C(C)=O)(C1CC(CC(O1)O)O)=O,8,1,0,1,9,4.7e-05
G5,C(CC1C(C(C)(CC(O1)O)O)=O)=O,8,1,0,1,6,4.7e-05
G5,C(CC1(C(COC(C1)O)=O)O)(C)=O,4,1,0,1,26,4.7e-05
G5,C1(C(COC(CC(C)O)(C1)O)=O)=O,4,1,0,1,4,4.7e-05
G5,C(CC1C(C(CC(O1)O)O)=O)(C)=O,8,1,0,1,26,4.7e-05
G5,C(C(C1CC(C)(CC(O1)O)O)=O)=O,8,1,0,1,6,4.7e-05
G5,C1(C(CO)(CC=O)OC(CC1)O)=O,4,1,0,1,4,4.7e-05
G5,C(CCC1(C(COC(C1)O)=O)O)=O,4,2,0,2,27,9.499999999999999e-05
G5,C(CC1CCC(C(CO)(O)O1)=O)=O,4,1,0,1,44,4.7e-05
G5,C(C1C(C)OC(C(C1)=O)(CO)O)=O,8,1,0,1,46,4.7e-05
G5,C(CCC1C(C(CC(O1)O)O)=O)=O,8,2,0,2,27,9.499999999999999e-05
G5,C(C1(C(CCC(O1)O)O)CC=O)=O,8,1,0,1,27,4.7e-05
G5,C(CC1CCC(C(C=O)(O)O1)O)=O,8,1,0,1,27,4.7e-05
G5,C(C1C(C)OC(C=O)(C(C1)O)O)=O,16,1,0,1,46,4.7e-05
G5,C1(CC(C(C)=O)(O)OC(C)C1O)=O,8,1,0,1,24,4.7e-05
G5,C1(C(CC(C)O)(OCC(C1)=O)O)=O,4,1,0,1,4,4.7e-05
G5,C1(COC(CC1(C=CCO)O)O)=O,8,1,0,1,0,4.7e-05
G5,C1(C(CC(OC1C=CCO)O)O)=O,16,1,0,1,29,4.7e-05
G5,C1(C(C(C=C)(O)OC(C)C1O)O)=O,16,1,0,1,32,4.7e-05
G5,C1(CC(C(C(C)O)O)(O)OCC1)=O,8,1,0,1,30,4.7e-05
G5,C1(COC(CC1)(C(C(C)O)O)O)=O,8,1,0,1,29,4.7e-05
G5,C(C)(C(C1(CC(O)OCC1)O)O)=O,8,1,0,1,49,4.7e-05
G5,C1(C(C(CC(C)O)(O)OCC1)O)=O,8,1,0,1,9,4.7e-05
G5,C1(C(COC(CC(C)O)(C1)O)O)=O,8,1,0,1,4,4.7e-05
G5,C(CCC1(CC(O)OCC1O)O)=O,8,2,0,2,27,9.499999999999999e-05
G5,C1(C(CC(C)O)(O)OCC(C1)O)=O,8,1,0,1,4,4.7e-05
G5,C(C(CC1(CC(O)OCC1)O)O)=O,8,1,0,1,29,4.7e-05
G5,C1(CCC2C1(C(CC(O)O2)O)O)=O,16,1,0,1,45,4.7e-05
G5,C(C1(C2CCC1(CC(O)O2)O)O)=O,16,2,0,2,44,9.499999999999999e-05
G5,C1C2(CC(OC(C=1)C2(CO)O)O)O,16,1,0,1,4,4.7e-05
G5,C1C2(CC(O)OCC2(C(C=1)O)O)O,16,1,0,1,4,4.7e-05
G5,C1C(C2(C(CC(OC2C=1)O)O)O)O,32,1,0,1,43,4.7e-05
G5,C1C(CO)(C(CC(O)O1)O)O,8,1,0,1,18,4.7e-05
G5,CC1C(CO)(C(CC(O)O1)O)O,16,1,0,1,4,4.7e-05
G5,CC(C1(COC(CC1O)O)O)O,16,1,0,1,4,4.7e-05
G5,C(C)(C1(COC(CC1O)O)O)=O,8,1,0,1,45,4.7e-05
G5,C(C1(COC(CC1(C)O)O)O)=O,8,1,0,1,6,4.7e-05
G5,C(C)(C1(C(C)OC(CC1O)O)O)=O,16,1,0,1,4,4.7e-05
G5,C(C1(C(C)OC(CC1(C)O)O)O)=O,16,1,0,1,4,4.7e-05
G5,C(C1(C(CC(OC1C=O)O)O)O)=O,16,1,0,1,0,4.7e-05
G5,CC1(CC(O)OCC1(CO)O)O,8,1,0,1,29,4.7e-05
G5,CC1(CC(O)OC(C)C1(CO)O)O,16,1,0,1,4,4.7e-05
G5,CC1(CC(O)OCC1(C(C)O)O)O,16,1,0,1,4,4.7e-05
G5,C(C1(COC(CC1O)O)O)=O,8,1,0,1,45,4.7e-05
G5,C(C1(C(C)OC(CC1O)O)O)=O,16,1,0,1,4,4.7e-05
G5,C(C1(C(CO)OC(CC1O)O)O)O,16,1,0,1,29,4.7e-05
G5,C1C(C(CO)O)(C(CC(O)O1)O)O,16,1,0,1,29,4.7e-05
G5,C1(CC2(C(C1)OC(CC2O)O)O)=O,16,1,0,1,26,4.7e-05
G5,C(C1(CC2(CC1OC(C2)O)O)O)=O,16,2,0,2,4,9.499999999999999e-05
G5,C1(CC2(C(O)OC(C)C1C2O)O)=O,32,2,0,2,17,9.499999999999999e-05
G5,C(C1C(C)(C(CC(O1)O)O)O)(O)=O,16,1,0,1,25,4.7e-05
G5,C(CC1(C(C)OC(CC1O)O)O)=O,16,1,0,1,4,4.7e-05
G5,C1(C2CC(CC(O2)O)(C1CO)O)=O,16,2,0,2,30,9.499999999999999e-05
G5,C1(C(CC2(CC(O)OCC12)O)O)=O,16,1,0,1,30,4.7e-05
G5,C1(CC(C2(CC(O)OCC12)O)O)=O,16,1,0,1,30,4.7e-05
G5,C1(C(C2(C(COC(C2)O)C1)O)O)=O,16,1,0,1,47,4.7e-05
G5,C1(CCC2(CC(O)OCC12O)O)=O,8,1,0,1,21,4.7e-05
G5,C1(CC2(CC1(CO)OC(C2)O)O)=O,8,2,0,2,2,9.499999999999999e-05
G5,C1(CC2(CC(O)OCC2(C1)O)O)=O,8,1,0,1,4,4.7e-05
G5,C1(CC2C(C(C)(CC(O)O2)O)O1)=O,16,1,0,1,48,4.7e-05
G5,C1(COC2C(C)(CC(OC12)O)O)=O,16,1,0,1,17,4.7e-05
G5,C(CC12COC(CC(O)O1)C2O)=O,16,1,0,1,4,4.7e-05
G5,C(CC1CC2C(C(CO2)(O)O1)O)=O,16,1,0,1,9,4.7e-05
G5,C(C1C(C)OC2(COC1C2O)O)=O,32,1,0,1,9,4.7e-05
G5,C(C)(C1C2(CC(O1)OC(C2)O)O)=O,16,1,0,1,9,4.7e-05
G5,C(CC1C2(CC(O1)OC(C2)O)O)=O,16,1,0,1,13,4.7e-05
G5,C1(CCC2(CC(O)OCC2O1)O)=O,8,1,0,1,4,4.7e-05
G5,C1(C2(C(C(C)O)OC(CO2)C1)O)=O,16,1,0,1,54,4.7e-05
G5,C1(COC2COC(CC2(C1)O)O)=O,8,1,0,1,54,4.7e-05
G5,C1(C2C(C)OC(C(CO)O2)(C1)O)=O,16,1,0,1,54,4.7e-05
G5,C1(C2COC(C(C(C)O)O2)(C1)O)=O,16,1,0,1,54,4.7e-05
G5,C1(CC2(CC(CO1)OC(C2)O)O)=O,8,1,0,1,19,4.7e-05
G5,C1(CC2CC(CO1)(CC(O)O2)O)=O,8,1,0,1,48,4.7e-05
G5,C1(COCC2CC1(CC(O)O2)O)=O,8,1,0,1,36,4.7e-05
G5,C1(C2C(C)OC(C(CO2)O)(C1)O)=O,16,1,0,1,36,4.7e-05
G5,C1(C2C(C)OC(CCO2)(C1O)O)=O,16,1,0,1,36,4.7e-05
G5,C1(C(C2(COCC1C(C)O2)O)O)=O,16,1,0,1,36,4.7e-05
G5,C1(COCC2(CC1OC(C2)O)O)=O,8,1,0,1,36,4.7e-05
G5,C1(CC2(C(O)OCC1C(C)O2)O)=O,16,2,0,2,4,9.499999999999999e-05
G5,C1(CCOC2CC1(CC(O)O2)O)=O,8,1,0,1,4,4.7e-05
G5,C1(COC2CC(CC(O)O2)(C1)O)=O,8,1,0,1,32,4.7e-05
G5,C1(CC2(COC(C1C(C)O2)O)O)=O,16,2,0,2,4,9.499999999999999e-05
G5,C1(C2C(C)OC(CC(O2)O)(C1)O)=O,16,2,0,2,38,9.499999999999999e-05
G5,C1(C2C(C(OC1CO2)O)C(C)O)=O,32,1,0,1,9,4.7e-05
G5,C1(C2(CC(CC(O2)O)O)OCC1)=O,8,1,0,1,53,4.7e-05
G5,C1(COC2(CC(CC(O)O2)O)C1)=O,8,1,0,1,26,4.7e-05
G5,C(CC12CC(CO1)(CC(O)O2)O)=O,8,1,0,1,26,4.7e-05
G5,C(C1CC2C(C(CC(O)O2)O)O1)=O,32,1,0,1,40,4.7e-05
G5,C(C1C2(CC(C)(O1)OC(C2)O)O)=O,16,1,0,1,4,4.7e-05
G5,C1(C2C(C(CC(O2)O)O)OC1C)=O,32,1,0,1,29,4.7e-05
G5,C(C12CC(CC(O1)O)(CCO2)O)=O,8,1,0,1,30,4.7e-05
G5,C(CC1C2(CCC(CO2)(O)O1)O)=O,8,2,0,2,7,9.499999999999999e-05
G5,C(CC12COC(C(O)O1)(CC2)O)=O,8,2,0,2,29,9.499999999999999e-05
G5,C1(COC2(C(O)OC(C)C1C2)O)=O,16,2,0,2,12,9.499999999999999e-05
G5,C1(C2C(O)OC(C)C1CC(O2)O)=O,32,2,0,2,4,9.499999999999999e-05
G5,C(C1CC2(CC(O)OC(C2)O1)O)=O,16,1,0,1,4,4.7e-05
G5,C1C2C(C(C=1CO)(CC(O2)O)O)O,16,1,0,1,2,4.7e-05
G5,C1C(C(C2(C=1COC(C2)O)O)O)O,16,1,0,1,2,4.7e-05
G5,C=C1C(C2C(C1(CC(O)O2)O)O)O,32,2,0,2,47,9.499999999999999e-05
G5,C=C1C2C(C(C1(CC(O2)O)O)O)O,32,2,0,2,47,9.499999999999999e-05
G5,C1C(C(C2C=1C(CC(O2)O)O)O)O,32,1,0,1,29,4.7e-05
G5,C=CC(C1C(C(CC(O)O1)O)O)O,32,1,0,1,4,4.7e-05
G5,C1C2(C(C(C=1)O)OC(CC2O)O)O,32,1,0,1,29,4.7e-05
G5,C1OC2C(CO)OC(CC2(C=1)O)O,16,1,0,1,9,4.7e-05
G5,C1C2(C(COC(C2)O)OC(C=1)O)O,16,1,0,1,2,4.7e-05
G5,C1OCC2C(C(C=1)(CC(O)O2)O)O,16,1,0,1,38,4.7e-05
G5,C1C2(C(C(OCC=1)OC(C2)O)O)O,16,1,0,1,19,4.7e-05
G5,C1C2(C(C(CC(O2)O)O)O)OCC=1,16,1,0,1,39,4.7e-05
G5,C1C2C(C(CC(O2)O)O)OC=1CO,16,1,0,1,40,4.7e-05
G5,C=C1C(C2C(C(CC(O)O2)O)O1)O,32,1,0,1,26,4.7e-05
G5,C1C2C(C(CC(O2)O)O)OC(C=1)O,32,1,0,1,37,4.7e-05
G5,C1OC2C(C(C=1)O)OC(CC2O)O,32,1,0,1,37,4.7e-05
G5,C(C1C(O)OCC(C1(CO)O)O)=O,16,1,0,1,45,4.7e-05
G5,C1(CC(C=O)(O)OC(C1CO)=O)=O,4,1,0,1,30,4.7e-05
G5,C(C1CC(COC1(C=O)O)=O)(O)=O,4,1,0,1,12,4.7e-05
G5,C1(C(C(CO)=O)CC(C(O)O1)=O)=O,4,1,0,1,12,4.7e-05
G5,C1(C(C(C=O)=O)C(CC(O)O1)O)=O,8,1,0,1,17,4.7e-05
G5,C1(C(C=O)C(CC(C=O)(O)O1)O)=O,8,1,0,1,23,4.7e-05
G5,C1(C(C=O)C(CC(CO)(O)O1)=O)=O,4,1,0,1,17,4.7e-05
G5,C1(CC(O)OC(C1C(CO)=O)=O)=O,4,1,0,1,17,4.7e-05
G5,C1(C(C(CC(CC=O)(O)O1)=O)O)=O,4,1,0,1,17,4.7e-05
G5,C1(C(C=O)C(C(C(C)(O)O1)O)=O)=O,8,1,0,1,17,4.7e-05
G5,C(CC1(C(C(CC(O1)=O)=O)O)O)=O,4,1,0,1,17,4.7e-05
G5,C1(C(C(O)OC(C1C(C)=O)=O)O)=O,8,1,0,1,17,4.7e-05
G5,C1(CC(C(C=O)O)(O)OC(C1)=O)=O,4,1,0,1,17,4.7e-05
G5,C1(C(C(O)OC(C1CC=O)=O)O)=O,8,1,0,1,17,4.7e-05
G5,C(C1C(OC(C=O)C(C1)=O)O)(O)=O,8,1,0,1,17,4.7e-05
G5,C1(CC(O)OC(C1C(C=O)O)=O)=O,8,1,0,1,17,4.7e-05
G5,C1(C(CC(C)(C(O)O1)O)O)=O,8,1,0,1,29,4.7e-05
G5,C(C1CC(C)(C(C(O1)O)O)O)(O)=O,16,1,0,1,26,4.7e-05
G5,C1(C(CC(C(O)O1)O)O)=O,8,1,0,1,29,4.7e-05
G5,C1(C(CC(C(O)O1)(CCO)O)O)=O,8,1,0,1,29,4.7e-05
G5,C1(C(C(CO)C(C(C)(O)O1)O)O)=O,16,1,0,1,29,4.7e-05
G5,C1(C(C(CO)C(C)(C(O)O1)O)O)=O,16,1,0,1,29,4.7e-05
G5,C1(C(C(CO)C(C(O)O1)O)O)=O,16,1,0,1,29,4.7e-05
G5,C1(C(C(CO)CC(CO)(O)O1)O)=O,8,1,0,1,29,4.7e-05
G5,C(C1C(CO)C(CC(O1)O)O)(O)=O,16,1,0,1,33,4.7e-05
G5,C1(C(C)(C(CO)C(C(O)O1)O)O)=O,16,1,0,1,29,4.7e-05
G5,C1(C(CCO)(CC(C(O)O1)O)O)=O,8,1,0,1,29,4.7e-05
G5,C(C1CCC(C(O1)O)O)(O)=O,8,1,0,1,12,4.7e-05
G5,C1(C(C)(C(CC(O)O1)O)O)=O,8,1,0,1,25,4.7e-05
G5,C1(C(C(CC(C)(O)O1)O)O)=O,8,1,0,1,17,4.7e-05
G5,C1(C(CO)(CCC(O)O1)O)=O,4,1,0,1,29,4.7e-05
G5,C(C1C(CCC(O1)O)O)(O)=O,8,1,0,1,33,4.7e-05
G5,C1(C(CC(CO)(C(C)(O)O1)O)O)=O,8,1,0,1,45,4.7e-05
G5,C1(C(C)(CC(CO)(C(O)O1)O)O)=O,8,1,0,1,14,4.7e-05
G5,C1(C(C)OC(C(C1O)=O)O)=O,8,1,0,1,1,4.7e-05
G5,C1(CC(C(C(C=O)(O)O1)O)O)=O,8,1,0,1,29,4.7e-05
G5,C(C1(C(C(O)OCC1)=O)O)=O,4,1,0,1,29,4.7e-05
G5,C1(C(O)OCCC1(CO)O)=O,4,1,0,1,29,4.7e-05
G5,C1(C(O)OCC(C1(CO)O)O)=O,8,1,0,1,0,4.7e-05
G5,C(C1(C(CC(CO)(CO1)O)O)O)=O,8,1,0,1,5,4.7e-05
G5,C1C(CO)(CC(C(O)O1)O)O,8,1,0,1,29,4.7e-05
G5,C(C1(C(CC(C(CO)O1)O)O)O)=O,16,1,0,1,20,4.7e-05
G5,C(C1(C(CC(C(CO)O1)O)O)O)O,16,1,0,1,41,4.7e-05
G5,C1(C(COC(C(C)O)(C1)O)O)=O,8,1,0,1,24,4.7e-05
G5,C1(C(CCO)OC(C(C1)=O)O)=O,4,1,0,1,29,4.7e-05
G5,C1(C(C(C(C)O)(O)OCC1)O)=O,8,1,0,1,25,4.7e-05
G5,C1(C(C)OC(CC1(CO)O)O)=O,8,1,0,1,25,4.7e-05
G5,C(C(C1CC(C(C(O1)O)O)O)=O)=O,16,1,0,1,0,4.7e-05
G5,C(C1C(CC(C(C=O)(O1)O)O)O)=O,16,1,0,1,0,4.7e-05
G5,C(C1(C(CC(CO1)(C)O)O)O)=O,8,1,0,1,49,4.7e-05
G5,C(C1C(C)(CC(C(O1)O)O)O)=O,16,1,0,1,0,4.7e-05
G5,C(C1CC(C)(C(C(O1)O)O)O)=O,16,1,0,1,0,4.7e-05
G5,C1(C(C)OC(C(C1(C)O)O)O)=O,16,1,0,1,49,4.7e-05
G5,C1(C(C(CO)(O)OCC1O)O)=O,8,1,0,1,5,4.7e-05
G5,C1C(C)(CC(C(CO)(O)O1)O)O,8,1,0,1,49,4.7e-05
G5,CC1(CC(C(O)OC1CO)O)O,16,1,0,1,52,4.7e-05
G5,C1C(C(CO)C(C(CO)(O)O1)O)O,16,1,0,1,5,4.7e-05
G5,C(C1C(CO)CC(C(O1)O)=O)=O,8,1,0,1,12,4.7e-05
G5,C(CO)(C1CCC(C(O1)O)=O)=O,4,1,0,1,20,4.7e-05
G5,C1(C(C(CCO)OC(C1)O)=O)=O,4,1,0,1,31,4.7e-05
G5,C1C2C(CO)C(C(C(O)O2)(O)O1)O,32,1,0,1,19,4.7e-05
G5,C1(C(CCO)OC(C(C1O)O)O)=O,16,1,0,1,31,4.7e-05
G5,C1C(C)(CC(C(O)O1)O)O,8,1,0,1,49,4.7e-05
G5,C1C(C)(C(C(C(CO)(O)O1)O)O)O,16,1,0,1,5,4.7e-05
G5,C(C1C(C(C)O)CC(C(O1)O)=O)=O,16,1,0,1,12,4.7e-05
G5,C(C(C)O)(C1CCC(C(O1)O)=O)=O,8,1,0,1,12,4.7e-05
G5,C1(C(CC(C)O)OC(C(C1)=O)O)=O,8,1,0,1,22,4.7e-05
G5,C1(C(C(CC(C)O)OC(C1)O)=O)=O,8,1,0,1,9,4.7e-05
G5,C(C(C1(C(CC(CO1)O)O)O)O)=O,16,1,0,1,29,4.7e-05
G5,C1C(CC(C(O)O1)O)O,8,1,0,1,0,4.7e-05
G5,C(C1(C(C(CO)C(CO1)O)O)O)=O,16,1,0,1,19,4.7e-05
G5,C(OC1COC(C(C1)O)O)=O,8,1,0,1,2,4.7e-05
G5,C1(C(CO)(O)OCC(C1O)O)=O,8,1,0,1,5,4.7e-05
G5,C(C1(C(CCCO1)O)O)=O,4,1,0,1,29,4.7e-05
G5,C1(CCC(C(C=O)(O)O1)O)=O,4,1,0,1,29,4.7e-05
G5,C1(COC(C(CO)(C1(C)O)O)O)=O,8,1,0,1,25,4.7e-05
G5,C(C1(C(C(C)OC(C1O)O)=O)O)=O,16,1,0,1,0,4.7e-05
G5,C(C1(C(COC(C)(C1O)O)=O)O)=O,8,1,0,1,5,4.7e-05
G5,C(C1(C(COC(C1(C)O)O)=O)O)=O,8,1,0,1,45,4.7e-05
G5,C(C1(C(OC(C(C1O)=O)C)O)O)=O,16,1,0,1,1,4.7e-05
G5,C(C1(C(OCC(C1(C)O)=O)O)O)=O,8,1,0,1,25,4.7e-05
G5,C(C)(C1(C(OCC(C1O)=O)O)O)=O,8,1,0,1,5,4.7e-05
G5,C(C1(C(C)(OCC(C1O)=O)O)O)=O,8,1,0,1,5,4.7e-05
G5,C(C)(C1(C(COC(C1O)O)=O)O)=O,8,1,0,1,0,4.7e-05
G5,C(C1(C(COC(C1O)O)=O)O)=O,8,1,0,1,0,4.7e-05
G5,C(C1(C(OCC(C1O)=O)O)O)=O,8,1,0,1,5,4.7e-05
G5,C(C1(C(C(C)OC(C1)O)=O)O)=O,8,1,0,1,29,4.7e-05
G5,C(C1(C(COC(CO)(C1)O)=O)O)=O,4,1,0,1,51,4.7e-05
G5,C(C1(C(CO)(OCC(C1)=O)O)O)=O,4,1,0,1,51,4.7e-05
G5,C(C1(C(COC(C1)O)=O)O)=O,4,1,0,1,0,4.7e-05
G5,C(C1(COC(C(C1)O)O)O)=O,8,1,0,1,2,4.7e-05
G5,C(C1(C(C)OC(C(C1)O)O)O)=O,16,1,0,1,4,4.7e-05
G5,C1(C(C(CO)(O)OCC1(C)O)O)=O,8,1,0,1,2,4.7e-05
G5,C(C1(C(CO)OC(C(C1)O)O)O)=O,16,1,0,1,0,4.7e-05
G5,C1(C2CC(CC(O2)O)O1)=O,8,2,0,2,33,9.499999999999999e-05
G5,C1(C2(C(CC(CO2)O1)O)O)=O,8,2,0,2,50,9.499999999999999e-05
G5,C(CC1COC(C(C1)=O)(CO)O)=O,4,2,0,2,46,9.6e-05
G5,C(C(C1CC(CO)CC(O1)O)=O)=O,8,1,0,1,55,4.7e-05
G5,C(CC1COC(C=O)(C(C1)O)O)=O,8,1,0,1,55,4.7e-05
G5,C(C1CC(C(CO)=O)OC(C1)O)=O,8,1,0,1,25,4.7e-05
G5,C(C(C(C1CCCC(O1)O)=O)O)=O,8,1,0,1,27,4.7e-05
G5,C(CC1C(COC(C1)O)=O)(CO)=O,4,1,0,1,32,4.7e-05
G5,C1(COC(CO)(CC1CC=O)O)=O,4,1,0,1,32,4.7e-05
G5,C(CC1C(CO)(OCC(C1)=O)O)=O,4,2,0,2,32,9.6e-05
G5,C(CC1CC(C(OC1C=O)O)O)=O,16,1,0,1,27,4.7e-05
G5,C(C(C1CC(C=O)OC(C1)O)O)=O,16,1,0,1,27,4.7e-05
G5,C(CC1CC(C=O)OC(C1O)O)=O,16,1,0,1,27,4.7e-05
G5,CC1(CCOC(C1O)O)O,8,1,0,1,28,4.7e-05
G5,C(C1(CCOC(C1)(CCO)O)O)=O,4,1,0,1,29,4.7e-05
G5,C(C1(CC(C(CO1)C(C)O)O)O)=O,16,1,0,1,29,4.7e-05
G5,C(C1(CC(CCO1)O)O)(CCO)=O,4,1,0,1,18,4.7e-05
G5,C(CO)(CC1(CC(CCO1)O)O)=O,4,1,0,1,26,4.7e-05
G5,C(C)(C(C1(CC(CCO1)O)O)O)=O,8,1,0,1,49,4.7e-05
G5,C(CC1(C(C(C)(CCO1)O)O)O)=O,8,1,0,1,28,4.7e-05
G5,C(C)(CC1(C(C(CCO1)O)O)O)=O,8,1,0,1,26,4.7e-05
G5,C(C(C1(CC(C)(O)OCC1)O)O)=O,8,1,0,1,27,4.7e-05
G5,C(C(C1(CC(C)(CCO1)O)O)O)=O,8,1,0,1,29,4.7e-05
G5,C(CCC1(C(C(CCO1)O)O)O)=O,8,1,0,1,7,4.7e-05
G5,C(CCC1(CCOC(C1O)O)O)=O,8,1,0,1,29,4.7e-05
G5,C(C(CC1(CC(CCO1)O)O)O)=O,8,1,0,1,27,4.7e-05
G5,C(C1(C(C(CCO1)O)O)O)=CCO,16,1,0,1,11,4.7e-05
G5,C(C1(C(C(O)OCC1)O)O)=CCO,16,1,0,1,0,4.7e-05
G5,C(C1(CCC(CO1)O)O)=O,4,1,0,1,7,4.7e-05
G5,C1CC(C(CO)(C(CO)(O)O1)O)O,8,1,0,1,2,4.7e-05
G5,C(C1(CCOC(C1(C)O)O)O)=O,8,1,0,1,29,4.7e-05
G5,C1(COC(C)(C(C(C)O)(C1)O)O)=O,8,1,0,1,45,4.7e-05
G5,C1C2(C(C(CCO2)O1)O)O,8,1,0,1,29,4.7e-05
G5,C1C2(CCC(CO2)(O)O1)O,3,1,0,1,29,4.7e-05
G5,C(C1(CC(C(CO)O)CCO1)O)=O,8,1,0,1,46,4.7e-05
G5,C(C(C1(CC(CO)CCO1)O)O)=O,8,1,0,1,46,4.7e-05
G5,C(C1CCOC(C1)(C(CO)O)O)=O,8,1,0,1,46,4.7e-05
G5,C(C(CO)O)(C1CC(O)OCC1)=O,8,1,0,1,46,4.7e-05
G5,C(C(C(C1(CCCCO1)O)O)O)=O,8,1,0,1,46,4.7e-05
G5,C(CO)(CC1C(C(O)OCC1)O)=O,8,1,0,1,46,4.7e-05
G5,C(C(C1CC(CO)(O)OCC1)O)=O,8,1,0,1,46,4.7e-05
G5,C(C(C(C1CC(O)OCC1)O)O)=O,16,1,0,1,46,4.7e-05
G5,C1(CC(C(C(C)(O)O1)O)O)=O,8,1,0,1,28,4.7e-05
G5,C1(CC(C)(C(C(O)O1)O)O)=O,8,1,0,1,6,4.7e-05
G5,C1(CC(C(C(O)O1)O)O)=O,8,1,0,1,28,4.7e-05
G5,C1(C(C(CC(CO)(O)O1)O)=O)=O,4,1,0,1,29,4.7e-05
G5,C1(C(C(C(C(C)(O)O1)O)O)=O)=O,8,1,0,1,33,4.7e-05
G5,C1(C(CCC(C=O)(O)O1)O)=O,4,1,0,1,29,4.7e-05
G5,C1(C(C(C(CO)(C(O)O1)O)O)O)=O,16,1,0,1,17,4.7e-05
G5,C(C1(C(C(O)OC(C1O)=O)O)O)=O,16,1,0,1,33,4.7e-05
G5,C(C1(C(O)OC(C(C1O)O)=O)O)=O,16,1,0,1,1,4.7e-05
G5,C1(C(C=O)(C(C(C(O)O1)O)O)O)=O,16,1,0,1,1,4.7e-05
G5,C(C1(C(C(C)(O)OC(C1)=O)O)O)=O,8,1,0,1,17,4.7e-05
G5,C1(C(C)(C(C=O)(CC(O)O1)O)O)=O,8,1,0,1,43,4.7e-05
G5,C(C1(C(C)(C(O)OC(C1)=O)O)O)=O,8,1,0,1,29,4.7e-05
G5,C(C1(CC(O)OC(C1O)=O)O)=O,8,1,0,1,33,4.7e-05
G5,C(C1(C(C(O)OC(C1)=O)O)O)=O,8,1,0,1,0,4.7e-05
G5,C1(CC2C(C(CO2)(O)O1)O)=O,8,1,0,1,29,4.7e-05
G5,C1(C2(CCC(CO2)(O)O1)O)=O,4,2,0,2,17,9.499999999999999e-05
G5,C1C2CC(C(CO)(C(C=1)(O2)O)O)O,16,1,0,1,21,4.7e-05
G5,C1C(C2(C(OC(C=1)CC2O)O)O)O,32,1,0,1,43,4.7e-05
G5,C1C2C(C(C(C(O)O1)(C2O)O)O)O,64,2,0,2,43,9.499999999999999e-05
G5,C1C2(CC(C(C(O)O1)(C2O)O)O)O,32,2,0,2,43,9.499999999999999e-05
G5,C1(C(CO)(C2CC1CC(O)O2)O)=O,16,2,0,2,46,9.499999999999999e-05
G5,C(C1(C(C2CC1OC(C2)O)O)O)=O,32,2,0,2,43,9.499999999999999e-05
G5,C1(C2(C(CC(CC2O)(O)O1)=O)O)=O,8,1,0,1,17,4.7e-05
G5,C1(C2(C(CC(C(O)O1)C2O)=O)O)=O,16,2,0,2,17,9.499999999999999e-05
G5,C(C1(C(OCC(C1O)=O)O)O)(O)=O,8,1,0,1,5,4.7e-05
G5,C1(C(C(CC(O)O1)=O)(CO)O)=O,4,1,0,1,2,4.7e-05
G5,C1(C(C(CC(O)O1)=O)(C(C)O)O)=O,8,1,0,1,17,4.7e-05
G5,C1(C(C(C)=O)(C(CC(O)O1)O)O)=O,8,1,0,1,45,4.7e-05
G5,C1(C(C=O)(C(C)(CC(O)O1)O)O)=O,8,1,0,1,17,4.7e-05
G5,CC1(C(C(CCO1)O)(C(C)O)O)O,16,1,0,1,4,4.7e-05
G5,CC(C1(C(O)OCCC1O)O)O,16,1,0,1,18,4.7e-05
G5,C(C1(C(CO)(O)OCCC1O)O)=O,8,1,0,1,5,4.7e-05
G5,C(CO)(C1(C(O)OCCC1O)O)=O,8,1,0,1,5,4.7e-05
G5,C(C1(C(C)(O)OCCC1O)O)(O)=O,8,1,0,1,0,4.7e-05
G5,C(C1(C(O)OCCC1O)O)(O)=O,8,1,0,1,17,4.7e-05
G5,C1C2(C(CO1)(C(CCO2)O)O)O,8,1,0,1,10,4.7e-05
G5,C1(C(C=O)(C(CC(O)O1)O)O)=O,8,1,0,1,17,4.7e-05
G5,CC(C1(C(O)OC(C)CC1O)O)O,32,1,0,1,28,4.7e-05
G5,C(C1(C(O)OC(C)CC1O)O)(O)=O,16,1,0,1,17,4.7e-05
G5,C1C2(C(CO1)(C(CC(C)O2)O)O)O,16,1,0,1,10,4.7e-05
G5,C(C1(C(C)OC(C)(CC1O)O)O)=O,16,1,0,1,6,4.7e-05
G5,C(C(C1(COC(CC1O)O)O)=O)=O,8,1,0,1,5,4.7e-05
G5,C1(C(O)OC(C(C1(CO)O)O)=O)=O,8,1,0,1,33,4.7e-05
G5,C1(C(O)OC(C)C(C1(CO)O)O)=O,16,1,0,1,11,4.7e-05
G5,C1(COC2(COCC2(C1O)O)O)=O,8,1,0,1,10,4.7e-05
G5,C1(C(C(CC(O)O1)O)C(C=O)O)=O,16,1,0,1,43,4.7e-05
G5,C(C1C(CC(OC1C=O)O)O)(O)=O,16,1,0,1,43,4.7e-05
G5,C1(C2(C(CO1)OC(CC2O)O)O)=O,16,1,0,1,40,4.7e-05
G5,C1(C2C(CO1)OC(CC2O)O)=O,16,1,0,1,8,4.7e-05
G5,C1(C(CO)(C(CC(O)O1)O)O)=O,8,1,0,1,17,4.7e-05
G5,C(C1(COC(CC1O)O)O)(O)=O,8,1,0,1,17,4.7e-05
G5,C1(C(C(C)O)(C(CC(O)O1)O)O)=O,16,1,0,1,4,4.7e-05
G5,C(C1(C(C)OC(CC1O)O)O)(O)=O,16,1,0,1,4,4.7e-05
G5,C1(C2C(OC(C2O)C(C)(O)O1)=O)=O,16,1,0,1,48,4.7e-05
G5,C1(C2(C(COC2CC(O)O1)=O)O)=O,8,1,0,1,9,4.7e-05
G5,C1(C2(C(CC(CO2)(O)O1)=O)CO)=O,4,1,0,1,54,4.7e-05
G5,C1(C2C(OC(CO1)(CC2O)O)=O)=O,8,1,0,1,48,4.7e-05
G5,C1(C2(C(CC(COC2)(O)O1)=O)O)=O,4,1,0,1,36,4.7e-05
G5,C(C1C(C(O)OC(C1O)=O)O)(O)=O,16,1,0,1,33,4.7e-05
G5,C1(C(C=O)(C(CC(C)(O)O1)O)O)=O,8,1,0,1,17,4.7e-05
G5,C(C1C(C(O)OC(C)C1O)O)(O)=O,32,1,0,1,11,4.7e-05
G5,C1(C2C(CO1)OC(CC2(C)O)O)=O,16,1,0,1,8,4.7e-05
G5,C1(C2C(CO1)OC(C)(CC2O)O)=O,16,1,0,1,8,4.7e-05
G5,C1(C(CO)(C(C)(CC(O)O1)O)O)=O,8,1,0,1,33,4.7e-05
G5,C(C1(COC(CC1(C)O)O)O)(O)=O,8,1,0,1,33,4.7e-05
G5,C1(C(CO)(C(CC(C)(O)O1)O)O)=O,8,1,0,1,6,4.7e-05
G5,C(C1(COC(C)(CC1O)O)O)(O)=O,8,1,0,1,6,4.7e-05
G5,C1CC(C(C(O)O1)(C(CO)O)O)O,16,1,0,1,0,4.7e-05
G5,C1CC(C(C(O)O1)(CO)O)O,8,1,0,1,18,4.7e-05
G5,CC1CC(C(C(O)O1)(CO)O)O,16,1,0,1,28,4.7e-05
G5,CC1C(C(C(C(O)O1)(CO)O)O)O,32,1,0,1,28,4.7e-05
G5,C(C1(CC(O)OCC1(C=O)O)O)=O,8,1,0,1,23,4.7e-05
G5,C(C1(COC(C)(CC1O)O)O)=O,8,1,0,1,41,4.7e-05
G5,C1C2(CC(O1)OC(C2(CO)O)O)O,16,1,0,1,35,4.7e-05
G5,C1C2(C(CO1)(O)OCC(C2O)O)O,16,1,0,1,10,4.7e-05
G5,C(C)(C1(C(O)OCCC1O)O)=O,8,1,0,1,1,4.7e-05
G5,C(C1(C(C)(O)OCCC1O)O)=O,8,1,0,1,1,4.7e-05
G5,C(C)(C1(C(O)OC(C)CC1O)O)=O,16,1,0,1,1,4.7e-05
G5,C(C1(C(C)(O)OC(C)CC1O)O)=O,16,1,0,1,1,4.7e-05
G5,CC1(C(CO)(C(CCO1)O)O)O,8,1,0,1,18,4.7e-05
G5,CC1(C(CO)(C(CC(C)O1)O)O)O,16,1,0,1,28,4.7e-05
G5,C(C)(C1(COC(CC1(C)O)O)O)=O,8,1,0,1,6,4.7e-05
G5,C(C)(C1(COC(C)(CC1O)O)O)=O,8,1,0,1,6,4.7e-05
G5,C1(C2COC(C)(C(C2O)O1)O)=O,16,1,0,1,48,4.7e-05
G5,C1(COC2CC(O)OCC12O)=O,8,1,0,1,9,4.7e-05
G5,C1(C2COC(CO1)(CC2O)O)=O,8,1,0,1,48,4.7e-05
G5,C1(CC2(COCC1(CO2)O)O)=O,4,1,0,1,36,4.7e-05
G5,C1C2C(C(C(C(O)O2)(CO)O1)O)O,32,1,0,1,37,4.7e-05
G5,C1(C2(COC(C)(C(C2O)O1)O)O)=O,16,1,0,1,2,4.7e-05
G5,C1(C2(COC(CO1)(CC2O)O)O)=O,8,1,0,1,2,4.7e-05
G5,C1(C2(CO)C(CC(C(O)O2)O1)O)O,32,2,0,2,43,9.499999999999999e-05
G5,C(C1(C(O)OCCC1O)O)=O,8,1,0,1,1,4.7e-05
G5,C(C1(C(O)OC(C)CC1O)O)=O,16,1,0,1,1,4.7e-05
G5,C(C1(C(O)OC(C)C(C1O)O)O)=O,32,1,0,1,1,4.7e-05
G5,C(C1(C=O)C(C(CC(O1)O)=O)O)=O,4,1,0,1,23,4.7e-05
G5,C(C1(C=O)C(CC(C(O1)O)=O)O)=O,4,1,0,1,1,4.7e-05
G5,C(C1(C(O)OC2CC1(CO2)O)O)=O,16,1,0,1,1,4.7e-05
G5,C1(C2C(CO1)OC(C(C2O)O)O)=O,32,1,0,1,8,4.7e-05
G5,C1(C(O)OCC(C)(C1(CO)O)O)=O,8,1,0,1,49,4.7e-05
G5,C(C(C1(C(O)OCCC1O)O)O)=O,16,1,0,1,0,4.7e-05
G5,C(C1(C(C(O)OC(C)C1O)O)O)=O,32,1,0,1,11,4.7e-05
G5,C1(C2C(C)OC(C)(C(C2O)O1)O)=O,32,1,0,1,48,4.7e-05
G5,C1(COC2CC(O)OC(C)C12O)=O,16,1,0,1,9,4.7e-05
G5,C1(CC2(COC1(CO)C(C)O2)O)=O,8,1,0,1,54,4.7e-05
G5,C1(C2C(C)OC(CO1)(CC2O)O)=O,16,1,0,1,48,4.7e-05
G5,C1(CC2(COCC1(C(C)O2)O)O)=O,8,1,0,1,36,4.7e-05
G5,C1(CC(O)OC(C1(C(C)=O)O)=O)=O,4,1,0,1,9,4.7e-05
G5,C1(C(C=O)(C(CC(C)(O)O1)=O)O)=O,4,1,0,1,17,4.7e-05
G5,C1C2(CC(C(C(O)O1)(C2)O)O)O,16,2,0,2,21,9.499999999999999e-05
G5,C1(CCC2(COC(CC12O)O)O)=O,8,1,0,1,7,4.7e-05
G5,C1(C2CC(C(C(C)(O2)O)(C1)O)O)=O,16,1,0,1,45,4.7e-05
G5,C1(CC(O)OC2CC(CC12O)O)=O,16,1,0,1,13,4.7e-05
G5,C1(CC2(C(OC1(C)CC2O)O)O)=O,16,1,0,1,21,4.7e-05
G5,C1(CC2(C(O)OC(CC2O)C1)O)=O,16,2,0,2,26,9.499999999999999e-05
G5,C1C2(C(OC(C=1)(CO)CC2O)O)O,16,1,0,1,32,4.7e-05
G5,C1C2(CC(C(O)O1)(C(C2O)O)O)O,32,2,0,2,20,9.499999999999999e-05
G5,C1C2(C(CC(C(O)O1)(C2O)O)O)O,32,2,0,2,43,9.499999999999999e-05
G5,C1(C2(C(CC(C(O)O1)(C2)O)=O)O)=O,8,2,0,2,17,9.499999999999999e-05
G5,C1(C2(C(C(C(O)O1)C(C2)O)=O)O)=O,16,2,0,2,17,9.499999999999999e-05
G5,C1(C(C=O)(CC(C(O)O1)=O)O)=O,4,1,0,1,29,4.7e-05
G5,C(C1(C(C)(OCC(C1)=O)O)O)(O)=O,4,1,0,1,17,4.7e-05
G5,C(C1(CC(C)OC(C1(C)O)O)O)=O,16,1,0,1,11,4.7e-05
G5,C(CC1(C(CCOC1(C)O)O)O)=O,8,1,0,1,45,4.7e-05
G5,C(C)(C1(CC(O)OC(C1O)=O)O)=O,8,1,0,1,45,4.7e-05
G5,C(C1(C)C(C)(C(CC(O1)O)O)O)=O,16,1,0,1,11,4.7e-05
G5,C(C)(C1CC(C(C)(C(O1)O)O)O)=O,16,1,0,1,11,4.7e-05
G5,C(C1(C)C(CC(C(C)(O1)O)O)O)=O,16,1,0,1,11,4.7e-05
G5,C(C)(C1(CC(O)OC(C)C1O)O)=O,16,1,0,1,45,4.7e-05
G5,C(C1(C)CC(C(C)(C(O1)O)O)O)=O,16,1,0,1,11,4.7e-05
G5,C(C1(C)C(CC(C)(C(O1)O)O)O)=O,16,1,0,1,11,4.7e-05
G5,C(C1(C(C)(C(CCO1)O)O)O)=O,8,1,0,1,18,4.7e-05
G5,CC1(C(CO)(O)OCCC1O)O,8,1,0,1,18,4.7e-05
G5,C1CC(C(C(O)O1)(CCO)O)O,8,1,0,1,29,4.7e-05
G5,C(CC1(C(O)OCCC1O)O)(O)=O,8,1,0,1,29,4.7e-05
G5,CC1(C(O)OCCC1O)O,8,1,0,1,11,4.7e-05
G5,C1CC2(C(C(CCO2)O)(O)O1)O,8,1,0,1,34,4.7e-05
G5,CC1(C(O)OC(C)CC1(CO)O)O,16,1,0,1,11,4.7e-05
G5,CC1(C(C(C)OC(C1(C)O)O)O)O,32,1,0,1,11,4.7e-05
G5,CC1(C(O)OC(C)(CO)CC1O)O,16,1,0,1,11,4.7e-05
G5,C(C1(C(C)(C(CC(C)O1)O)O)O)=O,16,1,0,1,25,4.7e-05
G5,CC1CC(C(C)(C(CO)(O)O1)O)O,16,1,0,1,25,4.7e-05
G5,CC1CC(C(C(O)O1)(CCO)O)O,16,1,0,1,29,4.7e-05
G5,CC1(C(O)OC(C)CC1O)O,16,1,0,1,11,4.7e-05
G5,C1CC2(C(C(CC(C)O2)O)(O)O1)O,16,1,0,1,34,4.7e-05
G5,CC1(C(O)OC(C)C(C1O)O)O,32,1,0,1,11,4.7e-05
G5,CC1(C(O)OC(CO)CC1O)O,16,1,0,1,11,4.7e-05
G5,C1(C(C)(C(CC(C=O)(O)O1)O)O)=O,8,1,0,1,25,4.7e-05
G5,C(C1(C)C(CC(C(O1)O)=O)O)(O)=O,8,1,0,1,25,4.7e-05
G5,C1(C(C)(C(C)(CC(O)O1)O)O)=O,8,1,0,1,25,4.7e-05
G5,C1(C(C)(C(CC(C)(O)O1)O)O)=O,8,1,0,1,25,4.7e-05
G5,C1(C(CCO)(C(CC(O)O1)O)O)=O,8,1,0,1,45,4.7e-05
G5,C(C1(COC(C(C1(C)O)=O)O)O)=O,8,1,0,1,25,4.7e-05
G5,C(C1(C(C)(C(C(CO1)=O)O)O)O)=O,8,1,0,1,5,4.7e-05
G5,C1(COC2(C(C1O)(O)OCC2)O)=O,8,1,0,1,5,4.7e-05
G5,C1(COC(C(C)(C1(C)O)O)O)=O,8,1,0,1,25,4.7e-05
G5,C1(C(C)(C(C(C(O)O1)=O)(C)O)O)=O,8,1,0,1,25,4.7e-05
G5,C1(C(O)OC(C(C1(C)O)O)=O)=O,8,1,0,1,33,4.7e-05
G5,C1(C(O)OCC(C=C)(C1(C)O)O)=O,8,1,0,1,25,4.7e-05
G5,C1(C(O)OC(C)C(C1(C)O)O)=O,16,1,0,1,11,4.7e-05
G5,C1(COC(C)(C(C)(C1(C)O)O)O)=O,8,1,0,1,25,4.7e-05
G5,C1(COC(C(C=C)(C1(C)O)O)O)=O,8,1,0,1,25,4.7e-05
G5,C1(C(C(CC(O)O1)O)(CC=O)O)=O,8,1,0,1,33,4.7e-05
G5,C(C1(CCOC(C)(C1(C)O)O)O)=O,8,1,0,1,14,4.7e-05
G5,C(C1(CCOC(C1(C=C)O)O)O)=O,8,1,0,1,28,4.7e-05
G5,C1(C(C=O)(CC(C(O)O1)O)O)=O,8,1,0,1,17,4.7e-05
G5,C1(C(C(C(C(O)O1)O)=O)(C)O)=O,8,1,0,1,17,4.7e-05
G5,C1(C(C=O)(CCC(C=O)(O)O1)O)=O,4,1,0,1,17,4.7e-05
G5,C1(CC(C=O)(O)OC(C1(C)O)=O)=O,4,1,0,1,17,4.7e-05
G5,C1(C(C(C=O)=O)(CCC(O)O1)O)=O,4,1,0,1,17,4.7e-05
G5,C1(C(C(C(C(O)O1)O)=O)(C=C)O)=O,8,1,0,1,17,4.7e-05
G5,C1(C(C(CC(O)O1)=O)(CCO)O)=O,4,1,0,1,17,4.7e-05
G5,C1(C2(C(CC(CCO2)(O)O1)=O)O)=O,4,1,0,1,17,4.7e-05
G5,C1(CC(CO)(C(C)(C(O)O1)O)O)=O,8,1,0,1,29,4.7e-05
G5,C1(C(C(C)(C(C)(C(O)O1)O)O)O)=O,16,1,0,1,11,4.7e-05
G5,C(C1(CC(O)OC(C1O)=O)O)(O)=O,8,1,0,1,33,4.7e-05
G5,C1(C(C(C(C)(C(O)O1)O)O)O)=O,16,1,0,1,29,4.7e-05
G5,C(C1(C)C(C(CC(C)(O1)O)=O)O)=O,8,1,0,1,26,4.7e-05
G5,C(C1(C)C(C)(CC(C(O1)O)=O)O)=O,8,1,0,1,11,4.7e-05
G5,C(C1(C)C(CC(C(O1)O)=O)O)=O,8,1,0,1,11,4.7e-05
G5,C(C1(C(CC(C(C)(O1)O)=O)O)C)=O,8,1,0,1,14,4.7e-05
G5,C1(C(C)(C(C=O)(C)OC(C1)O)O)=O,8,1,0,1,45,4.7e-05
G5,C1C2(CC(O1)OC(C2(C)O)O)O,16,1,0,1,11,4.7e-05
G5,C(C1(CCOC(C1(C)O)O)O)(O)=O,8,1,0,1,11,4.7e-05
G5,C(C1(CC(O)OC(C)C1O)O)(O)=O,16,1,0,1,11,4.7e-05
G5,C(C1CC(C(C)(C(O1)O)O)O)(O)=O,16,1,0,1,11,4.7e-05
G5,C1C(CO)(C(C(C)(C(O)O1)O)O)O,16,1,0,1,11,4.7e-05
G5,C(C1(COC(C(C)(C1O)O)O)O)=O,16,1,0,1,11,4.7e-05
G5,C(C)(C1(C(COC(C1)O)O)O)=O,8,1,0,1,0,4.7e-05
G5,C(CO)(C1(C(COC(C1)O)O)O)=O,8,1,0,1,0,4.7e-05
G5,C1(C(O)OCC(CO)(C1(C)O)O)=O,8,1,0,1,25,4.7e-05
G5,C(C1(C(C)(C(C(CO1)O)O)O)O)=O,16,1,0,1,25,4.7e-05
G5,CC1(C(CO)(O)OCC(C1O)O)O,16,1,0,1,25,4.7e-05
G5,C1C(C(C2(C(CCO2)(O)O1)O)O)O,16,1,0,1,34,4.7e-05
G5,C1(C(C)(C(CC(CO)(O)O1)O)O)=O,8,1,0,1,25,4.7e-05
G5,C1(C(C)(C(CO)(CC(O)O1)O)O)=O,8,1,0,1,29,4.7e-05
G5,C1(C(C)(C(C(C(C)(O)O1)O)O)O)=O,16,1,0,1,25,4.7e-05
G5,C1(C(C)(C(C)(C(C(O)O1)O)O)O)=O,16,1,0,1,25,4.7e-05
G5,C(C1C(C=O)(CC(C(O)O1)=O)O)=O,8,1,0,1,0,4.7e-05
G5,C1(COC(C(C1(CC=O)O)O)O)=O,8,1,0,1,0,4.7e-05
G5,C(C1C(C(C)(C(C(O1)O)O)O)=O)=O,16,1,0,1,25,4.7e-05
G5,C1(C(C)(C(C=O)OC(C1O)O)O)=O,16,1,0,1,25,4.7e-05
G5,CC1(C(COC(C1(C)O)O)O)O,16,1,0,1,11,4.7e-05
G5,C(C1(C(OCC(C1)=O)O)O)(O)=O,4,1,0,1,17,4.7e-05
G5,C(C1(COC(CO)(CC1)O)O)(O)=O,4,1,0,1,7,4.7e-05
G5,C(C1(COC(C)(C(C1)O)O)O)(O)=O,8,1,0,1,5,4.7e-05
G5,C(C1(C(CO)(CC(CO1)=O)O)O)=O,4,1,0,1,49,4.7e-05
G5,C1(C(C(O)OCC1(C)O)O)=O,8,1,0,1,2,4.7e-05
G5,C(C1(COC(C=O)(CC1)O)O)=O,4,1,0,1,12,4.7e-05
G5,C1(CC(C=O)(O)OCC1(C)O)=O,4,1,0,1,24,4.7e-05
G5,C(C(C1(COC(CC1)O)O)=O)=O,4,1,0,1,27,4.7e-05
G5,C1C2CC(C(C(CO)(O)O2)(O)O1)O,16,1,0,1,2,4.7e-05
G5,C1C2CC(CO)(C(C(O)O2)(O)O1)O,16,2,0,2,2,9.499999999999999e-05
G5,C1(C2(COC(CCO2)(C1)O)O)=O,4,1,0,1,30,4.7e-05
G5,C1C2(CC(CO)(C(CO2)(O)O1)O)O,8,2,0,2,32,9.499999999999999e-05
G5,C1(C2(CO)CC(C(C(O)O2)O1)O)O,32,2,0,2,43,9.499999999999999e-05
G5,CC1(C(O)OCCC1(CO)O)O,8,1,0,1,3,4.7e-05
G5,C1(C(C)(C(C(C(O)O1)O)O)O)=O,16,1,0,1,25,4.7e-05
G5,C(C1C(C(C(C(O1)O)=O)(C)O)O)=O,16,1,0,1,0,4.7e-05
G5,C(C)(C1(CC(O)OCC1(C)O)O)=O,8,1,0,1,45,4.7e-05
G5,C1(C(O)OCC(C)(C1(C)O)O)=O,8,1,0,1,49,4.7e-05
G5,C(CC1(C(O)OCCC1O)O)=O,8,1,0,1,43,4.7e-05
G5,C(CC1(C(O)OC(C)CC1O)O)=O,16,1,0,1,43,4.7e-05
G5,C(C1(C)C(C(CC(O1)O)O)O)(O)=O,16,1,0,1,25,4.7e-05
G5,C(C1(C)C(CC(C(O1)O)O)O)(O)=O,16,1,0,1,25,4.7e-05
G5,C(C1(CC(O)OCC1(C=C)O)O)=O,8,1,0,1,7,4.7e-05
G5,C(C1CC(C(C)(C(O1)O)O)O)=O,16,1,0,1,11,4.7e-05
G5,C(C1(C)C(CC(C(O1)O)O)O)=O,16,1,0,1,11,4.7e-05
G5,C(C1(CC(O)OC(C)C1O)O)=O,16,1,0,1,11,4.7e-05
G5,C1(C(C(O)OC(C)C1(C)O)O)=O,16,1,0,1,4,4.7e-05
G5,C(C1(C(C)OC(C=O)(CC1)O)O)=O,8,1,0,1,12,4.7e-05
G5,C1(CC(C=O)(O)OC(C)C1(C)O)=O,8,1,0,1,4,4.7e-05
G5,C(C(C1(C(C)OC(CC1)O)O)=O)=O,8,1,0,1,27,4.7e-05
G5,C1(C(C(O)OC(C)C1(C=C)O)O)=O,16,1,0,1,4,4.7e-05
G5,C1(C2(C(C)OC(CCO2)(C1)O)O)=O,8,1,0,1,30,4.7e-05
G5,C(C1C(CC(C(C)(O1)O)O)O)(O)=O,16,1,0,1,45,4.7e-05
G5,C(C1C(CC(C)(C(O1)O)O)O)(O)=O,16,1,0,1,16,4.7e-05
G5,C1(C(C(CO)(C(C(O)O1)O)O)O)=O,16,1,0,1,33,4.7e-05
G5,C1(C(C(C(O)=O)OC(C)(C1)O)O)=O,8,1,0,1,26,4.7e-05
G5,C(C1(CC(C)(O)OC(C1O)=O)O)=O,8,1,0,1,27,4.7e-05
G5,C1(C(C)(C(C(O)=O)OC(C1)O)O)=O,8,1,0,1,14,4.7e-05
G5,C1(C(C(C)=O)(CC(C(O)O1)=O)O)=O,4,1,0,1,17,4.7e-05
G5,C1(CC(O)OC(C1(CC=O)O)=O)=O,4,1,0,1,17,4.7e-05
G5,C1(C(C=O)(CC(C(C)(O)O1)=O)O)=O,4,1,0,1,14,4.7e-05
G5,C1(COC(C(CO)=O)(CC1)O)=O,2,1,0,1,12,4.7e-05
G5,C(CC1C(OCC(C1O)=O)O)=O,8,1,0,1,5,4.7e-05
G5,C(C1C(COC(C1CO)O)=O)=O,8,1,0,1,55,4.7e-05
G5,C(C1(C(C)C(C(CO1)=O)O)O)=O,8,1,0,1,5,4.7e-05
G5,C1(COC(CO)(C(C)C1O)O)=O,8,1,0,1,5,4.7e-05
G5,C1(COC(C(CCO)C1O)O)=O,8,1,0,1,55,4.7e-05
G5,C1(COC(C(CO)C1CO)O)=O,8,1,0,1,55,4.7e-05
G5,C1(COC(C(C)C1O)O)=O,8,1,0,1,49,4.7e-05
G5,C1(CC(C(C)=O)(O)OCC1)=O,2,1,0,1,2,4.7e-05
G5,C(C1(CC(C=O)C(CO1)=O)O)=O,4,1,0,1,29,4.7e-05
G5,C(C1C(COC(C1C)O)=O)=O,8,1,0,1,49,4.7e-05
G5,C(C)(C1(CCC(CO1)=O)O)=O,2,1,0,1,49,4.7e-05
G5,C(C1C(CC(C)C(O1)O)=O)=O,8,1,0,1,49,4.7e-05
G5,C(C1(C(C)CC(CO1)=O)O)=O,4,1,0,1,52,4.7e-05
G5,C1(C(CO)OC(C(C)C1)O)=O,8,1,0,1,28,4.7e-05
G5,C1(COC(CO)(C(C)C1)O)=O,4,1,0,1,52,4.7e-05
G5,C(CC1(CCC(CO1)=O)O)=O,2,1,0,1,21,4.7e-05
G5,C1(C(C(C)(O)OC(CO)C1)=O)=O,4,1,0,1,29,4.7e-05
G5,C(C1CC(C(C(C)(O1)O)=O)O)=O,8,1,0,1,32,4.7e-05
G5,C1(COC(C(C)C1CO)O)=O,8,1,0,1,55,4.7e-05
G5,C1(CC(C)(O)OCC1)=O,2,1,0,1,27,4.7e-05
G5,C1(COC(C(C)C1)O)=O,4,1,0,1,28,4.7e-05
G5,C1(COC(C(C(CO)O)C1)O)=O,8,2,0,2,46,9.499999999999999e-05
G5,C1(C(CO)OC(C(C)C1O)O)=O,16,1,0,1,49,4.7e-05
G5,C1(COC(CC1C(C=O)O)O)=O,8,1,0,1,0,4.7e-05
G5,C(C(C1C(CCC(O1)O)=O)O)=O,8,1,0,1,20,4.7e-05
G5,C(C1C(O)OCC(C1)O)(O)=O,8,1,0,1,29,4.7e-05
G5,C(C1(CCC(CO1)O)O)(O)=O,4,1,0,1,29,4.7e-05
G5,C(C1C(CCC(O1)O)O)=O,8,1,0,1,27,4.7e-05
G5,C1C2C(CC(C(O)O2)O1)O,16,1,0,1,29,4.7e-05
G5,C1(CC2C(C(C1C(O)O2)O)O)=O,32,1,0,1,0,4.7e-05
G5,C1(CCOC(C1C(CO)O)O)=O,8,1,0,1,2,4.7e-05
G5,C1(COC2C(COC(C12)O)O)=O,16,1,0,1,29,4.7e-05
G5,C1(COC2COC(C1C2O)O)=O,16,1,0,1,29,4.7e-05
G5,C1(CC2OC(C1C(CO)O2)O)=O,16,1,0,1,9,4.7e-05
G5,C1(CC2OC(C1C(CO2)O)O)=O,16,1,0,1,38,4.7e-05
G5,C1(CC2COC(C1C(O)O2)O)=O,16,2,0,2,44,9.499999999999999e-05
G5,C1(CC2C(O)OCC1C(O)O2)=O,16,2,0,2,2,9.499999999999999e-05
G5,C1(COC(C(C)C1(CO)O)O)=O,8,1,0,1,49,4.7e-05
G5,C(C1(C(COC(C1C)O)O)O)=O,16,1,0,1,49,4.7e-05
G5,C(C1(C(C=O)CC(CO1)=O)O)=O,4,1,0,1,51,4.7e-05
G5,C(C1C(C)(OCC(C1)=O)O)=O,4,1,0,1,41,4.7e-05
G5,C(C(C1C(O)OCC(C1)O)=O)=O,8,1,0,1,29,4.7e-05
G5,C1(C(C(C=O)OC(C1C)O)O)=O,16,1,0,1,49,4.7e-05
G5,C1(C2C(O)OC(C(CO)O2)C1)=O,16,1,0,1,29,4.7e-05
G5,C1(C2C(O)OC(C(CO2)O)C1)=O,16,1,0,1,29,4.7e-05
G5,C1(C2C(CC(C(O2)O)O1)O)=O,16,2,0,2,29,9.499999999999999e-05
G5,C1C2C(C(C(C(O)O2)O)O1)O,32,1,0,1,36,4.7e-05
G5,C1C2(CC(O)OC(CO)(C2O)O1)O,16,1,0,1,5,4.7e-05
G5,C(C12CC(CO1)(CC(O2)O)O)=O,8,1,0,1,51,4.7e-05
G5,C1(C(O)OC2(C)C(C1CO2)O)=O,16,1,0,1,45,4.7e-05
G5,C1(C(O)OC2C(C)(C1CO2)O)=O,16,1,0,1,42,4.7e-05
G5,C1C2(CC(O)OC(CO)(C2)O1)O,8,1,0,1,51,4.7e-05
G5,C1C2(CC(O)OC(C)(C2O)O1)O,16,1,0,1,0,4.7e-05
G5,C1(C(O)OC2C(C1CO2)O)=O,16,1,0,1,0,4.7e-05
G5,C1(C2OC(CO)(CC1CO2)O)=O,8,1,0,1,12,4.7e-05
G5,C1(C(O)OC2(CO)CC1CO2)=O,8,1,0,1,12,4.7e-05
G5,C1(C(C)(O)OC2C(C1CO2)O)=O,16,1,0,1,30,4.7e-05
G5,C1(C2(C)OC(C(C1CO2)O)O)=O,16,1,0,1,14,4.7e-05
G5,C1(C2OC(C)C1CC(CO)(O2)O)=O,16,1,0,1,12,4.7e-05
G5,C1(C(O)OC2(CO)CC1C(C)O2)=O,16,1,0,1,12,4.7e-05
G5,C1(C2OC(C)C1C(C(C)(O2)O)O)=O,32,1,0,1,45,4.7e-05
G5,C1(C(O)OC2(C)C(C1C(C)O2)O)=O,32,1,0,1,45,4.7e-05
G5,C(C1C2(CC(C)(O)OC(C2)O1)O)=O,16,1,0,1,27,4.7e-05
G5,C1(C(C)(O)OC2C(C1C(C)O2)O)=O,32,1,0,1,14,4.7e-05
G5,C1(C2(C)OC(C)C1C(C(O2)O)O)=O,32,1,0,1,14,4.7e-05
G5,C12C(C(CO1)(CC(O)O2)O)O,16,1,0,1,5,4.7e-05
G5,C1C2(CC(O)OC(C2(CO)O)O1)O,16,1,0,1,29,4.7e-05
G5,C(C1(C2OCC1(CC(O)O2)O)O)=O,16,1,0,1,1,4.7e-05
G5,C(C1(CC2CC(O1)OC2CO)O)=O,16,1,0,1,46,4.7e-05
G5,C(C12CC(CC(O1)O)C(CO)O2)=O,16,1,0,1,46,4.7e-05
G5,C(C(C1(CC2COC(C2)O1)O)O)=O,16,1,0,1,55,4.7e-05
G5,C(C(C12CC(CO1)CC(O)O2)O)=O,16,1,0,1,55,4.7e-05
G5,C(C1C2CC(CO)(O)OC(C2)O1)=O,16,1,0,1,32,4.7e-05
G5,C(C1C2CC(CO)(O1)OC(C2)O)=O,16,1,0,1,32,4.7e-05
G5,C(C(C1C2CC(OC(C2)O)O1)O)=O,32,1,0,1,43,4.7e-05
G5,C1C2(C(C(C(O)O1)(CCO2)O)O)O,16,2,0,2,5,9.499999999999999e-05
G5,C(C1(C2C(CC(C(O)O2)O1)O)O)O,32,2,0,2,51,9.499999999999999e-05
G5,C1C(C2C(C(CC(O)O2)(O)O1)O)O,32,2,0,2,49,9.499999999999999e-05
G5,C1C(C2CC(C(C(O)O2)O)(O)O1)O,32,2,0,2,41,9.499999999999999e-05
G5,C1C2C(C(C(O)O1)C(C(O)O2)O)O,64,2,0,2,37,9.499999999999999e-05
G5,C1(C2C(O)OC(C(C)(O2)O)C1)=O,16,2,0,2,29,9.499999999999999e-05
G5,C1(C2C(O)OC(C)(C(O2)O)C1)=O,16,2,0,2,16,9.499999999999999e-05
G5,CC1(C2COC(C(O)O2)(C1)O)O,16,2,0,2,29,9.499999999999999e-05
G5,C1C2(CCOC(C(O)O1)(C2)O)O,8,2,0,2,29,9.499999999999999e-05
G5,C(C1C2C(CC(C(O)O2)(O1)O)O)=O,32,2,0,2,0,9.499999999999999e-05
G5,C1C(C2(COC(C(C2)(O)O1)O)O)O,16,2,0,2,51,9.499999999999999e-05
G5,C1C2C(CO)(CC(C(O)O2)(O)O1)O,16,2,0,2,51,9.499999999999999e-05
G5,C1(C2C(O)OC(C(O2)O)C1)=O,16,2,0,2,15,9.499999999999999e-05
G5,C1C(C2(CC(C(CO2)O)(O)O1)O)O,10,1,0,1,2,4.7e-05
G5,C1C(C2(C(C(CCO2)(O)O1)O)O)O,16,2,0,2,9,9.499999999999999e-05
G5,C1C2C(O)OC(CO)(C(C2O)O)O1,32,1,0,1,5,4.7e-05
G5,C1(C2OC(CO)(C(CO2)C1)O)=O,8,1,0,1,12,4.7e-05
G5,C(C1(C2COC(CC2O)O1)O)=O,16,1,0,1,33,4.7e-05
G5,C(C12CC(C(C(O1)O)CO2)O)=O,16,1,0,1,23,4.7e-05
G5,C1(CC2(CO)OCC1C(O)O2)=O,8,1,0,1,30,4.7e-05
G5,C1(CC2OCC1C(CO)(O)O2)=O,8,1,0,1,12,4.7e-05
G5,C1(C(C2(C)OC(C1CO2)O)O)=O,16,1,0,1,26,4.7e-05
G5,C1(C(C2OCC1C(C)(O)O2)O)=O,16,1,0,1,12,4.7e-05
G5,C(C1(C2COC(C(C2O)O)O1)O)=O,32,1,0,1,15,4.7e-05
G5,C1(C(O)OC2C(O)OCC1C2O)=O,32,2,0,2,15,9.499999999999999e-05
G5,C1C2(CC(C(O)O1)(CCO2)O)O,8,2,0,2,3,9.499999999999999e-05
G5,C1C2C(CO)(O)OC(C(C2O)O)O1,32,1,0,1,12,4.7e-05
G5,C(C1C2C(O)OC(C(O)O2)C1O)=O,64,2,0,2,43,9.499999999999999e-05
G5,C(C1C2C(O)OC(C(C2O)O)O1)=O,64,1,0,1,43,4.7e-05
G5,CC1(C2C(CC(C(O)O2)O1)O)O,32,2,0,2,49,9.499999999999999e-05
G5,CC1(C2C(C(C(C(O)O2)O1)O)O)O,64,2,0,2,49,9.499999999999999e-05
G5,C(C1(CC2(CC(O1)OCC2)O)O)=O,8,1,0,1,30,4.7e-05
G5,C1(C2OC(CO)(C(C(C)O2)C1)O)=O,16,1,0,1,12,4.7e-05
G5,C(C12CC(O)OC(C1)CC(O2)O)=O,16,2,0,2,13,9.499999999999999e-05
G5,C(C1(CC2CC(CC(O)O2)O1)O)=O,16,2,0,2,13,9.499999999999999e-05
G5,C(C1(C2C(CC(O1)OC2C)O)O)=O,32,1,0,1,4,4.7e-05
G5,C(C12CC(C(C(O1)O)C(C)O2)O)=O,32,1,0,1,23,4.7e-05
G5,C1(CC2(CO)OC(C)C1C(O)O2)=O,16,1,0,1,4,4.7e-05
G5,C1(CC2OC(CO)(C1C(C)O2)O)=O,16,1,0,1,4,4.7e-05
G5,C1(C(C2(C)OC(C)C1C(O)O2)O)=O,32,1,0,1,9,4.7e-05
G5,C1(C(C2OC(C)C1C(C)(O)O2)O)=O,32,1,0,1,2,4.7e-05
G5,C(C1(C2C(O)OC(C(O)O2)C1)O)O,32,2,0,2,20,9.499999999999999e-05
G5,CC1(C2C(O)OC(C(O)O2)C1O)O,64,2,0,2,26,9.499999999999999e-05
G5,C1(C2C(C(C(C(O)O2)O1)O)O)O,36,1,0,1,15,4.7e-05
G5,C1(C2(CC(C(C(CO)O2)O1)O)O)O,32,2,0,2,20,9.499999999999999e-05
G5,C1C2(C(O)OC(CO)(CC2O)O1)O,16,1,0,1,30,4.7e-05
G5,C1C2(C(O)OC(CC2(CO)O)O1)O,16,1,0,1,41,4.7e-05
G5,C1C2(C(O)OC(C)(C(C2O)O)O1)O,32,1,0,1,26,4.7e-05
G5,CC1(C(C2OCC1(C(O)O2)O)O)O,32,1,0,1,1,4.7e-05
G5,C1C2(C(O)OC(C(C2O)O)O1)O,32,1,0,1,1,4.7e-05
G5,C1C2(C(C)(O)OC(C(C2O)O)O1)O,32,1,0,1,12,4.7e-05
G5,C1C2(C(CO)(O)OC(CC2O)O1)O,16,1,0,1,12,4.7e-05
G5,C1(CC2OCC1(C(C)(O)O2)O)=O,8,1,0,1,12,4.7e-05
G5,C1(CC2(C)OC(C1(CO2)O)O)=O,8,1,0,1,26,4.7e-05
G5,C(C12C(O)OC(C(O1)O)CC2O)=O,32,2,0,2,43,9.499999999999999e-05
G5,C1(CC2OC(C)C1(C(C)(O)O2)O)=O,16,1,0,1,9,4.7e-05
G5,C1(CC2(C)OC(C)C1(C(O)O2)O)=O,16,1,0,1,2,4.7e-05
G5,C1C2C(C(C(O)O1)(CC(O)O2)O)O,32,2,0,2,37,9.499999999999999e-05
G5,C1C2(C(O)OC(CO)(C(C2)O)O1)O,16,1,0,1,43,4.7e-05
G5,C12C(CC(CO1)(C(CO)(O)O2)O)O,16,1,0,1,32,4.7e-05
G5,C1(C2OC(C)(C(CO2)(C1)O)O)=O,8,1,0,1,45,4.7e-05
G5,C1(C2(C)OC(C(CO2)(C1)O)O)=O,8,1,0,1,14,4.7e-05
G5,C1(C2OC(C)(C(C(C)O2)(C1)O)O)=O,16,1,0,1,45,4.7e-05
G5,C1(C2(C)OC(C)C(C(O2)O)(C1)O)=O,16,1,0,1,14,4.7e-05
G5,C1C2(CC(C(O)O1)(C(CO2)O)O)O,16,2,0,2,51,9.499999999999999e-05
G5,C1(C(O)OC2COC(CC2C1)O)=O,16,2,0,2,46,9.499999999999999e-05
G5,C(CC1CC2(C(O)OC1CO2)O)=O,16,2,0,2,46,9.499999999999999e-05
G5,C(C1(CC2CC(O1)OCC2O)O)=O,16,1,0,1,46,4.7e-05
G5,C(C12CC(C(CO1)O)CC(O2)O)=O,16,1,0,1,46,4.7e-05
G5,C1(C(CO)OC2CC1CC(O)O2)=O,16,1,0,1,46,4.7e-05
G5,C(C1C(C2CC(O)OC(C2)O1)O)=O,32,1,0,1,43,4.7e-05
G5,C1C2(C(C(C(CCO2)(O)O1)O)O)O,16,2,0,2,30,9.499999999999999e-05
G5,C1C2C(C(C(CC(O)O2)(O)O1)O)O,32,2,0,2,3,9.499999999999999e-05
G5,C1C2C(CC(C(C(O)O2)O)(O)O1)O,32,2,0,2,41,9.499999999999999e-05
G5,C1(C2OC(C(CCO2)(C1)O)O)=O,8,1,0,1,29,4.7e-05
G5,C1(COC2C(C(C1C(O)O2)O)O)=O,32,1,0,1,1,4.7e-05
G5,C1(C2C(O)OC(C(C(O2)O)O)C1)=O,32,2,0,2,1,9.499999999999999e-05
G5,C1(C2C(C(O)OC(C(O2)O)C1)O)=O,32,2,0,2,0,9.499999999999999e-05
G5,C1C(C2(C(CC(CO2)(O)O1)O)O)O,16,2,0,2,32,9.499999999999999e-05
G5,C1C(C2(CC(C(CO2)(O)O1)O)O)O,16,2,0,2,2,9.499999999999999e-05
G5,C1C2C(O)OCC(C(C2O)O)(O)O1,32,2,0,2,5,9.499999999999999e-05
G5,C1(C2C(O)OCC(C(O2)O)C1)=O,16,2,0,2,55,9.499999999999999e-05
G5,C1C2(CC(C(CCO2)(O)O1)O)O,8,2,0,2,20,9.499999999999999e-05
G5,C1(CC2(C(O)OC(C)C1CO2)O)=O,16,2,0,2,4,9.499999999999999e-05
G5,C1(C2CC(O)OC(C(C)(O2)O)C1)=O,16,2,0,2,45,9.499999999999999e-05
G5,C1(C(O)OC2CC(O)OC(C2)C1)=O,16,2,0,2,13,9.499999999999999e-05
G5,C1(C2C(C)(O)OC(CC(O2)O)C1)=O,16,2,0,2,9,9.499999999999999e-05
G5,C1(C2CC(CC(O2)O)OC(C1)O)=O,16,2,0,2,13,9.499999999999999e-05
G5,C1(C2C(O)OC(C)(CC(O2)O)C1)=O,16,2,0,2,6,9.499999999999999e-05
G5,C1(C2C(O)OC(C)C(C(O2)O)C1)=O,32,2,0,2,46,9.499999999999999e-05
G5,C1(CC2C(OC1(C)CC(O)O2)O)=O,16,2,0,2,21,9.499999999999999e-05
G5,C1(CC2C(O)OC(C)C1C(O)O2)=O,32,2,0,2,37,9.499999999999999e-05
G5,C1C(C2C(CC(C(O)O2)(O)O1)O)O,32,2,0,2,20,9.499999999999999e-05
G5,C1C2C(O)OC(C(O)O1)C(C2O)O,64,2,0,2,23,9.499999999999999e-05
G5,C1C2(CC(C(CO2)(C(O)O1)O)O)O,16,2,0,2,35,9.499999999999999e-05
G5,C1C2(C(O)OC(C(O)O1)CC2O)O,32,2,0,2,43,9.499999999999999e-05
G5,C1C2(C(CC(CO2)(C(O)O1)O)O)O,16,2,0,2,43,9.499999999999999e-05
G5,C1C2(C(O)OC(C(O)O1)C(C2)O)O,32,2,0,2,43,9.499999999999999e-05
G5,C1(C2COC(CC1CC(O2)O)O)=O,16,2,0,2,46,9.499999999999999e-05
G5,C1(C(COC2CC1CC(O)O2)O)=O,16,1,0,1,46,4.7e-05
G5,C1(COC2CC(C(C(O)O2)O)C1)=O,16,1,0,1,32,4.7e-05
G5,C1(COC2C(C(CC(O)O2)C1)O)=O,16,1,0,1,32,4.7e-05
G5,C1(C2(C(C(C(CO2)O)O1)O)O)=O,16,2,0,2,29,9.499999999999999e-05
G5,C1(C2CC(C(C(O2)O)O)O1)=O,16,2,0,2,29,9.499999999999999e-05
G5,C1(C2C(C(C(C(O2)O)O)O1)O)=O,32,2,0,2,29,9.499999999999999e-05
G5,C1(C2(C(C(C(CO2)O1)O)O)O)=O,16,2,0,2,29,9.499999999999999e-05
G5,C1(C2CC(C(C(O2)O)O1)O)=O,16,2,0,2,29,9.499999999999999e-05
G5,C1(C2C(C(C(C(O2)O)O1)O)O)=O,32,2,0,2,29,9.499999999999999e-05
G5,C1(C2C(C(C(C(O2)O)O)C1)O)=O,32,3,0,3,12,0.00014199999999999998
G5,C1(C2C(C)(C(C(C(O2)O)O)C1)O)=O,32,3,0,3,32,0.00014199999999999998
G5,C1(CC2COC(C1(C2(C)O)O)O)=O,16,3,0,3,29,0.00014199999999999998
G5,C1(CC2C(O)OCC1(C2(C)O)O)=O,16,3,0,3,41,0.00014199999999999998
G5,C1CC2CC(C(C(C2O)O)O)(O)O1,32,1,0,1,46,4.7e-05
G5,C(CC(C1C(OCC(C1)=O)O)O)=O,8,2,0,2,18,9.499999999999999e-05
G5,C(C1CC(CO)(O)OCC1C=O)=O,8,1,0,1,18,4.7e-05
G5,C(C(CO)C1C(OCC(C1)=O)O)=O,8,2,0,2,18,9.499999999999999e-05
G5,C(CC(C1C(COC(C1)O)=O)O)=O,8,1,0,1,18,4.7e-05
G5,C(C1COC(CC1C(CO)=O)O)=O,8,1,0,1,46,4.7e-05
G5,C1(COC(C(CO)C1CC=O)O)=O,8,1,0,1,46,4.7e-05
G5,C(C(CO)C1C(COC(C1)O)=O)=O,8,1,0,1,46,4.7e-05
G5,C(CC1CCC(C(O)O1)=O)=O,4,1,0,1,7,4.7e-05
G5,C(C1COC(C=O)(CC1)O)=O,4,1,0,1,7,4.7e-05
G5,C(C1COC(CO)(CC1)O)=O,4,1,0,1,7,4.7e-05
G5,C(C1CC(O)OCC1C=O)=O,8,1,0,1,18,4.7e-05
G5,C(C1C(C)OC(C=O)(CC1)O)=O,8,1,0,1,7,4.7e-05
G5,C(CC1CCCC(C=O)(O)O1)=O,4,1,0,1,7,4.7e-05
G5,C(CC1(C)CCC(C(O)O1)=O)=O,4,1,0,1,7,4.7e-05
G5,C(C1C(C)OC(CO)(CC1)O)=O,8,1,0,1,7,4.7e-05
G5,C(CC1CCCC(CO)(O)O1)=O,4,1,0,1,7,4.7e-05
G5,C(C1C(C)OC(CC1C=O)O)=O,16,1,0,1,28,4.7e-05
G5,C(C1CC(CC=O)OC(C1)O)=O,8,1,0,1,43,4.7e-05
G5,C(C(C1CCCC(C=O)(O)O1)O)=O,8,1,0,1,7,4.7e-05
G5,C(C(C1(CCC(C(O)O1)=O)C)O)=O,8,1,0,1,7,4.7e-05
G5,C(C1C(C)(CCC(C=O)(O1)O)O)=O,8,1,0,1,7,4.7e-05
G5,C(C1(C(C)OC(CO)(CC1)O)O)=O,8,1,0,1,7,4.7e-05
G5,C(C(C1CCCC(CO)(O)O1)O)=O,8,1,0,1,27,4.7e-05
G5,C(C1C(C)(CCC(CO)(O1)O)O)=O,8,1,0,1,7,4.7e-05
G5,C(C1CC(O)OC(C)C1(C=O)O)=O,16,1,0,1,43,4.7e-05
G5,C(C1CC(O)OC(C1)C(C=O)O)=O,16,1,0,1,43,4.7e-05
G5,C(CC1C(OC(C=O)C(C1)O)O)=O,16,1,0,1,43,4.7e-05
G5,C(C1CC(OC(C=O)C1(C)O)O)=O,16,1,0,1,45,4.7e-05
G5,C(C1C(CO)OC(C=O)(CC1)O)=O,8,1,0,1,7,4.7e-05
G5,C(CC1C(CCC(CO)(O)O1)O)=O,8,1,0,1,7,4.7e-05
G5,C(C1C(CO)OC(CO)(CC1)O)=O,8,1,0,1,7,4.7e-05
G5,C(C1CC(O)OCC1(CC=O)O)=O,8,1,0,1,29,4.7e-05
G5,C(C1CC(O)OC(C1O)CC=O)=O,16,1,0,1,43,4.7e-05
G5,C(C1C(C(O)OCC1O)CC=O)=O,16,1,0,1,46,4.7e-05
G5,C(C1C(CO)OC(CC1C=O)O)=O,16,1,0,1,46,4.7e-05
G5,C1(C(C)(CCC(C=O)(O)O1)O)=O,4,1,0,1,25,4.7e-05
G5,C(C1(C)CCC(C(O1)O)=O)(O)=O,4,1,0,1,25,4.7e-05
G5,C(C1CCCC(C=O)(O1)O)(O)=O,4,1,0,1,7,4.7e-05
G5,C1(C(C)(CCC(CO)(O)O1)O)=O,4,1,0,1,25,4.7e-05
G5,C(C1CCCC(CO)(O1)O)(O)=O,4,1,0,1,7,4.7e-05
G5,C(C1CC(O)OC(C1(C)O)=O)=O,8,1,0,1,29,4.7e-05
G5,C(CC1C(O)OC(C(C1)O)=O)=O,8,1,0,1,25,4.7e-05
G5,C(C1CC(C(O)=O)OC(C1)O)=O,8,1,0,1,25,4.7e-05
G5,C1(C(OC(C(C=O)=O)CC1)O)=O,4,1,0,1,20,4.7e-05
G5,C1(C(OC(C(C(C)=O)=O)CC1)O)=O,4,1,0,1,25,4.7e-05
G5,C1(C(OC(C(C=O)=O)(C)CC1)O)=O,4,1,0,1,25,4.7e-05
G5,C(C1(CCCC(C(C=O)=O)O1)O)=O,4,1,0,1,7,4.7e-05
G5,C(C(C1CCCC(CO)(O1)O)=O)=O,4,1,0,1,7,4.7e-05
G5,C(C1CC(C(C=O)=O)OC(C1)O)=O,8,1,0,1,43,4.7e-05
G5,C(CO)(C1(C)CCC(C(O1)O)=O)=O,4,1,0,1,7,4.7e-05
G5,C(C1(CCCC(C(CO)=O)O1)O)=O,4,1,0,1,7,4.7e-05
G5,C(CO)(C1CCCC(CO)(O1)O)=O,4,1,0,1,7,4.7e-05
G5,C(CC1C(OC(C(C1O)=O)C)O)=O,16,1,0,1,25,4.7e-05
G5,C(CC1C(OCC(C1(C)O)=O)O)=O,8,1,0,1,25,4.7e-05
G5,C(C(C=O)C1C(OCC(C1)=O)O)=O,4,2,0,2,45,9.499999999999999e-05
G5,C(CC1C(COC(C1C=O)O)=O)=O,8,1,0,1,45,4.7e-05
G5,C(C(C=O)C1C(COC(C1)O)=O)=O,4,1,0,1,45,4.7e-05
G5,C(C1(CCC(C(O1)O)=O)CCO)=O,4,1,0,1,7,4.7e-05
G5,C(C(C1COC(C=O)(CC1)O)O)=O,8,1,0,1,7,4.7e-05
G5,C(C1C(CO)CCC(C=O)(O1)O)=O,8,1,0,1,7,4.7e-05
G5,C(C(CC1CCC(C(O)O1)=O)O)=O,8,1,0,1,7,4.7e-05
G5,C(C(C1COC(CO)(CC1)O)O)=O,8,1,0,1,7,4.7e-05
G5,C(C1C(CO)CCC(CO)(O1)O)=O,8,1,0,1,7,4.7e-05
G5,C(C1(CCOC(C1CC=O)O)O)=O,8,1,0,1,29,4.7e-05
G5,C(C1CC(O)OCC1C(C=O)O)=O,16,1,0,1,29,4.7e-05
G5,C(C1CC(OC(C=O)C1CO)O)=O,16,1,0,1,29,4.7e-05
G5,C(CC1C(OC(C=O)CC1O)O)=O,16,1,0,1,43,4.7e-05
G5,C(CC1C(O)OC(C(C1)=O)=O)=O,4,1,0,1,29,4.7e-05
G5,C1(C(C=O)(CCC(CO)(O)O1)O)=O,4,1,0,1,7,4.7e-05
G5,C1(C(C=O)(C(C=O)CC(O)O1)O)=O,8,1,0,1,17,4.7e-05
G5,C1(COC2(CCC(C(O)O2)=O)C1)=O,4,1,0,1,35,4.7e-05
G5,C(C1(CCC2C(COC2O1)=O)O)=O,8,1,0,1,7,4.7e-05
G5,C1(COC2C1CCC(CO)(O)O2)=O,8,1,0,1,7,4.7e-05
G5,C(C1CC(O)OC2C1C(CO2)=O)=O,16,1,0,1,35,4.7e-05
G5,C1(C(OC(C(C=CC=O)=O)CC1)O)=O,8,1,0,1,7,4.7e-05
G5,C(C(CC1C(OCC(C1)=O)O)O)=O,8,2,0,2,11,9.499999999999999e-05
G5,C(C1CC(C=O)OC(CO)(C1)O)=O,8,1,0,1,11,4.7e-05
G5,C(C(CC1C(COC(C1)O)=O)O)=O,8,1,0,1,11,4.7e-05
G5,C(C1CC(C(CO)=O)CC(O1)O)=O,8,1,0,1,11,4.7e-05
G5,C(C(C)(C1C(OCC(C1)=O)O)O)=O,8,2,0,2,11,9.499999999999999e-05
G5,C(C(C)(C1C(COC(C1)O)=O)O)=O,8,1,0,1,7,4.7e-05
G5,C1(COC(C(C)(C1CC=O)O)O)=O,8,1,0,1,7,4.7e-05
G5,C1(COC(CC1CCO)O)=O,4,1,0,1,46,4.7e-05
G5,C(CO)(C1CC(O)OCC1)=O,4,1,0,1,46,4.7e-05
G5,C1(COC(CC1C(C)O)O)=O,8,1,0,1,46,4.7e-05
G5,C(CC1C(OCC(C1)=O)O)(O)=O,4,2,0,2,18,9.499999999999999e-05
G5,C(C1CC(CO)(O)OC(C1)=O)=O,4,1,0,1,18,4.7e-05
G5,C1(COC(CC1CC(O)=O)O)=O,4,1,0,1,18,4.7e-05
G5,C(CO)(C1CC(O)OC(C1)=O)=O,4,1,0,1,18,4.7e-05
G5,C1(C(OC(C(C=C)=O)CC1)O)=O,4,1,0,1,7,4.7e-05
G5,C1(C2C(CO1)OC(C=O)(CC2)O)=O,8,1,0,1,8,4.7e-05
G5,C1(CC2(CCC(C(O)O2)=O)CO1)=O,4,1,0,1,8,4.7e-05
G5,C1(CC2C(CCC(C=O)(O)O2)O1)=O,8,1,0,1,7,4.7e-05
G5,C(C1CCCC(C=O)(O1)O)=O,4,1,0,1,7,4.7e-05
G5,C(C1(C)CCC(C(O1)O)=O)=O,4,1,0,1,29,4.7e-05
G5,C1(C(O)OC(CC1)C(CO)O)=O,8,1,0,1,29,4.7e-05
G5,C(C1(CCC(C(CO)O1)O)O)=O,8,1,0,1,29,4.7e-05
G5,C(C1(CCC(CO)(CO1)O)O)=O,4,1,0,1,7,4.7e-05
G5,C1(C(O)OC(CO)(CO)CC1)=O,2,1,0,1,7,4.7e-05
G5,C1(C(O)OCCC1)=O,2,1,0,1,55,4.7e-05
G5,C(C1(CCCCO1)O)=O,2,1,0,1,46,4.7e-05
G5,C1(C(O)OC(C)CC1)=O,4,1,0,1,27,4.7e-05
G5,C1(C(CO)(CCC(C=O)(O)O1)O)=O,4,1,0,1,7,4.7e-05
G5,C(C1(CO)CCC(C(O1)O)=O)(O)=O,4,1,0,1,7,4.7e-05
G5,C(C1(COC(C=O)(CC1)O)O)(O)=O,4,1,0,1,7,4.7e-05
G5,C(C1C(CCC(C=O)(O1)O)O)(O)=O,8,1,0,1,20,4.7e-05
G5,C(C(C1CCC(C(O)O1)=O)O)(O)=O,8,1,0,1,20,4.7e-05
G5,C1(CCCC(C=O)(O)O1)=O,2,1,0,1,18,4.7e-05
G5,C1(COCC21CCC(C(O2)O)=O)=O,4,1,0,1,10,4.7e-05
G5,C(C1(CCC2C(C(CO2)=O)O1)O)=O,8,1,0,1,10,4.7e-05
G5,C1(C2(CCC(C(O2)O)=O)OCC1)=O,4,1,0,1,34,4.7e-05
G5,C1(C2C(CO1)OC(CO)(CC2)O)=O,8,1,0,1,8,4.7e-05
G5,C1(CC2C(CCC(CO)(O)O2)O1)=O,8,1,0,1,7,4.7e-05
G5,C(C1CCCC(CO)(O1)O)=O,4,1,0,1,11,4.7e-05
G5,C(C1(CCC(C(CO)O1)O)O)O,8,1,0,1,29,4.7e-05
G5,C1C(CO)(CCC(CO)(O)O1)O,4,1,0,1,7,4.7e-05
G5,C1CCCC(CO)(O)O1,2,1,0,1,27,4.7e-05
G5,C(C1C(CCC(CO)(O1)O)O)(O)=O,8,1,0,1,20,4.7e-05
G5,C1(CCCC(CO)(O)O1)=O,2,1,0,1,18,4.7e-05
G5,C1(COC2CCC(CO)(OC12)O)=O,8,1,0,1,10,4.7e-05
G5,C1(C2C(CO1)OC(CC2C=O)O)=O,16,1,0,1,8,4.7e-05
G5,C(C1CC(O)OC2C1OC(C2)=O)=O,16,1,0,1,8,4.7e-05
G5,C(C1CC(O)OC(CO)C1O)=O,16,1,0,1,29,4.7e-05
G5,C(CC1C(O)OCC(C1O)O)=O,16,1,0,1,29,4.7e-05
G5,C(C1CC(O)OCC1(CO)O)=O,8,1,0,1,29,4.7e-05
G5,C(C1CC(O)OC(C1(CO)O)=O)=O,8,1,0,1,33,4.7e-05
G5,C(C1CC(O)OCC1(C(O)=O)O)=O,8,1,0,1,33,4.7e-05
G5,C(CC1C(O)OC(C(C1O)O)=O)=O,16,1,0,1,43,4.7e-05
G5,C(C1C(C(C(O)=O)OC(C1)O)O)=O,16,1,0,1,43,4.7e-05
G5,C(C1CC(O)OC(C1)=O)=O,4,1,0,1,18,4.7e-05
G5,C(CC1C(OC2C(C1OC2)=O)O)=O,16,1,0,1,10,4.7e-05
G5,C(C1C2C(C(CO2)=O)OC(C1)O)=O,16,1,0,1,10,4.7e-05
G5,C(CC1C(OC2C(C1CO2)=O)O)=O,16,1,0,1,34,4.7e-05
G5,C1(C(CO)(O)OCC(CO)C1)=O,4,2,0,2,46,9.499999999999999e-05
G5,C1(C(CO)(O)OCC(CCO)C1)=O,4,2,0,2,46,9.499999999999999e-05
G5,C(CO)(C1(CC(CO)CCO1)O)=O,4,1,0,1,46,4.7e-05
G5,C1(C(CO)(O)OCC(C(C)O)C1)=O,8,2,0,2,46,9.499999999999999e-05
G5,C1(C(CO)(O)OC(C)C(CO)C1)=O,8,1,0,1,46,4.7e-05
G5,C(CO)(C(C1CCOC(C1)O)O)=O,8,1,0,1,46,4.7e-05
G5,C(CC1CCOC(CO)(C1O)O)=O,8,1,0,1,46,4.7e-05
G5,C(CO)(C(C1(CCCCO1)O)O)=O,4,1,0,1,46,4.7e-05
G5,C1(COC(CO)(CC1CCO)O)=O,4,1,0,1,46,4.7e-05
G5,C1(COC(CO)(C(CCO)C1)O)=O,4,2,0,2,46,9.499999999999999e-05
G5,C(CO)(C1CCOC(CO)(C1)O)=O,4,1,0,1,46,4.7e-05
G5,C1C(C(CO)CC(CO)(O)O1)O,8,1,0,1,29,4.7e-05
G5,C(C1CC(O)OC(CO)C1O)O,16,1,0,1,29,4.7e-05
G5,C(C1(CC(CO)C(CO1)O)O)(O)=O,8,1,0,1,29,4.7e-05
G5,C(C1C(C(CO)CC(O1)O)O)(O)=O,16,1,0,1,29,4.7e-05
G5,C(CC1COC(C(C1O)O)O)(O)=O,16,1,0,1,55,4.7e-05
G5,C(C)(C1COC(C(C1)=O)O)=O,4,1,0,1,55,4.7e-05
G5,C(CC1COC(C(C1)=O)O)=O,4,1,0,1,55,4.7e-05
G5,C(C1COC(C(C1)=O)(C)O)=O,4,1,0,1,55,4.7e-05
G5,C1(C(COC(C1)O)CC=O)=O,4,1,0,1,29,4.7e-05
G5,C(CC1(C(CCCO1)=O)O)=O,2,1,0,1,55,4.7e-05
G5,C1C2C(CO)CC(C(O)O2)(O)O1,16,1,0,1,46,4.7e-05
G5,C1CC(CC(CO)(O)O1)C(CO)O,8,1,0,1,46,4.7e-05
G5,C1C(C(CC(CO)(O)O1)CCO)O,8,1,0,1,46,4.7e-05
G5,CC(C1CC(CO)(O)OCC1O)O,16,1,0,1,46,4.7e-05
G5,C1CC(CO)CC(C(CO)O)(O)O1,8,1,0,1,46,4.7e-05
G5,C1CCCC(C(C(CO)O)O)(O)O1,8,1,0,1,46,4.7e-05
G5,C1CC(CC(O)O1)C(C(CO)O)O,16,1,0,1,46,4.7e-05
G5,C(CC1CC(O)OC(CO)C1O)O,16,1,0,1,46,4.7e-05
G5,CC(C1CC(O)OC(CO)C1O)O,32,1,0,1,46,4.7e-05
G5,C1CC2CC(C(CO)(C2O)O)(O)O1,16,2,0,2,46,9.499999999999999e-05
G5,C(CC1C(C(O)OCC1)=O)(C)=O,4,1,0,1,46,4.7e-05
G5,C(C(C1CCOC(C)(C1)O)=O)=O,4,1,0,1,46,4.7e-05
G5,C(C1(CC(C(C)=O)CCO1)O)=O,4,1,0,1,29,4.7e-05
G5,C(C)(C1C(C)OC(C(C1)=O)O)=O,8,1,0,1,46,4.7e-05
G5,C(CC1CC(C=O)(O)OCC1)=O,4,1,0,1,46,4.7e-05
G5,C(C(CC1CC(O)OCC1)=O)=O,4,1,0,1,46,4.7e-05
G5,C(CC1C(C)OC(C(C1)=O)O)=O,8,1,0,1,46,4.7e-05
G5,C(C1CC(C(C)=O)(O)OCC1)=O,4,1,0,1,29,4.7e-05
G5,C(C1C(C)OC(C(C1)=O)(C)O)=O,8,1,0,1,46,4.7e-05
G5,C(C(C)=O)(C1CCOC(C1)O)=O,4,1,0,1,46,4.7e-05
G5,C1(C(C)(O)OCCC1CC=O)=O,4,1,0,1,46,4.7e-05
G5,C(C1CCOC(C1)(CC=O)O)=O,4,1,0,1,29,4.7e-05
G5,C(CC(C1CCOC(C1)O)=O)=O,4,1,0,1,29,4.7e-05
G5,C1(C(C(C)OC(C1)O)CC=O)=O,8,1,0,1,46,4.7e-05
G5,C(C(CC1(CCCCO1)O)=O)=O,2,1,0,1,46,4.7e-05
G5,C(CC(C1(CCCCO1)O)=O)=O,2,1,0,1,46,4.7e-05
G5,C(CC1(C(CCC(C)O1)=O)O)=O,4,1,0,1,46,4.7e-05
G5,C1CC2C(C(C(C2CO)(O)O1)O)O,32,2,0,2,46,9.499999999999999e-05
G5,C1CCC2C(C(C(C2O)O)O)(O)O1,32,1,0,1,46,4.7e-05
G5,C1CC2C(C(C(C2C(O)O1)O)O)O,64,1,0,1,46,4.7e-05
G5,C1CC2C(CO)OC(C(C2)(O)O1)O,16,1,0,1,46,4.7e-05
G5,C1C2C(CCO)CC(C(O)O2)(O)O1,16,1,0,1,46,4.7e-05
G5,CC(C1CC2(C(O)OC1CO2)O)O,32,1,0,1,46,4.7e-05
G5,C1CC2C(O)OC(CO)C(C2)(O)O1,16,1,0,1,46,4.7e-05
G5,C1C(C2CC(C(O)O1)(O)OCC2)O,16,1,0,1,46,4.7e-05
G5,C1CC2COC(C(C(C2)(O)O1)O)O,16,1,0,1,46,4.7e-05
G5,C1C(C2(CC(C(O)O1)CCO2)O)O,16,1,0,1,38,4.7e-05
G5,C1C2(CC(CCO2)C(C(O)O1)O)O,16,1,0,1,46,4.7e-05
G5,C1(CC(C(C(O)O1)=O)CC(C)=O)=O,4,1,0,1,18,4.7e-05
G5,C1(CC(C(C=O)=O)CC(C)(O)O1)=O,4,1,0,1,18,4.7e-05
G5,C(C)(C1CC(C=O)(O)OC(C1)=O)=O,4,1,0,1,18,4.7e-05
G5,C1(CC(CC(C=O)(O)O1)CC=O)=O,4,1,0,1,18,4.7e-05
G5,C1(CC(CC(O)O1)CC(C=O)=O)=O,4,1,0,1,18,4.7e-05
G5,C(C)(C1(CC(C=O)CC(O1)=O)O)=O,4,1,0,1,18,4.7e-05
G5,C1(CC(C(C(C)=O)=O)CC(O)O1)=O,4,1,0,1,29,4.7e-05
G5,C1(CC(C(C(C)(O)O1)=O)CC=O)=O,4,1,0,1,29,4.7e-05
G5,C(CC1(CC(C=O)CC(O1)=O)O)=O,4,1,0,1,18,4.7e-05
G5,C(C1CC(O)OC(C1)=O)(CC=O)=O,4,1,0,1,18,4.7e-05
G5,C1(CCCC(CC(C=O)=O)(O)O1)=O,2,1,0,1,18,4.7e-05
G5,C1(CCCC(C(CC=O)=O)(O)O1)=O,2,1,0,1,18,4.7e-05
G5,C(C1C(C(C)=O)CC(C(O)O1)=O)=O,8,1,0,1,0,4.7e-05
G5,C(CC1C(C=O)OC(C(C1)=O)O)=O,8,1,0,1,0,4.7e-05
G5,C1(CC(C=O)C(C=O)OC1(C)O)=O,8,1,0,1,0,4.7e-05
G5,C(C1C(C(CC(O1)O)=O)CC=O)=O,8,1,0,1,0,4.7e-05
G5,C(CC1(C(CCC(C=O)O1)=O)O)=O,4,1,0,1,0,4.7e-05
G5,C(C1C(CCC(C=O)(O1)O)O)=O,8,1,0,1,20,4.7e-05
G5,C(C(C1CCC(C(O)O1)=O)O)=O,8,1,0,1,20,4.7e-05
G5,C(C1(COC(CO)(CC1)O)O)=O,4,1,0,1,7,4.7e-05
G5,C(C1C(CCC(CO)(O1)O)O)=O,8,1,0,1,7,4.7e-05
G5,C(C1C(C(C=O)OC(C1)O)O)=O,16,1,0,1,43,4.7e-05
G5,C1(COC(C(CC(C=O)=O)C1)O)=O,4,2,0,2,45,9.499999999999999e-05
G5,C1(COC(C=O)(CC1CC=O)O)=O,4,1,0,1,12,4.7e-05
G5,C1(COC(CC1CC(C=O)=O)O)=O,4,1,0,1,12,4.7e-05
G5,C(C1CCC(C(O1)O)=O)(CC=O)=O,4,1,0,1,7,4.7e-05
G5,C(CC1C(OCC(C1C=O)=O)O)=O,8,1,0,1,55,4.7e-05
G5,C(C)(C1(C=O)CCC(C(O1)O)=O)=O,4,1,0,1,1,4.7e-05
G5,C(C1C(CC(C(O1)O)CC=O)=O)=O,8,1,0,1,43,4.7e-05
G5,C(C)(C1(CO)CCC(C(O1)O)=O)=O,4,1,0,1,7,4.7e-05
G5,C(C1(CCC(C(C)=O)(CO1)O)O)=O,4,1,0,1,7,4.7e-05
G5,C(C1(CCC(C(C(C)=O)O1)O)O)=O,8,1,0,1,20,4.7e-05
G5,C(C)(C(C1CCC(C(O)O1)=O)O)=O,8,1,0,1,20,4.7e-05
G5,C(C)(C1(COC(CO)(CC1)O)O)=O,4,1,0,1,7,4.7e-05
G5,C(C)(C1C(CCC(CO)(O1)O)O)=O,8,1,0,1,7,4.7e-05
G5,C(C1CC(O)OCC1(C(C)=O)O)=O,8,1,0,1,43,4.7e-05
G5,C(C1C(C(C(C)=O)OC(C1)O)O)=O,16,1,0,1,43,4.7e-05
G5,C(C1(CCC(C(C=O)=O)CO1)O)=O,4,1,0,1,7,4.7e-05
G5,C1(C(O)OC(CC1)CC(C=O)=O)=O,4,1,0,1,7,4.7e-05
G5,C(C(C1COC(CO)(CC1)O)=O)=O,4,1,0,1,7,4.7e-05
G5,C(C1CC(O)OCC1C(C=O)=O)=O,8,1,0,1,43,4.7e-05
G5,C(C1CCC(C(O1)O)=O)(CCO)=O,4,1,0,1,7,4.7e-05
G5,C(C1(CCC(C(CO)=O)CO1)O)=O,4,1,0,1,7,4.7e-05
G5,C(CO)(CC1CCC(C(O)O1)=O)=O,4,1,0,1,7,4.7e-05
G5,C(CO)(C1COC(CO)(CC1)O)=O,4,1,0,1,7,4.7e-05
G5,C(CC1C(OCC(C1CO)=O)O)=O,8,1,0,1,43,4.7e-05
G5,C(C1CC(O)OCC1C(CO)=O)=O,8,1,0,1,43,4.7e-05
G5,C(C1(C=O)CCC(C(O1)O)=O)=O,2,1,0,1,29,4.7e-05
G5,C(CO)(CC1C(OCC(C1)=O)O)=O,4,2,0,2,49,9.499999999999999e-05
G5,C(C)(C(C1C(OCC(C1)=O)O)O)=O,8,2,0,2,49,9.499999999999999e-05
G5,C1(COC(C)(C(C1CC=O)O)O)=O,8,1,0,1,11,4.7e-05
G5,C1(COC(CC1C(C(C)=O)O)O)=O,8,1,0,1,11,4.7e-05
G5,C(C)(C1CCC(C(O1)O)=O)=O,4,1,0,1,7,4.7e-05
G5,C(CC1(C=O)CCC(C(O1)O)=O)=O,4,1,0,1,7,4.7e-05
G5,C(C1CCC(C=O)(OC1C=O)O)=O,8,1,0,1,7,4.7e-05
G5,C(C1CCC(CO)(OC1C=O)O)=O,8,1,0,1,7,4.7e-05
G5,C(C1C(C=O)C(C=O)CC(O1)O)=O,16,1,0,1,43,4.7e-05
G5,C1(C2C(C(CC(O2)O)C1CO)O)=O,32,2,0,2,43,9.499999999999999e-05
G5,C1(C(C(C2CC(O)OCC12)O)O)=O,32,1,0,1,43,4.7e-05
G5,C1(CC2CC(O)OC(CO)C2O1)=O,16,1,0,1,4,4.7e-05
G5,C1(CC2CC(O)OC(CO1)C2O)=O,16,1,0,1,4,4.7e-05
G5,C(CO)(C1C(COC(C1)O)O)=O,8,1,0,1,46,4.7e-05
G5,C1(COC(CC1C(CO)O)O)=O,8,1,0,1,46,4.7e-05
G5,C1C(CCC(CO)(O)O1)O,4,1,0,1,46,4.7e-05
G5,C(CC1C(C(O)OCC1O)=O)(C)=O,8,1,0,1,46,4.7e-05
G5,C(C(C1CC(C)(O)OCC1O)=O)=O,8,1,0,1,46,4.7e-05
G5,C(C)(C1C(CO)OC(C(C1)=O)O)=O,8,1,0,1,46,4.7e-05
G5,C(C1(CC(C(C)=O)C(CO1)O)O)=O,8,1,0,1,46,4.7e-05
G5,C(C1C(CO)OC(C(C1)=O)(C)O)=O,8,1,0,1,46,4.7e-05
G5,C(C1CC(C(C)=O)(O)OCC1O)=O,8,1,0,1,46,4.7e-05
G5,C(C(C)=O)(C1CC(O)OCC1O)=O,8,1,0,1,46,4.7e-05
G5,C1(C(C)(O)OCC(C1CC=O)O)=O,8,1,0,1,46,4.7e-05
G5,C(C1CC(CC=O)(O)OCC1O)=O,8,1,0,1,46,4.7e-05
G5,C1(C(C(CO)OC(C1)O)CC=O)=O,8,1,0,1,46,4.7e-05
G5,C(CC(C1CC(O)OCC1O)=O)=O,8,1,0,1,46,4.7e-05
G5,C(C(CC1(CCC(CO1)O)O)=O)=O,4,1,0,1,46,4.7e-05
G5,C(CC1(C(CCC(CO)O1)=O)O)=O,4,1,0,1,46,4.7e-05
G5,C(CC(C1(CCC(CO1)O)O)=O)=O,4,1,0,1,46,4.7e-05
G5,C(C1CC(CO)(O)OC(C1O)=O)=O,8,1,0,1,33,4.7e-05
G5,C(C(C1C(OCC(C1)=O)O)O)(O)=O,8,2,0,2,33,9.499999999999999e-05
G5,C(CO)(C1CC(O)OC(C1O)=O)=O,8,1,0,1,33,4.7e-05
G5,C1(COC(CC1C(C(O)=O)O)O)=O,8,1,0,1,33,4.7e-05
G5,C(C1(CC(CO)C(CO1)O)O)=O,8,1,0,1,55,4.7e-05
G5,C1(C(O)OCC(C(CO)O)C1)=O,8,1,0,1,55,4.7e-05
G5,C(C1(CC(C(CO1)O)C(C)O)O)=O,16,1,0,1,46,4.7e-05
G5,C1(C(O)OC(C)C(C(CO)O)C1)=O,16,1,0,1,46,4.7e-05
G5,C(C1C(C(CO)CC(O1)O)O)=O,16,1,0,1,55,4.7e-05
G5,C(CC1COC(C(C1O)O)O)=O,16,1,0,1,55,4.7e-05
G5,C(C1C(C(C(C)O)CC(O1)O)O)=O,32,1,0,1,46,4.7e-05
G5,C(CC1C(C)OC(C(C1O)O)O)=O,32,1,0,1,46,4.7e-05
G5,C1(CC2(C(C1COC(C2)O)O)O)=O,16,1,0,1,23,4.7e-05
G5,C1(CC2CC1(CC(C(O)O2)O)O)=O,16,1,0,1,21,4.7e-05
G5,C1(CC2C(CC1(CC(O)O2)O)O)=O,16,1,0,1,21,4.7e-05
G5,C1(CC2C(C1C(CC(O)O2)O)O)=O,32,1,0,1,26,4.7e-05
G5,C1C2C(CC(C(C(C=1)(O2)O)O)O)O,32,1,0,1,32,4.7e-05
G5,C1(C(C2C(C1CCC(O)O2)O)O)=O,32,1,0,1,4,4.7e-05
G5,C1(C(C(C(C(C(O)O1)O)O)=O)O)=O,16,1,0,1,17,4.7e-05
G5,C1(CC(C(CC(CO)(O)O1)O)=O)=O,4,1,0,1,29,4.7e-05
G5,C1(C(C(CC(C(C)(O)O1)O)=O)O)=O,8,1,0,1,45,4.7e-05
G5,C1(C(C(CC(C)(C(O)O1)O)=O)O)=O,8,1,0,1,16,4.7e-05
G5,C1(CC(C(C(C(C)(O)O1)O)O)=O)=O,8,1,0,1,17,4.7e-05
G5,C1(CC(C(C(C)(C(O)O1)O)O)=O)=O,8,1,0,1,45,4.7e-05
G5,C1(C(C(C(O)OC(C)C1)CO)O)=O,16,1,0,1,4,4.7e-05
G5,C(C1C(O)OC(C)CC(C1O)=O)=O,16,1,0,1,4,4.7e-05
G5,C(C1C(C(C)(O)OCCC1O)O)=O,16,1,0,1,45,4.7e-05
G5,C(C1COC(CC(C1(C)O)O)O)=O,16,1,0,1,45,4.7e-05
G5,C(C1COC(C)(C(CC1O)O)O)=O,16,1,0,1,45,4.7e-05
G5,C1(CC(C(O)=O)OC(CC1O)O)=O,8,1,0,1,33,4.7e-05
G5,C1(C(CC(O)OC(C(C)O)C1)O)=O,16,1,0,1,11,4.7e-05
G5,C(C1C(CCOC(C1(C)O)O)O)=O,16,1,0,1,45,4.7e-05
G5,C(C1COC(CC(C)(C1O)O)O)=O,16,1,0,1,45,4.7e-05
G5,C(C1COC(C(C)(CC1O)O)O)=O,16,1,0,1,18,4.7e-05
G5,C(C1C(CC(COC1O)=O)O)(O)=O,8,1,0,1,49,4.7e-05
G5,C1C(C)(CC(C(C(O)O1)CO)O)O,16,1,0,1,18,4.7e-05
G5,C1C(CC(C(C(O)O1)CO)O)O,16,1,0,1,6,4.7e-05
G5,C1(C(C)(O)OCCC(C1O)O)=O,8,1,0,1,25,4.7e-05
G5,C1CC(C(C(C(O)O1)CO)O)O,16,1,0,1,29,4.7e-05
G5,C1(CC(C(C(CO)C(O)O1)O)O)=O,16,1,0,1,29,4.7e-05
G5,C(C1COC(C)(CC(C1O)=O)O)=O,8,1,0,1,26,4.7e-05
G5,C(C1COC(C(CC1(C)O)=O)O)=O,8,1,0,1,6,4.7e-05
G5,C(C)(C1C(C(O)OCCC1O)=O)=O,8,1,0,1,26,4.7e-05
G5,C1(CC(CCO)OC(C(C1)=O)O)=O,4,1,0,1,18,4.7e-05
G5,C(C1C(C(O)OCCC1O)=O)=O,8,1,0,1,23,4.7e-05
G5,C(C1C(CC(C(C)(O)OC1)=O)O)=O,8,1,0,1,14,4.7e-05
G5,C(C1COC(CC(C1(C)O)=O)O)=O,8,1,0,1,14,4.7e-05
G5,C(C1C(C(C)(O)OCCC1O)=O)=O,8,1,0,1,14,4.7e-05
G5,C(CC1(C(CC(CCO1)O)=O)O)=O,4,1,0,1,18,4.7e-05
G5,C1(C(CC(O)OC(CCO)C1)=O)=O,4,1,0,1,18,4.7e-05
G5,C1(C(C)(O)OCCC(C1)O)=O,4,1,0,1,18,4.7e-05
G5,C1(C(CC(C(CO)C(O)O1)O)O)=O,16,1,0,1,33,4.7e-05
G5,C(C1C(O)OCCC(C1O)=O)(O)=O,8,1,0,1,17,4.7e-05
G5,C(C1C(CC(O)OCC1(C)O)O)=O,16,1,0,1,49,4.7e-05
G5,C(C1C(O)OCC(C)(CC1O)O)=O,16,1,0,1,45,4.7e-05
G5,C1(C(C=O)C(C(CC(O)O1)O)O)=O,16,1,0,1,43,4.7e-05
G5,C1(C(C=O)C(CC(C(O)O1)O)O)=O,16,1,0,1,43,4.7e-05
G5,CC(C1C(O)OCC(CC1O)O)O,32,1,0,1,6,4.7e-05
G5,C1(C(O)OC(C)CC(C1O)O)=O,16,1,0,1,5,4.7e-05
G5,C1(C(C)(O)OC(C)CC(C1O)O)=O,16,1,0,1,25,4.7e-05
G5,C1(C(CO)(O)OC(C)CC(C1)O)=O,8,1,0,1,25,4.7e-05
G5,CC(C1C(O)OCCC(C1O)O)O,32,1,0,1,29,4.7e-05
G5,C(C1C(C(O)OC(C)CC1O)=O)=O,16,1,0,1,23,4.7e-05
G5,C1(C(C)(O)OC(C)CC(C1)O)=O,8,1,0,1,14,4.7e-05
G5,C1(C(O)OC(C)C(C(C1O)O)O)=O,32,1,0,1,5,4.7e-05
G5,C1(C(C)(O)OC(C)C(C(C1)O)O)=O,16,1,0,1,14,4.7e-05
G5,C1(CC(C(C(C)O)OC(C1)O)O)=O,16,1,0,1,6,4.7e-05
G5,C(C1(C(C(CC(CO1)O)O)O)O)=O,16,1,0,1,6,4.7e-05
G5,C1(C(O)OC(CO)CC(C1O)O)=O,16,1,0,1,6,4.7e-05
G5,C(C1C(COC(CC1O)O)O)=O,16,1,0,1,6,4.7e-05
G5,C(C1C(O)OCC(CC1O)O)=O,16,1,0,1,6,4.7e-05
G5,C(C1(CC(CC(CO1)O)O)O)(O)=O,8,1,0,1,29,4.7e-05
G5,C(C)(C1(CC(CC(CO1)O)O)O)=O,8,1,0,1,14,4.7e-05
G5,C1(C(C)(O)OC(CO)CC(C1)O)=O,8,1,0,1,14,4.7e-05
G5,C(C1C(COC(CC1(C)O)O)O)=O,16,1,0,1,6,4.7e-05
G5,C(C1C(COC(C)(CC1O)O)O)=O,16,1,0,1,6,4.7e-05
G5,C(CC1(CC(CC(CO1)O)O)O)=O,8,1,0,1,6,4.7e-05
G5,C(C1C(C)(O)OCC(CC1O)O)=O,16,1,0,1,6,4.7e-05
G5,C(C)(C1C(O)OCC(CC1O)O)=O,16,1,0,1,6,4.7e-05
G5,C=CC1(C(C(CC(CO1)O)O)O)O,16,1,0,1,7,4.7e-05
G5,C(C1C(O)OCC(C(C1O)=O)O)=O,16,1,0,1,5,4.7e-05
G5,C1(COC(C(C(C1O)O)=O)O)=O,8,1,0,1,5,4.7e-05
G5,C1(COC(C(C(C1(C)O)O)=O)O)=O,8,1,0,1,25,4.7e-05
G5,C1(C(C(C(C(C)(OC1)O)=O)O)O)=O,8,1,0,1,5,4.7e-05
G5,C1(C(COC(C(CO)(C1)O)O)=O)=O,4,1,0,1,5,4.7e-05
G5,C1(CC(C(COC1(CO)O)=O)O)=O,4,1,0,1,1,4.7e-05
G5,C1(C(COC(CO)(C(C1)O)O)=O)=O,4,1,0,1,1,4.7e-05
G5,C1(C(C(C(C(C)OC1O)=O)O)O)=O,16,1,0,1,25,4.7e-05
G5,C(C1(C(C(C(CCO1)O)O)O)O)=O,16,1,0,1,5,4.7e-05
G5,C1(C(C(C(C(C(O)O1)=O)O)O)O)=O,16,1,0,1,5,4.7e-05
G5,C(C1C(C(O)OCC(C1O)=O)=O)=O,8,1,0,1,23,4.7e-05
G5,C1(C(O)OC2CC(CO2)(C1O)O)=O,16,1,0,1,35,4.7e-05
G5,C1(C2C(C(O)OC(C1)O2)(CO)O)=O,16,1,0,1,5,4.7e-05
G5,C1(C2C(C(CO)(O)OC(C1)O2)O)=O,16,1,0,1,5,4.7e-05
G5,C1(C(C(C(CC(O)O1)O)=O)O)=O,8,1,0,1,2,4.7e-05
G5,C1(C(COC(C)(C(C)(C1)O)O)=O)=O,4,1,0,1,14,4.7e-05
G5,C1(COC(C(CC1(C)O)=O)(C)O)=O,4,1,0,1,14,4.7e-05
G5,C(C)(C1(COC(CC(C1)=O)O)O)=O,4,1,0,1,25,4.7e-05
G5,C(C1(C(CC(C(CO1)=O)=O)O)O)=C,4,1,0,1,25,4.7e-05
G5,C(C1(C(OCC(C(C1)=O)=O)O)O)=C,4,1,0,1,25,4.7e-05
G5,C1(CC(C(C(C)OC1(C)O)=O)O)=O,8,1,0,1,14,4.7e-05
G5,C1(C(C)OC(CC(C1O)O)O)=O,16,1,0,1,25,4.7e-05
G5,C1(C(C)OC(CC(C)(C1O)O)O)=O,16,1,0,1,25,4.7e-05
G5,C1(C(C)OC(C)(CC(C1O)O)O)=O,16,1,0,1,25,4.7e-05
G5,C1(CC(COC(C1)O)(C(C)O)O)=O,8,1,0,1,29,4.7e-05
G5,C(C1C(OCC(C(C1O)O)=O)O)=O,16,1,0,1,5,4.7e-05
G5,C(C1C(C(C(CC(O1)O)O)O)=O)=O,16,1,0,1,5,4.7e-05
G5,C(C1C(O)OC(CC(C1O)O)=O)=O,16,1,0,1,29,4.7e-05
G5,C(CC1CC(CC(C(O)O1)=O)=O)=O,4,1,0,1,26,4.7e-05
G5,C(CC1CC(C(CC(O)O1)=O)=O)=O,4,1,0,1,14,4.7e-05
G5,C(C1C(O)OC(C(CC1O)O)=O)=O,16,1,0,1,33,4.7e-05
G5,C(C1C(CC(O)OC(C1O)=O)O)=O,16,1,0,1,33,4.7e-05
G5,C1(C2C(CC(OC1CO2)O)O)=O,16,1,0,1,10,4.7e-05
G5,C1(C2OC(CC(C1CO2)O)O)=O,16,1,0,1,34,4.7e-05
G5,C1(C(C(C(OC(C1O)O)=O)O)O)=O,16,1,0,1,5,4.7e-05
G5,C1(C(C(C(C)OC(C1O)O)O)O)=O,32,1,0,1,5,4.7e-05
G5,C(C1(CC(C(CCO1)O)O)O)(O)=O,8,1,0,1,29,4.7e-05
G5,C(C)(C1(CC(C(CCO1)O)O)O)=O,8,1,0,1,29,4.7e-05
G5,C(CC1(CC(C(CCO1)O)O)O)=O,8,1,0,1,29,4.7e-05
G5,C(C1C(C)(O)OCCC(C1O)O)=O,16,1,0,1,29,4.7e-05
G5,C(C)(C1C(O)OCCC(C1O)O)=O,16,1,0,1,29,4.7e-05
G5,C=CC1(C(C(C(CCO1)O)O)O)O,16,1,0,1,7,4.7e-05
G5,C(C1(CC(O)OC(C(C1)=O)=O)O)=O,4,1,0,1,29,4.7e-05
G5,C(C1(CC(CC(C(O1)=O)=O)O)O)=O,4,1,0,1,23,4.7e-05
G5,C1(C(CC(C)(CC(O)O1)O)=O)=O,4,1,0,1,28,4.7e-05
G5,C1(C(CC(CC(C)(O)O1)O)=O)=O,4,1,0,1,28,4.7e-05
G5,C1(C(C)(CC(CC(O)O1)=O)O)=O,4,1,0,1,29,4.7e-05
G5,C1(CC(CC(C(O)O1)=O)=O)=O,2,1,0,1,30,4.7e-05
G5,C1(CC(C(CC(O)O1)=O)=O)=O,2,1,0,1,17,4.7e-05
G5,C1(C(C(C(CC(C)(O)O1)=O)=O)O)=O,4,1,0,1,26,4.7e-05
G5,C1(CC(CC(C(CO)(O)O1)=O)=O)=O,2,1,0,1,17,4.7e-05
G5,C1(CC(C(C=O)(O)OC(C1)=O)O)=O,4,1,0,1,17,4.7e-05
G5,C(C1C(OCC(C(C1)=O)=O)O)(O)=O,4,1,0,1,17,4.7e-05
G5,C1(C(C=O)CC(C(C(O)O1)=O)O)=O,8,1,0,1,17,4.7e-05
G5,C1(C(C(OC(C(C1)=O)(C)O)=O)O)=O,4,1,0,1,24,4.7e-05
G5,C1(CC(C(CC(CO)(O)O1)=O)=O)=O,2,1,0,1,17,4.7e-05
G5,C1(C(C(CCC(CO)(O)O1)=O)O)=O,4,1,0,1,29,4.7e-05
G5,C(C1C(O)OCC(C(C1)=O)O)(O)=O,8,1,0,1,29,4.7e-05
G5,C1(C2C(C(C(C(C)(O)O1)O2)O)=O)=O,16,1,0,1,17,4.7e-05
G5,C1(CC(C2C(C(CO2)(O)O1)O)=O)=O,8,1,0,1,17,4.7e-05
G5,C1(CC(C2CC(C(O2)O)(O)O1)=O)=O,8,1,0,1,17,4.7e-05
G5,C(C1C(OC2C(CC1O2)=O)O)(O)=O,16,1,0,1,23,4.7e-05
G5,C1(C2C(C(CC(O)O1)OC2O)=O)=O,16,1,0,1,17,4.7e-05
G5,C(C1C(O)OC2CC(C1O2)=O)(O)=O,16,1,0,1,17,4.7e-05
G5,C1(C2C(C(CC(CO2)(O)O1)O)=O)=O,8,1,0,1,17,4.7e-05
G5,C1(C2C(CC(C(CO2)(O)O1)O)=O)=O,8,1,0,1,17,4.7e-05
G5,C1(C2C(CCC(C(O2)O)(O)O1)=O)=O,8,1,0,1,12,4.7e-05
G5,C1(C2C(C(CC(O)O1)(O)OC2)=O)=O,8,1,0,1,17,4.7e-05
G5,C1(C2C(CC(C(O)O1)(O)OC2)=O)=O,8,1,0,1,30,4.7e-05
G5,C1(C2C(CC(C(O)O1)OC2O)=O)=O,16,1,0,1,17,4.7e-05
G5,C1(C(CC(CC(C=O)(O)O1)=O)O)=O,4,1,0,1,33,4.7e-05
G5,C(C1CC(CC(C(O)O1)=O)=O)(O)=O,4,1,0,1,33,4.7e-05
G5,C(C1CC(C(CC(O1)O)=O)=O)(O)=O,4,1,0,1,33,4.7e-05
G5,C1(C(C(CC(C(C)(O)O1)=O)O)O)=O,8,1,0,1,14,4.7e-05
G5,C1(CC(C(C(O)=O)OC(C1)O)O)=O,8,1,0,1,9,4.7e-05
G5,C1(CC(C(C=C)=O)OC(C(C1)=O)O)=O,4,1,0,1,7,4.7e-05
G5,C(C1(C=C)CC(CC(C(O1)O)=O)=O)=O,4,1,0,1,7,4.7e-05
G5,C1(CC(C=CC=O)OC(C(C1)=O)O)=O,8,1,0,1,43,4.7e-05
G5,C1(CC(C(C)O)OC(C(C1)=O)O)=O,8,1,0,1,11,4.7e-05
G5,C1(CC(C=O)(O)OC(C)C(C1)O)=O,8,1,0,1,11,4.7e-05
G5,C=CC(C1CC(C(CC(O1)O)=O)=O)=O,4,1,0,1,14,4.7e-05
G5,C(C1(C=C)CC(C(CC(O1)O)=O)=O)=O,4,1,0,1,14,4.7e-05
G5,C(C1CC(C(CC(O1)O)=O)=O)=CC=O,8,1,0,1,14,4.7e-05
G5,C1(C(CC(O)OC(C(C)O)C1)=O)=O,8,1,0,1,11,4.7e-05
G5,C1(C(C)(O)OC2CC(CO2)(C1)O)=O,8,1,0,1,14,4.7e-05
G5,C1(C2C(C)(C(C)(O)OC(C1)O2)O)=O,16,1,0,1,14,4.7e-05
G5,C1(CC(C=C)(COC(C1)O)O)=O,4,1,0,1,29,4.7e-05
G5,C1(CC(C(C)OC(C1)O)O)=O,8,1,0,1,11,4.7e-05
G5,C1(CC2(COCC2OC(C1)O)O)=O,8,1,0,1,10,4.7e-05
G5,C1(C2C(C)(CC(OC1CO2)O)O)=O,16,1,0,1,10,4.7e-05
G5,C1(C2C(CC(C)(OC1CO2)O)O)=O,16,1,0,1,10,4.7e-05
G5,C1(CC2(C(OCC2)OC(C1)O)O)=O,8,1,0,1,34,4.7e-05
G5,C1(C2OC(CC(C)(C1CO2)O)O)=O,16,1,0,1,34,4.7e-05
G5,C1(C2OC(C)(CC(C1CO2)O)O)=O,16,1,0,1,34,4.7e-05
G5,C1(C2C(C(C=C)(O)OC(C1)O2)O)=O,16,1,0,1,7,4.7e-05
G5,C1(C2C(C=C)(C(O)OC(C1)O2)O)=O,16,1,0,1,7,4.7e-05
G5,C(C1C(CC(C(C(O)O1)O)O)O)O,32,1,0,1,41,4.7e-05
G5,C1(C(CC(O)OC(CO)C1)O)=O,8,1,0,1,0,4.7e-05
G5,C(C1C(C(C(CC(O1)O)O)O)O)=O,32,1,0,1,0,4.7e-05
G5,C(C1C(CC(C(C(O1)O)O)O)O)=O,32,1,0,1,0,4.7e-05
G5,C1C(C)(CC(C(C(O)O1)O)O)O,16,1,0,1,49,4.7e-05
G5,C(C1(C(C(O)OCC(C1)O)O)O)=O,16,1,0,1,0,4.7e-05
G5,C1C(CC(CO)(C(C(O)O1)O)O)O,16,1,0,1,0,4.7e-05
G5,C12C(CC(CO1)(C(C(O)O2)O)O)O,32,1,0,1,27,4.7e-05
G5,C(C1C(C(CC(C(O1)O)O)O)O)=O,32,1,0,1,0,4.7e-05
G5,C1(C(C)OC(C(C(C1O)O)O)O)=O,32,1,0,1,0,4.7e-05
G5,C1C(CC(C(C(CO)(O)O1)O)O)O,16,1,0,1,6,4.7e-05
G5,C1CC(C(C(C(CO)(O)O1)O)O)O,16,1,0,1,29,4.7e-05
G5,C(C1(CC(OCC(C1O)=O)O)O)=O,8,1,0,1,5,4.7e-05
G5,C(C1(CC(C(C(CO1)=O)O)O)O)=O,8,1,0,1,5,4.7e-05
G5,C1(COC(CC(C)(C1O)O)O)=O,8,1,0,1,5,4.7e-05
G5,C1(COC(C)(CC(C1O)O)O)=O,8,1,0,1,5,4.7e-05
G5,C1(C(C)(O)OCC(C(C1O)O)O)=O,16,1,0,1,25,4.7e-05
G5,C(C1C(C(O)OCC(C1O)O)=O)=O,16,1,0,1,23,4.7e-05
G5,C1(CC(C(CO)OC(C1)O)O)=O,8,1,0,1,41,4.7e-05
G5,C(C1(CC(C)OC(C(C1)=O)O)O)=O,8,1,0,1,45,4.7e-05
G5,C(C)(C1CC(CC(C(O1)O)=O)O)=O,8,1,0,1,22,4.7e-05
G5,C(C1(C)CC(C(CC(O1)O)O)=O)=O,8,1,0,1,4,4.7e-05
G5,C(C1(C)CC(CC(C(O1)O)=O)O)=O,8,1,0,1,22,4.7e-05
G5,C1(C(O)OC(C)CC(CO)(C1)O)=O,8,1,0,1,45,4.7e-05
G5,C1(C(C(C(C)(O)OC(C)C1)O)O)=O,16,1,0,1,4,4.7e-05
G5,C1(C(C(C(O)OC(C)C1)(C)O)O)=O,16,1,0,1,45,4.7e-05
G5,C1(C(O)OC(C)C(C(C)(C1)O)O)=O,16,1,0,1,45,4.7e-05
G5,C1(C(C(C)OC(C(C1)O)(C)O)O)=O,16,1,0,1,45,4.7e-05
G5,C1(C(C(C)OC(C(C)(C1)O)O)O)=O,16,1,0,1,4,4.7e-05
G5,C(C1(CC(CC(CO1)(C)O)O)O)=O,8,1,0,1,45,4.7e-05
G5,C1(C(O)OC(CO)(C)CC(C1)O)=O,8,1,0,1,45,4.7e-05
G5,C1(C(O)OC(C)CC(C1)O)=O,8,1,0,1,3,4.7e-05
G5,C1(C(O)OC(C)C(C(C1)O)O)=O,16,1,0,1,45,4.7e-05
G5,C(C1(CC(CC(CO1)O)O)O)=O,8,1,0,1,29,4.7e-05
G5,C(C1(C(COC(C(C1)=O)O)O)O)=O,8,1,0,1,0,4.7e-05
G5,C1(C(OC(C(C(C1)O)=O)CO)O)=O,8,1,0,1,5,4.7e-05
G5,C1(C(COC(C=O)(CC1O)O)O)=O,8,1,0,1,5,4.7e-05
G5,C1(COC(C(CC1(C)O)=O)O)=O,4,1,0,1,26,4.7e-05
G5,C1(C(COC(C(C)(C1)O)O)=O)=O,4,1,0,1,25,4.7e-05
G5,C1(C(OC(C(C(C1)O)=O)C)O)=O,8,1,0,1,29,4.7e-05
G5,C(C1(CC(C(CCO1)O)O)O)=O,8,1,0,1,29,4.7e-05
G5,C1(CC(CO)(CC(C(O)O1)=O)O)=O,4,1,0,1,29,4.7e-05
G5,C1(C(C(C)(CC(C(O)O1)=O)O)O)=O,8,1,0,1,26,4.7e-05
G5,C1(CC(C(CC(C=O)(O)O1)O)O)=O,8,1,0,1,29,4.7e-05
G5,C1(C(O)OC(C(C)=O)CC(C1)=O)=O,4,1,0,1,45,4.7e-05
G5,C(C1(C)CC(CC(C(O1)O)=O)=O)=O,4,1,0,1,45,4.7e-05
G5,C(C1CC(C(CC(O1)O)=O)=O)(C)=O,4,1,0,1,45,4.7e-05
G5,C(C1(C)CC(C(CC(O1)O)=O)=O)=O,4,1,0,1,45,4.7e-05
G5,C1(C(O)OC2CC(CO2)(C1)O)=O,8,1,0,1,45,4.7e-05
G5,C1(C2C(C(C)(O)OC(C1)O2)O)=O,16,1,0,1,35,4.7e-05
G5,C1(C2C(C(O)OC(C1)O2)(C)O)=O,16,1,0,1,35,4.7e-05
G5,C1(C(CC(CC(C=O)(O)O1)O)O)=O,8,1,0,1,29,4.7e-05
G5,C(C1(COC(C(CC1O)=O)O)O)=O,8,1,0,1,23,4.7e-05
G5,C1(COC(C(C(C1)O)C(C)O)O)=O,16,1,0,1,49,4.7e-05
G5,C(C1(COC(CC(C1O)=O)O)O)=O,8,1,0,1,23,4.7e-05
G5,C(C1(C(C(CC(CO1)=O)O)O)O)=O,8,1,0,1,49,4.7e-05
G5,C1(C(C)(C(C(CC(O)O1)=O)O)O)=O,8,1,0,1,28,4.7e-05
G5,C1(C(CC(CC(CO)(O)O1)O)=O)=O,4,1,0,1,49,4.7e-05
G5,C1(C(CC(CO)(CC(O)O1)O)=O)=O,4,1,0,1,29,4.7e-05
G5,C(C)(C1(CC(CC(CO1)=O)O)O)=O,4,1,0,1,14,4.7e-05
G5,C(C1C(COC(CC1(C)O)O)=O)=O,8,1,0,1,49,4.7e-05
G5,C(C1C(COC(C)(CC1O)O)=O)=O,8,1,0,1,6,4.7e-05
G5,C(CC1(CC(CC(CO1)=O)O)O)=O,4,1,0,1,49,4.7e-05
G5,C(C1C(CC(COC1(C)O)=O)O)=O,8,1,0,1,6,4.7e-05
G5,C(C)(C1C(CC(COC1O)=O)O)=O,8,1,0,1,6,4.7e-05
G5,C1(C(C(C=C)(COC(C1)O)O)O)=O,8,1,0,1,7,4.7e-05
G5,C1(COC(C=C)(C(C(C1)O)O)O)=O,8,1,0,1,49,4.7e-05
G5,C1(C(C(C(C)OC(C1)O)O)O)=O,16,1,0,1,11,4.7e-05
G5,C(C1(COC(C(C(C1)=O)O)O)O)=O,8,1,0,1,2,4.7e-05
G5,C(C1C(CC(CC(O1)O)O)=O)=O,8,1,0,1,55,4.7e-05
G5,C1(C(C)(CC(C(C(O)O1)O)=O)O)=O,8,1,0,1,25,4.7e-05
G5,C1(C(CC(C(C(C)(O)O1)O)O)=O)=O,8,1,0,1,49,4.7e-05
G5,C1(C(CC(C)(C(C(O)O1)O)O)=O)=O,8,1,0,1,0,4.7e-05
G5,C(C1C(CC(CC(C)(O1)O)O)=O)=O,8,1,0,1,6,4.7e-05
G5,C1(CC(C(C(C)=O)OC(C1)O)O)=O,8,1,0,1,9,4.7e-05
G5,C1(CC(C)(C(C=O)OC(C1)O)O)=O,8,1,0,1,27,4.7e-05
G5,C1(CC(C=C)(COC(C1O)O)O)=O,8,1,0,1,25,4.7e-05
G5,C1(C(C(O)OC(C(C1)O)C)O)=O,16,1,0,1,11,4.7e-05
G5,C1(C(C(C(O)OC(C)C1O)O)O)=O,32,1,0,1,5,4.7e-05
G5,C1(CC(C=O)OC(CC1O)O)=O,8,1,0,1,20,4.7e-05
G5,C(C1C(C(C(C(O)OC1)O)O)=O)=O,16,1,0,1,2,4.7e-05
G5,C(C1C(C(COC(C1O)O)O)=O)=O,16,1,0,1,2,4.7e-05
G5,C(C1C(C(OCC(C1O)=O)O)O)=O,16,1,0,1,43,4.7e-05
G5,C1(C2C(C(O)OC(C1)O2)O)=O,16,1,0,1,0,4.7e-05
G5,C(C1(C(CC(C(O)OC1)O)=O)O)=O,8,1,0,1,15,4.7e-05
G5,C1(C(O)OCC(C(C)(C1O)O)O)=O,16,1,0,1,5,4.7e-05
G5,C1(C(COC(C)(C(C)(C1)O)O)O)=O,8,1,0,1,14,4.7e-05
G5,C1(C(C)(O)OCC(C(C)(C1)O)O)=O,8,1,0,1,14,4.7e-05
G5,C1(C(CO)OC(C)(CC(C1)O)O)=O,8,1,0,1,6,4.7e-05
G5,C1(CC(C)(C(CO)OC(C1)O)O)=O,8,1,0,1,6,4.7e-05
G5,C1(C(COC(C=C)(C(C1)O)O)O)=O,8,1,0,1,7,4.7e-05
G5,C1(CC(C=C)(C(O)OCC1O)O)=O,8,1,0,1,7,4.7e-05
G5,C(C1COC(CC(C1O)O)O)=O,16,1,0,1,43,4.7e-05
G5,C(C1COC(C(CC1O)O)O)=O,16,1,0,1,43,4.7e-05
G5,C1(C(COC(C=O)(C(C1)O)O)O)=O,8,1,0,1,1,4.7e-05
G5,C1(C(C(C(C=O)(O)OCC1)O)O)=O,8,1,0,1,3,4.7e-05
G5,C(C1COC(C(C(C1O)O)=O)O)=O,16,1,0,1,5,4.7e-05
G5,C1(CCOC(C=O)(C(C1)O)O)=O,4,1,0,1,2,4.7e-05
G5,C1(C(CC(C(CO)C(O)O1)O)=O)=O,8,1,0,1,18,4.7e-05
G5,C1(CC(C(C(CO)C(O)O1)O)=O)=O,8,1,0,1,17,4.7e-05
G5,C1(C(C(CC(CO)C(O)O1)=O)O)=O,8,1,0,1,17,4.7e-05
G5,C(C1(C(CCOC(C1O)O)=O)O)=O,8,1,0,1,27,4.7e-05
G5,C1(C2COC(C(C1O)O2)(C)O)=O,16,1,0,1,2,4.7e-05
G5,C1(C2C(C(CO2)(O)OCC1)O)=O,8,1,0,1,2,4.7e-05
G5,C1(C2COC(CC1O)(CO2)O)=O,8,1,0,1,2,4.7e-05
G5,C1(C2COC(C(C1)O)(CO2)O)=O,8,1,0,1,2,4.7e-05
G5,C1(C2COC(CC1)(C(O2)O)O)=O,8,2,0,2,12,9.499999999999999e-05
G5,C1(C(O)OC(C)CC(C1CO)O)=O,16,1,0,1,3,4.7e-05
G5,C1(C(C(C(O)OCC1)C(C)O)O)=O,16,1,0,1,4,4.7e-05
G5,C1(C(OCC(C(C1CO)O)=O)O)=O,8,1,0,1,5,4.7e-05
G5,C(C1(CCOC(C(C1O)=O)O)O)=O,8,1,0,1,1,4.7e-05
G5,C1(C(CC(C(C)=O)(O)OCC1)O)=O,4,1,0,1,14,4.7e-05
G5,C(C1(CCOC(C(C1)=O)(C)O)O)=O,4,1,0,1,14,4.7e-05
G5,C(CC1(CC(C(CCO1)=O)O)O)=O,4,1,0,1,30,4.7e-05
G5,C(C1C(C)(O)OCCC(C1O)=O)=O,8,1,0,1,3,4.7e-05
G5,C(C)(C1C(O)OCCC(C1O)=O)=O,8,1,0,1,3,4.7e-05
G5,C1(C(C(C(C=C)(O)OCC1)O)O)=O,8,1,0,1,3,4.7e-05
G5,C1(C(C(C)(C(C)(O)OCC1)O)O)=O,8,1,0,1,14,4.7e-05
G5,C1(C(C)(O)OCCC(CO)(C1)O)=O,4,1,0,1,14,4.7e-05
G5,C1(COC(CC(C)(C1CO)O)O)=O,8,1,0,1,3,4.7e-05
G5,C1(COC(C)(CC(C1CO)O)O)=O,8,1,0,1,3,4.7e-05
G5,C1(C(C(C=C)(C(O)OCC1)O)O)=O,8,1,0,1,7,4.7e-05
G5,C1(CC(C(C=O)OC(C1)O)O)=O,8,1,0,1,0,4.7e-05
G5,C1(C2C(C(C(OC1CO2)O)O)O)=O,32,1,0,1,10,4.7e-05
G5,C1(C2OC(C(C(C1CO2)O)O)O)=O,32,1,0,1,34,4.7e-05
G5,C1(C(CC(O)OC(CO)(C)C1)O)=O,8,1,0,1,49,4.7e-05
G5,CC1(COC(CO)(CC(C1)O)O)O,8,1,0,1,49,4.7e-05
G5,CC1(C(C(CC(C)(CO1)O)O)O)O,16,1,0,1,49,4.7e-05
G5,C1C(CC(CC(CO)(O)O1)O)O,8,1,0,1,29,4.7e-05
G5,CC1(C(C(CC(CO1)O)O)O)O,16,1,0,1,49,4.7e-05
G5,C1CC(C(CC(CO)(O)O1)O)O,8,1,0,1,29,4.7e-05
G5,CC1(C(C(C(CCO1)O)O)O)O,16,1,0,1,29,4.7e-05
G5,C1(CC(C(CC(CO)(O)O1)O)O)=O,8,1,0,1,29,4.7e-05
G5,C1(CC(C(C(C(C)(O)O1)O)O)O)=O,16,1,0,1,29,4.7e-05
G5,C(C1(CC(C)(OCC(C1)=O)O)O)=O,4,1,0,1,27,4.7e-05
G5,C(C1(CC(C)(CC(CO1)=O)O)O)=O,4,1,0,1,26,4.7e-05
G5,C1(CC(C=O)(O)OCC(C)(C1)O)=O,4,1,0,1,49,4.7e-05
G5,C1(CC(CO)(C)OC(C(C1)=O)O)=O,4,1,0,1,49,4.7e-05
G5,C(C)(C1(CC(OCC(C1)=O)O)O)=O,4,1,0,1,24,4.7e-05
G5,C1(C(CC(O)OC(C)(CO)C1)=O)=O,4,1,0,1,49,4.7e-05
G5,C1(COC(CC(C)(C1)O)O)=O,4,1,0,1,6,4.7e-05
G5,C1(COC(C)(CC(C1)O)O)=O,4,1,0,1,6,4.7e-05
G5,C1(CC(COC(C1)O)(C)O)=O,4,1,0,1,49,4.7e-05
G5,C1(C(CC(CC(CO)(O)O1)O)O)=O,8,1,0,1,29,4.7e-05
G5,C1(C(CC(C(C(C)(O)O1)O)O)O)=O,16,1,0,1,49,4.7e-05
G5,C(C1C(C(O)OCCC1O)O)=O,16,1,0,1,43,4.7e-05
G5,C(C1C(C(O)OC(C)CC1O)O)=O,32,1,0,1,43,4.7e-05
G5,C(C1C(C)OC(CC(C1O)O)O)=O,32,1,0,1,43,4.7e-05
G5,C(C1C(C)OC(C(CC1O)O)O)=O,32,1,0,1,43,4.7e-05
G5,C(C1CC(C(C(C(O1)O)=O)O)O)=O,16,1,0,1,5,4.7e-05
G5,C(C1CC(CC(C(C)(O1)O)=O)O)=O,8,1,0,1,21,4.7e-05
G5,C1(C2C(C(C(CC(O2)O)O)C1)O)=O,32,1,0,1,18,4.7e-05
G5,C1C2(C(C(C(C=1)OC(C2)O)O)O)O,32,1,0,1,32,4.7e-05
G5,C1C(CO)(CC(CC(O)O1)O)O,8,1,0,1,4,4.7e-05
G5,C(C1C(CC(CC(O)O1)O)O)O,16,1,0,1,29,4.7e-05
G5,C(C1(CC(O)OCC(C)(C1)O)O)=O,8,1,0,1,4,4.7e-05
G5,C1(C(CC(O)OC(C)C1)O)=O,8,1,0,1,4,4.7e-05
G5,C(C)(C1C(CC(CC(O1)O)O)O)=O,16,1,0,1,4,4.7e-05
G5,C(C1C(C)(CC(CC(O1)O)O)O)=O,16,1,0,1,4,4.7e-05
G5,CC1(C(CO)OC(CC(C1)O)O)O,16,1,0,1,4,4.7e-05
G5,C1C(CCO)(CC(CC(O)O1)O)O,8,1,0,1,4,4.7e-05
G5,C(C1C(CC(CC(O1)O)O)O)=O,16,1,0,1,45,4.7e-05
G5,C1C(C)(CC(CO)(CC(O)O1)O)O,8,1,0,1,4,4.7e-05
G5,CC1(CC(O)OCC(C)(C1O)O)O,16,1,0,1,4,4.7e-05
G5,C1C(C)(CC(CC(O)O1)O)O,8,1,0,1,18,4.7e-05
G5,C(CC1CC(C(CC(O)O1)O)O)=O,16,1,0,1,4,4.7e-05
G5,C(CC1C(CC(CC(O)O1)O)O)=O,16,1,0,1,4,4.7e-05
G5,C(CC1CC(CC(C(O)O1)O)O)=O,16,1,0,1,4,4.7e-05
G5,C(C1C(C(C(CC(O)O1)O)O)O)O,32,1,0,1,4,4.7e-05
G5,C(C1(CC(O)OCC(C1)O)O)=O,8,1,0,1,4,4.7e-05
G5,C1C(C)(C(C(CC(O)O1)O)O)O,16,1,0,1,4,4.7e-05
G5,C1C(CC(CO)(CC(O)O1)O)O,8,1,0,1,4,4.7e-05
G5,C1C(C(C(C)(CC(O)O1)O)O)O,16,1,0,1,29,4.7e-05
G5,C1C(CC(CC(O)O1)O)O,8,1,0,1,6,4.7e-05
G5,C1(C(CC(O)OC(C)C1O)O)=O,16,1,0,1,4,4.7e-05
G5,C1CC(C(CC(O)O1)O)O,8,1,0,1,29,4.7e-05
G5,C1(C(CC(CO)(CC(O)O1)O)O)=O,8,1,0,1,29,4.7e-05
G5,C1(C(C(C(C)(CC(O)O1)O)O)O)=O,16,1,0,1,29,4.7e-05
G5,C1(CC(C(CC(O)O1)O)O)=O,8,1,0,1,29,4.7e-05
G5,C12C(CC(CO1)(CC(O)O2)O)O,16,1,0,1,27,4.7e-05
G5,C(C1CC(C(CC(O1)O)O)O)=O,16,1,0,1,4,4.7e-05
G5,C(CC1C(CCC(C(O1)O)O)=O)=O,8,1,0,1,7,4.7e-05
G5,C(C1(CC(OC(C=O)CC1)O)O)=O,8,1,0,1,29,4.7e-05
G5,C(CC1C(CCC(C(O)O1)=O)O)=O,8,1,0,1,7,4.7e-05
G5,C(C1(CC(OC(C(C1)=O)C)O)O)=O,8,1,0,1,4,4.7e-05
G5,C1(C(C(C(C)OC(C)(C1)O)O)=O)=O,8,1,0,1,26,4.7e-05
G5,C1(CC(C)OC(C(C1)=O)(CO)O)=O,4,1,0,1,4,4.7e-05
G5,C1(CC(C)OC(C=O)(C(C1)O)O)=O,8,1,0,1,4,4.7e-05
G5,C1(C(COC(C(C(C)O)C1)O)=O)=O,8,1,0,1,46,4.7e-05
G5,C(C(C1CCC(CC(O1)O)O)=O)=O,8,1,0,1,27,4.7e-05
G5,C1(C(C(C)OC(C(C1)=O)(C)O)O)=O,8,1,0,1,24,4.7e-05
G5,C1(C(CC(C)OC(CO)(C1)O)=O)=O,4,1,0,1,4,4.7e-05
G5,C1(C(C(C=C)(CC(OC1)O)O)O)=O,8,1,0,1,7,4.7e-05
G5,C1(C(C(CC(OC1C=C)O)O)O)=O,16,1,0,1,31,4.7e-05
G5,C(C(C1(CCCOC(C1)O)O)O)=O,8,1,0,1,29,4.7e-05
G5,C(C)(C1(CC(O)OCC(C1)O)O)=O,8,1,0,1,29,4.7e-05
G5,C=CC1(CC(O)OCC(C1O)O)O,16,1,0,1,29,4.7e-05
G5,C1C(C(CO)(C(CC(O)O1)O)O)O,16,1,0,1,29,4.7e-05
G5,C1(C(C(C)(C(CC(O)O1)O)O)O)=O,16,1,0,1,25,4.7e-05
G5,C(C1(COC(CC(C1)O)O)O)=O,8,1,0,1,43,4.7e-05
G5,C(C1(C(C)OC(CC(C1)O)O)O)=O,16,1,0,1,4,4.7e-05
G5,C1(C(C2(CC1COC(C2)O)O)O)=O,16,1,0,1,47,4.7e-05
G5,C1(CC2(CC1(COC(C2)O)O)O)=O,8,1,0,1,2,4.7e-05
G5,C1(CC2C(CC(CC(O)O2)O)O1)=O,16,1,0,1,48,4.7e-05
G5,C1(C2C(C)OC(C(C1O)O2)(C)O)=O,32,1,0,1,4,4.7e-05
G5,C1(C2C(C(CO2)(O)OC(C)C1)O)=O,16,1,0,1,4,4.7e-05
G5,C1(COC2CC(CC(OC12)O)O)=O,16,1,0,1,9,4.7e-05
G5,C1(C2OC(C(C(C1)O2)C(C)O)O)=O,32,1,0,1,23,4.7e-05
G5,C1(C2C(C(O)OC(C1)O2)C(C)O)=O,32,1,0,1,4,4.7e-05
G5,C1(CC2(CC(COC(C2)O)O1)O)=O,8,1,0,1,19,4.7e-05
G5,C1(COC2COC(CC1(C2)O)O)=O,8,1,0,1,54,4.7e-05
G5,C1(CC2COCC1(CC(O)O2)O)=O,8,1,0,1,4,4.7e-05
G5,C1(C2COCC(CC(O2)O)(C1)O)=O,8,1,0,1,36,4.7e-05
G5,C1(C2C(C)OC(CC1O)(CO2)O)=O,16,1,0,1,4,4.7e-05
G5,C1(C2C(C)OC(C(C1)O)(CO2)O)=O,16,1,0,1,17,4.7e-05
G5,C1(C2OC(CC(CCO2)(C1)O)O)=O,8,1,0,1,30,4.7e-05
G5,C1(C2C(C)OC(CC1)(C(O2)O)O)=O,16,2,0,2,12,9.499999999999999e-05
G5,C1(CC2OC(CC1(CCO2)O)O)=O,8,1,0,1,53,4.7e-05
G5,C(C1(CC(O)OC2COC1C2)O)=O,16,1,0,1,4,4.7e-05
G5,C(CC1C2C(CC(C(O)O1)O2)O)=O,32,1,0,1,40,4.7e-05
G5,C(CC1C2CC(C(C(O)O1)O2)O)=O,32,1,0,1,40,4.7e-05
G5,C(C1C2CC(C(CC(O)O2)O)O1)=O,32,1,0,1,40,4.7e-05
G5,C(C12CCC(CO1)(CC(O2)O)O)=O,8,1,0,1,29,4.7e-05
G5,C(C1C2(CCC(O1)OC(C2)O)O)=O,16,1,0,1,29,4.7e-05
G5,C1C(C2C(C=1C(CC(O)O2)O)O)O,32,1,0,1,29,4.7e-05
G5,C=CC1C(C(C(CC(O1)O)O)O)O,32,1,0,1,4,4.7e-05
G5,C1C2(C(C(C=1)OC(CC2O)O)O)O,32,1,0,1,29,4.7e-05
G5,C1OC2C(COC(CC2(C=1)O)O)O,16,1,0,1,9,4.7e-05
G5,C1OC2COC(CC(C=1)(C2O)O)O,16,1,0,1,9,4.7e-05
G5,C=C1C2C(C(C(CC(O2)O)O)O1)O,32,1,0,1,26,4.7e-05
G5,C1OC2C(C(CC(OC2C=1)O)O)O,32,1,0,1,36,4.7e-05
G5,C1OC2C(C(C=1)OC(CC2O)O)O,32,1,0,1,37,4.7e-05
G5,C1(C(C(CC(C(O)O1)=O)=O)CO)=O,4,1,0,1,30,4.7e-05
G5,C1(CCC(C=O)(O)OC(C1O)=O)=O,4,1,0,1,12,4.7e-05
G5,C1(C(CC(C=O)(O)OC(C1)=O)O)=O,4,1,0,1,17,4.7e-05
G5,C1(C(C=O)C(CC(C(O)O1)=O)O)=O,8,1,0,1,23,4.7e-05
G5,C1(C(C(C(CC(O)O1)=O)=O)CO)=O,4,1,0,1,17,4.7e-05
G5,C1(C(C=O)C(C(CC(O)O1)O)=O)=O,8,1,0,1,17,4.7e-05
G5,C1(C(C=O)C(C(CC(O)O1)=O)O)=O,8,1,0,1,17,4.7e-05
G5,C1(C(C=O)CC(C(C(O)O1)O)=O)=O,8,1,0,1,17,4.7e-05
G5,C1(C(C=O)C(CC(C(O)O1)O)=O)=O,8,1,0,1,17,4.7e-05
G5,C1(C(CC(C)(C(C(O)O1)O)O)O)=O,16,1,0,1,26,4.7e-05
G5,C(C1CC(C(CC(O1)O)O)O)(O)=O,16,1,0,1,29,4.7e-05
G5,C(C1CC(CC(C(O1)O)O)O)(O)=O,16,1,0,1,20,4.7e-05
G5,C1(C(C(CO)C(CC(O)O1)O)O)=O,16,1,0,1,33,4.7e-05
G5,C(C1(CCOC(C(C1)O)O)O)(O)=O,8,1,0,1,29,4.7e-05
G5,C1(C(CCC(C(O)O1)O)O)=O,8,1,0,1,12,4.7e-05
G5,C1(C(C(CCC(O)O1)O)O)=O,8,1,0,1,33,4.7e-05
G5,C1(CC(C(C(C(O)O1)=O)O)O)=O,8,1,0,1,29,4.7e-05
G5,C1(C(O)OC2CC(C1O2)O)=O,16,1,0,1,5,4.7e-05
G5,C(C1(C(CC(C(CO1)O)O)O)O)=O,16,1,0,1,20,4.7e-05
G5,C1C(C(CC(C(CO)(O)O1)O)O)O,16,1,0,1,41,4.7e-05
G5,C1(CC(OC(C(C1O)=O)C)O)=O,8,1,0,1,9,4.7e-05
G5,C1(C(C(OC(C(C1)=O)C)O)O)=O,8,1,0,1,5,4.7e-05
G5,C1C(C(C)(CC(C(O)O1)O)O)O,16,1,0,1,52,4.7e-05
G5,C(C1(CCOC(C(C1)O)O)O)=O,8,1,0,1,29,4.7e-05
G5,C1CC(CO)(CC(C(O)O1)O)O,8,1,0,1,29,4.7e-05
G5,C(C1CC(CC(C(O1)O)O)O)=O,16,1,0,1,21,4.7e-05
G5,C1C(C(CO)(CC(C(O)O1)O)O)O,16,1,0,1,29,4.7e-05
G5,C(CC1(C(CC(CCO1)=O)O)O)=O,4,1,0,1,30,4.7e-05
G5,C(CC1(C(CCC(CO1)=O)O)O)=O,4,1,0,1,7,4.7e-05
G5,C(C1C(C(CC(C(O)O1)O)O)O)O,32,1,0,1,49,4.7e-05
G5,C(C1(C(COC(C(C1)O)O)O)O)=O,16,1,0,1,0,4.7e-05
G5,CC1(CCOC(C(C1O)O)O)O,16,1,0,1,29,4.7e-05
G5,C1CC(CC(C(O)O1)O)O,8,1,0,1,29,4.7e-05
G5,C1(C(CCOC(CCO)(C1)O)O)=O,4,1,0,1,29,4.7e-05
G5,C(C1(CCOC(CO)(CC1)O)O)=O,4,1,0,1,29,4.7e-05
G5,C(C1(CCC(CO)(CCO1)O)O)=O,4,1,0,1,29,4.7e-05
G5,C(C1(CCOC(C)(C(C1)O)O)O)=O,8,1,0,1,29,4.7e-05
G5,C(C1(CC(C(C)(CCO1)O)O)O)=O,8,1,0,1,29,4.7e-05
G5,C1(C(O)OCC(C(C1)O)C(C)O)=O,16,1,0,1,29,4.7e-05
G5,C1(C(CCO)(O)OCCC(C1)O)=O,4,1,0,1,18,4.7e-05
G5,C(CC1(C(CC(CCO1)O)O)O)=O,8,1,0,1,29,4.7e-05
G5,C1(C(C(COC(C1)O)C(C)O)O)=O,16,1,0,1,29,4.7e-05
G5,C(C(C1(CCC(O)OCC1)O)O)=O,8,1,0,1,29,4.7e-05
G5,C(C(C1(CCC(CCO1)O)O)O)=O,8,1,0,1,29,4.7e-05
G5,C(C)(C1(CCOC(C(C1)O)O)O)=O,8,1,0,1,29,4.7e-05
G5,C=CC1(CCOC(C(C1O)O)O)O,16,1,0,1,0,4.7e-05
G5,C1C(CC(C(C(O)O1)(CO)O)O)O,16,1,0,1,6,4.7e-05
G5,C(C1(C(O)OCCC(C1O)O)O)=O,16,1,0,1,29,4.7e-05
G5,C1C(C(CC(C(O)O1)(CO)O)O)O,16,1,0,1,29,4.7e-05
G5,C1(CC(C(O)OCC1)(C(C)O)O)=O,8,1,0,1,25,4.7e-05
G5,C1C2C(CC(C(O)O1)O2)O,16,1,0,1,29,4.7e-05
G5,C1C2CC(C(C(O)O1)O2)O,16,1,0,1,29,4.7e-05
G5,C1(C(O)OCCC(C(CO)O)C1)=O,8,1,0,1,46,4.7e-05
G5,C(CC1CCOC(C(C1O)O)O)=O,16,1,0,1,46,4.7e-05
G5,C(CC1CC(O)OCC(C1O)O)=O,16,1,0,1,4,4.7e-05
G5,C1(CC(CO)(CC(C(O)O1)O)O)=O,8,1,0,1,29,4.7e-05
G5,C1(C(CO)CC(C(C(O)O1)O)=O)=O,8,1,0,1,29,4.7e-05
G5,C1(CC(C)(C(C(C(O)O1)O)O)O)=O,16,1,0,1,29,4.7e-05
G5,C1(CC(CC(C(O)O1)O)O)=O,8,1,0,1,29,4.7e-05
G5,C1(C(C(C(CC(O)O1)O)O)=O)=O,8,1,0,1,33,4.7e-05
G5,C1(CC(CC(CO)(C(O)O1)O)=O)=O,4,1,0,1,17,4.7e-05
G5,C1(C2C(CC(C(O)O1)O2)O)=O,16,1,0,1,29,4.7e-05
G5,C1(C2CC(C(C(O)O1)O2)O)=O,16,1,0,1,29,4.7e-05
G5,C1(CC2C(C1(COC(C2)O)O)O)=O,16,1,0,1,43,4.7e-05
G5,C(C1C(C(O)OCCC1O)O)(O)=O,16,1,0,1,29,4.7e-05
G5,C(C1(C(COC(CC1O)O)=O)O)=O,8,1,0,1,5,4.7e-05
G5,C1(C2C(OC(C2O)CC(O)O1)=O)=O,16,1,0,1,17,4.7e-05
G5,C1(C2(C(C(CC(O)O1)OC2)=O)O)=O,8,1,0,1,9,4.7e-05
G5,C1(C2(C=O)C(CC(C(O)O1)O2)O)=O,16,1,0,1,40,4.7e-05
G5,C1(C2COC(CC(C2O)O1)O)=O,16,1,0,1,48,4.7e-05
G5,C1C2C(C(C(C(O)O1)(CO)O2)O)O,32,1,0,1,26,4.7e-05
G5,C1(C2CC(O)OCC1(CO2)O)=O,8,1,0,1,9,4.7e-05
G5,C(C12COC(C(CC1O)O2)O)=O,16,1,0,1,40,4.7e-05
G5,C1(C2(COC(CC(C2O)O1)O)O)=O,16,1,0,1,27,4.7e-05
G5,C12C(CC(C(C(O)O1)(CO)O)O2)O,32,1,0,1,43,4.7e-05
G5,C1(C2COC(C(C(C2O)O1)O)O)=O,32,1,0,1,8,4.7e-05
G5,C1(C2COC(C(C(C2O)O)O1)O)=O,32,1,0,1,8,4.7e-05
G5,C1(C2C(C)OC(CC(C2O)O1)O)=O,32,1,0,1,48,4.7e-05
G5,C1(C2CC(O)OC(C)C1(CO2)O)=O,16,1,0,1,9,4.7e-05
G5,C(C12C(C)OC(C(CC1O)O2)O)=O,32,1,0,1,40,4.7e-05
G5,C1(C(C=O)(C(CCC(O)O1)=O)O)=O,4,1,0,1,17,4.7e-05
G5,C1C2(C(O)OCC(C=1)(CC2O)O)O,16,1,0,1,32,4.7e-05
G5,C(C)(C1(CC(O)OCCC1O)O)=O,8,1,0,1,45,4.7e-05
G5,C1(C(O)OCCC(C1(C)O)O)=O,8,1,0,1,18,4.7e-05
G5,C(C1(CC(O)OCCC1O)O)(O)=O,8,1,0,1,29,4.7e-05
G5,C1C(C)(CC(C(C)(C(O)O1)O)O)O,16,1,0,1,11,4.7e-05
G5,C1(C(C=O)(CC(CC(O)O1)O)O)=O,8,1,0,1,17,4.7e-05
G5,C1(C(O)OC(C)CC(C1(C)O)O)=O,16,1,0,1,25,4.7e-05
G5,C1C(CC(C(C)(C(O)O1)O)O)O,16,1,0,1,11,4.7e-05
G5,C1(C(C)(C(CC(C(O)O1)=O)O)O)=O,8,1,0,1,25,4.7e-05
G5,C(C1(CCOC(CC1O)O)O)(O)=O,8,1,0,1,45,4.7e-05
G5,C1(C(OCC(C(C1(C)O)O)=O)O)=O,8,1,0,1,5,4.7e-05
G5,C1(COC(CC(C1(C)O)O)O)=O,8,1,0,1,25,4.7e-05
G5,C1(COC(CC(C)(C1(C)O)O)O)=O,8,1,0,1,25,4.7e-05
G5,C1(COC(C)(CC(C1(C)O)O)O)=O,8,1,0,1,25,4.7e-05
G5,C(C1(CCOC(CC1O)O)O)=O,8,1,0,1,29,4.7e-05
G5,C(C1(C(CC(O)OC(C1)=O)O)O)=O,8,1,0,1,29,4.7e-05
G5,C(C1(CCOC(CC1(C)O)O)O)=O,8,1,0,1,29,4.7e-05
G5,C(C1(CCOC(C)(CC1O)O)O)=O,8,1,0,1,29,4.7e-05
G5,CC1(C(O)OCCC(C1O)O)O,16,1,0,1,29,4.7e-05
G5,C1(C(C=O)(CCC(C(O)O1)=O)O)=O,4,1,0,1,17,4.7e-05
G5,C1(C(C(CC(C(O)O1)=O)=O)(C)O)=O,4,1,0,1,17,4.7e-05
G5,C1(C(C(C(CC(O)O1)=O)=O)(C)O)=O,4,1,0,1,17,4.7e-05
G5,C(C1(C(O)OCCC(C1)=O)O)(O)=O,4,1,0,1,29,4.7e-05
G5,C1(C2(C(CC(C(C)(O)O1)O2)=O)O)=O,8,1,0,1,22,4.7e-05
G5,C1(C2(C(CCC(CO2)(O)O1)=O)O)=O,4,1,0,1,12,4.7e-05
G5,C1(C2(C=O)CC(C(C(O)O1)O2)O)=O,16,1,0,1,40,4.7e-05
G5,C1(C2(C(C(C(C(O)O1)O2)O)=O)C)=O,16,1,0,1,29,4.7e-05
G5,C1(CC(C(C(C)(C(O)O1)O)O)O)=O,16,1,0,1,29,4.7e-05
G5,C1(C(CC(C(C)(C(O)O1)O)O)O)=O,16,1,0,1,11,4.7e-05
G5,C1(COC(C(C)(C(C1)O)O)O)=O,8,1,0,1,11,4.7e-05
G5,C(C1(COC(CC(C1)O)O)O)(O)=O,8,1,0,1,33,4.7e-05
G5,C1(C2(COC(C(C1)O2)(C)O)O)=O,8,1,0,1,2,4.7e-05
G5,C1(C2(COC(CC1)(CO2)O)O)=O,4,1,0,1,12,4.7e-05
G5,C(C12COC(C(C(C1)O)O2)O)=O,16,1,0,1,40,4.7e-05
G5,C1(C(C2C(O)OCC1(C)O2)O)=O,16,1,0,1,29,4.7e-05
G5,C(C1(CC(O)OCCC1O)O)=O,8,1,0,1,43,4.7e-05
G5,C(C1(CC(O)OC(C)CC1O)O)=O,16,1,0,1,43,4.7e-05
G5,C1(C(C)(C(C(CC(O)O1)O)O)O)=O,16,1,0,1,25,4.7e-05
G5,C1(C(C)(C(CC(C(O)O1)O)O)O)=O,16,1,0,1,25,4.7e-05
G5,C(C1(CCC(C(O)OC1C)=O)O)=O,8,1,0,1,12,4.7e-05
G5,C1(C(C)(C(C)OC(C(C1)=O)O)O)=O,8,1,0,1,4,4.7e-05
G5,C1(C(CC(O)OC(C)C1(C)O)=O)=O,8,1,0,1,4,4.7e-05
G5,C1(C2(C(C)OC(C(C1)O2)(C)O)O)=O,16,1,0,1,22,4.7e-05
G5,C1(C2(C(C)OC(CC1)(CO2)O)O)=O,8,1,0,1,12,4.7e-05
G5,C(C12C(C)OC(C(C(C1)O)O2)O)=O,32,1,0,1,40,4.7e-05
G5,C1(C(C2C(O)OC(C)C1(C)O2)O)=O,32,1,0,1,29,4.7e-05
G5,C1(C(C(CC(C(C)(O)O1)O)O)O)=O,16,1,0,1,45,4.7e-05
G5,C1(C(C(CC(C)(C(O)O1)O)O)O)=O,16,1,0,1,16,4.7e-05
G5,C1(C(C(C(OC(C)(C1)O)=O)O)O)=O,8,1,0,1,26,4.7e-05
G5,C1(C(C)(C(C(OC(C1)O)=O)O)O)=O,8,1,0,1,14,4.7e-05
G5,C1(C(C=O)(CC(CC(O)O1)=O)O)=O,4,1,0,1,37,4.7e-05
G5,C1(C(COC(C(C)C1)O)O)=O,8,1,0,1,28,4.7e-05
G5,C1(C(C(C)(O)OCC(C1)O)=O)=O,4,1,0,1,29,4.7e-05
G5,C1(C(CC(C=O)OC(C1)O)O)=O,8,1,0,1,32,4.7e-05
G5,C1(CCOC(C(C1O)=O)(C)O)=O,4,1,0,1,3,4.7e-05
G5,C1(CC(C(C(C)(OC1)O)=O)O)=O,4,1,0,1,49,4.7e-05
G5,C1(C(C(C(O)OCC1)C)O)=O,8,1,0,1,3,4.7e-05
G5,C1(C(C(C(O)OCC1O)C)O)=O,16,1,0,1,49,4.7e-05
G5,C1(C(C(C=O)OC(CC1)O)O)=O,8,1,0,1,20,4.7e-05
G5,C12CC(C(CC(O)O1)O2)O,16,1,0,1,43,4.7e-05
G5,C1(CC(C2OCC1C(O)O2)O)=O,16,1,0,1,2,4.7e-05
G5,C1(C2C(O)OC(CO)C(C1)O2)=O,16,1,0,1,29,4.7e-05
G5,C1(C2C(O)OC(C(C1)O)CO2)=O,16,1,0,1,29,4.7e-05
G5,C1(C2OC(CC(C1O)O2)O)=O,16,1,0,1,5,4.7e-05
G5,C12CC(C(C(C(CO)(O)O1)O)O2)O,32,1,0,1,38,4.7e-05
G5,C1(CC2C(C(C(CO)(O2)O1)O)O)O,32,1,0,1,51,4.7e-05
G5,C12C(CC(C(C(CO)(O)O1)O)O2)O,32,1,0,1,51,4.7e-05
G5,C1(C2OC(CO)(CC(C1)O2)O)=O,8,1,0,1,20,4.7e-05
G5,C1(C2OC(CO)(CC(O2)O)C1)=O,8,1,0,1,51,4.7e-05
G5,C1(C2OC(C)(C(C(C1)O2)O)O)=O,16,1,0,1,20,4.7e-05
G5,C1(C2OC(C)(C(C(O2)O)O)C1)=O,16,1,0,1,26,4.7e-05
G5,C1(C2OC(C(C(C1)O2)O)O)=O,16,1,0,1,15,4.7e-05
G5,C(C1(CC2C(CC(O1)O2)O)O)=O,16,1,0,1,20,4.7e-05
G5,C(C12CC(C(CC(O1)O)O2)O)=O,16,1,0,1,20,4.7e-05
G5,C(C1(CC2CC(C(O1)O2)O)O)=O,16,1,0,1,20,4.7e-05
G5,C(C1(CC2C(C(C(O1)O2)O)O)O)=O,32,1,0,1,0,4.7e-05
G5,C(C12CC(C(C(C(O1)O)O)O2)O)=O,32,1,0,1,0,4.7e-05
G5,C12CC(C(CC(CO)(O)O1)O2)O,16,1,0,1,21,4.7e-05
G5,C1(CC2C(CC(CO)(O2)O1)O)O,16,1,0,1,21,4.7e-05
G5,C1C2(CC(O1)OC(C(C2)O)O)O,16,1,0,1,21,4.7e-05
G5,C12C(CC(CO)(CC(O)O1)O2)O,16,1,0,1,21,4.7e-05
G5,C1(C(C(O)OC2CC1CO2)O)=O,16,1,0,1,43,4.7e-05
G5,C1(CC(O)OC2C(C1CO2)O)=O,16,1,0,1,30,4.7e-05
G5,C1(C2OC(C(C(C1CO)O2)O)O)=O,32,1,0,1,15,4.7e-05
G5,CC1(C(C2C(CC(O1)O2)O)O)O,32,1,0,1,49,4.7e-05
G5,CC12C(C(C(CC(O)O1)O2)O)O,32,1,0,1,49,4.7e-05
G5,CC1(CC2OC(C(C1O2)O)O)O,32,1,0,1,16,4.7e-05
G5,C12C(C(C(C)(CC(O)O1)O2)O)O,32,1,0,1,16,4.7e-05
G5,C(C1C2C(C(O)OC(C1O)O2)O)=O,64,1,0,1,43,4.7e-05
G5,C12C(CC(CC(CO)(O)O1)O2)O,16,1,0,1,21,4.7e-05
G5,CC1(C(C2CC(C(O1)O2)O)O)O,32,1,0,1,49,4.7e-05
G5,C12C(C(C(CC(CO)(O)O1)O2)O)O,32,1,0,1,20,4.7e-05
G5,C1(C(C2C(CC(CO)(O2)O1)O)O)O,32,1,0,1,20,4.7e-05
G5,CC1(C(C2C(C(C(O1)O2)O)O)O)O,64,1,0,1,20,4.7e-05
G5,CC12C(C(C(C(C(O)O1)O)O2)O)O,64,1,0,1,5,4.7e-05
G5,C12C(CC(CC(O)O1)O2)O,16,1,0,1,43,4.7e-05
G5,C1(C2CC(O)OC(CCO)(C1)O2)=O,8,1,0,1,30,4.7e-05
G5,C1(C2OC(CC(O2)O)(CCO)C1)=O,8,1,0,1,30,4.7e-05
G5,C(C12CC(O)OC(CO)(CC1)O2)=O,8,1,0,1,29,4.7e-05
G5,C(C12CCC(CO)(CC(O1)O)O2)=O,8,1,0,1,29,4.7e-05
G5,C(C1(CCC2(COC(C2)O1)O)O)=O,8,1,0,1,29,4.7e-05
G5,C(C12CC(O)OC(C)(C(C1)O)O2)=O,16,1,0,1,22,4.7e-05
G5,C(C12CC(C(C)(CC(O1)O)O2)O)=O,16,1,0,1,22,4.7e-05
G5,C(C1(CC2C(C)(CC(O1)O2)O)O)=O,16,1,0,1,22,4.7e-05
G5,C1(C2OC(CC(C1C(C)O2)O)O)=O,32,1,0,1,45,4.7e-05
G5,C1(C2(CCO)OC(CC(O2)O)C1)=O,8,1,0,1,53,4.7e-05
G5,C1(CC2OC1(CC(O)O2)CCO)=O,8,1,0,1,53,4.7e-05
G5,C(CC12CC(O)OC(CC1O)O2)=O,16,1,0,1,13,4.7e-05
G5,C(CC12C(CC(CC(O)O1)O2)O)=O,16,1,0,1,13,4.7e-05
G5,C(C(C12CCC(O1)OC(C2)O)O)=O,16,1,0,1,29,4.7e-05
G5,C(CC12CCC(O1)OC(C2O)O)=O,16,1,0,1,29,4.7e-05
G5,C(C1C2(CCC(O)OC(C2)O1)O)=O,16,1,0,1,44,4.7e-05
G5,C(C(C12CCC(CC(O)O1)O2)O)=O,16,1,0,1,44,4.7e-05
G5,C1(C(C(O)OC2CC1C(C)O2)O)=O,32,1,0,1,46,4.7e-05
G5,C(C)(C12CC(C(CC(O1)O)O2)O)=O,16,1,0,1,21,4.7e-05
G5,C(C)(C1(CC2C(CC(O1)O2)O)O)=O,16,1,0,1,21,4.7e-05
G5,C(C)(C12CC(O)OC(C(C1)O)O2)=O,16,1,0,1,21,4.7e-05
G5,C(CC12CC(C(CC(O)O1)O2)O)=O,16,1,0,1,6,4.7e-05
G5,C(CC1(CC2C(CC(O2)O1)O)O)=O,16,1,0,1,6,4.7e-05
G5,C(CC12CC(C(O1)OC(C2)O)O)=O,16,1,0,1,4,4.7e-05
G5,C1(CC(O)OC2C(C1C(C)O2)O)=O,32,1,0,1,37,4.7e-05
G5,C=CC12C(C(C(CC(O1)O)O2)O)O,32,1,0,1,7,4.7e-05
G5,C=CC1(C(C2C(CC(O1)O2)O)O)O,32,1,0,1,7,4.7e-05
G5,C=CC12CC(O)OC(C(C1O)O)O2,32,1,0,1,7,4.7e-05
G5,C=CC1(CC2OC1C(C(O)O2)O)O,32,1,0,1,7,4.7e-05
G5,C12C(CC(CO)(C(C(O)O1)O)O2)O,32,1,0,1,20,4.7e-05
G5,C12C(C(CO1)(CC(C(O)O2)O)O)O,32,1,0,1,12,4.7e-05
G5,CC12C(C(O)OC(C(C1O)O)O2)O,64,1,0,1,26,4.7e-05
G5,C12C(C(C)(C(C(C(O)O1)O)O2)O)O,64,1,0,1,5,4.7e-05
G5,C12C(C(C(C(C(O)O1)O)O2)O)O,64,1,0,1,15,4.7e-05
G5,C12C(CO)C(C(C(C(O)O1)O)O2)O,64,1,0,1,43,4.7e-05
G5,C1(C(O)OC2CCC1O2)=O,8,1,0,1,27,4.7e-05
G5,C12C(CO)(C(C(CC(O)O1)O2)O)O,32,1,0,1,43,4.7e-05
G5,C(C1(C(O)OC2CC(C1O2)O)O)=O,32,1,0,1,43,4.7e-05
G5,C(C1(C2OC(CC(C1O)O2)O)O)=O,32,1,0,1,43,4.7e-05
G5,C(C1(C(O)OC2C(CC1O2)O)O)=O,32,1,0,1,1,4.7e-05
G5,C12C(CO)(CC(C(C(O)O1)O)O2)O,32,1,0,1,43,4.7e-05
G5,C1(CC(O)OC2CC1(CO2)O)=O,8,1,0,1,2,4.7e-05
G5,C(C1(CC2OC1C(C(O)O2)O)O)=O,32,1,0,1,1,4.7e-05
G5,C(C12CC(O)OC(C(C1O)O)O2)=O,32,1,0,1,1,4.7e-05
G5,C1(CC(O)OC2CC1(C(C)O2)O)=O,16,1,0,1,4,4.7e-05
G5,C12C3CC(C(C(O)O1)O3)O2,32,1,0,1,40,4.7e-05
G5,C1(C(O)OC2CC(C(CO)O2)C1)=O,16,1,0,1,46,4.7e-05
G5,C(CC1C2C(C(O)OC(C1)O2)O)=O,32,1,0,1,43,4.7e-05
G5,C1(C2OC(CC(CO2)(C1)O)O)=O,8,1,0,1,51,4.7e-05
G5,C1(C(O)OC2CC(C1CO2)O)=O,16,1,0,1,33,4.7e-05
G5,C1(C(C2OCC1CC(O)O2)O)=O,16,1,0,1,43,4.7e-05
G5,C1(CC2OCC1C(C(O)O2)O)=O,16,1,0,1,2,4.7e-05
G5,C1(C(O)OC2C(C(C1CO2)O)O)=O,32,1,0,1,15,4.7e-05
G5,C1(C(O)OC2CC(CCO2)(C1)O)=O,8,1,0,1,30,4.7e-05
G5,C1(C(O)OC2CC(C1C(C)O2)O)=O,32,1,0,1,4,4.7e-05
G5,C1(CC(O)OC2CC1(CCO2)O)=O,8,1,0,1,53,4.7e-05
G5,C1(C(C2OC(CC1C(C)O2)O)O)=O,32,1,0,1,4,4.7e-05
G5,C1(CC2OC(C)C1C(C(O)O2)O)=O,32,1,0,1,4,4.7e-05
G5,C1(CC2OCC1(CC(O)O2)O)=O,8,1,0,1,12,4.7e-05
G5,C1(CC2OC(CC1(C(C)O2)O)O)=O,16,1,0,1,4,4.7e-05
G5,C1(C2OC(CO)C(CC(O2)O)C1)=O,16,1,0,1,46,4.7e-05
G5,C1(C(O)OC2CC(C(CO2)O)C1)=O,16,1,0,1,46,4.7e-05
G5,C1C2(CC(C(C(CO2)(O)O1)O)O)O,16,2,0,2,32,9.499999999999999e-05
G5,C1C2(CC(CC(CO2)(O)O1)O)O,3,1,0,1,49,4.7e-05
G5,C1(C2C(O)OC(C(C1)O)C(O2)O)=O,32,2,0,2,1,9.499999999999999e-05
G5,C1(C(C2C(O)OC(C(O)O2)C1)O)=O,32,2,0,2,0,9.499999999999999e-05
G5,C1(C2OC(C(C(C1)O)CO2)O)=O,16,1,0,1,23,4.7e-05
G5,C1(C(CC2OC(C1CO2)O)O)=O,16,1,0,1,38,4.7e-05
G5,C1(C(C2C(O)OC(C1)OC2)O)=O,16,1,0,1,23,4.7e-05
G5,C1(C(C2OC(C(CO2)C1)O)O)=O,16,1,0,1,55,4.7e-05
G5,C1(C2CC(O)OC(CC(O2)O)C1)=O,16,2,0,2,13,9.499999999999999e-05
G5,C1(C2OC(C(C(C1)O)C(C)O2)O)=O,32,1,0,1,23,4.7e-05
G5,C1(C(CC2OC(C)C1C(O)O2)O)=O,32,1,0,1,4,4.7e-05
G5,C1(C(C2C(O)OC(C1)OC2C)O)=O,32,1,0,1,4,4.7e-05
G5,C1(C(C2OC(C(C(C)O2)C1)O)O)=O,32,1,0,1,46,4.7e-05
G5,C1(CC(C2OC(C)C1C(O)O2)O)=O,32,1,0,1,37,4.7e-05
G5,C1C2C(C(CC(C(O)O2)(O)O1)O)O,32,2,0,2,12,9.499999999999999e-05
G5,C1C2C(O)OC(C(C(C2O)O)O)O1,64,1,0,1,23,4.7e-05
G5,C1C2(C(O)OC(CC(C2O)O)O1)O,32,1,0,1,38,4.7e-05
G5,C12C(CC(C(CO1)(C(O)O2)O)O)O,32,1,0,1,43,4.7e-05
G5,C1(CCC2OC(C1(CO2)O)O)=O,8,1,0,1,38,4.7e-05
G5,C1(CCC2OC(C)C1(C(O)O2)O)=O,16,1,0,1,4,4.7e-05
G5,C12C(C(CC(CO1)(C(O)O2)O)O)O,32,1,0,1,43,4.7e-05
G5,C1(CC2(COC(C1)OC2O)O)=O,8,1,0,1,38,4.7e-05
G5,C1(CC2(C(O)OC(C1)OC2C)O)=O,16,1,0,1,25,4.7e-05
G5,C1(C2OC(CC(C(CO2)O)C1)O)=O,16,1,0,1,46,4.7e-05
G5,C1(C2C(O)OCC(CC(O2)O)C1)=O,16,2,0,2,55,9.499999999999999e-05
G5,C1(C2COC(C(CC(O2)O)C1)O)=O,16,2,0,2,43,9.499999999999999e-05
G5,C(C1C(CO)C(OCC(C1)=O)O)=O,8,1,0,1,18,4.7e-05
G5,C1(COC(CC(C1CC=O)O)O)=O,8,1,0,1,18,4.7e-05
G5,C(C1COC(C(CC1)=O)O)=O,4,1,0,1,7,4.7e-05
G5,C1(COC(C(CO)CC1)O)=O,4,1,0,1,7,4.7e-05
G5,C(C1CCC(C(O)OC1C)=O)=O,8,1,0,1,7,4.7e-05
G5,C(CC1CCCC(C(O)O1)=O)=O,4,1,0,1,7,4.7e-05
G5,C1(COC(C(CC1)C(C)O)O)=O,8,1,0,1,7,4.7e-05
G5,C(C(C1CCCC(C(O)O1)=O)O)=O,8,1,0,1,7,4.7e-05
G5,C(C1C(CCCC(C=O)(O1)O)O)=O,8,1,0,1,7,4.7e-05
G5,C(C1C(CCC(C(O1)O)=O)(C)O)=O,8,1,0,1,7,4.7e-05
G5,C1(COC(C(CC1)(C(C)O)O)O)=O,8,1,0,1,7,4.7e-05
G5,C(C1C(CCCC(CO)(O1)O)O)=O,8,1,0,1,27,4.7e-05
G5,C(C1CC(C(C=O)OC(C1)O)O)=O,16,1,0,1,43,4.7e-05
G5,C(C1C(COC(C=O)(CC1)O)O)=O,8,1,0,1,7,4.7e-05
G5,C(C1CCC(C(O)OC1CO)=O)=O,8,1,0,1,7,4.7e-05
G5,C(C1CCC(CO)(O)OCC1O)=O,8,1,0,1,7,4.7e-05
G5,C1(COC(C(CC1)C(CO)O)O)=O,8,1,0,1,7,4.7e-05
G5,C(C1C(COC(CC1C=O)O)O)=O,16,1,0,1,46,4.7e-05
G5,C1(C(C)(CCC(C(O)O1)=O)O)=O,4,1,0,1,25,4.7e-05
G5,C1(C(CCCC(C=O)(O)O1)O)=O,4,1,0,1,7,4.7e-05
G5,C(C1CCCC(C(O1)O)=O)(O)=O,4,1,0,1,7,4.7e-05
G5,C1(C(CCCC(CO)(O)O1)O)=O,4,1,0,1,7,4.7e-05
G5,C(C1CC(C(OC(C1)O)=O)O)=O,8,1,0,1,25,4.7e-05
G5,C(C1(C(CCC(CO1)=O)O)O)=O,4,1,0,1,20,4.7e-05
G5,C(C)(C1(C(CCC(CO1)=O)O)O)=O,4,1,0,1,25,4.7e-05
G5,C1(COC(C(CO)=O)(CCC1)O)=O,2,1,0,1,7,4.7e-05
G5,C(CC1C(OCC(C(C1)=O)=O)O)=O,4,1,0,1,43,4.7e-05
G5,C1(C(OC(C(C=O)=O)CCC1)O)=O,4,1,0,1,7,4.7e-05
G5,C(C1(C(CCC(CO1)=O)(C)O)O)=O,4,1,0,1,7,4.7e-05
G5,C(C1(CCC(C(CO1)=O)(C)O)O)=O,4,1,0,1,7,4.7e-05
G5,C(CO)(C1CCCC(C(O1)O)=O)=O,4,1,0,1,7,4.7e-05
G5,C1(C(C)OC(CO)(CCC1O)O)=O,8,1,0,1,7,4.7e-05
G5,C1(COC(C(C)O)(C(CC1)O)O)=O,8,1,0,1,7,4.7e-05
G5,C1(COC(CO)(CCC1(C)O)O)=O,4,1,0,1,7,4.7e-05
G5,C1(COC(CO)(C(C)(CC1)O)O)=O,4,1,0,1,7,4.7e-05
G5,C(C1CC(OC(C(C1O)=O)C)O)=O,16,1,0,1,25,4.7e-05
G5,C(C1CC(OCC(C1(C)O)=O)O)=O,8,1,0,1,25,4.7e-05
G5,C1(CC(C=O)C(C=O)C(OC1)O)=O,8,1,0,1,45,4.7e-05
G5,C(C1CCC(COC1O)=O)=O,4,1,0,1,45,4.7e-05
G5,C(C1(CCOC(C=O)(CC1)O)O)=O,4,1,0,1,7,4.7e-05
G5,C(C(C1CCC(C(O)OC1)=O)O)=O,8,1,0,1,7,4.7e-05
G5,C(C1C(CCC(C(O1)O)=O)CO)=O,8,1,0,1,7,4.7e-05
G5,C(C1CC(CCC(C=O)(O1)O)O)=O,8,1,0,1,7,4.7e-05
G5,C(C1CC(CCC(CO)(O1)O)O)=O,8,1,0,1,7,4.7e-05
G5,C(C1CC(O)OCCC1(C=O)O)=O,8,1,0,1,29,4.7e-05
G5,C(C1C(CC(C=O)OC(C1)O)O)=O,16,1,0,1,43,4.7e-05
G5,C(C1(CCCC(C(O1)=O)=O)O)=O,2,1,0,1,7,4.7e-05
G5,C1(C(CCCC(CO)(O)O1)=O)=O,2,1,0,1,7,4.7e-05
G5,C(C1(CCCC(CO1)=O)O)(O)=O,2,1,0,1,7,4.7e-05
G5,C(C1CC(O)OC(C(C1)=O)=O)=O,4,1,0,1,29,4.7e-05
G5,C(C1(C(OCC(CC1)=O)O)O)(O)=O,4,1,0,1,7,4.7e-05
G5,C1(COC(C=O)(C(C=O)CC1)O)=O,4,1,0,1,23,4.7e-05
G5,C1(COC(C(C(C=O)=O)CC1)O)=O,4,1,0,1,23,4.7e-05
G5,C(C)(C1(CCCC(CO1)=O)O)=O,2,1,0,1,14,4.7e-05
G5,C(CC1(CCCC(CO1)=O)O)=O,2,1,0,1,7,4.7e-05
G5,C(C1CCC(COC1(C)O)=O)=O,4,1,0,1,7,4.7e-05
G5,C(C)(C1CCC(COC1O)=O)=O,4,1,0,1,7,4.7e-05
G5,C1(COC2C1CCC(C(O)O2)=O)=O,8,1,0,1,7,4.7e-05
G5,C1(COC2(COC(C2CC1)O)O)=O,8,1,0,1,7,4.7e-05
G5,C1(COC2(C(CC1)OC(C2)O)O)=O,8,1,0,1,7,4.7e-05
G5,C(CC1C(O)OC2CC(C1O2)=O)=O,16,1,0,1,43,4.7e-05
G5,C1(COC(C(CC1CC=O)O)O)=O,8,1,0,1,11,4.7e-05
G5,C(C1C(C)(C(OCC(C1)=O)O)O)=O,8,1,0,1,11,4.7e-05
G5,C1(C2CCC(C(O)OC2CO1)=O)=O,8,1,0,1,8,4.7e-05
G5,C1(CC2C(CCC(C(O)O2)=O)O1)=O,8,1,0,1,7,4.7e-05
G5,C(C1CCCC(C(O1)O)=O)=O,4,1,0,1,7,4.7e-05
G5,C1(C(O)OC(CO)C(CC1)O)=O,8,1,0,1,29,4.7e-05
G5,C(C1(CCC(C(CO1)O)O)O)=O,8,1,0,1,29,4.7e-05
G5,C1(C(O)OCC(CO)(CC1)O)=O,4,1,0,1,7,4.7e-05
G5,C1(C(O)OCCCC1)=O,2,1,0,1,46,4.7e-05
G5,C1(C(CO)(CCC(C(O)O1)=O)O)=O,4,1,0,1,7,4.7e-05
G5,C(C1(COC(C(CC1)=O)O)O)(O)=O,4,1,0,1,7,4.7e-05
G5,C1(C(C(CCC(C=O)(O)O1)O)O)=O,8,1,0,1,20,4.7e-05
G5,C(C1C(CCC(C(O1)O)=O)O)(O)=O,8,1,0,1,20,4.7e-05
G5,C1(CCCC(C(O)O1)=O)=O,2,1,0,1,18,4.7e-05
G5,C1(C2CCC(C=O)(OC1CO2)O)=O,8,1,0,1,10,4.7e-05
G5,C1(COC2CCC(C(OC12)O)=O)=O,8,1,0,1,10,4.7e-05
G5,C(C1(CCC2C(C(O1)OC2)=O)O)=O,8,1,0,1,7,4.7e-05
G5,C1(COC(C=C)(C(CC1)O)O)=O,4,1,0,1,7,4.7e-05
G5,C1(COC(C(C)(CC1)O)O)=O,4,1,0,1,11,4.7e-05
G5,C1C(C(CCC(CO)(O)O1)O)O,8,1,0,1,29,4.7e-05
G5,C1(C(C(CCC(CO)(O)O1)O)O)=O,8,1,0,1,20,4.7e-05
G5,C1(COC2(C(COC2CC1)O)O)=O,8,1,0,1,10,4.7e-05
G5,C1(C2CCC(CO)(OC1CO2)O)=O,8,1,0,1,10,4.7e-05
G5,C1(COC2(COCC2(CC1)O)O)=O,4,1,0,1,10,4.7e-05
G5,C1(COC2(C(CC1)(O)OCC2)O)=O,4,1,0,1,34,4.7e-05
G5,C1(COC2(C(O)OCC2CC1)O)=O,8,1,0,1,7,4.7e-05
G5,C1(C2OC(CO)(CCC1CO2)O)=O,8,1,0,1,7,4.7e-05
G5,C(C1CC(O)OCC(C1O)O)=O,16,1,0,1,29,4.7e-05
G5,C(C1C(C(C(OC(C1)O)=O)O)O)=O,16,1,0,1,43,4.7e-05
G5,C(C1CC(OC2C(C1OC2)=O)O)=O,16,1,0,1,10,4.7e-05
G5,C(C1CC(OC2C(C1CO2)=O)O)=O,16,1,0,1,34,4.7e-05
G5,C(CC1C(OC2C(CC1O2)=O)O)=O,16,1,0,1,34,4.7e-05
G5,C1(C(CO)(O)OCCC(CO)C1)=O,4,1,0,1,46,4.7e-05
G5,C1(COC(CC(CO)C1O)O)=O,8,1,0,1,5,4.7e-05
G5,C1(COC(CC(CCO)C1O)O)=O,8,1,0,1,46,4.7e-05
G5,C1(COC(CC(C(C)O)C1O)O)=O,16,1,0,1,46,4.7e-05
G5,C1(C(C(CO)(O)OCCC1)O)=O,4,1,0,1,29,4.7e-05
G5,C1(C(C(CO)(O)OC(CC1)C)O)=O,8,1,0,1,46,4.7e-05
G5,C1C(C(C(CO)CC(O)O1)O)O,16,1,0,1,29,4.7e-05
G5,C1(C(C(C(CO)CC(O)O1)O)O)=O,16,1,0,1,29,4.7e-05
G5,C1(CC(CO)C(C(C(O)O1)O)O)=O,16,2,0,2,29,9.499999999999999e-05
G5,C(C1COC(CC(C1)=O)O)=O,4,1,0,1,55,4.7e-05
G5,C1(CC(C=O)(O)OCCC1)=O,2,1,0,1,55,4.7e-05
G5,C1C(C(C(CCO)CC(O)O1)O)O,16,1,0,1,46,4.7e-05
G5,CC(C1CC(O)OCC(C1O)O)O,32,1,0,1,46,4.7e-05
G5,C(C)(C1CCOC(C(C1)=O)O)=O,4,1,0,1,29,4.7e-05
G5,C(CC1CCOC(C(C1)=O)O)=O,4,1,0,1,46,4.7e-05
G5,C(C1CCOC(C(C1)=O)(C)O)=O,4,1,0,1,29,4.7e-05
G5,C(C1C(C)OC(CC(C1)=O)O)=O,8,1,0,1,46,4.7e-05
G5,C1(C(CCOC(C1)O)CC=O)=O,4,1,0,1,29,4.7e-05
G5,C1(CC(C=O)(O)OC(C)CC1)=O,4,1,0,1,46,4.7e-05
G5,C(CC1(C(CCCCO1)=O)O)=O,2,1,0,1,46,4.7e-05
G5,C1(CC(C(C)=O)CC(C(O)O1)=O)=O,4,1,0,1,18,4.7e-05
G5,C1(CC(CC=O)CC(C(O)O1)=O)=O,4,1,0,1,18,4.7e-05
G5,C1(CC(C=O)CC(OC1(C)O)=O)=O,4,1,0,1,18,4.7e-05
G5,C1(CC(C(CC(O)O1)=O)CC=O)=O,4,1,0,1,18,4.7e-05
G5,C1(CCCC(C(CC=O)(O)O1)=O)=O,2,1,0,1,18,4.7e-05
G5,C1(CC(C=O)C(C=O)OC(C1)O)=O,8,1,0,1,0,4.7e-05
G5,C1(CC(C=O)(OC(C=O)CC1)O)=O,4,1,0,1,0,4.7e-05
G5,C1(COC(CO)(CCC1O)O)=O,4,1,0,1,7,4.7e-05
G5,C1(COC(CO)(C(CC1)O)O)=O,4,1,0,1,7,4.7e-05
G5,C(C1C(CCC(C(O1)O)=O)O)=O,8,1,0,1,20,4.7e-05
G5,C1(COC(C(CO)(CC1)O)O)=O,4,1,0,1,7,4.7e-05
G5,C(C1CC(C=O)(OCC(C1)=O)O)=O,4,1,0,1,45,4.7e-05
G5,C(CC1C(COC(C(C1)=O)O)=O)=O,4,1,0,1,12,4.7e-05
G5,C(C1(CCCC(CO1)=O)O)=O,2,1,0,1,7,4.7e-05
G5,C(C1(CCC(C=O)C(CO1)=O)O)=O,4,1,0,1,7,4.7e-05
G5,C(C1C(COC(CO)(CC1)O)=O)=O,4,1,0,1,7,4.7e-05
G5,C(CO)(C1C(OCC(CC1)=O)O)=O,4,1,0,1,7,4.7e-05
G5,C(C1CCC(COC1(CO)O)=O)=O,4,1,0,1,7,4.7e-05
G5,C(C1CC(OCC(C1C=O)=O)O)=O,8,1,0,1,55,4.7e-05
G5,C1(CCCC(C=O)(OC1C=O)O)=O,4,1,0,1,7,4.7e-05
G5,C(C)(C1(C(OCC(CC1)=O)O)O)=O,4,1,0,1,1,4.7e-05
G5,C(C1(CCC(COC1(C)O)=O)O)=O,4,1,0,1,1,4.7e-05
G5,C(C1C(CCCC(CO)(O1)O)=O)=O,4,1,0,1,7,4.7e-05
G5,C(C(C1(CCCC(CO1)=O)O)O)=O,4,1,0,1,7,4.7e-05
G5,C(C1CC(OC(C=O)C(C1)=O)O)=O,8,1,0,1,43,4.7e-05
G5,C1(C(CO)OC(C=O)(CCC1)O)=O,4,1,0,1,7,4.7e-05
G5,C(C)(C1(COC(C(CC1)=O)O)O)=O,4,1,0,1,7,4.7e-05
G5,C(C)(C1C(CCC(C(O1)O)=O)O)=O,8,1,0,1,20,4.7e-05
G5,C1(C(CO)OC(CO)(CCC1)O)=O,4,1,0,1,7,4.7e-05
G5,C1(COC(C(CO)O)(CCC1)O)=O,4,1,0,1,7,4.7e-05
G5,C1(COC(C)(C(CO)(CC1)O)O)=O,4,1,0,1,7,4.7e-05
G5,C1(C(O)OCC(C(C=O)=O)CC1)=O,4,1,0,1,7,4.7e-05
G5,C(C1(C(CCC(CO1)=O)CO)O)=O,4,1,0,1,7,4.7e-05
G5,C(C1(CCC(C(CO1)=O)CO)O)=O,4,1,0,1,7,4.7e-05
G5,C(CO)(C1COC(C(CC1)=O)O)=O,4,1,0,1,7,4.7e-05
G5,C1(COC(C(CC1)O)(CCO)O)=O,4,1,0,1,7,4.7e-05
G5,C1(COC(CO)(CCC1CO)O)=O,4,1,0,1,7,4.7e-05
G5,C1(COC(CO)(C(CO)CC1)O)=O,4,1,0,1,7,4.7e-05
G5,C(CC1C(O)OCCC(C1O)=O)=O,8,1,0,1,3,4.7e-05
G5,C(C1CC(OCC(C1CO)=O)O)=O,8,1,0,1,43,4.7e-05
G5,C(CC1C(CC(COC1O)=O)O)=O,8,1,0,1,43,4.7e-05
G5,C(C1(C(OCC(CC1)=O)O)O)=O,4,1,0,1,29,4.7e-05
G5,C(C1CC(CO)(OCC(C1)=O)O)=O,4,1,0,1,49,4.7e-05
G5,C(C1C(C(C)(OCC(C1)=O)O)O)=O,8,1,0,1,49,4.7e-05
G5,C1(COC(CO)(CCC1)O)=O,2,1,0,1,7,4.7e-05
G5,C1(COC(C)(C(CC1)O)O)=O,4,1,0,1,7,4.7e-05
G5,C(C1CCC(C(OC1C=O)O)=O)=O,8,1,0,1,7,4.7e-05
G5,C(C(C1C(OCC(CC1)=O)O)O)=O,8,1,0,1,7,4.7e-05
G5,C1(CC2CC(O)OCC(C2O1)O)=O,16,1,0,1,4,4.7e-05
G5,C1(CC2CC(O)OCC(C2O)O1)=O,16,1,0,1,4,4.7e-05
G5,C(C)(C1C(COC(C(C1)=O)O)O)=O,8,1,0,1,46,4.7e-05
G5,C(C1C(COC(C(C1)=O)(C)O)O)=O,8,1,0,1,46,4.7e-05
G5,C(C1C(CO)OC(CC(C1)=O)O)=O,8,1,0,1,46,4.7e-05
G5,C1(C(C(COC(C1)O)O)CC=O)=O,8,1,0,1,46,4.7e-05
G5,C1(CC(C=O)(O)OC(CO)CC1)=O,4,1,0,1,46,4.7e-05
G5,C(CC1(C(CCC(CO1)O)=O)O)=O,4,1,0,1,46,4.7e-05
G5,C(CO)(C(C(C(CCO)=O)=O)O)=O,2,1,0,1,5,4.7e-05
G5,C(C)(C(C(C(CCO)=O)=O)(C)O)=O,2,1,0,1,14,4.7e-05
G5,C(CC(C(C(CCO)=O)=O)O)(C)=O,2,1,0,1,34,4.7e-05
G5,C=CC(C(C(C(CCO)=O)=O)O)=O,2,1,0,1,7,4.7e-05
G5,C(C(C=C)(C(C(CCO)=O)=O)O)=O,2,1,0,1,7,4.7e-05
G5,C(C(C(C(CCO)=O)=O)O)=CC=O,4,1,0,1,34,4.7e-05
G5,C(CCC(C=O)=O)(CC(CO)=O)=O,1,1,0,1,35,4.7e-05
G5,C(CO)(CC(CCC(CO)=O)=O)=O,1,1,0,1,35,4.7e-05
G5,C(C(C(CC(CO)=O)=O)CC=O)=O,2,1,0,1,35,4.7e-05
G5,C(C(C)CO)=O,2,1,0,1,28,4.7e-05
G5,C1(C2C(C(C(C2O)O1)O)=O)=O,16,2,0,2,0,9.499999999999999e-05
G5,C1(C2C(C(C(C2O)O)O1)=O)=O,16,2,0,2,0,9.499999999999999e-05
G5,C1(C(CO)C2C(C1C(O2)=O)=O)=O,8,2,0,2,30,9.499999999999999e-05
G5,C1(C2C(C(C(C(C2)=O)O)O1)=O)=O,8,2,0,2,12,9.499999999999999e-05
G5,C(C12CC(C(O1)=O)C(C2O)=O)=O,8,2,0,2,12,9.499999999999999e-05
G5,C(C1(CC2C(OC1C2=O)=O)O)=O,8,2,0,2,12,9.499999999999999e-05
G5,C1(C2C(C(CC(C2O)=O)O1)=O)=O,8,2,0,2,17,9.499999999999999e-05
G5,C1(C2CC(C=O)(C1C(O2)=O)O)=O,8,2,0,2,17,9.499999999999999e-05
G5,C(C1C(C2C(OC1C2=O)=O)O)=O,16,2,0,2,17,9.499999999999999e-05
G5,C1(C2C(CC(C(C2O)O1)=O)=O)=O,8,2,0,2,17,9.499999999999999e-05
G5,C1(CC(C2C(C1C(O2)=O)=O)O)=O,8,2,0,2,17,9.499999999999999e-05
G5,C1(C2C(C(C(CC2O)=O)O1)=O)=O,8,2,0,2,17,9.499999999999999e-05
G5,C1(C2C(C(C(C2C=O)O)O1)=O)=O,16,2,0,2,17,9.499999999999999e-05
G5,C1(C(C2C(C=O)C1C(O2)=O)O)=O,16,2,0,2,17,9.499999999999999e-05
G5,C1(C2C(C(CC(C2O)O1)=O)=O)=O,8,2,0,2,17,9.499999999999999e-05
G5,C1(C2C(C(C=O)C(C2O)O1)=O)=O,16,2,0,2,17,9.499999999999999e-05
G5,C1(C(C(C(C(C=O)O)O1)=O)O)=O,8,1,0,1,17,4.7e-05
G5,C1(C(C(C=O)=O)C(C)(CO1)O)=O,4,1,0,1,49,4.7e-05
G5,C1(CC(C(CC(CO)=O)O1)=O)=O,2,1,0,1,29,4.7e-05
G5,C1(C(C(C(C=O)=O)C(C)O1)O)=O,8,1,0,1,4,4.7e-05
G5,C1(C(C(C=O)C(C(C)=O)O1)O)=O,8,1,0,1,45,4.7e-05
G5,C1(C(C(C=O)C(C=O)(C)O1)O)=O,8,1,0,1,45,4.7e-05
G5,C1(C(C=O)C(C(CO)O1)=O)=O,4,1,0,1,17,4.7e-05
G5,C1(C(C=O)C(C(C(C)O)O1)=O)=O,8,1,0,1,17,4.7e-05
G5,C1(C(C(C(C=O)O1)=O)CO)=O,4,1,0,1,17,4.7e-05
G5,C1(C(C(C(C=O)O1)=O)C(C)O)=O,8,1,0,1,4,4.7e-05
G5,C1(C(C(C(CO)O1)=O)CO)=O,4,1,0,1,2,4.7e-05
G5,C1(C(C(C(CO)O1)=O)C(C)O)=O,8,1,0,1,4,4.7e-05
G5,C(C1COC(C1(C)O)=O)=O,4,1,0,1,28,4.7e-05
G5,C(C1COC(C1(CCO)O)=O)=O,4,1,0,1,7,4.7e-05
G5,C1(C(C(CO)C(CCO)O1)=O)=O,4,1,0,1,18,4.7e-05
G5,C(C1C(CCO)OC(C1O)=O)=O,8,1,0,1,33,4.7e-05
G5,C1(C(C(C(C(C)O)O1)=O)CO)=O,8,1,0,1,2,4.7e-05
G5,C1(C(C(CO)=O)C(C)(CO1)O)=O,4,1,0,1,49,4.7e-05
G5,C(CO)(C1C(C)OC(C1O)=O)=O,8,1,0,1,11,4.7e-05
G5,C(C1C(CO)(C)OC(C1O)=O)=O,8,1,0,1,49,4.7e-05
G5,C(C1C(C)OC(C1(C)O)=O)=O,8,1,0,1,28,4.7e-05
G5,C1(C(CC(CC(C)O)O1)=O)=O,4,1,0,1,28,4.7e-05
G5,C1(C(CC(C(C(C)O)O)O1)=O)=O,8,1,0,1,28,4.7e-05
G5,C(C1C(CO)OC(C1(C)O)=O)=O,8,1,0,1,28,4.7e-05
G5,C1(C(CC(CC(CO)O)O1)=O)=O,4,1,0,1,29,4.7e-05
G5,C(C1(CO)CC(C(O1)=O)=O)=O,2,1,0,1,17,4.7e-05
G5,C(CO)(C1CC(C(O1)=O)=O)=O,2,1,0,1,5,4.7e-05
G5,C1(C(C(C(C(C=O)=O)O1)O)O)=O,8,1,0,1,5,4.7e-05
G5,C1(C(C(C(CC=O)O1)=O)O)=O,4,1,0,1,2,4.7e-05
G5,C(CO)(C1(C)CC(C(O1)=O)=O)=O,2,1,0,1,0,4.7e-05
G5,C1(C(C(CO1)=O)C(CO)=O)=O,2,1,0,1,27,4.7e-05
G5,C1(C(C(C(C(C)=O)O1)=O)O)=O,4,1,0,1,0,4.7e-05
G5,C1(CC(C(C(CO)=O)O1)=O)=O,2,1,0,1,17,4.7e-05
G5,C(C1CC(C(O1)=O)=O)(C(C)O)=O,4,1,0,1,49,4.7e-05
G5,C(C1(C(C)O)CC(C(O1)=O)=O)=O,4,1,0,1,17,4.7e-05
G5,C1(C(CC(CO)(C(C)O)O1)=O)=O,4,1,0,1,29,4.7e-05
G5,C(C(C=O)C1CC(C(O1)=O)O)=O,4,1,0,1,33,4.7e-05
G5,C(CC1C(C=O)C(C(O1)=O)O)=O,8,1,0,1,33,4.7e-05
G5,C1(C(C(C(C=O)O1)=O)O)=O,4,1,0,1,17,4.7e-05
G5,C1(C(CC(C(CCO)O)O1)=O)=O,4,1,0,1,29,4.7e-05
G5,C(C1(C)CC(C(O1)=O)=O)(O)=O,2,1,0,1,29,4.7e-05
G5,C1(CC(C(O1)=O)=O)=O,1,1,0,1,17,4.7e-05
G5,C(C1CC(C(O1)=O)=O)(O)=O,2,1,0,1,33,4.7e-05
G5,C(C(C1CC(C(O1)=O)=O)O)(O)=O,4,1,0,1,29,4.7e-05
G5,C(CC(C1CC(C(O1)=O)=O)=O)=O,2,1,0,1,23,4.7e-05
G5,C(CC1(C=O)CC(C(O1)=O)=O)=O,2,1,0,1,29,4.7e-05
G5,C(C(CC1CC(C(O1)=O)=O)=O)=O,2,1,0,1,23,4.7e-05
G5,C(C)(C1(C)CC(C(O1)=O)=O)=O,2,1,0,1,14,4.7e-05
G5,C(CC1(C)CC(C(O1)=O)=O)=O,2,1,0,1,28,4.7e-05
G5,C(C)(CC1CC(C(O1)=O)=O)=O,2,1,0,1,28,4.7e-05
G5,C1(C(CC2(COC(C2)O)O1)=O)=O,4,1,0,1,28,4.7e-05
G5,C1(C(C)(C2C(COC2O1)=O)O)=O,8,1,0,1,28,4.7e-05
G5,C=CC(C1CC(C(O1)=O)=O)=O,2,1,0,1,7,4.7e-05
G5,C(C1(C=C)CC(C(O1)=O)=O)=O,2,1,0,1,29,4.7e-05
G5,C(C1(CO)CC(C(O1)=O)=O)=C,2,1,0,1,29,4.7e-05
G5,C(C1CC(C(O1)=O)=O)=CC=O,4,1,0,1,29,4.7e-05
G5,C1(C(CC(C(C)O)O1)=O)=O,4,1,0,1,11,4.7e-05
G5,C1(C(CC2(COCC2O)O1)=O)=O,4,1,0,1,10,4.7e-05
G5,C1(C(CC2(C(O)OCC2)O1)=O)=O,4,1,0,1,29,4.7e-05
G5,C1(C(C(CO)=O)C(C(O1)=O)O)=O,4,1,0,1,33,4.7e-05
G5,C1(C2C(COC(C2O)O1)=O)=O,8,1,0,1,17,4.7e-05
G5,C(C1CC(C(O1)=O)C(C=O)=O)=O,4,1,0,1,12,4.7e-05
G5,C1(C(C)OC(C1C(C=O)=O)=O)=O,4,1,0,1,24,4.7e-05
G5,C(C1C(OC(C(C=O)=O)C1)=O)=O,4,1,0,1,17,4.7e-05
G5,C1(C(C(CO1)=O)C(C(C)=O)=O)=O,2,1,0,1,24,4.7e-05
G5,C1(C(C(C(C=CC=O)O1)=O)O)=O,8,1,0,1,32,4.7e-05
G5,C1(C(C(C(C(C=C)=O)O1)=O)O)=O,4,1,0,1,17,4.7e-05
G5,C(CCO)(C1C(OCC1=O)=O)=O,2,1,0,1,30,4.7e-05
G5,C1(C(C(CO1)=O)CC(CO)=O)=O,2,1,0,1,29,4.7e-05
G5,C1(C(C=O)C(C(CCO)O1)=O)=O,4,1,0,1,17,4.7e-05
G5,C1(C(CO)OC(C1C(C)=O)=O)=O,4,1,0,1,26,4.7e-05
G5,C1(C(CO)OC(C1CC=O)=O)=O,4,1,0,1,17,4.7e-05
G5,C1(C(C(C(C=O)O1)=O)CCO)=O,4,1,0,1,17,4.7e-05
G5,C1(C(C(C(C=O)O)=O)CCO1)=O,4,1,0,1,17,4.7e-05
G5,C1(C(C(C(O1)=O)=O)CO)=O,2,1,0,1,17,4.7e-05
G5,C1(C(C=O)C(C(O1)=O)O)=O,4,1,0,1,17,4.7e-05
G5,C1(C2C(C(C=O)(C(C2)O)O1)=O)=O,8,2,0,2,17,9.499999999999999e-05
G5,C1(C2C(C(C=O)(C(C2)O1)O)=O)=O,8,2,0,2,17,9.499999999999999e-05
G5,C(C1(C(CC(O1)=O)=O)CO)=O,2,1,0,1,17,4.7e-05
G5,C(C1(C(CC(O1)=O)=O)C(C)O)=O,4,1,0,1,4,4.7e-05
G5,C1(CC(C(CO)(CO)O1)=O)=O,1,1,0,1,2,4.7e-05
G5,C1(CC(C(CO)(C(C)O)O1)=O)=O,4,1,0,1,4,4.7e-05
G5,C1(C(C(C(CO)(CO)O1)=O)O)=O,2,1,0,1,2,4.7e-05
G5,C1(CC2C(C=O)(C1C(O2)=O)O)=O,8,2,0,2,17,9.499999999999999e-05
G5,C(C12C(C(C(O1)=O)C(C2)=O)O)=O,8,2,0,2,17,9.499999999999999e-05
G5,C1(C(C=O)C(C=O)(CO1)O)=O,4,1,0,1,5,4.7e-05
G5,C1(C(C=O)C(C=O)(C(C)O1)O)=O,8,1,0,1,4,4.7e-05
G5,C1(C2C(C(C(C2CO)=O)O1)=O)=O,8,2,0,2,17,9.499999999999999e-05
G5,C1(C2C(OCC2C(C1O)=O)=O)=O,8,1,0,1,17,4.7e-05
G5,C1(C2C(OC1(C(C2)=O)CO)=O)=O,4,2,0,2,17,9.499999999999999e-05
G5,C1(C2C(OCC2(C(C1)=O)O)=O)=O,4,1,0,1,17,4.7e-05
G5,C1(C2(CO)CC(C1C(O2)=O)=O)=O,4,2,0,2,17,9.499999999999999e-05
G5,C(C1C(OC2C1OC(C2)=O)=O)=O,8,1,0,1,48,4.7e-05
G5,C1(C2C(C(C(C(C)=O)O2)O1)=O)=O,8,1,0,1,17,4.7e-05
G5,C(CC1C2C(C(C(O2)=O)O1)=O)=O,8,1,0,1,9,4.7e-05
G5,C1(C(C=O)C2C(C(CO2)=O)O1)=O,8,1,0,1,9,4.7e-05
G5,C1(C2C(C(OC2C(C)=O)O1)=O)=O,8,1,0,1,22,4.7e-05
G5,C(CC1C2C(OC(C2=O)O1)=O)=O,8,1,0,1,23,4.7e-05
G5,C1(CC(OC2COC(C12)=O)=O)=O,4,1,0,1,19,4.7e-05
G5,C(C(CO)O)(C1C(OC(C1)=O)=O)=O,4,2,0,2,17,9.499999999999999e-05
G5,C1(C2C(C(COC2CO1)=O)=O)=O,4,1,0,1,54,4.7e-05
G5,C1(C2COC(CC1C(O2)=O)=O)=O,4,1,0,1,17,4.7e-05
G5,C1(CC2C(C(C(O2)=O)CO1)=O)=O,4,1,0,1,19,4.7e-05
G5,C1(C2COCC(C1C(O2)=O)=O)=O,4,1,0,1,36,4.7e-05
G5,C1(C2C(C(C(CCO2)=O)O1)=O)=O,4,1,0,1,36,4.7e-05
G5,C1(C2C(C(C(COC2)=O)O1)=O)=O,4,1,0,1,36,4.7e-05
G5,C1(C2C(C(CC(CO2)=O)O1)=O)=O,4,1,0,1,17,4.7e-05
G5,C1(CCOC2C(C1C(O2)=O)=O)=O,4,1,0,1,30,4.7e-05
G5,C1(C2C(C(OCC(C2)=O)O1)=O)=O,4,1,0,1,12,4.7e-05
G5,C1(C2C(C(CO2)O1)=O)=O,4,1,0,1,17,4.7e-05
G5,C1(C2C(C(OC2)O1)=O)=O,4,1,0,1,17,4.7e-05
G5,C(CC12C(C(C(O1)=O)CO2)=O)=O,4,1,0,1,17,4.7e-05
G5,C1(C2(C)OC(C=O)C1C(O2)=O)=O,8,1,0,1,14,4.7e-05
G5,C(C12CC(C(O1)=O)C(CO2)=O)=O,4,1,0,1,17,4.7e-05
G5,C1(C2C(C(C=O)OC(C2)O1)=O)=O,8,1,0,1,17,4.7e-05
G5,C1(C(C(CO)=O)C(C(C)O1)O)=O,8,1,0,1,0,4.7e-05
G5,C1(COC2C1C(C(O2)=O)O)=O,8,1,0,1,33,4.7e-05
G5,C1(C(C(C(C(O)=O)=O)CO1)O)=O,4,1,0,1,33,4.7e-05
G5,C(C1C(C(C(O1)=O)=O)CO)(O)=O,4,1,0,1,33,4.7e-05
G5,C1(C(C(C=O)C(C(O)=O)O1)O)=O,8,1,0,1,33,4.7e-05
G5,C1(C(C(CO)C(C(C)O)O1)=O)=O,8,1,0,1,11,4.7e-05
G5,C(C1C(C(C)O)OC(C1O)=O)=O,16,1,0,1,33,4.7e-05
G5,C1(C(CC(CO)(CO)O1)=O)=O,1,1,0,1,29,4.7e-05
G5,C(C1(C)CC(C(O1)=O)=O)=O,2,1,0,1,7,4.7e-05
G5,C(C1(C)C(C(C(O1)=O)=O)CO)=O,4,1,0,1,7,4.7e-05
G5,C1(C(CC(CC(C=O)=O)O1)O)=O,4,1,0,1,29,4.7e-05
G5,C(CO)(CC1CC(C(O1)=O)=O)=O,2,1,0,1,49,4.7e-05
G5,C(CC1(CO)CC(C(O1)=O)=O)=O,2,1,0,1,29,4.7e-05
G5,C(C1C(OCC1=O)=O)=O,2,1,0,1,17,4.7e-05
G5,C(C)(C(C1CC(C(O1)=O)=O)O)=O,4,1,0,1,49,4.7e-05
G5,C(C(C1(C)CC(C(O1)=O)=O)O)=O,4,1,0,1,0,4.7e-05
G5,C(C1C(C(C(O1)=O)=O)CO)=O,4,1,0,1,29,4.7e-05
G5,C1(C(C(C=O)C(C=O)O1)O)=O,8,1,0,1,33,4.7e-05
G5,C1(C(CC(C)(C(CO)O)O1)=O)=O,4,1,0,1,28,4.7e-05
G5,C(CCO)(C1C(C(OC1)=O)=O)=O,2,1,0,1,2,4.7e-05
G5,C(CC1C(C(OC1)=O)=O)(CO)=O,2,1,0,1,29,4.7e-05
G5,C(C1COC(C1)=O)(C(C=O)O)=O,4,1,0,1,29,4.7e-05
G5,C1(C(C(C(C(C)=O)=O)CO1)O)=O,4,1,0,1,14,4.7e-05
G5,C(C1COC(C1O)=O)(CC=O)=O,4,1,0,1,2,4.7e-05
G5,C(C1COC(C1O)=O)(C(CO)O)=O,8,2,0,2,2,9.499999999999999e-05
G5,C1(C(C)(C(C(C=O)=O)CO1)O)=O,4,1,0,1,29,4.7e-05
G5,C(C1(CCO)CC(C(O1)=O)=O)=O,2,1,0,1,29,4.7e-05
G5,C1(C(C(C(C=O)=O)CO1)O)=O,4,1,0,1,33,4.7e-05
G5,C1(C(C)(C(C(CO)=O)CO1)O)=O,4,1,0,1,3,4.7e-05
G5,C1(C(CC(CO)(CCO)O1)=O)=O,2,1,0,1,29,4.7e-05
G5,C1(C(CC(C)(CO)O1)=O)=O,2,1,0,1,29,4.7e-05
G5,C1(CC(CO)(C(C(C)=O)O1)O)=O,4,1,0,1,29,4.7e-05
G5,C1(C(C(C)(C(C(C)=O)O1)O)O)=O,8,1,0,1,49,4.7e-05
G5,C1(C(C(CO)C(C)(CO)O1)=O)=O,4,1,0,1,29,4.7e-05
G5,C1(C(C)(C(C=O)C(C=O)O1)O)=O,8,1,0,1,28,4.7e-05
G5,C(CC(C1CC(C(O1)=O)=O)O)=O,4,1,0,1,29,4.7e-05
G5,C(C(CC1CC(C(O1)=O)=O)O)=O,4,1,0,1,29,4.7e-05
G5,C1(C(OC(C)C1)=O)=O,2,1,0,1,4,4.7e-05
G5,C(CC1(C)C(C(C(O1)=O)O)O)=O,8,1,0,1,29,4.7e-05
G5,C(CC1C(C)(C(C(O1)=O)O)O)=O,8,1,0,1,25,4.7e-05
G5,C1(CCC(C(CO)O)(CC=O)O1)=O,4,2,0,2,4,9.499999999999999e-05
G5,C(C1C(C)OC(C1)=O)(C(CO)O)=O,8,2,0,2,46,9.499999999999999e-05
G5,C1(CC(C(CCO)(CC=O)O1)O)=O,4,1,0,1,19,4.7e-05
G5,C1(C(C(C(CO)O1)=O)O)=O,4,1,0,1,2,4.7e-05
G5,C1(C(C(CO1)=O)CC(C=O)=O)=O,2,1,0,1,12,4.7e-05
G5,C1(CC(C(CC(C=O)=O)O1)=O)=O,2,1,0,1,17,4.7e-05
G5,C(CC(C1C(OCC1=O)=O)=O)=O,2,1,0,1,17,4.7e-05
G5,C(C1C(C(C(C)=O)OC1=O)=O)=O,4,1,0,1,17,4.7e-05
G5,C(CC(C1C(CC(O1)=O)=O)=O)=O,2,1,0,1,17,4.7e-05
G5,C(C1C(OC(C1=O)CC=O)=O)=O,4,1,0,1,17,4.7e-05
G5,C(C1C(C(C(O1)=O)C(C)=O)=O)=O,4,1,0,1,17,4.7e-05
G5,C1(C(C=O)OC(C1CC=O)=O)=O,4,1,0,1,17,4.7e-05
G5,C1(C2(CC(C(C2)O)O1)O)=O,8,2,0,2,29,9.499999999999999e-05
G5,C1(C(C(CO)CO1)(CC=O)O)=O,4,1,0,1,29,4.7e-05
G5,C1(C(C)(C(CO1)C(C=O)O)O)=O,8,1,0,1,29,4.7e-05
G5,C1(C(C)(C(CO)C(C=O)O1)O)=O,8,1,0,1,29,4.7e-05
G5,C1(C(CC(C=O)O1)(CCO)O)=O,4,1,0,1,29,4.7e-05
G5,C1(C(CC(C=O)O)(CCO1)O)=O,4,1,0,1,29,4.7e-05
G5,C1(C(C=O)(CC(CO)O1)O)=O,4,1,0,1,29,4.7e-05
G5,C1(C(C(CO1)O)(CCO)O)=O,4,1,0,1,29,4.7e-05
G5,C1(C(CCO)(CC(O1)=O)O)=O,2,1,0,1,29,4.7e-05
G5,C(C1(C)CC(C(O1)=O)O)(O)=O,4,1,0,1,29,4.7e-05
G5,C1(C2(COCC(C2)O1)O)=O,4,1,0,1,29,4.7e-05
G5,C1(C2(CCOC(C2)O1)O)=O,4,1,0,1,7,4.7e-05
G5,C1(C(C(C(O1)=O)O)O)=O,3,1,0,1,33,4.7e-05
G5,C1(CC(CO1)(OCC=O)O)=O,2,1,0,1,29,4.7e-05
G5,C1(C(CC(OCC=O)O1)O)=O,4,1,0,1,29,4.7e-05
G5,C1(C(C=O)(C(CO)(CO1)O)O)=O,4,1,0,1,5,4.7e-05
G5,C(C1(COC(C1O)=O)O)=O,4,1,0,1,33,4.7e-05
G5,C1(C(C=O)(C(C(CO)O1)O)O)=O,8,1,0,1,17,4.7e-05
G5,C1(C(C)(C(C(C)=O)(CO1)O)O)=O,4,1,0,1,28,4.7e-05
G5,C1(C(C(C)=O)(C(C)(CO1)O)O)=O,4,1,0,1,49,4.7e-05
G5,C1(C(C(C=O)(C(C=O)O1)O)O)=O,8,1,0,1,33,4.7e-05
G5,C(CO)(C1(COC(C1O)=O)O)=O,4,1,0,1,33,4.7e-05
G5,C1(C(C(C(C=C)=O)(CO1)O)O)=O,4,1,0,1,33,4.7e-05
G5,C(C)(C1(C(C)OC(C1O)=O)O)=O,8,1,0,1,33,4.7e-05
G5,C(C1(C=O)C(C(C(O1)=O)O)O)=O,4,1,0,1,1,4.7e-05
G5,C1(C(C=O)(C(C(C=O)O1)O)O)=O,8,1,0,1,1,4.7e-05
G5,C(C1(C(C)OC(C1O)=O)O)=O,8,1,0,1,33,4.7e-05
G5,C(C1(C(CO)OC(C1O)=O)O)=O,8,1,0,1,33,4.7e-05
G5,C1(C(C)(C(C(O1)=O)O)O)=O,4,1,0,1,28,4.7e-05
G5,C1(CC(CO)(C(C(O)=O)O1)O)=O,4,1,0,1,29,4.7e-05
G5,C(C1(COC(C1)=O)O)(CC=O)=O,2,1,0,1,29,4.7e-05
G5,C1(C(CCO)(C(C(O1)=O)O)O)=O,4,1,0,1,29,4.7e-05
G5,C1(C(C(C)(CO1)O)(CC=O)O)=O,4,1,0,1,29,4.7e-05
G5,C1(C(C(CO1)O)OC(CO)=O)=O,4,1,0,1,29,4.7e-05
G5,C1(C(C(CO1)OC(CO)=O)O)=O,4,1,0,1,29,4.7e-05
G5,C1(C2CC(C(C=O)O2)O1)=O,8,1,0,1,29,4.7e-05
G5,C1(CC2C(C(C(O2)=O)O)O1)=O,8,2,0,2,29,9.499999999999999e-05
G5,C1(CC2C(C(C(O2)=O)O1)O)=O,8,2,0,2,29,9.499999999999999e-05
G5,C1(C2(C(CC(C2O)O1)=O)O)=O,8,2,0,2,17,9.499999999999999e-05
G5,C1(C2(C=O)C(C(CC2O)O1)=O)=O,8,2,0,2,17,9.499999999999999e-05
G5,C1(C2(C=O)C(C(C(C2)=O)O1)O)=O,8,2,0,2,17,9.499999999999999e-05
G5,C1(C2(C=O)C(CC(C2O)O1)=O)=O,8,2,0,2,17,9.499999999999999e-05
G5,C1(C2(C(C=CC(C2O)O1)=O)O)=O,8,1,0,1,32,4.7e-05
G5,C1(C(C(CO1)=O)(C(C=O)O)O)=O,4,1,0,1,17,4.7e-05
G5,C1(C(C(CO1)=O)(C(C)O)O)=O,4,1,0,1,17,4.7e-05
G5,C1(C(C=O)(C(CO1)=O)CO)=O,2,1,0,1,2,4.7e-05
G5,C1(C(C=O)(C(CO1)=O)C(C)O)=O,4,1,0,1,4,4.7e-05
G5,C1(C(C(CO1)=O)(CO)CO)=O,1,1,0,1,2,4.7e-05
G5,C1(C(C(C(CO)O1)=O)(CO)O)=O,4,1,0,1,2,4.7e-05
G5,C1(C(C(CO1)=O)(CO)C(C)O)=O,4,1,0,1,4,4.7e-05
G5,C1(C(C)(C(C=O)(C(C)O1)O)O)=O,8,1,0,1,28,4.7e-05
G5,C1(C(C(C(C=O)=O)(CO1)O)O)=O,4,1,0,1,33,4.7e-05
G5,C1(C(C=O)(C(C=O)(CO1)O)O)=O,4,1,0,1,17,4.7e-05
G5,C1(C(C(CO)O)C(C=O)(CO1)O)=O,8,1,0,1,8,4.7e-05
G5,C1(C(CO)(C(C=O)(CO1)O)O)=O,4,1,0,1,33,4.7e-05
G5,C1(C(C(C)=O)(C(CO1)=O)O)=O,2,1,0,1,17,4.7e-05
G5,C1(C(C=O)(C(CO1)=O)O)=O,2,1,0,1,17,4.7e-05
G5,C1(C(C=O)(C(C(O1)=O)(C)O)O)=O,4,1,0,1,17,4.7e-05
G5,C1(C2C(CO1)OC(C2(C)O)=O)=O,8,1,0,1,8,4.7e-05
G5,C1(C(C(CO)O)C(C(O1)=O)(C)O)=O,8,1,0,1,8,4.7e-05
G5,C1(C(CO)(C(C(O1)=O)(C)O)O)=O,4,1,0,1,28,4.7e-05
G5,C1(C(C)(C(C(O)=O)(CO1)O)O)=O,4,1,0,1,28,4.7e-05
G5,C1(C(C(C)=O)(C(C(O1)=O)O)O)=O,4,1,0,1,33,4.7e-05
G5,C1(C(C=O)(C(C(O1)=O)O)O)=O,4,1,0,1,33,4.7e-05
G5,C1(C(C=O)(C(C(C)O1)=O)O)=O,4,1,0,1,17,4.7e-05
G5,C1(C(C(CO1)=O)(C(C=C)=O)O)=O,2,1,0,1,32,4.7e-05
G5,C1(C(C=O)(C(C(C=C)O1)=O)O)=O,4,1,0,1,17,4.7e-05
G5,C1(C(C(C=C)=O)(C(CO1)O)O)=O,4,1,0,1,17,4.7e-05
G5,C1(CC2C(C1(C(O2)=O)CO)=O)=O,4,2,0,2,17,9.499999999999999e-05
G5,C1(C2(C(C(C(C2)=O)O1)=O)CO)=O,4,2,0,2,17,9.499999999999999e-05
G5,C1(C2(C(C(C(C2O)O1)=C)=O)O)=O,8,2,0,2,17,9.499999999999999e-05
G5,C1(C(C=O)(C(C(C=C)O1)O)O)=O,8,1,0,1,28,4.7e-05
G5,C1(C2(C(C=CO2)=O)C(CO1)O)=O,4,1,0,1,17,4.7e-05
G5,C1(C2(C(C=COC2CO1)=O)O)=O,4,1,0,1,9,4.7e-05
G5,C1(C2(C=O)C(C(C(O2)=C)O1)O)=O,8,1,0,1,26,4.7e-05
G5,C1(C(C=O)(C2C(C=CO2)O1)O)=O,8,1,0,1,36,4.7e-05
G5,C1(C2(C=O)C(C(C=CO2)O1)O)=O,8,1,0,1,37,4.7e-05
G5,C1(C(C(C)=O)(C(C(C)O1)O)O)=O,8,1,0,1,11,4.7e-05
G5,C1(C(C(C(O)=O)C(C=O)O1)O)=O,8,1,0,1,33,4.7e-05
G5,C1(C(C(C(O1)=O)C(C=O)O)O)=O,8,1,0,1,33,4.7e-05
G5,C1(C2(C(CO1)OC(C2O)=O)O)=O,8,1,0,1,33,4.7e-05
G5,C1(C(C(CO)O)(C(C(O1)=O)O)O)=O,8,1,0,1,33,4.7e-05
G5,C1(C2C(CO1)OC(C2O)=O)=O,8,1,0,1,29,4.7e-05
G5,C1(C(C(CO)O)C(C(O1)=O)O)=O,8,1,0,1,29,4.7e-05
G5,C1(C(CO)(C(C(O1)=O)O)O)=O,4,1,0,1,33,4.7e-05
G5,C(C1(COC(C1O)=O)O)(O)=O,4,1,0,1,33,4.7e-05
G5,C(C1(C(C)OC(C1O)=O)O)(O)=O,8,1,0,1,4,4.7e-05
G5,C1(C(C(C)O)(C(C(O1)=O)O)O)=O,8,1,0,1,4,4.7e-05
G5,C1(C(C=O)(C(C=C)(CO1)O)O)=O,4,1,0,1,17,4.7e-05
G5,C1(C(C=O)(C(C(C)O1)O)O)=O,8,1,0,1,11,4.7e-05
G5,C1(C(C(C(C)O1)O)C(C=O)O)=O,16,1,0,1,11,4.7e-05
G5,C1(C(C(CO)O)C(C=C)(CO1)O)=O,8,1,0,1,8,4.7e-05
G5,C1(C(CO)(C(C=C)(CO1)O)O)=O,4,1,0,1,7,4.7e-05
G5,C1(C(C(CO)O)(C(C(C)O1)O)O)=O,16,1,0,1,40,4.7e-05
G5,C1(C(C(CO)O)C(C(C)O1)O)=O,16,1,0,1,8,4.7e-05
G5,C1(C(CO)(C(C(C)O1)O)O)=O,8,1,0,1,11,4.7e-05
G5,C1(C(C(C)O)(C(C(C)O1)O)O)=O,16,1,0,1,4,4.7e-05
G5,C1(C(C(CO)O)C(CO1)(CO)O)=O,8,1,0,1,8,4.7e-05
G5,C1(C(C(CO)O)C(C(CO)O1)O)=O,16,1,0,1,8,4.7e-05
G5,C(C1(COC(C1O)=O)O)(CCO)=O,4,1,0,1,2,4.7e-05
G5,C1(C(C(C(C=O)O1)O)C(CO)O)=O,16,1,0,1,8,4.7e-05
G5,C1(C(C(CO1)=O)(CO)O)=O,2,1,0,1,2,4.7e-05
G5,C1(C2(C(OCC2C(C1)=O)=O)O)=O,4,1,0,1,17,4.7e-05
G5,C(C12CC(C(O1)=O)(C(C2)=O)O)=O,4,2,0,2,17,9.499999999999999e-05
G5,C1(CC2C(C=O)C1(C(O2)=O)O)=O,8,2,0,2,17,9.499999999999999e-05
G5,C(C1C(C2(C(OC1C2)=O)O)=O)=O,8,2,0,2,17,9.499999999999999e-05
G5,C1(C(C=O)(C(C=O)CO1)O)=O,4,1,0,1,17,4.7e-05
G5,C(C1(C(CCO)OC(C1)=O)O)=O,4,1,0,1,29,4.7e-05
G5,C1(C(C=O)(C(C=O)C(C)O1)O)=O,8,1,0,1,17,4.7e-05
G5,C1(C(C=O)(CC(CC=O)O1)O)=O,4,1,0,1,17,4.7e-05
G5,C1(C(C)(C(C(C(C)O)O1)O)O)=O,16,1,0,1,25,4.7e-05
G5,C1(C(C)(C(CO1)(C(C)O)O)O)=O,8,1,0,1,28,4.7e-05
G5,C1(C(C)(C(CO)(C(C)O1)O)O)=O,8,1,0,1,28,4.7e-05
G5,C1(C(C)(C(C(CCO)O1)O)O)=O,8,1,0,1,25,4.7e-05
G5,C1(C(C)(C(C(O1)=O)(C)O)O)=O,3,1,0,1,25,4.7e-05
G5,C1(C(C)(C(C(C(O)=O)O1)O)O)=O,8,1,0,1,29,4.7e-05
G5,C(C1(C)C(C(C(O1)=O)O)O)(O)=O,8,1,0,1,29,4.7e-05
G5,C1(C(C)(C(C=C)(CO1)O)O)=O,4,1,0,1,29,4.7e-05
G5,C1(C(C)(C(C(C)O1)O)O)=O,8,1,0,1,29,4.7e-05
G5,C1(C(C)(C2(COCC2O1)O)O)=O,8,1,0,1,25,4.7e-05
G5,C1(C(C)(C2(C(OCC2)O1)O)O)=O,8,1,0,1,25,4.7e-05
G5,C1(C(CCO)(C(C(C)O1)O)O)=O,8,1,0,1,11,4.7e-05
G5,C1(C(C(CO1)=O)(CC=O)O)=O,2,1,0,1,17,4.7e-05
G5,C1(C(C(CO1)=O)(C)O)=O,2,1,0,1,17,4.7e-05
G5,C(CC1C(C=O)(CC(O1)=O)O)=O,4,1,0,1,29,4.7e-05
G5,C1(C(C=O)(CCO1)O)=O,2,1,0,1,17,4.7e-05
G5,C1(C(C=O)(CC(O1)=O)O)=O,2,1,0,1,29,4.7e-05
G5,C1(C(C=O)(CC(C=O)O1)O)=O,4,1,0,1,17,4.7e-05
G5,C1(C(C(C(C=O)O1)=O)(C)O)=O,4,1,0,1,17,4.7e-05
G5,C1(C(C(CO1)=O)(C=CC=O)O)=O,4,1,0,1,32,4.7e-05
G5,C1(C(C(C(C=O)O1)=O)(C=C)O)=O,4,1,0,1,17,4.7e-05
G5,C1(C(C(CC=O)=O)(CCO1)O)=O,2,1,0,1,17,4.7e-05
G5,C(CCO)(C1(C(OC(C1)=O)=O)O)=O,2,1,0,1,19,4.7e-05
G5,C1(C2COC1(C(O2)=O)CC=O)=O,4,1,0,1,17,4.7e-05
G5,C1(C2(C(C=O)=O)CC(CO2)O1)=O,4,1,0,1,17,4.7e-05
G5,C1(C2(C=O)CC(C(C=O)O2)O1)=O,8,1,0,1,40,4.7e-05
G5,C(C1C2C(C(C(O2)=O)(C)O1)=O)=O,8,1,0,1,29,4.7e-05
G5,C(C1(C)C(CO)(CC(O1)=O)O)=O,4,1,0,1,29,4.7e-05
G5,C(C1(C)C(C)(C(C(O1)=O)O)O)=O,8,1,0,1,11,4.7e-05
G5,C1(CC(C=O)(C(C(O)=O)O1)O)=O,4,1,0,1,33,4.7e-05
G5,C1(C(C(C(O1)=O)(CC=O)O)O)=O,4,1,0,1,33,4.7e-05
G5,C(C1(C)C(C(C(O1)=O)O)O)=O,8,1,0,1,29,4.7e-05
G5,C(C(C)(C1C(CC(O1)=O)O)O)=O,8,1,0,1,29,4.7e-05
G5,C(C1(C(C(C)O)OC(C1)=O)O)=O,8,1,0,1,29,4.7e-05
G5,C1(C(C(C(C)O1)O)(CC=O)O)=O,8,1,0,1,11,4.7e-05
G5,C(C(C)(C1CC(C(O1)=O)O)O)=O,8,1,0,1,11,4.7e-05
G5,C1(C(C)(C(CO1)O)O)=O,4,1,0,1,0,4.7e-05
G5,C1(C(C)(C(CO)(CO1)O)O)=O,4,1,0,1,29,4.7e-05
G5,C1(C(C)(C(CO1)(CC=O)O)O)=O,4,1,0,1,29,4.7e-05
G5,C1(C(C)(C(C(C(C)=O)O1)O)O)=O,8,1,0,1,25,4.7e-05
G5,C1(C(C)(C(C)(C(C=O)O1)O)O)=O,8,1,0,1,25,4.7e-05
G5,C1(C(C)(C(C)(C(CO)O1)O)O)=O,8,1,0,1,25,4.7e-05
G5,C1(C(C)(C(CO1)(CCO)O)O)=O,4,1,0,1,29,4.7e-05
G5,C1(C(C)(C(C(C=O)O1)O)O)=O,8,1,0,1,25,4.7e-05
G5,C1(C(C)(C(C)(CO1)O)O)=O,4,1,0,1,29,4.7e-05
G5,C1(C(CCO)(C(C)(CO1)O)O)=O,4,1,0,1,29,4.7e-05
G5,C1(C(C)(C(C(CC=O)O1)O)O)=O,8,1,0,1,25,4.7e-05
G5,C(C1(C(C)OC(C1)=O)O)(CCO)=O,4,1,0,1,19,4.7e-05
G5,C1(C(C(CO1)(CC(C)O)O)O)=O,8,1,0,1,33,4.7e-05
G5,C1(C(C(C)(C(C(C)O)O1)O)O)=O,16,1,0,1,33,4.7e-05
G5,C1(C(C(C(C(C)O)O1)O)O)=O,16,1,0,1,29,4.7e-05
G5,C1(C(C(CO1)(C(C)O)O)O)=O,8,1,0,1,29,4.7e-05
G5,C1(C(C(CO)(C(C)O1)O)O)=O,8,1,0,1,29,4.7e-05
G5,C1(C(C(CO1)(C(C=O)O)O)O)=O,8,1,0,1,33,4.7e-05
G5,C1(C(C(CO)(C(C=O)O1)O)O)=O,8,1,0,1,33,4.7e-05
G5,C1(C(C(C=CC=O)(CO1)O)O)=O,8,1,0,1,11,4.7e-05
G5,C1(C(C(C(C)O1)O)O)=O,8,1,0,1,11,4.7e-05
G5,C1(C(C(C(CO)(CO)O1)O)O)=O,4,1,0,1,29,4.7e-05
G5,C1(C(C2(COCC2O1)O)O)=O,8,1,0,1,33,4.7e-05
G5,C1(C(C2(C(OCC2)O1)O)O)=O,8,1,0,1,29,4.7e-05
G5,C1(C2(C(CO)OC(C2O)O1)O)=O,16,1,0,1,0,4.7e-05
G5,C1(C2(C(COC(C2O)O1)O)O)=O,16,1,0,1,15,4.7e-05
G5,C1(CC(CO1)C(C(C=O)O)O)=O,8,2,0,2,55,9.499999999999999e-05
G5,C1(CC(CO)C(C(C=O)O)O1)=O,8,2,0,2,55,9.499999999999999e-05
G5,C1(CC(CO1)C(C(CO)O)O)=O,8,5,0,5,55,0.00023799999999999998
G5,C1(CC(C(C)O1)C(C(CO)O)O)=O,16,3,0,3,46,0.00014199999999999998
G5,C1(C2COC(C1C(C2O)=O)=O)=O,8,2,0,2,30,9.499999999999999e-05
G5,C1(C2C(C(C(C(C2)=O)O1)O)=O)=O,8,1,0,1,12,4.7e-05
G5,C1(C2C(C(C(CO1)C2O)=O)=O)=O,8,2,0,2,17,9.499999999999999e-05
G5,C1(CC2C(C(C1C(O2)=O)=O)O)=O,8,1,0,1,17,4.7e-05
G5,C1(C(C(C(C(C=O)O1)O)=O)O)=O,8,1,0,1,17,4.7e-05
G5,C1(C(C(CC(C(C)=O)O1)=O)O)=O,4,1,0,1,45,4.7e-05
G5,C(C1(C)CC(C(C(O1)=O)O)=O)=O,4,1,0,1,16,4.7e-05
G5,C1(CC(C(C(C(C)=O)O1)O)=O)=O,4,1,0,1,17,4.7e-05
G5,C(C1(C)C(C(CC(O1)=O)=O)O)=O,4,1,0,1,45,4.7e-05
G5,C1(C(CC(C(CC=O)O1)=O)O)=O,4,1,0,1,33,4.7e-05
G5,C(C1C(C(C(OC1)=O)O)=O)=O,4,1,0,1,17,4.7e-05
G5,C1(C(C=O)C(C(CO1)O)=O)=O,4,1,0,1,17,4.7e-05
G5,C(C1C(C(C(OC1C)=O)O)=O)=O,8,1,0,1,17,4.7e-05
G5,C1(C(C=O)C(C(C(C)O1)O)=O)=O,8,1,0,1,17,4.7e-05
G5,C1(C(C(CC(CC=O)O1)=O)O)=O,4,1,0,1,17,4.7e-05
G5,C(CC1C(C(CC(O1)=O)=O)O)=O,4,1,0,1,17,4.7e-05
G5,C1(C(C(C(CO1)O)=O)CO)=O,4,1,0,1,2,4.7e-05
G5,C1(C(C(C(CO1)O)=O)C(C)O)=O,8,1,0,1,4,4.7e-05
G5,C1(C(C(C(CO)CO1)=O)O)=O,4,1,0,1,17,4.7e-05
G5,C(C1COC(CC1(CO)O)=O)=O,4,1,0,1,29,4.7e-05
G5,C1(C(C(CO)=O)C(CCO1)O)=O,4,1,0,1,0,4.7e-05
G5,C1(CC(C(C(CCO)O1)O)=O)=O,4,1,0,1,17,4.7e-05
G5,C(C1COC(C(C1(C)O)O)=O)=O,8,1,0,1,33,4.7e-05
G5,C1(C(C(CC(CCO)O1)=O)O)=O,4,1,0,1,18,4.7e-05
G5,C(C1COC(C(C1O)O)=O)=O,8,1,0,1,18,4.7e-05
G5,C1(C(C(C(C(C)O1)O)=O)CO)=O,8,1,0,1,2,4.7e-05
G5,C1(C(C(C(CO1)C(C)O)=O)O)=O,8,1,0,1,17,4.7e-05
G5,C1(C(C(C(CO)C(C)O1)=O)O)=O,8,1,0,1,17,4.7e-05
G5,C1(C(C(CC(CO)(C)O1)=O)O)=O,4,1,0,1,49,4.7e-05
G5,C1(CC(C(C(CO)(C)O1)O)=O)=O,4,1,0,1,49,4.7e-05
G5,C(C1C(C)(COC(C1O)=O)O)=O,8,1,0,1,49,4.7e-05
G5,C(C1C(C(C(OC1C)=O)O)O)=O,16,1,0,1,17,4.7e-05
G5,C1(C(CC(C(C(C)O)O1)O)=O)=O,8,1,0,1,28,4.7e-05
G5,C(C1C(COC(C1(C)O)=O)O)=O,8,1,0,1,28,4.7e-05
G5,C(C1(COC(C(C1)=O)=O)O)=O,2,1,0,1,17,4.7e-05
G5,C1(C(C=O)C(C(CO1)=O)O)=O,4,1,0,1,28,4.7e-05
G5,C(C)(C1(COC(C(C1)=O)=O)O)=O,2,1,0,1,29,4.7e-05
G5,C1(CC(C(CO1)=O)=O)=O,1,1,0,1,17,4.7e-05
G5,C(C1(C(C)OC(C(C1)=O)=O)O)=O,4,1,0,1,17,4.7e-05
G5,C1(C(C)(C(C(C(C)O1)=O)O)O)=O,8,1,0,1,25,4.7e-05
G5,C1(C(CC(CO1)(C(C)O)O)=O)=O,4,1,0,1,29,4.7e-05
G5,C1(C(CC(CO)(C(C)O1)O)=O)=O,4,1,0,1,29,4.7e-05
G5,C(C1C(C(C(C(O1)=O)O)O)=O)=O,8,1,0,1,5,4.7e-05
G5,C1(C(CC(C(CCO)O1)O)=O)=O,4,1,0,1,29,4.7e-05
G5,C1(C(C)(CC(C(O1)=O)=O)O)=O,2,1,0,1,29,4.7e-05
G5,C1(C(CC(C(O1)=O)=O)O)=O,2,1,0,1,33,4.7e-05
G5,C(C1C(CC(C(O1)=O)=O)O)(O)=O,4,1,0,1,29,4.7e-05
G5,C(C1(COC(C(C1)=O)=O)O)=C,2,1,0,1,29,4.7e-05
G5,C1(C(CC(C(C)O1)O)=O)=O,4,1,0,1,11,4.7e-05
G5,C1(C(CC2(COCC2O1)O)=O)=O,4,1,0,1,10,4.7e-05
G5,C1(C(C)(C2C(C(CO2)O1)=O)O)=O,8,1,0,1,10,4.7e-05
G5,C1(C(CC2(C(OCC2)O1)O)=O)=O,4,1,0,1,29,4.7e-05
G5,C1(C(C)(C2C(C(OC2)O1)=O)O)=O,8,1,0,1,34,4.7e-05
G5,C1(CC(C(C(O1)=O)O)=O)=O,2,1,0,1,17,4.7e-05
G5,C1(C(C(CC(C(O)=O)O1)=O)O)=O,4,1,0,1,33,4.7e-05
G5,C1(CC(C(C(C(O)=O)O1)O)=O)=O,4,1,0,1,33,4.7e-05
G5,C1(C2C(CC(O2)O1)=O)=O,4,1,0,1,17,4.7e-05
G5,C1(C2C(CC(C(O2)O)O1)=O)=O,8,1,0,1,27,4.7e-05
G5,C1(CC(C(C(CC=O)O1)=O)=O)=O,2,1,0,1,17,4.7e-05
G5,C(C1C(OC(C(C1=O)=O)C)=O)=O,4,1,0,1,17,4.7e-05
G5,C1(C(C(C)=O)C(C(CO1)=O)=O)=O,2,1,0,1,26,4.7e-05
G5,C1(CC(CC(C(C=O)=O)O1)=O)=O,2,1,0,1,17,4.7e-05
G5,C1(C(C(C(CO1)=O)=O)CC=O)=O,2,1,0,1,17,4.7e-05
G5,C1(CCOC(C1C(CO)=O)=O)=O,2,1,0,1,30,4.7e-05
G5,C1(C(C(CO)=O)CC(CO1)=O)=O,2,1,0,1,29,4.7e-05
G5,C1(C(C(C=O)=O)C(CCO1)O)=O,4,1,0,1,17,4.7e-05
G5,C1(C(COC(C1C(C)=O)=O)O)=O,4,1,0,1,26,4.7e-05
G5,C1(C(COC(C1CC=O)=O)O)=O,4,1,0,1,17,4.7e-05
G5,C1(CCOC(C1C(C=O)O)=O)=O,4,1,0,1,17,4.7e-05
G5,C(C1(C(CC(OC1)=O)=O)O)=O,2,1,0,1,17,4.7e-05
G5,C(C1(C(CC(OC1C)=O)=O)O)=O,4,1,0,1,4,4.7e-05
G5,C1(CC(C(CO)(CO1)O)=O)=O,2,1,0,1,2,4.7e-05
G5,C1(CC(C(CO1)(C(C)O)O)=O)=O,4,1,0,1,4,4.7e-05
G5,C1(CC(C(CO)(C(C)O1)O)=O)=O,4,1,0,1,4,4.7e-05
G5,C1(C(C(C(CO)(CO1)O)=O)O)=O,4,1,0,1,2,4.7e-05
G5,C1(C2C(OCC1C(C2O)=O)=O)=O,8,2,0,2,2,9.499999999999999e-05
G5,C1(C2C(OCC1(C(C2)=O)O)=O)=O,4,2,0,2,17,9.499999999999999e-05
G5,C1(C2(COC(C1C(C2)=O)=O)O)=O,4,2,0,2,17,9.499999999999999e-05
G5,C1(CC(C2C(CC(O2)=O)O1)=O)=O,4,1,0,1,17,4.7e-05
G5,C1(CC(C2C(C(CO2)=O)O1)=O)=O,4,1,0,1,17,4.7e-05
G5,C1(C(C(CC(O1)=O)=O)C(CO)O)=O,4,2,0,2,19,9.499999999999999e-05
G5,C1(C2C(C(CO1)OC(C2)=O)=O)=O,4,1,0,1,17,4.7e-05
G5,C1(C2COC(C1C(CO2)=O)=O)=O,4,1,0,1,17,4.7e-05
G5,C1(CC2COC(C1C(O2)=O)=O)=O,4,2,0,2,29,9.499999999999999e-05
G5,C1(CC(C(C(O1)=O)C(CO)=O)O)=O,4,1,0,1,17,4.7e-05
G5,C1(C2C(CC(CC(O2)=O)O1)=O)=O,4,1,0,1,48,4.7e-05
G5,C1(C2C(CC(C(CO2)=O)O1)=O)=O,4,1,0,1,17,4.7e-05
G5,C1(C2C(COC(C(C2)=O)O1)=O)=O,4,1,0,1,17,4.7e-05
G5,C1(CC2OCC(C1C(O2)=O)=O)=O,4,1,0,1,38,4.7e-05
G5,C1(C(C=O)C2C(C(CO2)O1)=O)=O,8,1,0,1,9,4.7e-05
G5,C1(C2C(CC(CC=O)(O2)O1)=O)=O,4,1,0,1,48,4.7e-05
G5,C1(CC2(C=O)OCC1C(O2)=O)=O,4,1,0,1,30,4.7e-05
G5,C1(CC2OC(C=O)C1C(O2)=O)=O,8,1,0,1,37,4.7e-05
G5,C1(CC(C(C(C(C)O)O1)O)=O)=O,8,1,0,1,0,4.7e-05
G5,C1(C(C(CC(C(C)O)O1)=O)O)=O,8,1,0,1,11,4.7e-05
G5,C1(C(C(C(C(O1)=O)=O)CO)O)=O,4,1,0,1,33,4.7e-05
G5,C1(C(C(C=O)C(C(O1)=O)O)O)=O,3,1,0,1,33,4.7e-05
G5,C1(C(C2C(C(CO2)O1)=O)O)=O,8,1,0,1,10,4.7e-05
G5,C1(C(C2C(C(OC2)O1)=O)O)=O,8,1,0,1,34,4.7e-05
G5,C1(C(C(CO)C(C(C)O1)O)=O)=O,8,1,0,1,11,4.7e-05
G5,C(C1C(C(C)OC(C1O)=O)O)=O,16,1,0,1,33,4.7e-05
G5,C1(C(C)(C(C(CO1)=O)O)O)=O,4,1,0,1,5,4.7e-05
G5,C1(C(CC(CO1)(CO)O)=O)=O,2,1,0,1,29,4.7e-05
G5,C1(C(C)(C(C=O)C(CO1)=O)O)=O,4,1,0,1,28,4.7e-05
G5,C(CC1(COC(C(C1)=O)=O)O)=O,2,1,0,1,29,4.7e-05
G5,C(C1C(COC(C1O)=O)=O)=O,4,1,0,1,33,4.7e-05
G5,C1(C(C)(CC(C(C=O)O1)=O)O)=O,4,1,0,1,25,4.7e-05
G5,C(C)(C1C(CC(C(O1)=O)=O)O)=O,4,1,0,1,49,4.7e-05
G5,C(C1C(C)(CC(C(O1)=O)=O)O)=O,4,1,0,1,0,4.7e-05
G5,C1(C(C)(CC(C(CO)O1)=O)O)=O,4,1,0,1,28,4.7e-05
G5,C1(C(CC(C)(C(CO)O1)O)=O)=O,4,1,0,1,28,4.7e-05
G5,C(CO)(C1COC(C(C1)=O)=O)=O,2,1,0,1,29,4.7e-05
G5,C1(CC(OCC1C(CO)=O)=O)=O,2,1,0,1,17,4.7e-05
G5,C1(C(C(OCC1C(C)=O)=O)O)=O,4,1,0,1,2,4.7e-05
G5,C1(C(COC(C1O)=O)CC=O)=O,4,1,0,1,17,4.7e-05
G5,C1(C(COC(C1)=O)C(C=O)O)=O,4,1,0,1,17,4.7e-05
G5,C1(C(C(C(CO1)C(CO)O)=O)O)=O,8,2,0,2,50,9.499999999999999e-05
G5,C1(C(C(C(C(CO)=O)CO1)O)O)=O,8,1,0,1,2,4.7e-05
G5,C1(C(C)(C(C(CO1)=O)CO)O)=O,4,1,0,1,3,4.7e-05
G5,C1(C(CC(CO1)(CCO)O)=O)=O,2,1,0,1,29,4.7e-05
G5,C1(C(CC(C)(CO1)O)=O)=O,2,1,0,1,29,4.7e-05
G5,C1(C(CCO)(CC(CO1)=O)O)=O,2,1,0,1,29,4.7e-05
G5,C1(C(C(CO)C(C)(CO1)O)=O)=O,4,1,0,1,29,4.7e-05
G5,C(CC1C(CC(C(O1)=O)=O)O)=O,4,1,0,1,29,4.7e-05
G5,C1(CC(C(C(C)O1)C(CO)O)=O)=O,8,2,0,2,19,9.499999999999999e-05
G5,C1(CC(CC(CO)(CC=O)O1)O)=O,4,1,0,1,48,4.7e-05
G5,C1(CC(C(C(CO)=O)C(C)O1)O)=O,8,1,0,1,4,4.7e-05
G5,C1(C(C(C(CO1)O)=O)O)=O,4,1,0,1,2,4.7e-05
G5,C1(C(C(C(OC1CO)=O)O)O)=O,8,1,0,1,33,4.7e-05
G5,C1(CCOC(C1C(C=O)=O)=O)=O,2,1,0,1,30,4.7e-05
G5,C1(C(C(C=O)=O)CC(CO1)=O)=O,2,1,0,1,12,4.7e-05
G5,C(C1C(OC(C=O)C(C1)=O)=O)=O,4,1,0,1,17,4.7e-05
G5,C(C1C(OC(C=O)CC1=O)=O)=O,4,1,0,1,17,4.7e-05
G5,C1(C(C=O)(CC(CO1)O)O)=O,4,1,0,1,29,4.7e-05
G5,C1(C(CO)(C(CCO1)O)O)=O,4,1,0,1,33,4.7e-05
G5,C1(C(C)(CC(CO1)O)O)=O,4,1,0,1,29,4.7e-05
G5,C1(C(C)(CC(C(O1)=O)O)O)=O,4,1,0,1,29,4.7e-05
G5,C1(C(C)(CC(C=O)(CO1)O)O)=O,4,1,0,1,14,4.7e-05
G5,C1(C2(COC(CO1)C2)O)=O,4,1,0,1,54,4.7e-05
G5,C1(C(C=O)(C(C(CO1)O)O)O)=O,8,1,0,1,17,4.7e-05
G5,C(C1(COC(C(C1O)O)=O)O)=O,8,1,0,1,17,4.7e-05
G5,C1(COC(C(C1(CO)O)O)=O)=O,4,1,0,1,33,4.7e-05
G5,C1(CC(OCC1(C(C)=O)O)=O)=O,2,1,0,1,17,4.7e-05
G5,C(C1(C(COC(C1O)=O)O)O)=O,8,1,0,1,33,4.7e-05
G5,C1(CC(CO)(C(C(O1)=O)O)O)=O,4,1,0,1,29,4.7e-05
G5,C1(C(C(C)(C(C(O1)=O)O)O)O)=O,3,1,0,1,29,4.7e-05
G5,C1(C(COC(C1)=O)(CC=O)O)=O,2,1,0,1,45,4.7e-05
G5,C1(C(C(C(C(O1)=O)O)O)O)=O,3,1,0,1,29,4.7e-05
G5,C1(C2CC(C(CO)(O2)O1)O)=O,8,1,0,1,29,4.7e-05
G5,C1(C2(C(CC(CC2=O)O1)=O)O)=O,1,1,0,1,9,4.7e-05
G5,C1(C(C=O)(C(C(CO1)=O)O)O)=O,4,1,0,1,5,4.7e-05
G5,C1(C(C=O)(C(CCO1)=O)O)=O,2,1,0,1,17,4.7e-05
G5,C1(C(C=O)(C(CC(C)O1)=O)O)=O,4,1,0,1,17,4.7e-05
G5,C1(C(C(CCO1)=O)(CO)O)=O,2,1,0,1,2,4.7e-05
G5,C1(C(C(CC(C)O1)=O)(CO)O)=O,4,1,0,1,17,4.7e-05
G5,C1(C(C(C)=O)(C(CCO1)O)O)=O,4,1,0,1,0,4.7e-05
G5,C1(C(C=O)(C(CCO1)O)O)=O,4,1,0,1,17,4.7e-05
G5,C1(C(C(CCO1)O)C(C=O)O)=O,8,1,0,1,29,4.7e-05
G5,C1(C(C(CO)O)(C(CCO1)O)O)=O,8,1,0,1,40,4.7e-05
G5,C1(C(C(CO)O)C(CCO1)O)=O,8,1,0,1,8,4.7e-05
G5,C1(C(C(C)O)(C(CCO1)O)O)=O,8,1,0,1,4,4.7e-05
G5,C1(C(C(C(CO1)O)=O)(CO)O)=O,4,1,0,1,2,4.7e-05
G5,C1(C(C(CCO1)=O)(C(C)O)O)=O,4,1,0,1,4,4.7e-05
G5,C1(C(C=O)(C(CC(C)O1)O)O)=O,8,1,0,1,17,4.7e-05
G5,C1(C(C(CO)O)C(CC(C)O1)O)=O,16,1,0,1,8,4.7e-05
G5,C1(C(CO)(C(CC(C)O1)O)O)=O,8,1,0,1,33,4.7e-05
G5,C1(C(C(CO)O)C(C(CO1)=O)O)=O,8,1,0,1,8,4.7e-05
G5,C1(C(CO)(C(C(CO1)=O)O)O)=O,4,1,0,1,5,4.7e-05
G5,C(C1(C(COC(C1O)=O)=O)O)=O,4,1,0,1,33,4.7e-05
G5,C1(CCOC(C1(C(C)=O)O)=O)=O,2,1,0,1,9,4.7e-05
G5,C1(C2COC(C1(C(C2)=O)O)=O)=O,4,2,0,2,17,9.499999999999999e-05
G5,C1(CC2OC1(C(O2)=O)C(C)=O)=O,4,1,0,1,9,4.7e-05
G5,C1(C2(C=O)C(CC(C)(O2)O1)=O)=O,4,1,0,1,26,4.7e-05
G5,C1(C(C(CO)O)C(C(CO1)O)O)=O,16,1,0,1,8,4.7e-05
G5,C1(CC(C(CO1)(C(CO)O)O)=O)=O,4,2,0,2,2,9.499999999999999e-05
G5,C1(C2(C(CC(C(C2)=O)O1)=O)O)=O,4,1,0,1,17,4.7e-05
G5,C1(C(C(C)=O)(CC(CO1)=O)O)=O,2,1,0,1,17,4.7e-05
G5,C1(C(C)(C(CCO1)O)O)=O,4,1,0,1,25,4.7e-05
G5,C1(C(CCO)(C(CCO1)O)O)=O,4,1,0,1,29,4.7e-05
G5,C1(C(C(CCO1)O)(CC=O)O)=O,4,1,0,1,29,4.7e-05
G5,C1(CCOC(C1(CC=O)O)=O)=O,2,1,0,1,4,4.7e-05
G5,C1(C(C)(C(CC(C)O1)O)O)=O,8,1,0,1,25,4.7e-05
G5,C1(C(C)(C(C(C(C)O1)O)O)O)=O,16,1,0,1,25,4.7e-05
G5,C1(C(C)(C(CC(CO)O1)O)O)=O,8,1,0,1,25,4.7e-05
G5,C1(C(C)(C(C(CO1)=O)(C)O)O)=O,4,1,0,1,25,4.7e-05
G5,C1(C(C)(C(C(C(O1)=O)O)O)O)=O,8,1,0,1,29,4.7e-05
G5,C1(C(C)(C2(COC(C2)O1)O)O)=O,8,1,0,1,25,4.7e-05
G5,C1(C(C)(C(C=O)(CCO1)O)O)=O,4,1,0,1,25,4.7e-05
G5,C1(C2(C(OCC1C(C2)=O)=O)O)=O,4,2,0,2,17,9.499999999999999e-05
G5,C1(C2(C(C)=O)CC(C(O2)O1)=O)=O,4,1,0,1,17,4.7e-05
G5,C1(CC2OC1(C(O2)=O)CC=O)=O,4,1,0,1,17,4.7e-05
G5,C1(C2(C=O)CC(C(C)(O2)O1)=O)=O,4,1,0,1,14,4.7e-05
G5,C1(CC(C=O)(C(C(O1)=O)O)O)=O,4,1,0,1,33,4.7e-05
G5,C(C1(C)C(C(CC(O1)=O)O)O)=O,8,1,0,1,29,4.7e-05
G5,C(C1(C(C(C)OC(C1)=O)O)O)=O,8,1,0,1,29,4.7e-05
G5,C(C1(C)C(CC(C(O1)=O)O)O)=O,8,1,0,1,11,4.7e-05
G5,C1(C(C)(C(C)(C(CO1)O)O)O)=O,8,1,0,1,25,4.7e-05
G5,C1(C(C=O)(CC(CO1)=O)O)=O,2,1,0,1,17,4.7e-05
G5,C1(C(C)(C(CO)(CCO1)O)O)=O,4,1,0,1,29,4.7e-05
G5,C1(C(C)(C(CC(C=O)O1)O)O)=O,8,1,0,1,25,4.7e-05
G5,C(C1(CC(C)OC(C1O)=O)O)=O,8,1,0,1,33,4.7e-05
G5,C1(C(C(CC(C(C)=O)O1)O)O)=O,8,1,0,1,45,4.7e-05
G5,C(C1(C)CC(C(C(O1)=O)O)O)=O,8,1,0,1,16,4.7e-05
G5,C1(C(C(CCO1)O)O)=O,4,1,0,1,17,4.7e-05
G5,C1(C(C(CO)(CC(C)O1)O)O)=O,8,1,0,1,33,4.7e-05
G5,C1(C(C(C)(C(C(C)O1)O)O)O)=O,16,1,0,1,33,4.7e-05
G5,C1(C(C(CC(CO)(C)O1)O)O)=O,8,1,0,1,49,4.7e-05
G5,C1(C(C(CC(C)O1)O)O)=O,8,1,0,1,33,4.7e-05
G5,C1(C(C(C(C(C)O1)O)O)O)=O,16,1,0,1,29,4.7e-05
G5,C1(C(C2(COC(C2)O1)O)O)=O,8,1,0,1,33,4.7e-05
G5,C1(C(C(C(CO)(CO1)O)O)O)=O,8,1,0,1,29,4.7e-05
G5,C1(C2CCC(CO)(O2)O1)=O,4,1,0,1,12,4.7e-05
G5,C1(C2CC(C(C)(O2)O1)O)=O,8,1,0,1,45,4.7e-05
G5,C1(C2(C)CC(C(O2)O1)O)=O,8,1,0,1,14,4.7e-05
G5,C1(C2C(CO)(CC(O2)O1)O)=O,8,1,0,1,29,4.7e-05
G5,C1(C2C(C)(C(C(O2)O1)O)O)=O,16,1,0,1,29,4.7e-05
G5,C1(C2C(C(C(O2)O1)O)O)=O,16,1,0,1,17,4.7e-05
G5,C(CC1C(COC(C1)=O)=O)=O,2,1,0,1,18,4.7e-05
G5,C1(C(CC(CO1)C(CO)O)=O)=O,4,1,0,1,29,4.7e-05
G5,C1(C(CC(CO)C(CO)O1)=O)=O,4,2,0,2,50,9.499999999999999e-05
G5,C(CC1COC(C(C1O)O)=O)=O,8,1,0,1,29,4.7e-05
G5,C1(CC(CO)C(C(C=O)O1)O)=O,8,2,0,2,55,9.499999999999999e-05
G5,C1(CC(CCO1)C(C(CO)O)O)=O,8,3,0,3,46,0.00014199999999999998
G5,C1(C(C(C(CO1)=O)CC=O)O)=O,4,1,0,1,33,4.7e-05
G5,C1(C(C(CO)C(CCO1)O)=O)=O,4,1,0,1,18,4.7e-05
G5,C(C1C(CCOC(C1O)=O)O)=O,8,1,0,1,33,4.7e-05
G5,C1(C(C(CC(C)(CO1)O)=O)O)=O,4,1,0,1,49,4.7e-05
G5,C1(CC(C(C(C)(CO1)O)O)=O)=O,4,1,0,1,49,4.7e-05
G5,C1(C(C(C(OC(C)C1)=O)O)O)=O,8,1,0,1,33,4.7e-05
G5,C1(CC(C(OC(C)C1O)=O)O)=O,8,1,0,1,4,4.7e-05
G5,C1(C(CC(CC(C)O1)O)=O)=O,4,1,0,1,28,4.7e-05
G5,C1(C(CC(C(C(C)O1)O)O)=O)=O,8,1,0,1,28,4.7e-05
G5,C1(C(CC(CC(CO)O1)O)=O)=O,4,1,0,1,29,4.7e-05
G5,C1(COC(C(CC1O)=O)=O)=O,2,1,0,1,5,4.7e-05
G5,C1(C(C)(CC(C(CO1)=O)=O)O)=O,2,1,0,1,25,4.7e-05
G5,C1(COC(C(CC1(C)O)=O)=O)=O,2,1,0,1,0,4.7e-05
G5,C1(C(CC(C(CO1)=O)=O)O)=O,2,1,0,1,33,4.7e-05
G5,C1(C(C(OCC(C1)=O)=O)O)=O,2,1,0,1,27,4.7e-05
G5,C1(CC(C(C(CO1)=O)O)=O)=O,2,1,0,1,17,4.7e-05
G5,C1(C(CC(C(OC1C)=O)=O)O)=O,4,1,0,1,49,4.7e-05
G5,C1(C(C(CC(C(O1)=O)=O)O)O)=O,4,1,0,1,29,4.7e-05
G5,C1(C(CC2(COC(C2)O1)O)=O)=O,4,1,0,1,28,4.7e-05
G5,C1(C(C)(C2C(CC(O2)O1)=O)O)=O,8,1,0,1,28,4.7e-05
G5,C1(C(C(CC(C(O1)=O)O)=O)O)=O,4,1,0,1,33,4.7e-05
G5,C1(CC(C(C(C(O1)=O)O)O)=O)=O,4,1,0,1,33,4.7e-05
G5,C1(C2C(CC(C(O2)O1)O)=O)=O,8,1,0,1,27,4.7e-05
G5,C(C1C(OCC(C(C1)=O)=O)=O)=O,2,1,0,1,17,4.7e-05
G5,C1(C(C=O)C(C(CCO1)O)=O)=O,4,1,0,1,17,4.7e-05
G5,C1(CC(C(CC(CO)O1)=O)=O)=O,2,1,0,1,17,4.7e-05
G5,C1(C(C=O)C2CC(C(O2)O1)=O)=O,8,1,0,1,23,4.7e-05
G5,C1(C(C=O)C2C(CC(O2)O1)=O)=O,8,1,0,1,17,4.7e-05
G5,C1(CC(C(C(C(O1)=O)CO)=O)O)=O,4,1,0,1,19,4.7e-05
G5,C1(C2C(C(CC(CO2)O1)=O)=O)=O,4,1,0,1,36,4.7e-05
G5,C1(C2C(OC(C(C1)=O)CO2)=O)=O,4,1,0,1,36,4.7e-05
G5,C1(C2C(CC(C(OC2)O1)=O)=O)=O,4,1,0,1,30,4.7e-05
G5,C1(C2C(C(CC(OC2)O1)=O)=O)=O,4,1,0,1,17,4.7e-05
G5,C1(CCC2(C=O)OC1C(O2)=O)=O,4,1,0,1,12,4.7e-05
G5,C1(CC(C(C(C(C)O1)O)O)=O)=O,8,1,0,1,0,4.7e-05
G5,C1(C(C(CC(C(C)O1)O)=O)O)=O,8,1,0,1,11,4.7e-05
G5,C1(C(C2C(CC(O2)O1)=O)O)=O,8,1,0,1,33,4.7e-05
G5,C1(C(C)(CC(C(CO1)O)=O)O)=O,4,1,0,1,28,4.7e-05
G5,C1(C(CC(C)(C(CO1)O)O)=O)=O,4,1,0,1,28,4.7e-05
G5,C(C1COC(C(CC1O)=O)=O)=O,4,1,0,1,18,4.7e-05
G5,C(C1COC(CC(C1O)=O)=O)=O,4,1,0,1,17,4.7e-05
G5,C1(CC(C(C(C=O)CO1)=O)O)=O,4,1,0,1,29,4.7e-05
G5,C(C1COC(C(C(C1)=O)O)=O)=O,4,1,0,1,17,4.7e-05
G5,C(C1(CCOC(C(C1)=O)=O)O)=O,2,1,0,1,29,4.7e-05
G5,C1(C(C)(C(C(CCO1)=O)O)O)=O,4,1,0,1,3,4.7e-05
G5,C1(C(CC(CO)(CCO1)O)=O)=O,2,1,0,1,29,4.7e-05
G5,C1(CC(CO)(CC(CO1)=O)O)=O,2,1,0,1,29,4.7e-05
G5,C1(C(C(C)(CC(CO1)=O)O)O)=O,4,1,0,1,33,4.7e-05
G5,C(C1CC(CC(C(O1)=O)=O)O)=O,4,1,0,1,29,4.7e-05
G5,C1(CC(C(C(CO)C(C)O1)=O)O)=O,8,1,0,1,19,4.7e-05
G5,C1(C(C(C(OCC1O)=O)O)O)=O,8,1,0,1,33,4.7e-05
G5,C(C1C(OCCC(C1=O)=O)=O)=O,2,1,0,1,17,4.7e-05
G5,C(C1C(CC(COC1=O)=O)=O)=O,2,1,0,1,17,4.7e-05
G5,C(C1C(CC(CC(O1)=O)=O)=O)=O,2,1,0,1,17,4.7e-05
G5,C1(CC(C(CC(C=O)O1)=O)=O)=O,2,1,0,1,17,4.7e-05
G5,C1(C(C(CC(C(O1)=O)O)O)O)=O,8,1,0,1,29,4.7e-05
G5,C(C1(C(CCC(OC1)=O)=O)O)=O,2,1,0,1,29,4.7e-05
G5,C(C1(COC(CC(C1)=O)=O)O)=O,2,1,0,1,17,4.7e-05
G5,C1(C(C2CC(C(O2)O1)O)O)=O,16,1,0,1,29,4.7e-05
G5,C1(C2C(CC(C(O2)O1)O)O)=O,16,1,0,1,29,4.7e-05
G5,C1(C2CC(C(C(O2)O1)O)O)=O,16,1,0,1,29,4.7e-05
G5,C1(C(C=O)(C(CCCO1)=O)O)=O,2,1,0,1,29,4.7e-05
G5,C1(C(C(CCC(O1)=O)=O)(CO)O)=O,2,1,0,1,17,4.7e-05
G5,C1(C2(C=O)C(CCC(O2)O1)=O)=O,4,1,0,1,37,4.7e-05
G5,C1(CCC(OC(C)C1(CO)O)=O)=O,4,1,0,1,4,4.7e-05
G5,C(C1(C(CCOC(C1)=O)O)O)=O,4,1,0,1,29,4.7e-05
G5,C1(C(C)(C(CC(CO1)O)O)O)=O,8,1,0,1,25,4.7e-05
G5,C1(C(C)(C(C(CCO1)O)O)O)=O,8,1,0,1,25,4.7e-05
G5,C1(C(C=O)(CC(CCO1)=O)O)=O,2,1,0,1,29,4.7e-05
G5,C1(C2(C=O)CC(CC(O2)O1)=O)=O,4,1,0,1,37,4.7e-05
G5,C1(C(C)(C(CC(CO1)=O)O)O)=O,4,1,0,1,25,4.7e-05
G5,C1(C(C(CC(C)(CO1)O)O)O)=O,8,1,0,1,49,4.7e-05
G5,C1(C(C2C(C(C(O2)O1)O)O)O)=O,32,1,0,1,29,4.7e-05
G5,C1(C2CC(CC(O2)O1)O)=O,8,1,0,1,33,4.7e-05
G5,C1(C2C(C(C(C(O2)O1)O)O)O)=O,32,1,0,1,29,4.7e-05
G5,C1(C(C)(CCC(CO1)=O)O)=O,2,1,0,1,25,4.7e-05
G5,C1(C(C=O)(CCC(CO1)=O)O)=O,2,1,0,1,7,4.7e-05
G5,C(C1CC(OCC(C1)=O)=O)=O,2,1,0,1,18,4.7e-05
G5,C1(C(CCC(CO1)=O)C(CO)O)=O,4,1,0,1,8,4.7e-05
G5,C1(COC(CCC1)=O)=O,1,1,0,1,18,4.7e-05
G5,C1(C(CC(CO)C(CO1)O)=O)=O,4,2,0,2,27,9.499999999999999e-05
G5,C1(C(C(CC(CO)CO1)=O)O)=O,4,2,0,2,55,9.499999999999999e-05
G5,C1(C(C(C=O)CC(CO1)=O)O)=O,4,1,0,1,33,4.7e-05
G5,C1(C(C2(C(C(C(C2)O)O)C1)O)O)=O,32,1,0,1,32,4.7e-05
G5,C(C1C(CCO)(C(C(C1)=O)O)O)=O,8,1,0,1,18,4.7e-05
G5,C1(C(C(CC1)(CCO)O)O)=O,4,1,0,1,7,4.7e-05
G5,C1(C(C(CC1)(CC(C)O)O)O)=O,8,1,0,1,7,4.7e-05
G5,C1(C(C(CC1)(CC(CO)O)O)O)=O,8,1,0,1,7,4.7e-05
G5,C(CC1(C(C=O)CC(C1O)=O)O)=O,8,1,0,1,45,4.7e-05
G5,C(CC1(C(C(C=O)=O)CC(C1)=O)O)=O,4,1,0,1,45,4.7e-05
G5,C(CC1(C(C=O)CC(C(C1)=O)=O)O)=O,4,1,0,1,45,4.7e-05
G5,C(CC1(C(C(C(C1)=O)=O)CC=O)O)=O,4,1,0,1,45,4.7e-05
G5,C(CC1(C(C=O)CC(C1C=O)=O)O)=O,8,1,0,1,45,4.7e-05
G5,C(CC1(CCC(C1C(C=O)=O)=O)O)=O,4,1,0,1,45,4.7e-05
G5,C(C1C(C(CCC1(CC=O)O)=O)=O)=O,4,1,0,1,45,4.7e-05
G5,C(C1(C(C(CC1C=O)=O)O)O)(O)=O,8,1,0,1,33,4.7e-05
G5,C(C1CC(C(C1(C(C=C)=O)O)O)=O)=O,8,1,0,1,7,4.7e-05
G5,C(C1CC(C(C1(C=CC=O)O)O)=O)=O,16,1,0,1,43,4.7e-05
G5,C(C1C(C(C)O)(C(C(C1)=O)O)O)=O,16,1,0,1,11,4.7e-05
G5,C1(C(C(CC1)(C(C)O)O)O)=O,8,1,0,1,11,4.7e-05
G5,C1(CC(C(C=O)=O)C(CO)(C1)O)=O,4,1,0,1,0,4.7e-05
G5,C(C1C(CO)(CC(C(C1)=O)=O)O)=O,4,1,0,1,0,4.7e-05
G5,C(CC1C(C(CC1(CO)O)=O)=O)=O,4,1,0,1,0,4.7e-05
G5,C(C1C(CO)(C(C=O)C(C1)=O)O)=O,8,1,0,1,0,4.7e-05
G5,C1(CCC(CO)(C1C(C=O)=O)O)=O,4,1,0,1,0,4.7e-05
G5,C(C1C(C(CCC1(CO)O)=O)=O)=O,4,1,0,1,0,4.7e-05
G5,C(C1CC(C(C1(C(C)=O)O)O)=O)=O,8,1,0,1,45,4.7e-05
G5,C1(CC(C(C)=O)(C(C(C=O)=O)C1)O)=O,4,1,0,1,45,4.7e-05
G5,C(C1CC(C(CC1(C(C)=O)O)=O)=O)=O,4,1,0,1,45,4.7e-05
G5,C(CC1C(C(CC1(C(C)=O)O)=O)=O)=O,4,1,0,1,45,4.7e-05
G5,C(C1C(CC(C=O)C1(C(C)=O)O)=O)=O,8,1,0,1,45,4.7e-05
G5,C1(CCC(C(C)=O)(C1C(C=O)=O)O)=O,4,1,0,1,45,4.7e-05
G5,C(C1C(C(CCC1(C(C)=O)O)=O)=O)=O,4,1,0,1,45,4.7e-05
G5,C(C1(CC(CC1C(C=O)=O)=O)O)=O,4,1,0,1,0,4.7e-05
G5,C(C1(CC(C(CC1C=O)=O)=O)O)=O,4,1,0,1,0,4.7e-05
G5,C(CC1C(C(CC1(C=O)O)=O)=O)=O,4,1,0,1,0,4.7e-05
G5,C(C1C(CC(C=O)C1(C=O)O)=O)=O,8,1,0,1,45,4.7e-05
G5,C1(CCC(C=O)(C1C(C=O)=O)O)=O,4,1,0,1,45,4.7e-05
G5,C(C1C(C(CCC1(C=O)O)=O)=O)=O,4,1,0,1,0,4.7e-05
G5,C1(C(C(CC1)(CC(C=O)O)O)O)=O,8,1,0,1,7,4.7e-05
G5,C1(C(C(C(C)(C(CO)C1)O)O)=O)=O,8,1,0,1,55,4.7e-05
G5,C(CC1C(C)(C(C(C1O)=O)O)O)=O,16,1,0,1,32,4.7e-05
G5,C1(CCC(C)(C(C(C1O)=O)O)O)=O,8,1,0,1,32,4.7e-05
G5,C1(C(CC(C(C(CO)O)C1)O)O)=O,16,1,0,1,29,4.7e-05
G5,C(CO)(CC1C(C(CC1O)O)O)=O,16,1,0,1,29,4.7e-05
G5,C(CC1C(C(C(CC1O)O)O)O)=O,32,1,0,1,29,4.7e-05
G5,C1(CCC2(CC(C(C12O)O)O)O)=O,16,1,0,1,7,4.7e-05
G5,C1(C2(C(C(C(CO)O2)C1)O)O)=O,16,1,0,1,2,4.7e-05
G5,C1(C2(C(C(C(CO2)O)C1)O)O)=O,16,1,0,1,41,4.7e-05
G5,C1(C2(C(C)(C(C(CO)O2)C1)O)O)=O,16,1,0,1,46,4.7e-05
G5,C1(C2(C(C)(C(C(CO2)O)C1)O)O)=O,16,1,0,1,41,4.7e-05
G5,C(C1CC(CC1C(CO)=O)=O)=O,4,2,0,2,32,9.499999999999999e-05
G5,C(C1C(CC(C1)=O)O)(O)=O,4,1,0,1,46,4.7e-05
G5,C(C1(CCC(C1)=O)O)=O,2,1,0,1,27,4.7e-05
G5,C1(C(C2(CC1C(C2O)O)O)O)=O,32,1,0,1,9,4.7e-05
G5,C1(C(CC(C=O)C1C=O)O)=O,8,1,0,1,55,4.7e-05
G5,C(C1CC(C=O)C(C1O)=O)=O,8,2,0,2,9,9.499999999999999e-05
G5,C(C1CC(C=O)(C(C1)=O)O)=O,4,1,0,1,16,4.7e-05
G5,C(C1CC(C(C1)=O)(CO)O)=O,4,1,0,1,16,4.7e-05
G5,C(C1(C)C(C(C(C1)=O)O)O)=O,8,1,0,1,16,4.7e-05
G5,C(C1CC(C(C1O)=O)CO)=O,8,1,0,1,2,4.7e-05
G5,C1(C(C(C(CO)(C)C1)O)O)=O,8,1,0,1,49,4.7e-05
G5,C1(C(C(CC1C(CO)=O)O)O)=O,8,1,0,1,2,4.7e-05
G5,C(C1CC(C(C(C1O)O)O)O)=O,32,1,0,1,29,4.7e-05
G5,C(C1CC(CO)(C(C1O)O)O)=O,16,1,0,1,29,4.7e-05
G5,C1(CC(CC1C(C=O)=O)O)=O,4,1,0,1,2,4.7e-05
G5,C(C1C(CC(C(C1)O)=O)=O)=O,4,1,0,1,2,4.7e-05
G5,C(C1C(C(C(CC1)=O)O)=O)=O,4,2,0,2,9,9.499999999999999e-05
G5,C(C1(C(CC(CC1)=O)=O)O)=O,2,1,0,1,2,4.7e-05
G5,C(C(C1C(C(CC1)=O)=O)O)=O,4,2,0,2,14,9.499999999999999e-05
G5,C1(C(O)OC2C(C(CC12)O)O)=O,32,1,0,1,41,4.7e-05
G5,C1(C2C(CO)(CC1C(O2)O)O)=O,16,1,0,1,0,4.7e-05
G5,C1(C2C(C(CC1C(O2)O)O)O)=O,32,1,0,1,0,4.7e-05
G5,C1(C2C(C(C(CC1)(O2)O)O)O)=O,16,1,0,1,0,4.7e-05
G5,C1(C2C(C(CC1)(C(O2)O)O)O)=O,16,1,0,1,0,4.7e-05
G5,C1(C2C(CC1)(C(C(O2)O)O)O)=O,16,1,0,1,0,4.7e-05
G5,C(C1CC2(C(C(C1O2)O)O)O)=O,32,1,0,1,29,4.7e-05
G5,C(C1CC2(C(O)OC1C2O)O)=O,32,1,0,1,29,4.7e-05
G5,C1(C(O)OC2C(C1CC2O)O)=O,32,1,0,1,41,4.7e-05
G5,C1(C(C2(CO)CC1C(O)O2)O)=O,16,1,0,1,9,4.7e-05
G5,C1(C(C2C(CC1C(O)O2)O)O)=O,32,1,0,1,9,4.7e-05
G5,C1(C(C2(CC1C(CO)O2)O)O)=O,16,1,0,1,54,4.7e-05
G5,C1(C2C(CC1C(C(O2)O)O)O)=O,32,1,0,1,47,4.7e-05
G5,C1(C(O)OC2CC1C(C2O)O)=O,32,1,0,1,41,4.7e-05
G5,C1(C(C2(COC(C1C2)O)O)O)=O,16,1,0,1,38,4.7e-05
G5,C1(C(C(C2CC1C(O)O2)O)O)=O,32,1,0,1,38,4.7e-05
G5,C1(C(C2(CC1C(CO2)O)O)O)=O,16,1,0,1,19,4.7e-05
G5,C1(C(C2CC1C(C(O)O2)O)O)=O,32,1,0,1,47,4.7e-05
G5,C1(COC2(CC1C(C2O)O)O)=O,16,1,0,1,9,4.7e-05
G5,C(C1CC2(COC1(C2O)O)O)=O,16,1,0,1,29,4.7e-05
G5,C(C1CC2C(C(C1(O)O2)O)O)=O,32,1,0,1,29,4.7e-05
G5,C1(CC(C=O)C(C(C1)=O)CO)=O,4,1,0,1,30,4.7e-05
G5,C1(CC(C=O)C(C=O)C1CO)=O,8,1,0,1,23,4.7e-05
G5,C(C1(C(CC(C1)=O)O)CC=O)=O,4,3,0,3,23,0.000144
G5,C1(CC(C(C)C1C(C=O)=O)O)=O,8,1,0,1,29,4.7e-05
G5,C(C1CC(CCC(C1O)=O)=O)=O,4,1,0,1,7,4.7e-05
G5,C(CC1C(CCC(C1O)=O)=O)=O,4,1,0,1,7,4.7e-05
G5,C(CC1(C=O)CCC(C1O)=O)=O,4,2,0,2,29,9.499999999999999e-05
G5,C1(CC(C(C=O)=O)C(C)C1O)=O,8,1,0,1,12,4.7e-05
G5,C(C1CC(CC(C(C1)=O)O)=O)=O,4,1,0,1,45,4.7e-05
G5,C1(CC(C=O)C(C=O)CC1O)=O,8,1,0,1,29,4.7e-05
G5,C(C1(CC(C(C1)=O)O)CC=O)=O,4,2,0,2,29,9.6e-05
G5,C1(C(C(C(C=O)=O)C(C)C1)O)=O,8,2,0,2,45,9.499999999999999e-05
G5,C(C1CC(C(C=O)C1C=O)O)=O,16,1,0,1,29,4.7e-05
G5,C(C1C(C(C(CO)C1C)=O)=O)=O,8,2,0,2,4,9.499999999999999e-05
G5,C(C1C(C(CC(C1C)O)=O)=O)=O,8,1,0,1,4,4.7e-05
G5,C(C1C(CC(C(C1C)O)=O)=O)=O,8,1,0,1,4,4.7e-05
G5,C(C1C(C(C(CC1C)=O)O)=O)=O,8,2,0,2,9,9.499999999999999e-05
G5,C(CC1CC(C(C1C=O)=O)O)=O,8,2,0,2,29,9.6e-05
G5,C(C1C(C)C(C=O)C(C1O)=O)=O,16,2,0,2,29,9.499999999999999e-05
G5,C(C1(C(CC(CC1C)=O)=O)O)=O,4,1,0,1,29,4.7e-05
G5,C(C1(C(CCC1CC=O)=O)O)=O,4,1,0,1,44,4.7e-05
G5,C(C1C(C)C(C=O)(C(C1)=O)O)=O,8,1,0,1,46,4.7e-05
G5,C(C(C1C(C(CC1C)=O)=O)O)=O,8,2,0,2,14,9.499999999999999e-05
G5,C(C1(C(C)CC(C(C1)=O)=O)O)=O,4,1,0,1,29,4.7e-05
G5,C(C1(C(C)C(C=O)C(C1)=O)O)=O,8,1,0,1,29,4.7e-05
G5,C(C1C(C(C=CC(C1)=O)O)O)=O,8,1,0,1,29,4.7e-05
G5,C(CC1C(C=CC(C1O)O)=O)=O,8,1,0,1,29,4.7e-05
G5,C(C1C=CC(CO)(C1C=O)O)=O,8,1,0,1,29,4.7e-05
G5,C(C1(C=CC(C1O)O)CC=O)=O,8,1,0,1,29,4.7e-05
G5,C(CC1C(C(C=CC1O)=O)O)=O,8,2,0,2,29,9.499999999999999e-05
G5,C(CC1C=CC(C1(CO)O)=O)=O,4,1,0,1,21,4.7e-05
G5,C(CC1C=CC(C(C1O)O)=O)=O,8,1,0,1,21,4.7e-05
G5,C(CC1C=CC(C1(C=O)O)O)=O,8,1,0,1,29,4.7e-05
G5,C1(CCC(C=O)C1(C=O)O)=O,4,1,0,1,25,4.7e-05
G5,C(C1CCC(C1(CO)O)=O)=O,4,1,0,1,25,4.7e-05
G5,C1(C2CC(CO)(C(C2O)O1)O)=O,16,1,0,1,48,4.7e-05
G5,C1(C2CC(C(C(C2O)O1)O)O)=O,32,1,0,1,48,4.7e-05
G5,C1(C2CC(CO)(C(C2O)O)O1)=O,16,1,0,1,48,4.7e-05
G5,C1(C2CC(C(C(C2O)O)O1)O)=O,32,1,0,1,48,4.7e-05
G5,C1(C2CC(CO1)(C(C2O)O)O)=O,16,1,0,1,48,4.7e-05
G5,C1(C2CC(C(C(C2O)O)O)O1)=O,32,1,0,1,48,4.7e-05
G5,C1(C2C(CC(C(CO)C1)(O2)O)O)=O,16,1,0,1,11,4.7e-05
G5,C1(C(C2C(CC(CC1)(O)O2)O)O)=O,16,1,0,1,7,4.7e-05
G5,C(CC1C2(CC(C(C1O)O2)O)O)=O,32,1,0,1,43,4.7e-05
G5,C1(C2C(C(CC(CC1)(O2)O)O)O)=O,16,1,0,1,7,4.7e-05
G5,C1(CC(C=O)C(C(C=O)=O)CC1O)=O,8,1,0,1,7,4.7e-05
G5,C(CC1C(C(CC1C(C=O)=O)O)=O)=O,8,1,0,1,7,4.7e-05
G5,C(C1C(C(C(C1)=O)O)CC(C=O)=O)=O,8,2,0,2,7,9.499999999999999e-05
G5,C(CC1(C=O)C(C(CC1C=O)=O)O)=O,8,1,0,1,43,4.7e-05
G5,C(C1C(C=O)C(C(CC1C=O)=O)O)=O,16,1,0,1,43,4.7e-05
G5,C(C1C(C=O)C(C(C1CC=O)=O)O)=O,16,1,0,1,43,4.7e-05
G5,C1(C(CC(C(C=O)=O)CC1)O)=O,4,1,0,1,7,4.7e-05
G5,C1(C(C(CC1)CC(C=O)=O)O)=O,4,1,0,1,7,4.7e-05
G5,C1(C(CCC(C(CC1)O)=O)O)=O,3,1,0,1,7,4.7e-05
G5,C1(C(CC(C(CO)=O)CC1)O)=O,4,1,0,1,7,4.7e-05
G5,C1(C(C(CC1)CC(CO)=O)O)=O,4,1,0,1,7,4.7e-05
G5,C1(CC(CC1(CCC=O)O)O)=O,4,1,0,1,45,4.8e-05
G5,C(CCC1C(C(CC1O)O)=O)=O,8,1,0,1,45,4.8e-05
G5,C(CCC1C(CC(C1O)=O)O)=O,8,1,0,1,45,4.8e-05
G5,C(CCC1(CC(C(C1)=O)O)O)=O,4,1,0,1,45,4.8e-05
G5,C1(CC(CC1(C(C)CC=O)O)O)=O,8,1,0,1,45,4.8e-05
G5,C(CC(C)C1C(C(CC1O)O)=O)=O,16,1,0,1,45,4.8e-05
G5,C(CC(C)C1C(CC(C1O)=O)O)=O,16,1,0,1,45,4.8e-05
G5,C(CC(C)C1(CC(C(C1)=O)O)O)=O,8,1,0,1,45,4.8e-05
G5,C1(CC(CC1(CCC(O)=O)O)O)=O,4,1,0,1,45,4.8e-05
G5,C(CCC1C(C(CC1O)O)=O)(O)=O,8,1,0,1,45,4.8e-05
G5,C(CCC1C(CC(C1O)=O)O)(O)=O,8,1,0,1,45,4.8e-05
G5,C(CCC1(CC(C(C1)=O)O)O)(O)=O,4,1,0,1,45,4.8e-05
G5,C(CCC1(CC(C(C1O)=O)O)O)=O,8,1,0,1,2,4.8e-05
G5,C1(CC(CO1)C2(C(CC(C2)=O)=O)O)=O,4,1,0,1,26,4.8e-05
G5,C1(CC(CO1)C2C(CC(C2=O)O)=O)=O,8,1,0,1,26,4.8e-05
G5,C1(CC(CO1)C2C(CC(C2O)=O)=O)=O,8,1,0,1,26,4.8e-05
G5,C(CC(C)C1(C(CC(C1)=O)=O)O)=O,4,1,0,1,26,4.8e-05
G5,C(CC(C)C1C(CC(C1=O)O)=O)=O,8,1,0,1,26,4.8e-05
G5,C(CC(C)C1C(CC(C1O)=O)=O)=O,8,1,0,1,26,4.8e-05
G5,C(CCC1(C(CC(C1)=O)=O)O)(O)=O,2,1,0,1,26,4.8e-05
G5,C(CCC1C(CC(C1=O)O)=O)(O)=O,4,2,0,2,18,9.499999999999999e-05
G5,C1(CC(CO1)C2(CC(C(C2)=O)=O)O)=O,2,1,0,1,45,4.8e-05
G5,C1(CC(CO1)C2C(C(CC2O)=O)=O)=O,8,1,0,1,45,4.8e-05
G5,C(CC(C)C1(CC(C(C1)=O)=O)O)=O,2,1,0,1,45,4.8e-05
G5,C(CC(C)C1C(C(CC1O)=O)=O)=O,8,1,0,1,45,4.8e-05
G5,C(CCC1(CC(C(C1)=O)=O)O)(O)=O,1,1,0,1,45,4.8e-05
G5,C1(C(C(C(C1)CC(C)=O)O)O)=O,8,1,0,1,28,4.8e-05
G5,C1(C(C(C(C2C(C=CO2)=O)C1)O)O)=O,16,1,0,1,28,4.8e-05
G5,C1(C(C(C(C2C=CC(O2)=O)C1)O)O)=O,16,1,0,1,28,4.8e-05
G5,C1(CC(CO1)C2(C=CC(C2O)=O)O)=O,8,1,0,1,28,4.8e-05
G5,C1(CC(CO1)C2(C(C=CC2O)=O)O)=O,8,1,0,1,28,4.8e-05
G5,C1(C(C(C(C(CO)CO)C1)O)O)=O,8,1,0,1,18,4.8e-05
G5,C1(C(C(C(CC(CO)O)C1)O)O)=O,16,1,0,1,11,4.8e-05
G5,C1(C(C(C(C(CO)(C)O)C1)O)O)=O,16,1,0,1,11,4.8e-05
G5,C1(C(C(C(C(C(C)O)O)C1)O)O)=O,32,1,0,1,11,4.8e-05
G5,C(CCC1(C(C=CC1O)=O)O)=O,4,1,0,1,28,4.8e-05
G5,C1(C(C(C(C1)CC=CC=O)O)O)=O,16,1,0,1,28,4.8e-05
G5,C(CC(C)C1(C=CC(C1O)=O)O)=O,8,1,0,1,28,4.8e-05
G5,C(CC(C)C1(C(C=CC1O)=O)O)=O,8,1,0,1,28,4.8e-05
G5,C(C(C=C)C1C(C(C(C1)=O)O)O)=O,16,1,0,1,28,4.8e-05
G5,C(CCC1(C=CC(C1O)=O)O)(O)=O,4,1,0,1,28,4.8e-05
G5,C(CCC1(C(C=CC1O)=O)O)(O)=O,4,1,0,1,28,4.8e-05
G5,C1(CC(C(C(C1)CC(C)=O)=O)O)=O,4,1,0,1,45,4.8e-05
G5,C1(CC(C(CC1O)=O)CC(C)=O)=O,4,1,0,1,45,4.8e-05
G5,C(CCC1(C(C=CC(C1)=O)=O)O)=O,2,1,0,1,45,4.8e-05
G5,C(CCC1C(C=CC(C1O)=O)=O)=O,4,1,0,1,45,4.8e-05
G5,C1(CC(C(C(C1)CC=CC=O)=O)O)=O,8,1,0,1,45,4.8e-05
G5,C1(CC(C(CC1O)=O)CC=CC=O)=O,8,1,0,1,45,4.8e-05
G5,C(CC(C)C1(C(C=CC(C1)=O)=O)O)=O,4,1,0,1,45,4.8e-05
G5,C(CC(C)C1C(C=CC(C1O)=O)=O)=O,8,1,0,1,45,4.8e-05
G5,C(C(C=C)C1C(C(CC(C1)=O)O)=O)=O,8,1,0,1,45,4.8e-05
G5,C(C(C=C)C1C(CC(C(C1)=O)O)=O)=O,8,1,0,1,45,4.8e-05
G5,C(CCC1(C(C=CC(C1)=O)=O)O)(O)=O,2,1,0,1,45,4.8e-05
G5,C(CCC1C(C=CC(C1O)=O)=O)(O)=O,4,1,0,1,45,4.8e-05
G5,C(C)(CC1C(C=O)(CC(C1)=O)O)=O,4,1,0,1,45,4.8e-05
G5,C(CCC1C(C=CC1(C=O)O)=O)=O,4,1,0,1,45,4.8e-05
G5,C(C1(C(CC(C1)=O)CC=CC=O)O)=O,8,1,0,1,45,4.8e-05
G5,C(CC(C)C1C(C=CC1(C=O)O)=O)=O,8,1,0,1,45,4.8e-05
G5,C(C1(C(CC(C1)=O)C(C=O)C=C)O)=O,8,1,0,1,45,4.8e-05
G5,C(CCC1C(C=CC1(C=O)O)=O)(O)=O,4,1,0,1,45,4.8e-05
G5,C(C)(CC1C(C=O)C(C(C1)=O)O)=O,8,2,0,2,27,9.499999999999999e-05
G5,C(CCC1(C(C=CC1C=O)=O)O)=O,4,1,0,1,45,4.8e-05
G5,C(CCC1(C=O)C=CC(C1O)=O)=O,4,1,0,1,45,4.8e-05
G5,C(C1C(CC(C1O)=O)CC=CC=O)=O,16,2,0,2,45,9.499999999999999e-05
G5,C(CC(C)C1(C(C=CC1C=O)=O)O)=O,8,1,0,1,45,4.8e-05
G5,C(CC(C)C1(C=O)C=CC(C1O)=O)=O,8,1,0,1,45,4.8e-05
G5,C(C1C(CC(C1O)=O)C(C=O)C=C)=O,16,2,0,2,45,9.499999999999999e-05
G5,C(CCC1(C(C=CC1C=O)=O)O)(O)=O,4,1,0,1,45,4.8e-05
G5,C(CCC1(C=O)C=CC(C1O)=O)(O)=O,4,1,0,1,45,4.8e-05
G5,C(C)(CC1C(CC(C(C1)=O)=O)O)=O,4,1,0,1,27,4.8e-05
G5,C(CCC1(C=CC(C(C1)=O)=O)O)=O,2,1,0,1,27,4.8e-05
G5,C(CCC1C(C(C=CC1O)=O)=O)=O,4,1,0,1,27,4.8e-05
G5,C(CC1C(CC(C(C1)=O)=O)O)=CC=O,8,1,0,1,27,4.8e-05
G5,C(CC(C)C1(C=CC(C(C1)=O)=O)O)=O,4,1,0,1,27,4.8e-05
G5,C(CC(C)C1C(C(C=CC1O)=O)=O)=O,8,1,0,1,27,4.8e-05
G5,C(C(C=C)C1C(CC(C(C1)=O)=O)O)=O,8,1,0,1,27,4.8e-05
G5,C(CCC1(C=CC(C(C1)=O)=O)O)(O)=O,2,1,0,1,27,4.8e-05
G5,C(CCC1C(C(C=CC1O)=O)=O)(O)=O,4,1,0,1,27,4.8e-05
G5,C1(CC(C(C1C=O)O)CC(C)=O)=O,8,1,0,1,45,4.8e-05
G5,C(CCC1(C=CC(C1C=O)=O)O)=O,4,1,0,1,45,4.8e-05
G5,C(CCC1(C=O)C(C=CC1O)=O)=O,4,1,0,1,45,4.8e-05
G5,C(C1C(CC(C1O)CC=CC=O)=O)=O,16,1,0,1,45,4.8e-05
G5,C(CC(C)C1(C=CC(C1C=O)=O)O)=O,8,1,0,1,45,4.8e-05
G5,C(CC(C)C1(C=O)C(C=CC1O)=O)=O,8,1,0,1,45,4.8e-05
G5,C(C(C=C)C1C(C(C=O)C(C1)=O)O)=O,16,1,0,1,45,4.8e-05
G5,C(CCC1(C=CC(C1C=O)=O)O)(O)=O,4,1,0,1,45,4.8e-05
G5,C(CCC1(C=O)C(C=CC1O)=O)(O)=O,4,1,0,1,45,4.8e-05
G5,C(C(C=O)(CCC=O)CO)(O)=O,2,1,0,1,18,4.8e-05
G5,C(C(C=O)(CO)C(C)CC=O)(O)=O,4,1,0,1,18,4.8e-05
G5,C(C(C=O)C(CCC(O)=O)O)(O)=O,4,1,0,1,18,4.8e-05
G5,C(C(C=O)(CCC(O)=O)CO)(O)=O,2,1,0,1,18,4.8e-05
G5,C(C(C=O)(CCC=O)C(C)O)(O)=O,4,1,0,1,4,4.8e-05
G5,C(C(C=O)C(CCCC=O)O)(O)=O,4,1,0,1,4,4.8e-05
G5,C(C(C=O)C(C)(CCC=O)O)(O)=O,4,1,0,1,4,4.8e-05
G5,C(CCC(C(O)=O)C(C(O)=O)=O)=O,2,1,0,1,17,4.8e-05
G5,C(CCC(C(O)=O)C(C(C)=O)=O)=O,2,1,0,1,17,4.8e-05
G5,C(CC=O)(C(C(O)=O)CCC=O)=O,2,1,0,1,17,4.8e-05
G5,C(C(C(CC(O)=O)=O)CCC=O)=O,2,1,0,1,17,4.8e-05
G5,C(C(C(CCCC=O)=O)C(O)=O)=O,2,1,0,1,17,4.8e-05
G5,C(CCCC(C)=O)(C(C(O)=O)O)=O,2,1,0,1,17,4.8e-05
G5,C(C(C(C=C)=O)(CCC=O)O)(O)=O,2,1,0,1,17,4.8e-05
G5,C(C(CCC=O)(C(CCO)O)O)=O,4,1,0,1,0,4.8e-05
G5,C(CCC(CC(C(C=O)O)O)O)=O,8,1,0,1,0,4.8e-05
G5,C(CCC(CO)C(C(C=O)O)O)=O,8,1,0,1,0,4.8e-05
G5,C(C(CO)C(C(CCC=O)O)O)=O,8,1,0,1,6,4.8e-05
G5,C(C(CCC=O)(CO)C(CO)O)=O,4,1,0,1,6,4.8e-05
G5,C(C(C=O)C(C(CCC=O)O)O)=O,4,1,0,1,0,4.8e-05
G5,C(C(C=O)(CCC=O)C(CO)O)=O,2,1,0,1,0,4.8e-05
G5,C(C(CCC=O)(C(C(C)O)O)O)=O,8,1,0,1,11,4.8e-05
G5,C(CCCC(C(C(C=O)O)O)O)=O,8,1,0,1,11,4.8e-05
G5,C(CCC(C)(C(C(C=O)O)O)O)=O,8,1,0,1,11,4.8e-05
G5,C(CCC(C(C)O)(C(C=O)O)O)=O,8,1,0,1,11,4.8e-05
G5,C(CC(C)C(C(O)=O)C(C=O)=O)=O,4,1,0,1,17,4.8e-05
G5,C(CCC(C=O)(C=O)C(C=O)O)=O,2,1,0,1,0,4.8e-05
G5,C(C(CO)(CO)C(CO)CC=O)=O,2,1,0,1,18,4.8e-05
G5,C(C(CO)C(C1COC(C1)=O)O)=O,8,1,0,1,18,4.8e-05
G5,C(C(CO)(CO)C1COC(C1)=O)=O,2,1,0,1,18,4.8e-05
G5,C(C(CCC=O)(CO)CO)=O,1,1,0,1,18,4.8e-05
G5,C(C(CO)(CO)C(C)CC=O)=O,2,1,0,1,18,4.8e-05
G5,C(C(CO)C(CCC(O)=O)O)=O,4,1,0,1,18,4.8e-05
G5,C(C(CCC(O)=O)(CO)CO)=O,1,1,0,1,18,4.8e-05
G5,C(C(CCC=O)(CO)C(C)O)=O,4,1,0,1,18,4.8e-05
G5,C(C(CO)C(CCCC=O)O)=O,4,1,0,1,18,4.8e-05
G5,C(C(CO)C(C)(CCC=O)O)=O,4,1,0,1,18,4.8e-05
G5,C(C(CO)(C(C)CC=O)C(C)O)=O,8,1,0,1,18,4.8e-05
G5,C(C(CO)C(CC(C)CC=O)O)=O,8,1,0,1,18,4.8e-05
G5,C(C(CO)C(C)(C(C)CC=O)O)=O,8,1,0,1,18,4.8e-05
G5,C(C(C(C)O)C(CCC(O)=O)O)=O,8,1,0,1,18,4.8e-05
G5,C(C(CCC(O)=O)(CO)C(C)O)=O,4,1,0,1,18,4.8e-05
G5,C(C(CO)C(CCCC(O)=O)O)=O,4,1,0,1,18,4.8e-05
G5,C(C(CO)C(C)(CCC(O)=O)O)=O,4,1,0,1,18,4.8e-05
G5,C(CCC(C(C(C)=O)=O)(CO)O)=O,2,1,0,1,0,4.8e-05
G5,C(CCC(C(C(CO)=O)=O)CO)=O,2,1,0,1,2,4.8e-05
G5,C(CCC(C(C(C)O)=O)(CO)O)=O,4,1,0,1,2,4.8e-05
G5,C(CCC(C(C(CO)O)=O)(C)O)=O,4,1,0,1,2,4.8e-05
G5,C(C(C=O)(CO)C(CO)CC=O)=O,2,1,0,1,18,4.8e-05
G5,C(C(C=O)C(C1COC(C1)=O)O)=O,4,1,0,1,18,4.8e-05
G5,C(C(C=O)(CO)C1COC(C1)=O)=O,2,1,0,1,18,4.8e-05
G5,C(C(C=O)(CCC=O)CO)=O,1,1,0,1,18,4.8e-05
G5,C(C(C=O)(CO)C(C)CC=O)=O,2,1,0,1,18,4.8e-05
G5,C(C(C=O)C(CCC(O)=O)O)=O,2,1,0,1,18,4.8e-05
G5,C(C(C=O)(CCC(O)=O)CO)=O,1,1,0,1,18,4.8e-05
G5,C(C(C(C=O)=O)(CCC=O)CO)=O,2,1,0,1,2,4.8e-05
G5,C(CCC(C(C(C)=O)=O)CO)=O,2,1,0,1,14,4.8e-05
G5,C(CC(C)C(C(C(C)=O)=O)CO)=O,4,1,0,1,14,4.8e-05
G5,C(CC(C)CC(C(CCO)=O)=O)=O,2,1,0,1,14,4.8e-05
G5,C(CCC(CC(C(C)=O)=O)O)(O)=O,2,1,0,1,14,4.8e-05
G5,C(CCC(C(C(C)=O)=O)CO)(O)=O,2,1,0,1,14,4.8e-05
G5,C(C(CCC=O)CO)(CC=O)=O,2,1,0,1,2,4.8e-05
G5,C(C(C(CCO)=O)CCC=O)=O,2,1,0,1,2,4.8e-05
G5,C(C(CO)C(C)CC=O)(CC=O)=O,4,1,0,1,2,4.8e-05
G5,C(C(C(CCO)=O)C(C)CC=O)=O,4,1,0,1,2,4.8e-05
G5,C(CC(CC(CCC(O)=O)O)=O)=O,2,1,0,1,2,4.8e-05
G5,C(C(CCC(O)=O)CO)(CC=O)=O,2,1,0,1,2,4.8e-05
G5,C(C(C(CCO)=O)CCC(O)=O)=O,2,1,0,1,2,4.8e-05
G5,C(C(C(CCCC=O)=O)CO)=O,2,1,0,1,6,4.8e-05
G5,C(CCC(C=O)(C(C)=O)CO)=O,2,1,0,1,6,4.8e-05
G5,C(C(C(CC(C)CC=O)=O)CO)=O,4,1,0,1,6,4.8e-05
G5,C(CC(C)C(C=O)(C(C)=O)CO)=O,4,1,0,1,6,4.8e-05
G5,C(CCC(C(C=O)C(C)=O)O)(O)=O,4,1,0,1,6,4.8e-05
G5,C(C(C(CCCC(O)=O)=O)CO)=O,2,1,0,1,6,4.8e-05
G5,C(CCC(C=O)(C(C)=O)CO)(O)=O,2,1,0,1,6,4.8e-05
G5,C(CCC1(C(C(CO1)=O)CO)O)=O,4,1,0,1,27,4.8e-05
G5,C(CCC1(C(COC1O)=O)CO)=O,4,1,0,1,27,4.8e-05
G5,C(CCC1C(C(CO)C(O1)O)=O)=O,8,1,0,1,27,4.8e-05
G5,C(CCC1(CC(C(CO)O1)=O)O)=O,4,1,0,1,27,4.8e-05
G5,C(CCC1C(C(CO)OC1O)=O)=O,8,1,0,1,27,4.8e-05
G5,C1(CC(OC1(CO)CCC=O)O)=O,4,1,0,1,27,4.8e-05
G5,C(C(CO)O)(CCCC(C)=O)=O,2,1,0,1,7,4.8e-05
G5,C(C(CO)O)(CCC(CO)CO)=O,2,1,0,1,18,4.8e-05
G5,C(C(CO)O)(CCCC(CO)O)=O,4,1,0,1,11,4.8e-05
G5,C(C(CO)O)(CCC(CO)(C)O)=O,4,1,0,1,11,4.8e-05
G5,C(C(CO)O)(CCC(C(C)O)O)=O,8,1,0,1,11,4.8e-05
G5,C(CCC(C(C=C)=O)(CO)O)=O,2,1,0,1,7,4.8e-05
G5,C(C(CO)O)(CCCC=CC=O)=O,4,1,0,1,7,4.8e-05
G5,C(CC(C)C(C(C=C)=O)(CO)O)=O,4,1,0,1,7,4.8e-05
G5,C(C(C=C)CCC(C(CO)O)=O)=O,4,1,0,1,7,4.8e-05
G5,C(CCC(C(C(C=C)=O)O)O)(O)=O,4,1,0,1,7,4.8e-05
G5,C(CCC(C(C=C)=O)(CO)O)(O)=O,2,1,0,1,7,4.8e-05
G5,C(CCC1(C(C(CO1)O)=O)CO)=O,4,1,0,1,27,4.8e-05
G5,C(CCC1(C(C(CO)OC1)=O)O)=O,4,1,0,1,27,4.8e-05
G5,C(CCC1C(C(C(CO)O1)=O)O)=O,8,1,0,1,27,4.8e-05
G5,C(CCC1(C(C(CO)CO1)=O)O)=O,4,1,0,1,34,4.8e-05
G5,C(CCC1(C(C(O)OC1)=O)CO)=O,4,1,0,1,34,4.8e-05
G5,C(CCC1C(C(C(O)O1)=O)CO)=O,8,1,0,1,34,4.8e-05
G5,C(C(CCC=O)C(CCO)O)=O,4,1,0,1,18,4.8e-05
G5,C(CCC(CC(CC=O)O)O)=O,4,1,0,1,18,4.8e-05
G5,C(CC(C(CCC=O)CO)O)=O,4,1,0,1,18,4.8e-05
G5,C(CCC(CCO)(CC=O)O)=O,2,1,0,1,18,4.8e-05
G5,C(C(C(C)CC=O)C(CCO)O)=O,8,1,0,1,18,4.8e-05
G5,C(CC(C)C(CC(CC=O)O)O)=O,8,1,0,1,18,4.8e-05
G5,C(CC(C(CO)C(C)CC=O)O)=O,8,1,0,1,18,4.8e-05
G5,C(CC(C)C(CCO)(CC=O)O)=O,4,1,0,1,18,4.8e-05
G5,C(C(CCC(O)=O)C(CCO)O)=O,4,1,0,1,18,4.8e-05
G5,C(CCC(CC(CC=O)O)O)(O)=O,4,1,0,1,18,4.8e-05
G5,C(CCC(CO)C(CC=O)O)(O)=O,4,1,0,1,18,4.8e-05
G5,C(CCC(CCO)(CC=O)O)(O)=O,2,1,0,1,18,4.8e-05
G5,C(C(CCC=O)C(CC(C)O)O)=O,8,1,0,1,28,4.8e-05
G5,C(CCC(C(CC=O)O)C(C)O)=O,8,1,0,1,28,4.8e-05
G5,C(CC(CCC=O)(CC(C)O)O)=O,4,1,0,1,28,4.8e-05
G5,C(CC(CC(CCCC=O)O)O)=O,4,1,0,1,28,4.8e-05
G5,C(CCC(C)(CC(CC=O)O)O)=O,4,1,0,1,28,4.8e-05
G5,C(C(C(C)O)C(CCCC=O)O)=O,8,1,0,1,4,4.8e-05
G5,C(C(C(C)O)C(C)(CCC=O)O)=O,8,1,0,1,4,4.8e-05
G5,C(C(CCC=O)(C(C)O)C(C)O)=O,3,1,0,1,4,4.8e-05
G5,C(CCC(C)(C(C(C=O)=O)O)O)=O,4,1,0,1,0,4.8e-05
G5,C(C(CCC=O)C(CC=O)O)=O,4,1,0,1,45,4.8e-05
G5,C(C(C(CC=O)O)C(C)CC=O)=O,8,1,0,1,45,4.8e-05
G5,C(CC(C(C)CC=O)(CC=O)O)=O,2,1,0,1,45,4.8e-05
G5,C(C(CCC(O)=O)C(CC=O)O)=O,4,1,0,1,45,4.8e-05
G5,C(CCC(CC=O)(CC=O)O)(O)=O,1,1,0,1,45,4.8e-05
G5,C(C(C=O)C(CCCC=O)O)=O,2,1,0,1,4,4.8e-05
G5,C(C(C=O)C(C)(CCC=O)O)=O,2,1,0,1,4,4.8e-05
G5,C(C(C=O)(CCC=O)C(C)O)=O,2,1,0,1,4,4.8e-05
G5,C(C(C=O)C(CC(C)CC=O)O)=O,4,1,0,1,4,4.8e-05
G5,C(C(C=O)C(C)(C(C)CC=O)O)=O,4,1,0,1,4,4.8e-05
G5,C(C(C=O)(C(C)CC=O)C(C)O)=O,4,1,0,1,4,4.8e-05
G5,C(C(C=O)C(CCCC(O)=O)O)=O,2,1,0,1,4,4.8e-05
G5,C(C(C=O)C(C)(CCC(O)=O)O)=O,2,1,0,1,4,4.8e-05
G5,C(C(C=O)(CCC(O)=O)C(C)O)=O,2,1,0,1,4,4.8e-05
G5,C(CCC(C=O)C(C(O)=O)(C)O)=O,4,1,0,1,28,4.8e-05
G5,C(CCCC(CC(C(O)=O)=O)O)=O,2,1,0,1,4,4.8e-05
G5,C(CCC(C)(CC(C(O)=O)=O)O)=O,2,1,0,1,4,4.8e-05
G5,C(CCC(C(C(O)=O)=O)C(C)O)=O,4,1,0,1,4,4.8e-05
G5,C(C(C=O)C(CO)CC=O)(O)=O,4,1,0,1,28,4.8e-05
G5,C(C(C(O)=O)C(C(O)=O)CC=O)=O,4,1,0,1,18,4.8e-05
G5,C(C(C(O)=O)C1COC(C1)=O)=O,4,1,0,1,28,4.8e-05
G5,C(C(C(O)=O)CCC(C(O)=O)=O)=O,2,1,0,1,7,4.8e-05
G5,C(C(C(O)=O)C(C)CC(C=O)=O)=O,4,1,0,1,28,4.8e-05
G5,C(C(C(O)=O)C(C(C)=O)CC=O)=O,4,1,0,1,28,4.8e-05
G5,C(C(C(O)=O)C(C=O)CC(C)=O)=O,4,1,0,1,28,4.8e-05
G5,C(C(CC(C=O)C(O)=O)CC=O)=O,4,1,0,1,28,4.8e-05
G5,C(C(C)(CC=O)C(C=O)C(O)=O)=O,4,1,0,1,28,4.8e-05
G5,C(C(C)C(C=O)C(C=O)C(O)=O)=O,8,1,0,1,28,4.8e-05
G5,C(C(C=O)C(C)CC(CO)=O)(O)=O,4,1,0,1,28,4.8e-05
G5,C(C(C=O)C(C)(CO)CC=O)(O)=O,4,1,0,1,28,4.8e-05
G5,C(C(C(O)=O)C(C)CC=O)=O,4,1,0,1,28,4.8e-05
G5,C(C(C(O)=O)CCC(O)=O)=O,2,1,0,1,18,4.8e-05
G5,C(C(C=O)C(CO)CC(O)=O)(O)=O,4,1,0,1,18,4.8e-05
G5,C(C(C(O)=O)C(CC=O)CC=O)=O,2,1,0,1,28,4.8e-05
G5,C(CCC(C=O)C(C(C)=O)(C)O)=O,4,1,0,1,14,4.8e-05
G5,C(C)(C(CCCC=O)(CC=O)O)=O,2,1,0,1,14,4.8e-05
G5,C(C(C)(CC=O)O)(CCCC=O)=O,2,1,0,1,14,4.8e-05
G5,C(CCCC(CC(C(C)=O)=O)O)=O,2,1,0,1,4,4.8e-05
G5,C(CCC(C)(CC(C(C)=O)=O)O)=O,2,1,0,1,4,4.8e-05
G5,C(CCC(C(C(C)=O)=O)C(C)O)=O,4,1,0,1,4,4.8e-05
G5,C(CCCC(C(CC(C)O)=O)=O)=O,2,1,0,1,4,4.8e-05
G5,C(C(CCC=O)C(C)(CC=O)O)=O,4,1,0,1,6,4.8e-05
G5,C(CC(CCCC=O)(CC=O)O)=O,1,1,0,1,6,4.8e-05
G5,C(C(CCC=O)C(CC(C)=O)O)=O,4,1,0,1,6,4.8e-05
G5,C(CCCC(CC(CC=O)O)=O)=O,2,1,0,1,6,4.8e-05
G5,C(CCC(C(C)=O)C(CC=O)O)=O,4,1,0,1,6,4.8e-05
G5,C(CC(CC(CCCC=O)O)=O)=O,2,1,0,1,4,4.8e-05
G5,C(CC(CC(C)(CCC=O)O)=O)=O,2,1,0,1,4,4.8e-05
G5,C(C(CCC=O)C(C)O)(CC=O)=O,4,1,0,1,4,4.8e-05
G5,C(C(C(CC(C)O)=O)CCC=O)=O,4,1,0,1,4,4.8e-05
G5,C(CCCC(C(C=O)C(C)=O)O)=O,4,1,0,1,4,4.8e-05
G5,C(CCC(C)(C(C=O)C(C)=O)O)=O,4,1,0,1,4,4.8e-05
G5,C(C(C(CCCC=O)=O)C(C)O)=O,4,1,0,1,4,4.8e-05
G5,C(CCC(C=O)(C(C)=O)C(C)O)=O,4,1,0,1,4,4.8e-05
G5,C(C)(CCCC(C(CC=O)O)=O)=O,2,1,0,1,7,4.8e-05
G5,C(CCC(C=O)C(C(C=C)=O)O)=O,4,1,0,1,7,4.8e-05
G5,C(CCC(C(C=C)=O)(CC=O)O)=O,2,1,0,1,7,4.8e-05
G5,C(CC(C(CCCC=CC=O)=O)O)=O,4,1,0,1,7,4.8e-05
G5,C(CC(C)C(C=O)C(C(C=C)=O)O)=O,8,1,0,1,7,4.8e-05
G5,C(CC(C)C(C(C=C)=O)(CC=O)O)=O,4,1,0,1,7,4.8e-05
G5,C(CC(C(CCC(C=O)C=C)=O)O)=O,4,1,0,1,7,4.8e-05
G5,C(CCC(C=O)C(C=O)(C=C)O)=O,4,1,0,1,7,4.8e-05
G5,C(CC(C)C(C=O)C(C=O)(C=C)O)=O,8,1,0,1,7,4.8e-05
G5,C(CCC(C=O)C(C=C)(CO)O)=O,4,1,0,1,7,4.8e-05
G5,C(CCC(C(C=C)(CC=O)O)O)=O,4,1,0,1,7,4.8e-05
G5,C(C(C(C)O)O)(CCCC(C)=O)=O,4,1,0,1,4,4.8e-05
G5,C(CCCC(C(C(C=C)=O)O)O)=O,4,1,0,1,4,4.8e-05
G5,C(CCC(C)(C(C(C=C)=O)O)O)=O,4,1,0,1,4,4.8e-05
G5,C(CCC(C(C=C)=O)(C(C)O)O)=O,4,1,0,1,4,4.8e-05
G5,C(CC(C(CC=O)O)CC(C)=O)=O,4,1,0,1,43,4.8e-05
G5,C(CCC(C=O)C(C=CC=O)O)=O,8,1,0,1,43,4.8e-05
G5,C(CCC(C=CC=O)(CC=O)O)=O,4,1,0,1,43,4.8e-05
G5,C(CC(C(CC=O)O)CC=CC=O)=O,8,1,0,1,43,4.8e-05
G5,C(CC(C)C(C=O)C(C=CC=O)O)=O,16,1,0,1,43,4.8e-05
G5,C(CC(C)C(C=CC=O)(CC=O)O)=O,8,1,0,1,43,4.8e-05
G5,C(C(C=C)C(C(CC=O)O)CC=O)=O,8,1,0,1,43,4.8e-05
G5,C(C(CCC=O)C(C(C)O)O)=O,8,1,0,1,11,4.8e-05
G5,C(CCCC(C(CC=O)O)O)=O,4,1,0,1,11,4.8e-05
G5,C(CCC(C)(C(CC=O)O)O)=O,4,1,0,1,11,4.8e-05
G5,C(CC(CCC=O)(C(C)O)O)=O,4,1,0,1,11,4.8e-05
G5,C(C(C(C)CC=O)C(C(C)O)O)=O,16,1,0,1,11,4.8e-05
G5,C(CC(C)CC(C(CC=O)O)O)=O,8,1,0,1,11,4.8e-05
G5,C(CC(C(C)(C(C)CC=O)O)O)=O,8,1,0,1,11,4.8e-05
G5,C(CC(C(C)CC=O)(C(C)O)O)=O,8,1,0,1,11,4.8e-05
G5,C(C(CCC(O)=O)C(C(C)O)O)=O,8,1,0,1,11,4.8e-05
G5,C(CCCC(C(CC=O)O)O)(O)=O,4,1,0,1,11,4.8e-05
G5,C(CCC(C)(C(CC=O)O)O)(O)=O,4,1,0,1,11,4.8e-05
G5,C(CCC(C(C)O)(CC=O)O)(O)=O,4,1,0,1,11,4.8e-05
G5,C(C(CCC=O)(CC(C)O)O)(O)=O,4,1,0,1,27,4.8e-05
G5,C(CCC(C(C)O)C(C(O)=O)O)=O,8,1,0,1,27,4.8e-05
G5,C(CCCC(CC(C(O)=O)O)O)=O,4,1,0,1,27,4.8e-05
G5,C(CCC(C)(CC(C(O)=O)O)O)=O,4,1,0,1,27,4.8e-05
G5,C(C(CO)(CCCC=O)O)(O)=O,2,1,0,1,25,4.8e-05
G5,C(C(CO)(CC(C)CC=O)O)(O)=O,4,1,0,1,25,4.8e-05
G5,C(C(C)(C(CCC(O)=O)O)O)(O)=O,4,1,0,1,25,4.8e-05
G5,C(C(CO)(CCCC(O)=O)O)(O)=O,2,1,0,1,25,4.8e-05
G5,C(C)(C(CCC=O)C(C(O)=O)O)=O,4,1,0,1,26,4.8e-05
G5,C(C(C)(CC(CO)CC=O)O)(O)=O,4,1,0,1,14,4.8e-05
G5,C(C(C)(CC1COC(C1)=O)O)(O)=O,4,1,0,1,14,4.8e-05
G5,C(C(C)(CCCC=O)O)(O)=O,2,1,0,1,14,4.8e-05
G5,C(C(C)(CC(C)CC=O)O)(O)=O,4,1,0,1,14,4.8e-05
G5,C(C(C)(CCCC(O)=O)O)(O)=O,2,1,0,1,14,4.8e-05
G5,C(C(C=C)(C(CO)CC=O)O)(O)=O,4,1,0,1,7,4.8e-05
G5,C(C(C=C)(C1COC(C1)=O)O)(O)=O,4,1,0,1,7,4.8e-05
G5,C(C(C=C)(CCC=O)O)(O)=O,2,1,0,1,7,4.8e-05
G5,C(C(C=C)(C(C)CC=O)O)(O)=O,4,1,0,1,7,4.8e-05
G5,C(C(C=C)(CCC(O)=O)O)(O)=O,2,1,0,1,7,4.8e-05
G5,C(CC(CO)CC(C(C=O)=O)=O)=O,2,2,0,2,17,9.6e-05
G5,C1(CC(CO1)CC(C(C=O)=O)=O)=O,2,1,0,1,25,4.8e-05
G5,C(C(CC(C)CC(C(C=O)=O)=O)=O)=O,2,1,0,1,25,4.8e-05
G5,C(CC(C(C)=O)CC(C(C=O)=O)=O)=O,2,1,0,1,25,4.8e-05
G5,C(C(CC(C(C=O)=O)=O)CC(C)=O)=O,2,1,0,1,25,4.8e-05
G5,C(C(CCC(C(C=O)=O)=O)CC=O)=O,2,1,0,1,25,4.8e-05
G5,C(C(C)(CC=O)CC(C(C=O)=O)=O)=O,2,1,0,1,25,4.8e-05
G5,C(C(C)C(C=O)CC(C(C=O)=O)=O)=O,4,1,0,1,25,4.8e-05
G5,C(CCCC(C(C=O)=O)=O)=O,1,1,0,1,25,4.8e-05
G5,C(CC(C)CC(C(C=O)=O)=O)=O,2,1,0,1,25,4.8e-05
G5,C(CCCC(C(C=O)=O)=O)(O)=O,1,1,0,1,18,4.8e-05
G5,C(CC(CC=O)CC(C(C=O)=O)=O)=O,1,1,0,1,25,4.8e-05
G5,C(CCC(C(CO)=O)C(C=O)=O)=O,2,1,0,1,51,4.8e-05
G5,C(CCC(C(CC(C=O)=O)=O)O)=O,2,1,0,1,51,4.8e-05
G5,C(CCC(C(C)=O)(C(C=O)=O)O)=O,2,1,0,1,0,4.8e-05
G5,C(CCCC(C(C(C=O)=O)O)=O)=O,2,2,0,2,33,9.6e-05
G5,C(C(C(C=O)=O)(CCC=O)O)=O,2,1,0,1,5,4.8e-05
G5,C(C(C(C=O)=O)(C(C)CC=O)O)=O,4,1,0,1,5,4.8e-05
G5,C(C(C(C=O)=O)(CCC(O)=O)O)=O,2,1,0,1,5,4.8e-05
G5,C(CCC(C(C)=O)C(C(C=O)=O)=O)=O,2,1,0,1,27,4.8e-05
G5,C(CCCC(CC(C(C=O)=O)=O)=O)=O,1,1,0,1,27,4.8e-05
G5,C(CCC(C(C(C=O)=O)=O)CC=O)=O,2,1,0,1,27,4.8e-05
G5,C(CCC(C=O)CC(C(C=O)=O)=O)=O,2,1,0,1,27,4.8e-05
G5,C(CCC(C(C=O)=O)C(C(C)=O)=O)=O,2,1,0,1,27,4.8e-05
G5,C(CCCC(C(CC(C=O)=O)=O)=O)=O,1,1,0,1,27,4.8e-05
G5,C(CC=O)(C(C(C=O)=O)CCC=O)=O,2,1,0,1,27,4.8e-05
G5,C(C(C(CC(C=O)=O)=O)CCC=O)=O,2,1,0,1,27,4.8e-05
G5,C(CCC(C=CC(C(C=O)=O)=O)O)=O,4,1,0,1,17,4.8e-05
G5,C(CCC(C(C=O)=O)(C(C=C)=O)O)=O,2,1,0,1,33,4.8e-05
G5,C(CCC(C(C=CC(C=O)=O)=O)O)=O,4,1,0,1,12,4.8e-05
G5,C(CCC(C=CC=O)(C(C=O)=O)O)=O,4,1,0,1,43,4.8e-05
G5,C(C(C(C=O)=O)(CCCC=O)O)=O,2,1,0,1,0,4.8e-05
G5,C(CCCC(C(C=O)=O)(CO)O)=O,2,1,0,1,0,4.8e-05
G5,C(CCC(C(C(C=O)C=O)=O)O)=O,2,1,0,1,1,4.8e-05
G5,C(C(C(C(C=O)O)=O)CCC=O)=O,4,1,0,1,1,4.8e-05
G5,C(C(C(CC=O)=O)(CCC=O)O)=O,2,1,0,1,1,4.8e-05
G5,C(CCC(C(C)=O)C(CO)=O)=O,2,1,0,1,26,4.8e-05
G5,C(CCC(C(CC(C)=O)=O)O)=O,2,1,0,1,26,4.8e-05
G5,C(CC(C)CC(CC(CO)=O)=O)=O,2,1,0,1,26,4.8e-05
G5,C(CC(C)C(C(C)=O)C(CO)=O)=O,4,1,0,1,26,4.8e-05
G5,C(CC(C)C(C(CC(C)=O)=O)O)=O,4,1,0,1,26,4.8e-05
G5,C(CCC(C(C)=O)C(CO)=O)(O)=O,2,1,0,1,26,4.8e-05
G5,C(CCC(C(CC(C)=O)=O)O)(O)=O,2,1,0,1,26,4.8e-05
G5,C(CCC(C(C)=O)(C(C)=O)O)=O,1,1,0,1,49,4.8e-05
G5,C(CC(C)CC(C(C(C)=O)O)=O)=O,4,1,0,1,49,4.8e-05
G5,C(CC(C)C(C(C)=O)(C(C)=O)O)=O,2,1,0,1,49,4.8e-05
G5,C(CCCC(C(C(C)=O)O)=O)(O)=O,2,2,0,2,18,9.499999999999999e-05
G5,C(CCC(C(C)=O)(C(C)=O)O)(O)=O,1,1,0,1,49,4.8e-05
G5,C(CC(CO)CC(CCO)=O)=O,2,1,0,1,28,4.8e-05
G5,C(CC(CO)C(C(C)=O)CO)=O,4,1,0,1,28,4.8e-05
G5,C(C)(C(CO)C(C=O)CC(O)=O)=O,4,1,0,1,18,4.8e-05
G5,C(C)(CC(C(C=O)CC(O)=O)O)=O,4,1,0,1,18,4.8e-05
G5,C(CC(C(O)=O)CC=O)(CCO)=O,2,2,0,2,46,9.6e-05
G5,C(C)(C(CO)C(C(O)=O)CC=O)=O,4,1,0,1,18,4.8e-05
G5,C(C)(CC(C(C(O)=O)CC=O)O)=O,4,1,0,1,18,4.8e-05
G5,C1(CC(CO1)CC(CCO)=O)=O,2,1,0,1,28,4.8e-05
G5,C1(CC(CO1)C(C(C)=O)CO)=O,4,1,0,1,28,4.8e-05
G5,C1(CC(CO1)C(CC(C)=O)O)=O,4,1,0,1,28,4.8e-05
G5,C(CCCC(C(O)=O)=O)(CCO)=O,1,1,0,1,7,4.8e-05
G5,C(C)(C(CCC(C(O)=O)=O)CO)=O,2,1,0,1,7,4.8e-05
G5,C(C)(CC(CCC(C(O)=O)=O)O)=O,2,1,0,1,7,4.8e-05
G5,C(CC(C)CC(C=O)=O)(CCO)=O,2,1,0,1,28,4.8e-05
G5,C(C)(C(CO)C(C)CC(C=O)=O)=O,4,1,0,1,28,4.8e-05
G5,C(CC(C(C)=O)CC=O)(CCO)=O,2,1,0,1,28,4.8e-05
G5,C(C)(C(CO)C(C(C)=O)CC=O)=O,4,1,0,1,28,4.8e-05
G5,C(CC(C=O)CC(CCO)=O)(C)=O,2,2,0,2,27,9.499999999999999e-05
G5,C(CC(C=O)C(C(C)=O)CO)(C)=O,4,1,0,1,28,4.8e-05
G5,C(C)(CC(C(C=O)CC(C)=O)O)=O,4,1,0,1,28,4.8e-05
G5,C(CCC(C=O)CC=O)(CCO)=O,2,1,0,1,28,4.8e-05
G5,C(C)(C(CC(C=O)CC=O)CO)=O,4,1,0,1,28,4.8e-05
G5,C(C(C)(CC(CCO)=O)CC=O)=O,2,1,0,1,28,4.8e-05
G5,C(C)(C(CO)C(C=O)(C)CC=O)=O,4,1,0,1,28,4.8e-05
G5,C(C)(CC(C(C=O)(C)CC=O)O)=O,4,1,0,1,28,4.8e-05
G5,C(CC(C=O)C(C=O)C)(CCO)=O,4,1,0,1,28,4.8e-05
G5,C(C)(C(CO)C(C=O)C(C=O)C)=O,8,1,0,1,28,4.8e-05
G5,C(CCCC(CCO)=O)=O,1,1,0,1,28,4.8e-05
G5,C(CCC(C(C)=O)CO)=O,2,1,0,1,28,4.8e-05
G5,C(CC(C)CC(CO)=O)(CCO)=O,2,1,0,1,28,4.8e-05
G5,C(C)(C(CO)C(C)CC(CO)=O)=O,4,1,0,1,28,4.8e-05
G5,C(CC(C)(CO)CC(CCO)=O)=O,2,1,0,1,28,4.8e-05
G5,C(CC(C)(CO)C(C(C)=O)CO)=O,4,1,0,1,28,4.8e-05
G5,C(CC(C)(CO)C(CC(C)=O)O)=O,4,1,0,1,28,4.8e-05
G5,C(CC(C)CC(CCO)=O)=O,2,1,0,1,28,4.8e-05
G5,C(CC(C)C(C(C)=O)CO)=O,4,1,0,1,28,4.8e-05
G5,C(CCCC(CCO)=O)(O)=O,1,1,0,1,18,4.8e-05
G5,C(CCC(C(C)=O)CO)(O)=O,2,1,0,1,18,4.8e-05
G5,C(CCC(CC(C)=O)O)(O)=O,2,1,0,1,18,4.8e-05
G5,C(CC(CO)CC(CCO)=O)(O)=O,2,1,0,1,18,4.8e-05
G5,C(CC(CO)C(C(C)=O)CO)(O)=O,4,1,0,1,18,4.8e-05
G5,C(CC(CO)C(CC(C)=O)O)(O)=O,4,1,0,1,18,4.8e-05
G5,C(CC(CC=O)CC(CCO)=O)=O,1,1,0,1,28,4.8e-05
G5,C(CC(CC=O)C(C(C)=O)CO)=O,2,1,0,1,28,4.8e-05
G5,C(C(C(CC=O)=O)C1COC(C1)=O)=O,4,1,0,1,9,4.8e-05
G5,C(C(C(CC=O)=O)CCC=O)=O,2,1,0,1,9,4.8e-05
G5,C(C(C(CC=O)=O)C(C)CC=O)=O,4,1,0,1,9,4.8e-05
G5,C(C(C(CC=O)=O)CCC(O)=O)=O,2,1,0,1,9,4.8e-05
G5,C(C(C(CC(C)=O)=O)CCC=O)=O,2,1,0,1,27,4.8e-05
G5,C(CCC(C(CC=O)=O)C(C)=O)=O,2,1,0,1,27,4.8e-05
G5,C(CC(CC(CCCC=O)=O)=O)=O,1,1,0,1,27,4.8e-05
G5,C(C(C(CC(C)=O)=O)C(C)CC=O)=O,4,1,0,1,27,4.8e-05
G5,C(CC(C)C(C(CC=O)=O)C(C)=O)=O,4,1,0,1,27,4.8e-05
G5,C(CC(CC(CC(C)CC=O)=O)=O)=O,2,1,0,1,27,4.8e-05
G5,C(C)(CC(CO)CC(CO)=O)=O,2,1,0,1,11,4.8e-05
G5,C(CC(CO)CC(C)=O)(CC=O)=O,2,1,0,1,0,4.8e-05
G5,C(C)(CC(CO)CC(C=O)=O)=O,2,1,0,1,55,4.8e-05
G5,C(CC(CO)CC(C)=O)=O,2,1,0,1,28,4.8e-05
G5,C(C(CC(C)=O)CC(CO)=O)(O)=O,2,1,0,1,18,4.8e-05
G5,C(C(CC(O)=O)CC(C)=O)=O,2,2,0,2,18,9.499999999999999e-05
G5,C(CC(C(O)=O)CC(C)=O)=O,2,1,0,1,18,4.8e-05
G5,C(C)(CCCC(C(CO)=O)=O)=O,1,1,0,1,7,4.8e-05
G5,C(C)(CCCC(C(C(C)O)=O)=O)=O,2,1,0,1,7,4.8e-05
G5,C(C)(CC1C(OCC(C1)=O)O)=O,4,1,0,1,27,4.8e-05
G5,C(C)(CC1COC(C1)=O)=O,2,1,0,1,28,4.8e-05
G5,C(CC(C(C=O)O)CC(C)=O)=O,4,1,0,1,20,4.8e-05
G5,C(CO)(C(CC(C)=O)CC(C)=O)=O,1,1,0,1,45,4.8e-05
G5,C(C)(C(CC(C)=O)CC(CO)=O)=O,2,1,0,1,45,4.8e-05
G5,C(C)(CC(CC=O)CC(CO)=O)=O,2,2,0,2,27,9.499999999999999e-05
G5,C(C)(CC(CCO)CC(C=O)=O)=O,2,1,0,1,29,4.8e-05
G5,C(C)(CC(CO)CC(C(C)=O)=O)=O,2,1,0,1,27,4.8e-05
G5,C(CC(C(CCO)=O)CC=O)(C)=O,2,1,0,1,27,4.8e-05
G5,C(C)(CCCC(CC(CO)=O)=O)=O,1,1,0,1,27,4.8e-05
G5,C(C)(CCCC(C(CCO)=O)=O)=O,1,1,0,1,45,4.8e-05
G5,C(C)(CCCC(C(O)=O)=O)=O,1,1,0,1,7,4.8e-05
G5,C1(CC(CC(C1O)=O)CC(C)=O)=O,1,1,0,1,32,4.8e-05
G5,C1(CC(C(C(C1)=O)O)CC(C)=O)=O,4,1,0,1,45,4.8e-05
G5,C(CCCC(C)=O)(C(C(C)=O)O)=O,2,1,0,1,9,4.8e-05
G5,C(CC(C(C(C)=O)O)CC(C)=O)=O,4,1,0,1,45,4.8e-05
G5,C(CC1C(C(C(C1)=O)CO)=O)(C)=O,4,1,0,1,45,4.8e-05
G5,C(CC1C(CC(C1CO)=O)=O)(C)=O,4,1,0,1,45,4.8e-05
G5,C1(C(CO)(CC(C)=O)CC(C1)=O)=O,2,1,0,1,45,4.8e-05
G5,C(C)(CC1CC(C(C1CO)=O)=O)=O,4,2,0,2,27,9.499999999999999e-05
G5,C(C)(CCC1C(CC(C1=O)O)=O)=O,4,1,0,1,45,4.8e-05
G5,C(C)(CCC1C(C(C(C1)=O)O)=O)=O,4,1,0,1,47,4.8e-05
G5,C(C)(CCC1C(CC(C1O)=O)=O)=O,4,1,0,1,45,4.8e-05
G5,C(C)(CCC1C(C(CC1O)=O)=O)=O,4,1,0,1,45,4.8e-05
G5,C(CC1C(CC(C1C=O)O)=O)(C)=O,8,1,0,1,45,4.8e-05
G5,C(C1(C(CC(C1)=O)O)CC(C)=O)=O,4,1,0,1,45,4.8e-05
G5,C(C)(CC1C(C=O)CC(C1O)=O)=O,8,1,0,1,45,4.8e-05
G5,C1(CC(C(CC(C)=O)C1C=O)O)=O,8,1,0,1,45,4.8e-05
G5,C(C)(CCCC(CC(C=O)O)=O)=O,2,1,0,1,27,4.8e-05
G5,C(C)(CC1C(C(C)=O)OC(C1)=O)=O,4,1,0,1,48,4.8e-05
G5,C(CC1C(CC(C)=O)CC(O1)=O)=O,4,1,0,1,48,4.8e-05
G5,C(CC1C(OCCC(C1)=O)=O)(C)=O,2,1,0,1,19,4.8e-05
G5,C(CC1C(CCOC(C1)=O)=O)(C)=O,2,1,0,1,19,4.8e-05
G5,C(C)(CC1CC(COC(C1)=O)=O)=O,2,2,0,2,27,9.499999999999999e-05
G5,C1(CC(COC(C1)=O)CC(C)=O)=O,2,1,0,1,19,4.8e-05
G5,C(C)(CC1COCC(C(C1)=O)=O)=O,2,1,0,1,36,4.8e-05
G5,C1(COCC(CC1CC(C)=O)=O)=O,2,1,0,1,45,4.8e-05
G5,C(C1(CC(C(C1)=O)O)CC(C)=O)=O,4,1,0,1,45,4.8e-05
G5,C(CC1C(C(CC1C=O)O)=O)(C)=O,8,1,0,1,45,4.8e-05
G5,C1(C(CC(CC(C)=O)C1C=O)O)=O,8,1,0,1,27,4.8e-05
G5,C(CC(CO)(CO)CC(C)=O)=O,1,1,0,1,18,4.8e-05
G5,C(CC(C(CO)O)CC(C)=O)=O,4,1,0,1,46,4.8e-05
G5,C(CC(C(C=O)=O)C(C=O)C)(C)=O,4,1,0,1,45,4.8e-05
G5,C(C(C)(CC(C)=O)CC(C=O)=O)=O,2,1,0,1,45,4.8e-05
G5,C(C)(CCC(C=O)CC(C=O)=O)=O,2,1,0,1,45,4.8e-05
G5,C(C(CC(C=O)=O)CC(C)=O)=O,2,2,0,2,20,9.6e-05
G5,C(C)(CC(C)(CO)CC(C=O)=O)=O,2,1,0,1,49,4.8e-05
G5,C(C)(CCC(C=O)CC(CO)=O)=O,2,1,0,1,16,4.8e-05
G5,C(C(C)(CC(CO)=O)CC(C)=O)=O,2,1,0,1,16,4.8e-05
G5,C(CC(C(CO)=O)C(C=O)C)(C)=O,4,1,0,1,16,4.8e-05
G5,C(C)(CCC(C=O)C(C(C)=O)O)=O,4,1,0,1,45,4.8e-05
G5,C(C)(CC(C)CC(C=O)=O)=O,2,1,0,1,28,4.8e-05
G5,C(CC(C(C)=O)CC(C)=O)=O,2,1,0,1,28,4.8e-05
G5,C(C(CC(C)=O)CC(C)=O)=O,1,1,0,1,28,4.8e-05
G5,C(C)(CCC(C=O)CC=O)=O,2,1,0,1,28,4.8e-05
G5,C(C(C)(CC(C)=O)CC=O)=O,2,1,0,1,28,4.8e-05
G5,C(CC(C=O)C(C=O)C)(C)=O,4,1,0,1,28,4.8e-05
G5,C(C)(CCC(C=O)C(CO)=O)=O,2,1,0,1,9,4.8e-05
G5,C(C)(CC(C)C(C=O)C(CO)=O)=O,4,1,0,1,45,4.8e-05
G5,C(CC(CO)(CC=O)CC(C)=O)=O,1,1,0,1,46,4.8e-05
G5,C(CCCC(C)=O)(C(C=O)O)=O,2,1,0,1,0,4.8e-05
G5,C(CC(C)CC(C)=O)(C(C=O)O)=O,4,1,0,1,28,4.8e-05
G5,C(CC(C)(C(C=O)O)CC(C)=O)=O,4,1,0,1,6,4.8e-05
G5,C(C(CO)O)(CC(C)CC(C)=O)=O,4,1,0,1,28,4.8e-05
G5,C(CC(C)(C(CO)O)CC(C)=O)=O,4,1,0,1,46,4.8e-05
G5,C(C)(CCC(C(C=O)=O)CO)=O,2,1,0,1,49,4.8e-05
G5,C(C)(CCC(C(CO)=O)CO)=O,2,1,0,1,49,4.8e-05
G5,C(C)(CCC(C=O)C(C=O)O)=O,4,1,0,1,16,4.8e-05
G5,C(CC(C=O)C(C=O)CO)(C)=O,4,2,0,2,18,9.6e-05
G5,C(C(CO)(CC(C)=O)CC=O)=O,2,1,0,1,18,4.8e-05
G5,C(CCCC(C)=O)=O,1,1,0,1,27,4.8e-05
G5,C(C)(CCC(C(C=O)=O)C(C)O)=O,4,1,0,1,4,4.8e-05
G5,C(C)(CC(C)C(C(C=O)=O)CO)=O,4,1,0,1,27,4.8e-05
G5,C(C)(CC(CO)C(C=O)CC=O)=O,4,1,0,1,3,4.8e-05
G5,C(C(CCO)(CC(C)=O)CC=O)=O,2,1,0,1,46,4.8e-05
G5,C(CC(C=O)C(C=O)CCO)(C)=O,4,1,0,1,46,4.8e-05
G5,C(C)(CCC(C(CO)=O)C(C)O)=O,4,1,0,1,4,4.8e-05
G5,C(C)(CC(C)C(C(CO)=O)CO)=O,4,1,0,1,27,4.8e-05
G5,C(CC(CO)(CCO)CC(C)=O)=O,2,1,0,1,46,4.8e-05
G5,C(C)(CC(CO)(C)CC(CO)=O)=O,2,1,0,1,49,4.8e-05
G5,C(C)(CC(C)CC(CO)=O)=O,2,1,0,1,28,4.8e-05
G5,C(CC(C)(CO)CC(C)=O)=O,2,1,0,1,28,4.8e-05
G5,C(CC(C=O)C(C=O)C(C)O)(C)=O,8,2,0,2,28,9.6e-05
G5,C(C(C(C)O)(CC(C)=O)CC=O)=O,4,1,0,1,28,4.8e-05
G5,C(C)(CC(C)C(C=O)C(C=O)O)=O,8,1,0,1,45,4.8e-05
G5,C(CC(CC(C=O)O)CC(C)=O)=O,4,1,0,1,27,4.8e-05
G5,C(CC(C)CC(C)=O)=O,2,1,0,1,45,4.8e-05
G5,C(C)(CCCC(O)=O)=O,1,1,0,1,18,4.8e-05
G5,C(CC(CO)CC(C)=O)(O)=O,2,1,0,1,18,4.8e-05
G5,C(C)(CCC(C=O)C(C(O)=O)O)=O,4,1,0,1,33,4.8e-05
G5,C1(CC(C(C1O)=O)CC(C)=O)=O,4,1,0,1,47,4.8e-05
G5,C(CC(CC=O)CC(C)=O)=O,1,1,0,1,28,4.8e-05
G5,C(CCC(C(CCC=O)=O)O)=O,2,1,0,1,7,4.8e-05
G5,C(CCC(C=O)CC(CO)=O)=O,2,2,0,2,16,9.6e-05
G5,C(CC(C)C(C(CCC=O)=O)O)=O,4,1,0,1,7,4.8e-05
G5,C(CO)(C(C(C)CC=O)CC=O)=O,4,1,0,1,7,4.8e-05
G5,C(CC(C)C(C=O)CC(CO)=O)=O,4,1,0,1,7,4.8e-05
G5,C(CCC(C(CCC=O)=O)O)(O)=O,2,1,0,1,7,4.8e-05
G5,C(CO)(C(CCC(O)=O)CC=O)=O,2,1,0,1,7,4.8e-05
G5,C(CCC(C=O)CC(CO)=O)(O)=O,2,2,0,2,18,9.499999999999999e-05
G5,C(CCC(C=O)C(CCC=O)=O)=O,2,1,0,1,44,4.8e-05
G5,C(CCC(C(CC=O)=O)CC=O)=O,2,1,0,1,44,4.8e-05
G5,C(CCC(C=O)CC(CC=O)=O)=O,2,1,0,1,44,4.8e-05
G5,C(CC(C)C(C=O)C(CCC=O)=O)=O,4,1,0,1,44,4.8e-05
G5,C(CC(C)C(C(CC=O)=O)CC=O)=O,4,1,0,1,44,4.8e-05
G5,C(CC(C)C(C=O)CC(CC=O)=O)=O,4,1,0,1,44,4.8e-05
G5,C(C)(C(CCC=O)C(C=O)O)=O,4,1,0,1,27,4.8e-05
G5,C(CC(C=O)O)(CCCC=O)=O,2,2,0,2,27,9.6e-05
G5,C(C)(C(C(C)CC=O)C(C=O)O)=O,8,1,0,1,27,4.8e-05
G5,C(CC(C=O)O)(CC(C)CC=O)=O,4,1,0,1,27,4.8e-05
G5,C(CCC(C=O)(CC(C)=O)O)(O)=O,2,1,0,1,27,4.8e-05
G5,C(C)(C(CCC(O)=O)C(C=O)O)=O,4,1,0,1,27,4.8e-05
G5,C(CC(C=O)O)(CCCC(O)=O)=O,2,2,0,2,18,9.499999999999999e-05
G5,C(CO)(CC(CO)C(CCO)O)=O,4,1,0,1,18,4.8e-05
G5,C(CO)(CC(CO)C(CO)CO)=O,2,1,0,1,18,4.8e-05
G5,C(CO)(CC(CO)CC(CO)O)=O,4,1,0,1,11,4.8e-05
G5,C(CO)(CC(CO)C(CO)(C)O)=O,4,1,0,1,11,4.8e-05
G5,C(CO)(CC(CO)C(C(C)O)O)=O,8,1,0,1,11,4.8e-05
G5,C(CCC(C(C=CCO)=O)O)=O,4,1,0,1,11,4.8e-05
G5,C(CCC(C=CC(CO)=O)O)=O,4,1,0,1,11,4.8e-05
G5,C(CO)(CC(CO)CC=CC=O)=O,4,1,0,1,11,4.8e-05
G5,C(CC(C)C(C(C=CCO)=O)O)=O,8,1,0,1,11,4.8e-05
G5,C(CC(C)C(C=CC(CO)=O)O)=O,8,1,0,1,11,4.8e-05
G5,C(C(C=C)C(CO)CC(CO)=O)=O,4,1,0,1,11,4.8e-05
G5,C(CCC(C(C=CCO)=O)O)(O)=O,4,1,0,1,11,4.8e-05
G5,C(CCC(C=CC(CO)=O)O)(O)=O,4,1,0,1,11,4.8e-05
G5,C(CCC(C=O)C(C=CCO)=O)=O,4,1,0,1,0,4.8e-05
G5,C(CCC(C=CC(CC=O)=O)O)=O,4,1,0,1,0,4.8e-05
G5,C(CC(CC(CO)CC=CC=O)=O)=O,4,1,0,1,0,4.8e-05
G5,C(CC(C)C(C=O)C(C=CCO)=O)=O,8,1,0,1,0,4.8e-05
G5,C(CC(C)C(C=CC(CC=O)=O)O)=O,8,1,0,1,0,4.8e-05
G5,C(C(C=C)C(CO)CC(CC=O)=O)=O,4,1,0,1,0,4.8e-05
G5,C(CC(CO)CC(COC=O)=O)=O,2,1,0,1,28,4.8e-05
G5,C(CC(CO)C(C(C)=O)OC=O)=O,4,1,0,1,28,4.8e-05
G5,C1(CC(CO1)CC(COC=O)=O)=O,2,1,0,1,28,4.8e-05
G5,C1(CC(CO1)C(C(C)=O)OC=O)=O,4,1,0,1,28,4.8e-05
G5,C(CCCC(COC=O)=O)=O,1,1,0,1,35,4.8e-05
G5,C(CCC(C(C)=O)OC=O)=O,2,1,0,1,35,4.8e-05
G5,C(CC(C)CC(COC=O)=O)=O,2,1,0,1,35,4.8e-05
G5,C(CC(C)C(C(C)=O)OC=O)=O,4,1,0,1,35,4.8e-05
G5,C(CCCC(COC=O)=O)(O)=O,1,1,0,1,18,4.8e-05
G5,C(CCC(C(C)=O)OC=O)(O)=O,2,1,0,1,18,4.8e-05
G5,C(COC(C(CO)=O)CCC=O)=O,2,1,0,1,27,4.8e-05
G5,C(CCC(C(COCC=O)=O)O)=O,2,1,0,1,27,4.8e-05
G5,C(CCC(C=O)OCC(CO)=O)=O,2,1,0,1,27,4.8e-05
G5,C(C)(C(CCC=O)(OCC=O)O)=O,2,1,0,1,27,4.8e-05
G5,C(COC(C(CCCC=O)=O)O)=O,2,1,0,1,27,4.8e-05
G5,C(CCC(C=O)OC(C(C)=O)O)=O,4,1,0,1,27,4.8e-05
G5,C(CCC(C=O)(OCC(C)=O)O)=O,2,1,0,1,27,4.8e-05
G5,C(COC(C=O)O)(CCCC=O)=O,2,2,0,2,4,9.6e-05
G5,C(C)(C(CCC=O)OC(C=O)O)=O,4,1,0,1,27,4.8e-05
G5,C(CC(CO)C(C=O)OC=O)=O,4,1,0,1,28,4.8e-05
G5,C(OC(C=O)C(C=O)CC(O)=O)=O,4,1,0,1,18,4.8e-05
G5,C(OC(C=O)C(C(O)=O)CC=O)=O,4,1,0,1,18,4.8e-05
G5,C1(CC(CO1)C(C=O)OC=O)=O,4,1,0,1,28,4.8e-05
G5,C(C(CCC(C(O)=O)=O)OC=O)=O,2,1,0,1,7,4.8e-05
G5,C(C(C(C)CC(C=O)=O)OC=O)=O,4,1,0,1,28,4.8e-05
G5,C(OC(C=O)C(C(C)=O)CC=O)=O,4,1,0,1,28,4.8e-05
G5,C(OC(C=O)C(C=O)CC(C)=O)=O,4,1,0,1,28,4.8e-05
G5,C(C(CC(C=O)CC=O)OC=O)=O,4,1,0,1,28,4.8e-05
G5,C(CC(C=O)(C)C(C=O)OC=O)=O,4,1,0,1,28,4.8e-05
G5,C(C(C(C=O)C(C=O)C)OC=O)=O,8,1,0,1,28,4.8e-05
G5,C(CCC(C=O)OC=O)=O,2,1,0,1,28,4.8e-05
G5,C(C(C(C)CC(CO)=O)OC=O)=O,4,1,0,1,28,4.8e-05
G5,C(CC(C)(CO)C(C=O)OC=O)=O,4,1,0,1,28,4.8e-05
G5,C(CC(C)C(C=O)OC=O)=O,4,1,0,1,28,4.8e-05
G5,C(CCC(C=O)OC=O)(O)=O,2,1,0,1,18,4.8e-05
G5,C(CC(CO)C(C=O)OC=O)(O)=O,4,1,0,1,18,4.8e-05
G5,C(CC(C(C=O)OC=O)CC=O)=O,2,1,0,1,28,4.8e-05
G5,C(CCC(C=O)OC(CO)=O)=O,2,1,0,1,40,4.8e-05
G5,C(C(CCC=O)O)(OCC=O)=O,2,1,0,1,40,4.8e-05
G5,C(CC(C)C(C=O)OC(CO)=O)=O,4,1,0,1,40,4.8e-05
G5,C(C(C(C)CC=O)O)(OCC=O)=O,4,1,0,1,40,4.8e-05
G5,C(CCC(C=O)OC(CO)=O)(O)=O,2,1,0,1,40,4.8e-05
G5,C(CCC(C(OCC=O)=O)O)(O)=O,2,1,0,1,40,4.8e-05
G5,C(CC(CO)C(C=O)OC(C)=O)=O,4,1,0,1,28,4.8e-05
G5,C(CC(CO)CC=O)(OCC=O)=O,2,1,0,1,28,4.8e-05
G5,C1(CC(CO1)C(C=O)OC(C)=O)=O,4,1,0,1,28,4.8e-05
G5,C1(CC(CO1)CC(OCC=O)=O)=O,2,1,0,1,28,4.8e-05
G5,C(CCC(C=O)OC(C)=O)=O,2,1,0,1,28,4.8e-05
G5,C(CCCC(OCC=O)=O)=O,1,1,0,1,28,4.8e-05
G5,C(CC(C)C(C=O)OC(C)=O)=O,4,1,0,1,28,4.8e-05
G5,C(CC(C)CC(OCC=O)=O)=O,2,1,0,1,28,4.8e-05
G5,C(CCC(C=O)OC(C)=O)(O)=O,2,1,0,1,18,4.8e-05
G5,C(CCCC(OCC=O)=O)(O)=O,1,1,0,1,18,4.8e-05
G5,C(CCC(C(C=O)=O)(CCO)O)=O,2,1,0,1,27,4.8e-05
G5,C(CCC(CO)C(C(C=O)=O)O)=O,4,1,0,1,27,4.8e-05
G5,C(CCC(CC(C(C=O)=O)O)O)=O,4,1,0,1,27,4.8e-05
G5,C(CCC(CC(C(CO)=O)O)O)=O,4,1,0,1,31,4.8e-05
G5,C(CCC(CO)C(C(CO)=O)O)=O,4,1,0,1,31,4.8e-05
G5,C(CC(C(C=O)=O)C1COC(C1)=O)=O,4,1,0,1,20,4.8e-05
G5,C(C(C1COC(C1)=O)CC(C=O)=O)=O,4,1,0,1,20,4.8e-05
G5,C(CCC(C=O)CC(C=O)=O)=O,2,2,0,2,45,9.6e-05
G5,C(CC(C)C(C(C=O)=O)CC=O)=O,4,1,0,1,20,4.8e-05
G5,C(CC(C)C(C=O)CC(C=O)=O)=O,4,1,0,1,20,4.8e-05
G5,C(C(CCC(O)=O)CC(C=O)=O)=O,2,2,0,2,45,9.499999999999999e-05
G5,C(CC(CO)C(C=O)CC=O)=O,4,2,0,2,3,9.6e-05
G5,C(CC(C=O)C(C=O)CC(O)=O)=O,4,1,0,1,18,4.8e-05
G5,C(CC(C=O)C(C(O)=O)CC=O)=O,4,1,0,1,18,4.8e-05
G5,C(C(C1COC(C1)=O)CC=O)=O,4,1,0,1,27,4.8e-05
G5,C(CC(C(C=O)=O)C(C=O)CC=O)=O,4,2,0,2,20,9.6e-05
G5,C(CC(C=O)C(C=O)CC(C=O)=O)=O,4,2,0,2,20,9.6e-05
G5,C(C(C(C)CC(C=O)=O)CC=O)=O,4,1,0,1,27,4.8e-05
G5,C(CC(C(C)=O)C(C=O)CC=O)=O,4,1,0,1,27,4.8e-05
G5,C(CC(C=O)C(C=O)CC(C)=O)=O,4,1,0,1,27,4.8e-05
G5,C(C(CC(C=O)CC=O)CC=O)=O,3,2,0,2,28,9.499999999999999e-05
G5,C(CC(C=O)C(C=O)(C)CC=O)=O,4,2,0,2,27,9.499999999999999e-05
G5,C(CC(C=O)C(C=O)C(C=O)C)=O,8,2,0,2,28,9.499999999999999e-05
G5,C(CCC(C=O)CC=O)=O,2,2,0,2,27,9.6e-05
G5,C(CO)(CC(C)C(C=O)CC=O)=O,4,1,0,1,27,4.8e-05
G5,C(CC(C)(CO)C(C=O)CC=O)=O,4,1,0,1,28,4.8e-05
G5,C(CC(C)C(C=O)CC=O)=O,4,1,0,1,27,4.8e-05
G5,C(C(CCC(O)=O)CC=O)=O,2,2,0,2,18,9.499999999999999e-05
G5,C(CC(CO)C(C=O)CC=O)(O)=O,4,2,0,2,18,9.499999999999999e-05
G5,C(CC(C=O)C1C(C(C(C1)=O)O)=O)=O,8,2,0,2,47,9.499999999999999e-05
G5,C(CC(C(C=O)CC=O)CC=O)=O,2,1,0,1,27,4.8e-05
G5,C(CCC1(CC(C(CO1)=O)O)O)=O,4,1,0,1,27,4.8e-05
G5,C(CCC1C(OCC(C1O)=O)O)=O,8,1,0,1,27,4.8e-05
G5,C1OC(C(C=1)=O)C(CO)CC(C=O)=O,4,1,0,1,55,4.8e-05
G5,C1C(C(CO)CC(C=O)=O)OC(C=1)=O,4,1,0,1,55,4.8e-05
G5,C1(CC(CO1)C(C=CC(C=O)=O)O)=O,8,1,0,1,55,4.8e-05
G5,C(C(CC(CO)C(CCO)O)=O)=O,4,1,0,1,18,4.8e-05
G5,C(C(CC(CO)C(CO)CO)=O)=O,2,1,0,1,18,4.8e-05
G5,C(C(CC(CO)CC(CO)O)=O)=O,4,1,0,1,11,4.8e-05
G5,C(C(CC(CO)C(C)(CO)O)=O)=O,4,1,0,1,11,4.8e-05
G5,C(C(CC(CO)C(C(C)O)O)=O)=O,8,1,0,1,11,4.8e-05
G5,C(CCC(C=CC(C=O)=O)O)=O,4,1,0,1,55,4.8e-05
G5,C(CC(CO)CC(C=O)=O)=CC=O,4,1,0,1,55,4.8e-05
G5,C(CC(C)C(C=CC(C=O)=O)O)=O,8,1,0,1,55,4.8e-05
G5,C(C(C=C)C(CO)CC(C=O)=O)=O,4,1,0,1,55,4.8e-05
G5,C(CCC(C=CC(C=O)=O)O)(O)=O,4,1,0,1,55,4.8e-05
G5,C(CC(CO)C(C=CC=O)O)=O,8,1,0,1,28,4.8e-05
G5,C(CC(CC(CO)CC=O)=O)(O)=O,2,1,0,1,28,4.8e-05
G5,C(CC(CO)C(C(O)=O)C(C)=O)=O,4,1,0,1,28,4.8e-05
G5,C(CC(C=O)C(C=CC=O)O)(O)=O,8,1,0,1,18,4.8e-05
G5,C(C(CC=O)C(C=CC=O)O)(O)=O,8,1,0,1,18,4.8e-05
G5,C(CC(CO)C1C(C(OC1)=O)=O)=O,4,1,0,1,28,4.8e-05
G5,C(CC(C1CC(C(O1)=O)=O)CO)=O,4,1,0,1,28,4.8e-05
G5,C(CC(CO)C1C(OCC1=O)=O)=O,4,1,0,1,28,4.8e-05
G5,C(CC(CO)C1C(CC(O1)=O)=O)=O,4,1,0,1,28,4.8e-05
G5,C(C(C=C)(C(CO)CC=O)O)=O,4,1,0,1,28,4.8e-05
G5,C(CC(CO)C1C(C=CO1)=O)=O,4,1,0,1,28,4.8e-05
G5,C(CC(CO)C1C=CC(O1)=O)=O,4,1,0,1,28,4.8e-05
G5,C1(CC(CO1)C(C=CC=O)O)=O,8,1,0,1,28,4.8e-05
G5,C1(C(CCO1)(C(CO)CC=O)O)=O,4,1,0,1,28,4.8e-05
G5,C(CC(CO)C1COC(C1O)=O)=O,8,1,0,1,28,4.8e-05
G5,C(CC(CO)C1CC(C(O1)=O)O)=O,8,1,0,1,28,4.8e-05
G5,C(CC(CO)C(CCO)O)=O,4,1,0,1,18,4.8e-05
G5,C(CC(CO)C(CO)CO)=O,2,1,0,1,18,4.8e-05
G5,C(CC(CO)C(CO)C(C)O)=O,8,1,0,1,28,4.8e-05
G5,C(CC(CO)C(CC(C)O)O)=O,8,1,0,1,28,4.8e-05
G5,C(CC(CO)CC(CCO)O)=O,4,1,0,1,28,4.8e-05
G5,C(CC(CO)C(C)(CCO)O)=O,4,1,0,1,28,4.8e-05
G5,C(CC(CO)C(C(C(C)O)O)O)=O,16,1,0,1,28,4.8e-05
G5,C(CC(CO)C(CO)(C(C)O)O)=O,8,1,0,1,28,4.8e-05
G5,C(CC(CO)CC(C(CO)O)O)=O,8,1,0,1,28,4.8e-05
G5,C(CC(CO)C(C)(C(CO)O)O)=O,8,1,0,1,28,4.8e-05
G5,C(CC(CO)C(CO)(CCO)O)=O,4,1,0,1,29,4.8e-05
G5,C(CC(CO)C(C(CCO)O)O)=O,8,1,0,1,29,4.8e-05
G5,C(CC(CO)C(CO)C(CO)O)=O,8,1,0,1,29,4.8e-05
G5,C(CC(CO)C(CC(CO)O)O)=O,8,1,0,1,29,4.8e-05
G5,C(CC(CO)CC(CO)O)=O,4,1,0,1,11,4.8e-05
G5,C(CC(CO)C(C)(CO)O)=O,4,1,0,1,11,4.8e-05
G5,C(CC(CO)C(C(C)O)O)=O,8,1,0,1,11,4.8e-05
G5,C(CC(C(CO)CC=O)O)(O)=O,4,1,0,1,18,4.8e-05
G5,C(C(CO)C(CO)CC=O)(O)=O,4,1,0,1,18,4.8e-05
G5,C(C(C(CO)CC=O)C(C)O)(O)=O,8,1,0,1,28,4.8e-05
G5,C(CC(CC(CO)CC=O)O)(O)=O,4,1,0,1,28,4.8e-05
G5,C(CC(C)(C(CO)CC=O)O)(O)=O,4,1,0,1,28,4.8e-05
G5,C(C(CCC(C(O)=O)=O)O)=CC=O,4,1,0,1,7,4.8e-05
G5,C(C(CO)(CC(CO)CC=O)O)=O,4,1,0,1,11,4.8e-05
G5,C(CC(CO)CC(C(CC)=O)=O)=O,2,1,0,1,28,4.8e-05
G5,C(CC(CCC(C(C)=O)=O)CO)=O,2,1,0,1,28,4.8e-05
G5,C(CC(CO)C(C(C(C)=O)=O)C)=O,4,1,0,1,28,4.8e-05
G5,C(CC(CO)CC(CC(C)=O)=O)=O,2,1,0,1,28,4.8e-05
G5,C(CC(CO)C(C(C)=O)C(C)=O)=O,2,1,0,1,28,4.8e-05
G5,C(CC(CC(C=O)CC=O)CO)=O,4,1,0,1,28,4.8e-05
G5,C(C(C)(C(CO)CC=O)CC=O)=O,4,1,0,1,28,4.8e-05
G5,C(CC(CO)C(C=O)C(C=O)C)=O,8,1,0,1,28,4.8e-05
G5,C(CC(CO)C(C(C=O)=O)C)=O,4,1,0,1,28,4.8e-05
G5,C(CC(CCC(C(O)=O)=O)CO)=O,2,1,0,1,28,4.8e-05
G5,C(CC(CO)C(C(C(O)=O)=O)C)=O,4,1,0,1,28,4.8e-05
G5,C(CC(CO)CC=CC(C=O)=O)=O,4,1,0,1,28,4.8e-05
G5,C(C(C(C)CC(C=O)=O)O)=CC=O,8,1,0,1,28,4.8e-05
G5,C(CC(CO)C(C=C)C(C=O)=O)=O,4,1,0,1,28,4.8e-05
G5,C(CC(CO)CC(C=CC=O)=O)=O,4,1,0,1,28,4.8e-05
G5,C(CC(C(C)=O)C(C=CC=O)O)=O,8,1,0,1,28,4.8e-05
G5,C(C(CC(C)=O)C(C=CC=O)O)=O,8,1,0,1,28,4.8e-05
G5,C(C(C(C=O)=C)C(CO)CC=O)=O,4,1,0,1,28,4.8e-05
G5,C(C(CC(C=CC=O)O)CC=O)=O,8,1,0,1,28,4.8e-05
G5,C(CC(CO)CC(C=O)=CC=O)=O,4,1,0,1,28,4.8e-05
G5,C(CC(C=O)(C)C(C=CC=O)O)=O,8,1,0,1,28,4.8e-05
G5,C(CCC(C=CC=O)O)=O,4,1,0,1,28,4.8e-05
G5,C(CC(CO)C(C(C=CC)=O)O)=O,8,1,0,1,28,4.8e-05
G5,C(CC(CO)CC=CC(CO)=O)=O,4,1,0,1,28,4.8e-05
G5,C(CO)(CC(C)C(C=CC=O)O)=O,8,1,0,1,28,4.8e-05
G5,C(CC(CO)C(C(CO)=O)C=C)=O,4,1,0,1,28,4.8e-05
G5,C(CC(CO)C(C(CC=C)=O)O)=O,4,1,0,1,28,4.8e-05
G5,C(CC(CO)CC(C(C=C)O)=O)=O,4,1,0,1,28,4.8e-05
G5,C(CC(CO)C(C(C)=O)(C=C)O)=O,4,1,0,1,28,4.8e-05
G5,C(CC(CO)C(C(CC=O)=C)O)=O,4,1,0,1,28,4.8e-05
G5,C(CC(CO)C(C=O)C(CO)=C)=O,4,1,0,1,28,4.8e-05
G5,C(CC(CO)CC(CO)=CC=O)=O,4,1,0,1,28,4.8e-05
G5,C(CC(CO)C(C(C)=CC=O)O)=O,8,1,0,1,28,4.8e-05
G5,C(CC(CO)(C)C(C=CC=O)O)=O,8,1,0,1,28,4.8e-05
G5,C(CC(CO)CC=CC=O)=O,4,1,0,1,28,4.8e-05
G5,C(CC(C)C(C=CC=O)O)=O,8,1,0,1,28,4.8e-05
G5,C(C(C=C)C(CO)CC=O)=O,4,1,0,1,28,4.8e-05
G5,C(CCC(C=CC=O)O)(O)=O,4,1,0,1,18,4.8e-05
G5,C(CC(CO)C(C=CC(O)=O)O)=O,8,1,0,1,18,4.8e-05
G5,C(CC(CO)C(C=CC=O)O)(O)=O,8,1,0,1,18,4.8e-05
G5,C(CC(CO)C1(COC(C1)O)O)=O,8,1,0,1,43,4.8e-05
G5,C(CC(CO)C1C(CC(O)O1)O)=O,16,1,0,1,43,4.8e-05
G5,C(CC(CO)C1C(O)OCC1O)=O,16,1,0,1,43,4.8e-05
G5,C(CC(CO)C1(CC(CO1)O)O)=O,8,1,0,1,43,4.8e-05
G5,C(CC(CO)C1(C(CCO1)O)O)=O,8,1,0,1,28,4.8e-05
G5,C(CC(CO)C1(C(O)OCC1)O)=O,8,1,0,1,28,4.8e-05
G5,C(CC(CO)C1COC(C1O)O)=O,16,1,0,1,28,4.8e-05
G5,C(CC(CO)C1CC(C(O)O1)O)=O,16,1,0,1,28,4.8e-05
G5,C(CC(CO)C1(C(C=CC1=O)=O)O)=O,2,1,0,1,47,4.8e-05
G5,C(C(C=CC=O)C(CO)CC=O)=O,8,1,0,1,28,4.8e-05
G5,C(CC(C(C=CC=O)O)CC=O)=O,4,1,0,1,28,4.8e-05
G5,C1(CC(CO1)C(C(C(O)=O)=O)O)=O,4,1,0,1,28,4.8e-05
G5,C(CC(C)C(C(C(O)=O)=O)O)=O,4,1,0,1,45,4.8e-05
G5,C(CCC(C(C)=O)C(C(O)=O)=O)=O,2,1,0,1,0,4.8e-05
G5,C(C(C(C(O)=O)=O)CCC=O)=O,2,1,0,1,45,4.8e-05
G5,C(C(C(C(O)=O)=O)C(C)CC=O)=O,4,1,0,1,45,4.8e-05
G5,C(C(C(C(O)=O)=O)CCC(O)=O)=O,2,1,0,1,45,4.8e-05
G5,C1(CC(CO1)CC(CC(O)=O)=O)=O,2,1,0,1,28,4.8e-05
G5,C1(CC(CO1)C(C(C)=O)C(O)=O)=O,4,1,0,1,28,4.8e-05
G5,C(CCCC(CC(O)=O)=O)=O,1,1,0,1,6,4.8e-05
G5,C(CCC(C(C)=O)C(O)=O)=O,2,1,0,1,6,4.8e-05
G5,C(CC(C)CC(CC(O)=O)=O)=O,2,1,0,1,6,4.8e-05
G5,C(CC(C)C(C(C)=O)C(O)=O)=O,4,1,0,1,6,4.8e-05
G5,C(CCCC(O)=O)(CC(O)=O)=O,1,1,0,1,18,4.8e-05
G5,C(C)(C(C(O)=O)CCC(O)=O)=O,2,1,0,1,18,4.8e-05
G5,C(CCC(C(C=CC(O)=O)=O)O)=O,4,1,0,1,18,4.8e-05
G5,C(C(C=C)(C(C=O)CC(O)=O)O)=O,4,1,0,1,18,4.8e-05
G5,C(C(C=C)(C(C(O)=O)CC=O)O)=O,4,1,0,1,18,4.8e-05
G5,C(C(CC(O)=O)C1C(C=CO1)=O)=O,4,1,0,1,18,4.8e-05
G5,C(CC(C(O)=O)C1C(C=CO1)=O)=O,4,1,0,1,18,4.8e-05
G5,C(C(CC(O)=O)C1C=CC(O1)=O)=O,4,1,0,1,18,4.8e-05
G5,C(CC(C(O)=O)C1C=CC(O1)=O)=O,4,1,0,1,18,4.8e-05
G5,C(C(C(CCO)O)CC(O)=O)=O,4,1,0,1,18,4.8e-05
G5,C(C(C(CCO)O)CC=O)(O)=O,4,1,0,1,18,4.8e-05
G5,C(C(C(CO)CO)CC(O)=O)=O,2,1,0,1,18,4.8e-05
G5,C(C(C(CO)CO)CC=O)(O)=O,2,2,0,2,7,9.499999999999999e-05
G5,C(C(C(CO)C(C)O)CC(O)=O)=O,8,1,0,1,28,4.8e-05
G5,C(C(C(CO)C(C)O)CC=O)(O)=O,8,2,0,2,7,9.499999999999999e-05
G5,C(C(C(CC(C)O)O)CC(O)=O)=O,8,1,0,1,28,4.8e-05
G5,C(C(C(CC(C)O)O)CC=O)(O)=O,8,1,0,1,28,4.8e-05
G5,C(C(CC(CCO)O)CC(O)=O)=O,4,1,0,1,28,4.8e-05
G5,C(C(CC(CCO)O)CC=O)(O)=O,4,1,0,1,28,4.8e-05
G5,C(C(C(C)(CCO)O)CC(O)=O)=O,4,1,0,1,28,4.8e-05
G5,C(C(C(C)(CCO)O)CC=O)(O)=O,4,1,0,1,28,4.8e-05
G5,C(C(CC(CO)O)CC(O)=O)=O,4,1,0,1,11,4.8e-05
G5,C(C(CC(CO)O)CC=O)(O)=O,4,1,0,1,11,4.8e-05
G5,C(C(C(C)(CO)O)CC(O)=O)=O,4,1,0,1,11,4.8e-05
G5,C(C(C(C)(CO)O)CC=O)(O)=O,4,1,0,1,11,4.8e-05
G5,C(C(C(C(C)O)O)CC(O)=O)=O,8,1,0,1,11,4.8e-05
G5,C(C(C(C(C)O)O)CC=O)(O)=O,8,1,0,1,11,4.8e-05
G5,C(CC(C(C=O)CC(O)=O)O)(O)=O,4,1,0,1,18,4.8e-05
G5,C(CC(C(C(O)=O)CC=O)O)(O)=O,4,1,0,1,18,4.8e-05
G5,C(CC(C=O)C(C(O)=O)CO)(O)=O,4,1,0,1,18,4.8e-05
G5,C(C(CO)C(C(O)=O)CC=O)(O)=O,4,1,0,1,18,4.8e-05
G5,C(C(CC(O)=O)C(C(C=O)=O)C)=O,4,1,0,1,18,4.8e-05
G5,C(CC(C(O)=O)C(C(C=O)=O)C)=O,4,1,0,1,18,4.8e-05
G5,C(C(CC(O)=O)CC=CC(C=O)=O)=O,4,1,0,1,18,4.8e-05
G5,C(CC(C(O)=O)CC=CC(C=O)=O)=O,4,1,0,1,18,4.8e-05
G5,C(C(CC(O)=O)C(C=C)C(C=O)=O)=O,4,1,0,1,18,4.8e-05
G5,C(CC(C(O)=O)C(C=C)C(C=O)=O)=O,4,1,0,1,18,4.8e-05
G5,C(C(CC(O)=O)CC(C=CC=O)=O)=O,4,1,0,1,18,4.8e-05
G5,C(CC(C(O)=O)CC(C=CC=O)=O)=O,4,1,0,1,18,4.8e-05
G5,C(C(C(C=O)=C)C(C=O)CC(O)=O)=O,4,1,0,1,18,4.8e-05
G5,C(C(C(C=O)=C)C(C(O)=O)CC=O)=O,4,1,0,1,18,4.8e-05
G5,C(C(CC(O)=O)CC(C=O)=CC=O)=O,4,1,0,1,18,4.8e-05
G5,C(CC(C(O)=O)CC(C=O)=CC=O)=O,4,1,0,1,18,4.8e-05
G5,C(C(CC(O)=O)CC=CC=O)=O,4,1,0,1,18,4.8e-05
G5,C(CC(C(O)=O)CC=CC=O)=O,4,1,0,1,18,4.8e-05
G5,C(C(C=C)C(C=O)CC(O)=O)=O,4,1,0,1,18,4.8e-05
G5,C(C(C=C)C(C(O)=O)CC=O)=O,4,1,0,1,18,4.8e-05
G5,C(C(C=CC=O)C(C=O)CC(O)=O)=O,8,1,0,1,18,4.8e-05
G5,C(C(C=CC=O)C(C(O)=O)CC=O)=O,8,1,0,1,18,4.8e-05
G5,C(CC(C)C(C(C(CO)=O)=O)O)=O,4,1,0,1,5,4.8e-05
G5,C(CCC(C(C(CO)=O)=O)O)(O)=O,2,1,0,1,5,4.8e-05
G5,C(C(C=O)(C(CCCC=O)=O)O)=O,1,1,0,1,1,4.8e-05
G5,C(CCC(C=O)(C(C(C)=O)=O)O)=O,2,1,0,1,25,4.8e-05
G5,C(C(C(C(CCCC=O)=O)=O)O)=O,2,1,0,1,25,4.8e-05
G5,C(CCC(C(C(C(C)O)=O)=O)O)=O,4,1,0,1,0,4.8e-05
G5,C(CCC(C(C(CO)=O)=O)(C)O)=O,2,1,0,1,0,4.8e-05
G5,C1OC(C(C=1)=O)CCC(C(CO)=O)=O,2,1,0,1,7,4.8e-05
G5,C1C(CCC(C(CO)=O)=O)OC(C=1)=O,2,1,0,1,7,4.8e-05
G5,C1(CC(CO1)C(C(C(C=C)=O)=O)O)=O,4,1,0,1,7,4.8e-05
G5,C(C(CO)=O)(CCC(CO)CO)=O,1,1,0,1,18,4.8e-05
G5,C(C(CO)=O)(CCCC(CO)O)=O,2,1,0,1,11,4.8e-05
G5,C(C(CO)=O)(CCC(CO)(C)O)=O,2,1,0,1,11,4.8e-05
G5,C(C(CO)=O)(CCC(C(C)O)O)=O,4,1,0,1,11,4.8e-05
G5,C(CCCC(C(CO)=O)=O)=CC=O,2,1,0,1,7,4.8e-05
G5,C(CC(C)C(C(C(C=C)=O)=O)O)=O,4,1,0,1,7,4.8e-05
G5,C(C(C=C)CCC(C(CO)=O)=O)=O,2,1,0,1,7,4.8e-05
G5,C(CCC(C(C(C=C)=O)=O)O)(O)=O,2,1,0,1,7,4.8e-05
G5,C(CCCC(C(C(C)O)=O)=O)=O,2,2,0,2,7,9.6e-05
G5,C(CCCC(C(C(C)=O)=O)O)=O,2,1,0,1,49,4.8e-05
G5,C(CCC(C(C(C)=O)=O)(C)O)=O,2,1,0,1,49,4.8e-05
G5,C(CC(C)CC(C(C(C)O)=O)=O)=O,4,1,0,1,49,4.8e-05
G5,C(CC(C)CC(C(C(C)=O)=O)O)=O,4,1,0,1,49,4.8e-05
G5,C(CC(C)C(C(C(C)=O)=O)(C)O)=O,4,1,0,1,49,4.8e-05
G5,C(CCCC(C(C(C)O)=O)=O)(O)=O,2,2,0,2,7,9.499999999999999e-05
G5,C(CCCC(C(C(C)=O)=O)O)(O)=O,2,1,0,1,49,4.8e-05
G5,C(CCC(C(C(C)=O)=O)(C)O)(O)=O,2,1,0,1,49,4.8e-05
G5,C(CCCC(C(C(C=C)=O)=O)O)=O,2,1,0,1,7,4.8e-05
G5,C(CCC(C(C(C=C)=O)=O)(C)O)=O,2,1,0,1,7,4.8e-05
G5,C(CCCC(C(C(C)O)=O)=O)=CC=O,4,1,0,1,7,4.8e-05
G5,C(CC(C)CC(C(C(C=C)=O)=O)O)=O,4,1,0,1,7,4.8e-05
G5,C(CC(C)C(C(C(C=C)=O)=O)(C)O)=O,4,1,0,1,7,4.8e-05
G5,C(C(C=C)CCC(C(C(C)O)=O)=O)=O,4,1,0,1,7,4.8e-05
G5,C(CCC(C(C(CO)(C)O)=O)O)=O,4,1,0,1,49,4.8e-05
G5,C(CCCC(C(CO)=O)(CO)O)=O,2,1,0,1,49,4.8e-05
G5,C(CCC(C(C(CC=O)=O)=O)O)=O,2,1,0,1,0,4.8e-05
G5,C(CCC(C=O)C(C(CO)=O)=O)=O,2,1,0,1,0,4.8e-05
G5,C(CCC(C=O)C(C=O)(C=O)O)=O,2,2,0,2,1,9.6e-05
G5,C1(CC(CO1)C2C(C(C(C2)=O)O)=O)=O,8,1,0,1,47,4.8e-05
G5,C1(CC(CO1)C2(C(CCC2=O)=O)O)=O,2,1,0,1,47,4.8e-05
G5,C(CCC1(C(CCC1=O)=O)O)=O,1,1,0,1,47,4.8e-05
G5,C(CC(C)C1C(C(C(C1)=O)O)=O)=O,8,1,0,1,47,4.8e-05
G5,C(CC(C)C1(C(CCC1=O)=O)O)=O,2,1,0,1,47,4.8e-05
G5,C(CCC1C(C(C(C1)=O)O)=O)(O)=O,4,2,0,2,18,9.499999999999999e-05
G5,C(CCC1(C(CCC1=O)=O)O)(O)=O,1,1,0,1,47,4.8e-05
G5,C1(CC(CO1)C2C(OCC(C2)=O)=O)=O,4,1,0,1,7,4.8e-05
G5,C1(CC(CO1)C2C(COC(C2)=O)=O)=O,4,1,0,1,7,4.8e-05
G5,C1(CC(CO1)C2C(CCC(O2)=O)=O)=O,4,1,0,1,7,4.8e-05
G5,C(CCC1C(OCC(C1)=O)=O)=O,2,1,0,1,7,4.8e-05
G5,C1(COC(CC1CCC=O)=O)=O,2,1,0,1,7,4.8e-05
G5,C(CCC1C(CCC(O1)=O)=O)=O,2,1,0,1,7,4.8e-05
G5,C(CC(C)C1C(OCC(C1)=O)=O)=O,4,1,0,1,7,4.8e-05
G5,C1(COC(CC1C(C)CC=O)=O)=O,4,1,0,1,7,4.8e-05
G5,C(CC(C)C1C(CCC(O1)=O)=O)=O,4,1,0,1,7,4.8e-05
G5,C(CCC1C(OCC(C1)=O)=O)(O)=O,2,1,0,1,7,4.8e-05
G5,C(CCC1C(COC(C1)=O)=O)(O)=O,2,1,0,1,7,4.8e-05
G5,C(CCC1C(CCC(O1)=O)=O)(O)=O,2,1,0,1,7,4.8e-05
G5,C1(CC(CO1)C2C(CC(CO2)=O)=O)=O,4,1,0,1,54,4.8e-05
G5,C1(CC(CO1)C2C(COCC2=O)=O)=O,2,1,0,1,54,4.8e-05
G5,C(CCC1C(CC(CO1)=O)=O)=O,2,1,0,1,54,4.8e-05
G5,C(CCC1C(COCC1=O)=O)=O,1,1,0,1,54,4.8e-05
G5,C(CC(C)C1C(CC(CO1)=O)=O)=O,4,1,0,1,54,4.8e-05
G5,C(CC(C)C1C(COCC1=O)=O)=O,2,1,0,1,54,4.8e-05
G5,C(CCC1C(CC(CO1)=O)=O)(O)=O,2,1,0,1,54,4.8e-05
G5,C(CCC1C(COCC1=O)=O)(O)=O,1,1,0,1,54,4.8e-05
G5,C(CCC1C(C(C(CO)O1)O)=O)=O,8,1,0,1,27,4.8e-05
G5,C(CCC1(C(COC1CO)=O)O)=O,4,1,0,1,27,4.8e-05
G5,C(CCC1(CO)C(C(CO1)=O)O)=O,4,1,0,1,27,4.8e-05
G5,C(CCC(C1C(C(CO1)=O)O)O)=O,8,1,0,1,27,4.8e-05
G5,C(CCC1(C(CC(CO)O1)=O)O)=O,4,1,0,1,27,4.8e-05
G5,C(CCC1C(C(O)OC1CO)=O)=O,8,1,0,1,27,4.8e-05
G5,C(CCC1(CO)CC(C(O)O1)=O)=O,4,1,0,1,27,4.8e-05
G5,C(CCC(C1CC(C(O)O1)=O)O)=O,8,1,0,1,27,4.8e-05
G5,C(CCC(C1(CC(CO1)=O)O)O)=O,4,1,0,1,27,4.8e-05
G5,C(CCC1C(COC1(CO)O)=O)=O,4,1,0,1,27,4.8e-05
G5,C(CCC1C(CC(CO)(O1)O)=O)=O,4,1,0,1,27,4.8e-05
G5,C1(CC(CO1)C2C(C(OC2)=O)=O)=O,4,1,0,1,28,4.8e-05
G5,C1(CC(CO1)C2CC(C(O2)=O)=O)=O,4,1,0,1,28,4.8e-05
G5,C1(C(OCC1C(C)CC(C=O)=O)=O)=O,4,1,0,1,28,4.8e-05
G5,C(C(CC(C)C1CC(C(O1)=O)=O)=O)=O,4,1,0,1,28,4.8e-05
G5,C(CC(C(C)=O)C1C(C(OC1)=O)=O)=O,4,1,0,1,28,4.8e-05
G5,C(C)(C(C1CC(C(O1)=O)=O)CC=O)=O,4,1,0,1,28,4.8e-05
G5,C(CC(C=O)C1C(C(OC1)=O)=O)(C)=O,4,1,0,1,28,4.8e-05
G5,C(C(C1CC(C(O1)=O)=O)CC(C)=O)=O,4,1,0,1,28,4.8e-05
G5,C(C(CC1C(C(OC1)=O)=O)CC=O)=O,4,1,0,1,28,4.8e-05
G5,C(C(CC1CC(C(O1)=O)=O)CC=O)=O,4,1,0,1,28,4.8e-05
G5,C(C(C)(CC=O)C1C(C(OC1)=O)=O)=O,4,1,0,1,28,4.8e-05
G5,C(C(C)(C1CC(C(O1)=O)=O)CC=O)=O,4,1,0,1,28,4.8e-05
G5,C(C(C)C(C=O)C1C(C(OC1)=O)=O)=O,8,1,0,1,28,4.8e-05
G5,C(C(C)C(C=O)C1CC(C(O1)=O)=O)=O,8,1,0,1,28,4.8e-05
G5,C(CCC1C(C(OC1)=O)=O)=O,2,1,0,1,28,4.8e-05
G5,C(CCC1CC(C(O1)=O)=O)=O,2,1,0,1,28,4.8e-05
G5,C(CC(C)C1C(C(OC1)=O)=O)=O,4,1,0,1,28,4.8e-05
G5,C(CC(C)C1CC(C(O1)=O)=O)=O,4,1,0,1,28,4.8e-05
G5,C(CCC1C(C(OC1)=O)=O)(O)=O,2,1,0,1,18,4.8e-05
G5,C(CCC1CC(C(O1)=O)=O)(O)=O,2,1,0,1,18,4.8e-05
G5,C(CC(CC=O)C1C(C(OC1)=O)=O)=O,2,1,0,1,28,4.8e-05
G5,C(CC(C1CC(C(O1)=O)=O)CC=O)=O,2,1,0,1,28,4.8e-05
G5,C1(CC(CO1)C2C(COC2=O)=O)=O,4,1,0,1,28,4.8e-05
G5,C1(CC(CO1)C2C(CC(O2)=O)=O)=O,4,1,0,1,28,4.8e-05
G5,C1(COC(C1C(C)CC(C=O)=O)=O)=O,4,1,0,1,28,4.8e-05
G5,C1(C(C(C)CC(C=O)=O)OC(C1)=O)=O,4,1,0,1,28,4.8e-05
G5,C1(C(C(CO1)=O)C(C(C)=O)CC=O)=O,4,1,0,1,28,4.8e-05
G5,C1(CC(C(C(C(C)=O)CC=O)O1)=O)=O,4,1,0,1,28,4.8e-05
G5,C1(C(C(CO1)=O)C(C=O)CC(C)=O)=O,4,1,0,1,28,4.8e-05
G5,C1(CC(C(C(C=O)CC(C)=O)O1)=O)=O,4,1,0,1,28,4.8e-05
G5,C(C(CC1C(COC1=O)=O)CC=O)=O,4,1,0,1,28,4.8e-05
G5,C(C(CC1C(CC(O1)=O)=O)CC=O)=O,4,1,0,1,28,4.8e-05
G5,C(C(C)(CC=O)C1C(COC1=O)=O)=O,4,1,0,1,28,4.8e-05
G5,C(CC(C=O)(C)C1C(CC(O1)=O)=O)=O,4,1,0,1,28,4.8e-05
G5,C(C(C)C(C=O)C1C(COC1=O)=O)=O,8,1,0,1,28,4.8e-05
G5,C(C(C)C(C=O)C1C(CC(O1)=O)=O)=O,8,1,0,1,28,4.8e-05
G5,C(CCC1C(COC1=O)=O)=O,2,1,0,1,28,4.8e-05
G5,C(CCC1C(CC(O1)=O)=O)=O,2,1,0,1,28,4.8e-05
G5,C(CC(C)C1C(COC1=O)=O)=O,4,1,0,1,28,4.8e-05
G5,C(CC(C)C1C(CC(O1)=O)=O)=O,4,1,0,1,28,4.8e-05
G5,C(CCC1C(COC1=O)=O)(O)=O,2,1,0,1,18,4.8e-05
G5,C(CCC1C(CC(O1)=O)=O)(O)=O,2,1,0,1,18,4.8e-05
G5,C(CC(CC=O)C1C(COC1=O)=O)=O,2,1,0,1,28,4.8e-05
G5,C(CC(C1C(CC(O1)=O)=O)CC=O)=O,2,1,0,1,28,4.8e-05
G5,C(CCC1C(C(C(CO1)O)O)=O)=O,8,1,0,1,27,4.8e-05
G5,C(CCC1(C(COCC1O)=O)O)=O,4,1,0,1,27,4.8e-05
G5,C(CCC1(COCC(C1O)=O)O)=O,4,1,0,1,27,4.8e-05
G5,C(CCC1C(C(C(CO1)=O)O)O)=O,8,1,0,1,27,4.8e-05
G5,C(CCC1(C(CC(CO1)O)=O)O)=O,4,1,0,1,27,4.8e-05
G5,C(CCC1C(C(O)OCC1O)=O)=O,8,1,0,1,27,4.8e-05
G5,C(CCC1(COC(C(C1)=O)O)O)=O,4,1,0,1,27,4.8e-05
G5,C(CCC1C(CC(C(O)O1)=O)O)=O,8,1,0,1,27,4.8e-05
G5,C1(C(CCC=O)(CC(CO1)=O)O)=O,2,1,0,1,27,4.8e-05
G5,C1(COC(C(C1CCC=O)O)=O)=O,4,1,0,1,27,4.8e-05
G5,C1(CC(C(OC1CCC=O)=O)O)=O,4,1,0,1,27,4.8e-05
G5,C(C(C=C)(C1COC(C1)=O)O)=O,4,1,0,1,28,4.8e-05
G5,C(C(C=C)(CCC(C(O)=O)=O)O)=O,2,1,0,1,7,4.8e-05
G5,C(C(C=C)(C(C)CC(C=O)=O)O)=O,4,1,0,1,28,4.8e-05
G5,C(C(C=C)(C(C(C)=O)CC=O)O)=O,4,1,0,1,28,4.8e-05
G5,C(C(C=C)(C(C=O)CC(C)=O)O)=O,4,1,0,1,28,4.8e-05
G5,C(C(CC(C=O)(C=C)O)CC=O)=O,4,1,0,1,28,4.8e-05
G5,C(C(C)(CC=O)C(C=O)(C=C)O)=O,4,1,0,1,28,4.8e-05
G5,C(C(C=C)(CCC=O)O)=O,2,1,0,1,28,4.8e-05
G5,C(C(C=C)(C(C)CC(CO)=O)O)=O,4,1,0,1,28,4.8e-05
G5,C(C(C=C)(C(CO)(C)CC=O)O)=O,4,1,0,1,28,4.8e-05
G5,C(C(C=C)(C(C)CC=O)O)=O,4,1,0,1,28,4.8e-05
G5,C(C(C=C)(CCC(O)=O)O)=O,2,1,0,1,18,4.8e-05
G5,C(C(C=C)(C(CO)CC(O)=O)O)=O,4,1,0,1,18,4.8e-05
G5,C(C(C=C)(C(CC=O)CC=O)O)=O,2,1,0,1,28,4.8e-05
G5,C1(COC(C(C2C(C=CO2)=O)C1)O)=O,8,1,0,1,27,4.8e-05
G5,C1(CC(CO1)C2C(C=CO2)=O)=O,4,1,0,1,28,4.8e-05
G5,C(C(C(C1C(C=CO1)=O)CC=O)O)=O,8,1,0,1,20,4.8e-05
G5,C1OC(C(C=1)=O)CCC(C(O)=O)=O,2,1,0,1,7,4.8e-05
G5,C(CC(C(C=O)=O)C1C(C=CO1)=O)=O,4,1,0,1,20,4.8e-05
G5,C(C(C1C(C=CO1)=O)CC(C=O)=O)=O,4,1,0,1,20,4.8e-05
G5,C1OC(C(C=1)=O)C(C)CC(C=O)=O,4,1,0,1,28,4.8e-05
G5,C(CC(C(C)=O)C1C(C=CO1)=O)=O,4,1,0,1,28,4.8e-05
G5,C(C(C1C(C=CO1)=O)CC(C)=O)=O,4,1,0,1,28,4.8e-05
G5,C(C(CC1C(C=CO1)=O)CC=O)=O,4,1,0,1,28,4.8e-05
G5,C(CC(C=O)(C)C1C(C=CO1)=O)=O,4,1,0,1,28,4.8e-05
G5,C(C(C)C(C=O)C1C(C=CO1)=O)=O,8,1,0,1,28,4.8e-05
G5,C(C(C(CO)=O)CC1C(C=CO1)=O)=O,4,1,0,1,9,4.8e-05
G5,C(CCC1C(C=CO1)=O)(C(C=O)O)=O,4,1,0,1,0,4.8e-05
G5,C1OC(C(C=1)=O)CC(C(C=O)=O)CO,4,1,0,1,49,4.8e-05
G5,C(C(CC1C(C=CO1)=O)C(C=O)O)=O,8,1,0,1,16,4.8e-05
G5,C(C(CO)C(C=O)C1C(C=CO1)=O)=O,8,1,0,1,18,4.8e-05
G5,C(CC(C=O)(CO)C1C(C=CO1)=O)=O,4,1,0,1,18,4.8e-05
G5,C(CCC1C(C=CO1)=O)=O,2,1,0,1,28,4.8e-05
G5,C(CO)(CC(C)C1C(C=CO1)=O)=O,4,1,0,1,28,4.8e-05
G5,C(CC(C)(CO)C1C(C=CO1)=O)=O,4,1,0,1,28,4.8e-05
G5,C(CC(C)C1C(C=CO1)=O)=O,4,1,0,1,28,4.8e-05
G5,C(CCC1C(C=CO1)=O)(O)=O,2,1,0,1,18,4.8e-05
G5,C(CC(CO)C1C(C=CO1)=O)(O)=O,4,1,0,1,18,4.8e-05
G5,C1(CC(C(C1O)=O)C2C(C=CO2)=O)=O,8,1,0,1,47,4.8e-05
G5,C(CC(C1C(C=CO1)=O)CC=O)=O,2,1,0,1,28,4.8e-05
G5,C1(COC(C(C2C=CC(O2)=O)C1)O)=O,8,1,0,1,27,4.8e-05
G5,C1(CC(CO1)C2(C=CC(CO2)=O)O)=O,4,1,0,1,27,4.8e-05
G5,C1(CC(CO1)C2C(C=CC(O2)O)=O)=O,8,1,0,1,27,4.8e-05
G5,C1(COC(C(C(CCO)O)C1)O)=O,8,1,0,1,18,4.8e-05
G5,C1(COC(C(C(CO)CO)C1)O)=O,4,1,0,1,18,4.8e-05
G5,C1(COC(C(CC(CO)O)C1)O)=O,8,1,0,1,11,4.8e-05
G5,C1(COC(C(C(CO)(C)O)C1)O)=O,8,1,0,1,11,4.8e-05
G5,C1(COC(C(C(C(C)O)O)C1)O)=O,16,1,0,1,11,4.8e-05
G5,C(CCC1(C=CC(CO1)=O)O)=O,2,1,0,1,27,4.8e-05
G5,C(CCC1C(C=CC(O1)O)=O)=O,4,1,0,1,27,4.8e-05
G5,C1(COC(C(C1)CC=CC=O)O)=O,8,1,0,1,27,4.8e-05
G5,C(CC(C)C1(C=CC(CO1)=O)O)=O,4,1,0,1,27,4.8e-05
G5,C(CC(C)C1C(C=CC(O1)O)=O)=O,8,1,0,1,27,4.8e-05
G5,C(C(C=C)C1C(OCC(C1)=O)O)=O,8,1,0,1,27,4.8e-05
G5,C(CCC1(C=CC(CO1)=O)O)(O)=O,2,1,0,1,27,4.8e-05
G5,C(CCC1C(C=CC(O1)O)=O)(O)=O,4,1,0,1,27,4.8e-05
G5,C1(CC(CO1)C2C=CC(O2)=O)=O,4,1,0,1,28,4.8e-05
G5,C1(C(CCO1)(C2COC(C2)=O)O)=O,4,1,0,1,28,4.8e-05
G5,C1(CC(CO1)C2COC(C2O)=O)=O,8,1,0,1,28,4.8e-05
G5,C1(CC(CO1)C2CC(C(O2)=O)O)=O,8,1,0,1,28,4.8e-05
G5,C(C(C=CC=O)(C1COC(C1)=O)O)=O,8,1,0,1,20,4.8e-05
G5,C(C(C(C1C=CC(O1)=O)CC=O)O)=O,8,1,0,1,20,4.8e-05
G5,C1(CC(CO1)C(CCO)O)=O,4,1,0,1,18,4.8e-05
G5,C1(CC(CO1)C(CO)CO)=O,2,1,0,1,18,4.8e-05
G5,C1(CC(CO1)C(CO)C(C)O)=O,8,1,0,1,28,4.8e-05
G5,C1(CC(CO1)C(CC(C)O)O)=O,8,1,0,1,28,4.8e-05
G5,C1(CC(CO1)CC(CCO)O)=O,4,1,0,1,28,4.8e-05
G5,C1(CC(CO1)C(C)(CCO)O)=O,4,1,0,1,28,4.8e-05
G5,C1(CC(CO1)C(C(C(C)O)O)O)=O,16,1,0,1,28,4.8e-05
G5,C1(CC(CO1)C(CO)(C(C)O)O)=O,8,1,0,1,28,4.8e-05
G5,C1(CC(CO1)CC(C(CO)O)O)=O,8,1,0,1,28,4.8e-05
G5,C1(CC(CO1)C(C)(C(CO)O)O)=O,8,1,0,1,28,4.8e-05
G5,C1(CC(CO1)C(CO)(CCO)O)=O,4,1,0,1,29,4.8e-05
G5,C1(CC(CO1)C(C(CCO)O)O)=O,8,1,0,1,29,4.8e-05
G5,C1(CC(CO1)C(CO)C(CO)O)=O,8,1,0,1,29,4.8e-05
G5,C1(CC(CO1)C(CC(CO)O)O)=O,8,1,0,1,29,4.8e-05
G5,C1(CC(CO1)CC(CO)O)=O,4,1,0,1,11,4.8e-05
G5,C1(CC(CO1)C(C)(CO)O)=O,4,1,0,1,11,4.8e-05
G5,C1(CC(CO1)C(C(C)O)O)=O,8,1,0,1,11,4.8e-05
G5,C1(CC(CO1)C(CC(O)=O)O)=O,4,1,0,1,18,4.8e-05
G5,C(C(CO)C1COC(C1)=O)(O)=O,4,1,0,1,18,4.8e-05
G5,C(C(C1COC(C1)=O)C(C)O)(O)=O,8,1,0,1,28,4.8e-05
G5,C1(CC(CO1)CC(CC(O)=O)O)=O,4,1,0,1,28,4.8e-05
G5,C1(CC(CO1)C(C)(CC(O)=O)O)=O,4,1,0,1,28,4.8e-05
G5,C1C(CCC(C(O)=O)=O)OC(C=1)=O,2,1,0,1,7,4.8e-05
G5,C(C(C)(C(C1COC(C1)=O)O)O)=O,8,1,0,1,11,4.8e-05
G5,C(C(CO)(CC1COC(C1)=O)O)=O,4,1,0,1,11,4.8e-05
G5,C1(CC(CO1)CC(C(CC)=O)=O)=O,2,1,0,1,28,4.8e-05
G5,C1(CC(CCC(C(C)=O)=O)CO1)=O,2,1,0,1,28,4.8e-05
G5,C1(CC(CO1)C(C(C(C)=O)=O)C)=O,4,1,0,1,28,4.8e-05
G5,C(CC1COC(C1)=O)(CC(C)=O)=O,2,1,0,1,28,4.8e-05
G5,C(C)(C(C(C)=O)C1COC(C1)=O)=O,2,1,0,1,28,4.8e-05
G5,C(C(CC1COC(C1)=O)CC=O)=O,4,1,0,1,28,4.8e-05
G5,C(C(C)(C1COC(C1)=O)CC=O)=O,4,1,0,1,28,4.8e-05
G5,C(C(C1COC(C1)=O)C(C=O)C)=O,8,1,0,1,28,4.8e-05
G5,C(C(C(C=O)=O)(C)C1COC(C1)=O)=O,4,1,0,1,49,4.8e-05
G5,C(C(C(C=O)=O)CC1COC(C1)=O)=O,4,1,0,1,49,4.8e-05
G5,C1(CC(CCC(C=O)=O)CO1)=O,2,1,0,1,28,4.8e-05
G5,C1(CC(CO1)C(C(C=O)=O)C)=O,4,1,0,1,28,4.8e-05
G5,C(C(C=O)C(CC1COC(C1)=O)=O)=O,2,1,0,1,6,4.8e-05
G5,C(C(C=O)(C1COC(C1)=O)CC=O)=O,2,1,0,1,43,4.8e-05
G5,C(C(C=O)C(C=O)C1COC(C1)=O)=O,4,1,0,1,43,4.8e-05
G5,C1(CC(CO1)CCC(C(O)=O)=O)=O,2,1,0,1,28,4.8e-05
G5,C1(CC(CO1)C(C(C(O)=O)=O)C)=O,4,1,0,1,28,4.8e-05
G5,C(CC(C(C=O)=O)C1C=CC(O1)=O)=O,4,1,0,1,20,4.8e-05
G5,C(C(C1C=CC(O1)=O)CC(C=O)=O)=O,4,1,0,1,20,4.8e-05
G5,C1(CC(CO1)CC=CC(C=O)=O)=O,4,1,0,1,28,4.8e-05
G5,C1C(C(C)CC(C=O)=O)OC(C=1)=O,4,1,0,1,28,4.8e-05
G5,C1(CC(CO1)C(C=C)C(C=O)=O)=O,4,1,0,1,28,4.8e-05
G5,C1(CC(CO1)CC(C=CC=O)=O)=O,4,1,0,1,28,4.8e-05
G5,C(CC(C(C)=O)C1C=CC(O1)=O)=O,4,1,0,1,28,4.8e-05
G5,C(C(C1C=CC(O1)=O)CC(C)=O)=O,4,1,0,1,28,4.8e-05
G5,C(C(C(C=O)=C)C1COC(C1)=O)=O,4,1,0,1,28,4.8e-05
G5,C(C(CC1C=CC(O1)=O)CC=O)=O,4,1,0,1,28,4.8e-05
G5,C1(CC(CO1)CC(C=O)=CC=O)=O,4,1,0,1,28,4.8e-05
G5,C(CC(C=O)(C)C1C=CC(O1)=O)=O,4,1,0,1,28,4.8e-05
G5,C(C(C)C(C=O)C1C=CC(O1)=O)=O,8,1,0,1,28,4.8e-05
G5,C1(CC(CO1)C(C(C(C=O)=C)=O)O)=O,4,1,0,1,9,4.8e-05
G5,C(C(C(CO)=O)CC1C=CC(O1)=O)=O,4,1,0,1,9,4.8e-05
G5,C(C(C(C=C)=O)(C1COC(C1)=O)O)=O,4,1,0,1,0,4.8e-05
G5,C(CCC1C=CC(O1)=O)(C(C=O)O)=O,4,1,0,1,0,4.8e-05
G5,C1(CC(CO1)C(C(C(C=O)=O)=C)O)=O,4,1,0,1,49,4.8e-05
G5,C1C(CC(C(C=O)=O)CO)OC(C=1)=O,4,1,0,1,49,4.8e-05
G5,C(C(C(C=O)=C)(C1COC(C1)=O)O)=O,4,1,0,1,16,4.8e-05
G5,C(C(CC1C=CC(O1)=O)C(C=O)O)=O,8,1,0,1,16,4.8e-05
G5,C1(CC(CO1)C(C(C=O)=CC=O)O)=O,8,1,0,1,18,4.8e-05
G5,C(C(CO)C(C=O)C1C=CC(O1)=O)=O,8,1,0,1,18,4.8e-05
G5,C(CC(C=O)(CO)C1C=CC(O1)=O)=O,4,1,0,1,18,4.8e-05
G5,C(CCC1C=CC(O1)=O)=O,2,1,0,1,28,4.8e-05
G5,C1(CC(CO1)C(C(C=CC)=O)O)=O,8,1,0,1,28,4.8e-05
G5,C1(CC(CO1)CC=CC(CO)=O)=O,4,1,0,1,28,4.8e-05
G5,C(CO)(CC(C)C1C=CC(O1)=O)=O,4,1,0,1,28,4.8e-05
G5,C1(CC(CO1)C(C(CO)=O)C=C)=O,4,1,0,1,28,4.8e-05
G5,C1(CC(CO1)C(C(CC=C)=O)O)=O,4,1,0,1,28,4.8e-05
G5,C1(CC(CO1)CC(C(C=C)O)=O)=O,4,1,0,1,28,4.8e-05
G5,C1(CC(CO1)C(C(C)=O)(C=C)O)=O,4,1,0,1,28,4.8e-05
G5,C1(CC(CO1)C(C(CC=O)=C)O)=O,4,1,0,1,28,4.8e-05
G5,C1(CC(CO1)C(C=O)C(CO)=C)=O,4,1,0,1,28,4.8e-05
G5,C1(CC(CO1)CC(CO)=CC=O)=O,4,1,0,1,28,4.8e-05
G5,C1(CC(CO1)C(C(C)=CC=O)O)=O,8,1,0,1,28,4.8e-05
G5,C(CC(C)(CO)C1C=CC(O1)=O)=O,4,1,0,1,28,4.8e-05
G5,C1(CC(CO1)CC=CC=O)=O,4,1,0,1,28,4.8e-05
G5,C(CC(C)C1C=CC(O1)=O)=O,4,1,0,1,28,4.8e-05
G5,C(C(C=C)C1COC(C1)=O)=O,4,1,0,1,28,4.8e-05
G5,C(CCC1C=CC(O1)=O)(O)=O,2,1,0,1,18,4.8e-05
G5,C1(CC(CO1)C(C=CC(O)=O)O)=O,8,1,0,1,18,4.8e-05
G5,C(CC(CO)C1C=CC(O1)=O)(O)=O,4,1,0,1,18,4.8e-05
G5,C1(CC(CO1)C2(COC(C2)O)O)=O,8,1,0,1,43,4.8e-05
G5,C1(CC(CO1)C2C(CC(O)O2)O)=O,16,1,0,1,43,4.8e-05
G5,C1(CC(CO1)C2C(O)OCC2O)=O,16,1,0,1,43,4.8e-05
G5,C1(CC(CO1)C2(CC(CO2)O)O)=O,8,1,0,1,43,4.8e-05
G5,C1(CC(CO1)C2(C(CCO2)O)O)=O,8,1,0,1,28,4.8e-05
G5,C1(CC(CO1)C2(C(O)OCC2)O)=O,8,1,0,1,28,4.8e-05
G5,C1(CC(CO1)C2COC(C2O)O)=O,16,1,0,1,28,4.8e-05
G5,C1(CC(CO1)C2CC(C(O)O2)O)=O,16,1,0,1,28,4.8e-05
G5,C1(CC(CO1)C2(C(C=CC2=O)=O)O)=O,2,1,0,1,47,4.8e-05
G5,C1(CC(C(C1O)=O)C2C=CC(O2)=O)=O,8,1,0,1,47,4.8e-05
G5,C(C(C=CC=O)C1COC(C1)=O)=O,8,1,0,1,28,4.8e-05
G5,C(CC(C1C=CC(O1)=O)CC=O)=O,2,1,0,1,28,4.8e-05
G5,C1(C(CCC=O)(CCO1)O)=O,2,1,0,1,28,4.8e-05
G5,C(CCC1COC(C1O)=O)=O,4,1,0,1,28,4.8e-05
G5,C(CCC1CC(C(O1)=O)O)=O,4,1,0,1,28,4.8e-05
G5,C1(C(CCO1)(C(C)CC=O)O)=O,4,1,0,1,28,4.8e-05
G5,C(CC(C)C1COC(C1O)=O)=O,8,1,0,1,28,4.8e-05
G5,C(CC(C)C1CC(C(O1)=O)O)=O,8,1,0,1,28,4.8e-05
G5,C1(C(CCC(O)=O)(CCO1)O)=O,2,1,0,1,28,4.8e-05
G5,C(CCC1COC(C1O)=O)(O)=O,4,1,0,1,28,4.8e-05
G5,C(CCC1CC(C(O1)=O)O)(O)=O,4,1,0,1,28,4.8e-05
G5,C(C(CCC(C=O)=O)CCC=O)=O,2,1,0,1,7,4.8e-05
G5,C(CCC(C(C=O)=O)CCC=O)=O,1,1,0,1,7,4.8e-05
G5,C(CC(CCC=O)CC(C=O)=O)=O,2,1,0,1,7,4.8e-05
G5,C(C(CCC(C=O)=O)C(C)CC=O)=O,4,1,0,1,7,4.8e-05
G5,C(CC(C)C(C(C=O)=O)CCC=O)=O,4,1,0,1,7,4.8e-05
G5,C(CC(C(C)CC=O)CC(C=O)=O)=O,4,1,0,1,7,4.8e-05
G5,C(C(CCC=O)CCC(CO)=O)=O,2,1,0,1,27,4.8e-05
G5,C(CCCC(C(CCC=O)O)=O)=O,2,1,0,1,27,4.8e-05
G5,C(CCC(C(CO)=O)CCC=O)=O,1,1,0,1,27,4.8e-05
G5,C(CCC(CC=O)CC(CO)=O)=O,2,1,0,1,27,4.8e-05
G5,C(CCC(C=O)C(C=O)CC=O)=O,4,1,0,1,43,4.8e-05
G5,C(CCC(C=O)(CC=O)CC=O)=O,1,1,0,1,43,4.8e-05
G5,C(CC(C)C(C=O)C(C=O)CC=O)=O,8,1,0,1,43,4.8e-05
G5,C(CC(C)C(C=O)(CC=O)CC=O)=O,2,1,0,1,43,4.8e-05
G5,C(C(C)(CCC=O)O)(CC=O)=O,2,1,0,1,45,4.8e-05
G5,C(CCCC(C(CC=O)=O)O)=O,2,1,0,1,45,4.8e-05
G5,C(CCC(C=O)C(C(C)O)=O)=O,4,1,0,1,45,4.8e-05
G5,C(C(C)(C(C)CC=O)O)(CC=O)=O,4,1,0,1,45,4.8e-05
G5,C(CC(C)CC(C(CC=O)=O)O)=O,4,1,0,1,45,4.8e-05
G5,C(CC(C)C(C=O)C(C(C)O)=O)=O,8,1,0,1,45,4.8e-05
G5,C(C(C)(CCC(O)=O)O)(CC=O)=O,2,1,0,1,45,4.8e-05
G5,C(CCCC(C(CC=O)=O)O)(O)=O,2,1,0,1,45,4.8e-05
G5,C(CCC(C=O)C(C(C)O)=O)(O)=O,4,1,0,1,45,4.8e-05
G5,C(CCC(C(CO)C(C=O)O)O)=O,8,1,0,1,2,4.8e-05
G5,C(C(CCC=O)(C(CO)CO)O)=O,2,1,0,1,2,4.8e-05
G5,C(CCC(CO)(CO)C(C=O)O)=O,2,1,0,1,2,4.8e-05
G5,C(CCC(C(C)O)C(C=O)O)=O,8,1,0,1,11,4.8e-05
G5,C(C(CCC=O)(CC(C)O)O)=O,4,1,0,1,11,4.8e-05
G5,C(CCCC(CC(C=O)O)O)=O,4,1,0,1,11,4.8e-05
G5,C(CCC(C)(CC(C=O)O)O)=O,4,1,0,1,11,4.8e-05
G5,C(CC(C)C(C(C)O)C(C=O)O)=O,16,1,0,1,11,4.8e-05
G5,C(C(CC(C)O)(C(C)CC=O)O)=O,8,1,0,1,11,4.8e-05
G5,C(CC(C)CC(CC(C=O)O)O)=O,8,1,0,1,11,4.8e-05
G5,C(CC(C)C(C)(CC(C=O)O)O)=O,8,1,0,1,11,4.8e-05
G5,C(CCC(C(C)O)C(C=O)O)(O)=O,8,1,0,1,11,4.8e-05
G5,C(C(CCC(O)=O)(CC(C)O)O)=O,4,1,0,1,11,4.8e-05
G5,C(CCCC(CC(C=O)O)O)(O)=O,4,1,0,1,11,4.8e-05
G5,C(CCC(C)(CC(C=O)O)O)(O)=O,4,1,0,1,11,4.8e-05
G5,C(CCCC(C(C(C)O)=O)O)=O,4,1,0,1,49,4.8e-05
G5,C(CCC(C(C(C)O)=O)(C)O)=O,4,1,0,1,49,4.8e-05
G5,C(CC(C)CC(C(C(C)O)=O)O)=O,8,1,0,1,49,4.8e-05
G5,C(CC(C)C(C(C(C)O)=O)(C)O)=O,8,1,0,1,49,4.8e-05
G5,C(CCCC(C(C(C)O)=O)O)(O)=O,4,1,0,1,49,4.8e-05
G5,C(CCC(C(C(C)O)=O)(C)O)(O)=O,4,1,0,1,49,4.8e-05
G5,C(CCC(C(C(C=O)(C)O)=O)O)=O,4,1,0,1,0,4.8e-05
G5,C(CCCC(C=O)(C(CO)=O)O)=O,2,1,0,1,0,4.8e-05
G5,C(CCC(CO)(CC(C=O)O)O)=O,4,1,0,1,0,4.8e-05
G5,C(CCC(C(CC(C=O)O)O)O)=O,8,1,0,1,0,4.8e-05
G5,C(CCC(C(CO)O)C(C=O)O)=O,8,1,0,1,0,4.8e-05
G5,C(C(CCC=O)(CC(CO)O)O)=O,4,1,0,1,0,4.8e-05
G5,C(CCC(C(C(O)=O)=O)(C)O)=O,2,1,0,1,4,4.8e-05
G5,C(CCCC(C(C(O)=O)=O)O)=O,2,1,0,1,4,4.8e-05
G5,C(CC(C)C(C(C(O)=O)=O)(C)O)=O,4,1,0,1,4,4.8e-05
G5,C(CC(C)CC(C(C(O)=O)=O)O)=O,4,1,0,1,4,4.8e-05
G5,C(CCC(C(C(O)=O)=O)(C)O)(O)=O,2,1,0,1,4,4.8e-05
G5,C(CCCC(C(C(O)=O)=O)O)(O)=O,2,1,0,1,4,4.8e-05
G5,C(CC(C(CCO)O)C(C=O)O)=O,8,1,0,1,18,4.8e-05
G5,C(CC(C(CO)CO)C(C=O)O)=O,4,1,0,1,18,4.8e-05
G5,C(CC(C(CO)(C)O)C(C=O)O)=O,8,1,0,1,11,4.8e-05
G5,C(CC(C(C(C)O)O)C(C=O)O)=O,16,1,0,1,11,4.8e-05
G5,C(C(C=CC=O)(CCC=O)O)=O,4,1,0,1,20,4.8e-05
G5,C(CC(C(C=O)O)CC=CC=O)=O,8,1,0,1,20,4.8e-05
G5,C(C(C=CC=O)(C(C)CC=O)O)=O,8,1,0,1,20,4.8e-05
G5,C(CC(C(C=O)O)C(C=O)C=C)=O,8,1,0,1,20,4.8e-05
G5,C(C(C=CC=O)(CCC(O)=O)O)=O,4,1,0,1,20,4.8e-05
G5,C(CCC(C(CO)(CCO)O)O)=O,4,1,0,1,29,4.8e-05
G5,C(CCC(CO)C(CO)(CO)O)=O,2,1,0,1,29,4.8e-05
G5,C(CCC(CC(CO)(CO)O)O)=O,2,1,0,1,29,4.8e-05
G5,C(CCC(CO)(C(CCO)O)O)=O,4,1,0,1,27,4.8e-05
G5,C(CCC(C(C(CCO)O)O)O)=O,8,1,0,1,27,4.8e-05
G5,C(CCC(CO)C(C(CO)O)O)=O,8,1,0,1,27,4.8e-05
G5,C(CCC(CC(C(CO)O)O)O)=O,8,1,0,1,27,4.8e-05
G5,C(CCC(C(C)=O)(CCO)O)=O,2,1,0,1,45,4.8e-05
G5,C(CCCC(C(CCO)O)=O)=O,2,1,0,1,45,4.8e-05
G5,C(CCC(CO)C(C(C)=O)O)=O,4,1,0,1,45,4.8e-05
G5,C(CCC(CC(C(C)=O)O)O)=O,4,1,0,1,45,4.8e-05
G5,C(CC(C)C(C(C)=O)(CCO)O)=O,4,1,0,1,45,4.8e-05
G5,C(CC(C)CC(C(CCO)O)=O)=O,4,1,0,1,45,4.8e-05
G5,C(CC(C)C(CO)C(C(C)=O)O)=O,8,1,0,1,45,4.8e-05
G5,C(CC(C)C(CC(C(C)=O)O)O)=O,8,1,0,1,45,4.8e-05
G5,C(CCC(C(C)=O)(CCO)O)(O)=O,2,1,0,1,45,4.8e-05
G5,C(CCCC(C(CCO)O)=O)(O)=O,2,1,0,1,45,4.8e-05
G5,C(CCC(CO)C(C(C)=O)O)(O)=O,4,1,0,1,45,4.8e-05
G5,C(CCC(CC(C(C)=O)O)O)(O)=O,4,1,0,1,45,4.8e-05
G5,C(C(CCO)(CCCC=O)O)=O,2,1,0,1,29,4.8e-05
G5,C(C(C)(C(CO)CCC=O)O)=O,4,1,0,1,29,4.8e-05
G5,C(C(C)(CC(CCC=O)O)O)=O,4,1,0,1,29,4.8e-05
G5,C(C(CCO)(CC(C)CC=O)O)=O,4,1,0,1,29,4.8e-05
G5,C(C(C)(C(CO)C(C)CC=O)O)=O,8,1,0,1,29,4.8e-05
G5,C(C(C)(CC(C(C)CC=O)O)O)=O,8,1,0,1,29,4.8e-05
G5,C(C(CCO)(CCCC(O)=O)O)=O,2,1,0,1,29,4.8e-05
G5,C(C(C)(C(CO)CCC(O)=O)O)=O,4,1,0,1,29,4.8e-05
G5,C(C(C)(CC(CCC(O)=O)O)O)=O,4,1,0,1,29,4.8e-05
G5,C(C(CCC(CCO)O)=O)(O)=O,2,1,0,1,18,4.8e-05
G5,C(C(CCC(CO)CO)=O)(O)=O,1,1,0,1,18,4.8e-05
G5,C(CC(CO)(CO)C(CCO)O)=O,2,1,0,1,18,4.8e-05
G5,C(CC(CO)(CO)C(CO)CO)=O,1,1,0,1,18,4.8e-05
G5,C(CC(C(CCO)O)C(CO)O)=O,8,1,0,1,46,4.8e-05
G5,C(CC(C(CO)O)C(CO)CO)=O,4,1,0,1,46,4.8e-05
G5,C(CC(C(C=O)=O)C(CO)CO)=O,2,1,0,1,18,4.8e-05
G5,C(C(C(CO)CO)CC(C=O)=O)=O,2,2,0,2,29,9.499999999999999e-05
G5,C(C(CC(C)C(CCO)O)=O)=O,4,1,0,1,18,4.8e-05
G5,C(C(CC(C)C(CO)CO)=O)=O,2,1,0,1,18,4.8e-05
G5,C(C)(C(C(CCO)O)CC=O)=O,4,1,0,1,18,4.8e-05
G5,C(C)(C(C(CO)CO)CC=O)=O,2,1,0,1,18,4.8e-05
G5,C(C(C(CCO)O)CC(C)=O)=O,4,1,0,1,18,4.8e-05
G5,C(C(C(CO)CO)CC(C)=O)=O,2,1,0,1,18,4.8e-05
G5,C(C(CC(CO)CO)CC=O)=O,2,1,0,1,18,4.8e-05
G5,C(C(C)(C(CCO)O)CC=O)=O,4,1,0,1,18,4.8e-05
G5,C(C(C)(C(CO)CO)CC=O)=O,2,1,0,1,18,4.8e-05
G5,C(C(C(CO)CO)C(C=O)C)=O,4,1,0,1,18,4.8e-05
G5,C(C(C(CO)=O)CC(CCO)O)=O,4,1,0,1,18,4.8e-05
G5,C(C(C(CO)=O)CC(CO)CO)=O,2,1,0,1,18,4.8e-05
G5,C(C(C(CCC(CO)CO)=O)O)=O,2,1,0,1,18,4.8e-05
G5,C(C(C(CO)CC(CCO)O)=O)=O,4,1,0,1,49,4.8e-05
G5,C(C(C(CO)CC(CO)CO)=O)=O,2,1,0,1,49,4.8e-05
G5,C(CO)(C(CO)CC(CCO)O)=O,4,1,0,1,18,4.8e-05
G5,C(CO)(C(CO)CC(CO)CO)=O,2,1,0,1,18,4.8e-05
G5,C(C(CC(CCO)O)C(C=O)O)=O,8,1,0,1,18,4.8e-05
G5,C(C(CC(CO)CO)C(C=O)O)=O,4,1,0,1,18,4.8e-05
G5,C(C(C(CO)CO)C(C=O)CO)=O,4,1,0,1,18,4.8e-05
G5,C(C(CO)(C(CO)CO)CC=O)=O,2,1,0,1,18,4.8e-05
G5,C(CCC(CCO)O)=O,2,1,0,1,18,4.8e-05
G5,C(CCC(CO)CO)=O,1,1,0,1,18,4.8e-05
G5,C(CO)(CC(C)C(CCO)O)=O,4,1,0,1,18,4.8e-05
G5,C(CO)(CC(C)C(CO)CO)=O,2,1,0,1,18,4.8e-05
G5,C(CC(C)(CO)C(CCO)O)=O,4,1,0,1,18,4.8e-05
G5,C(CC(C)(CO)C(CO)CO)=O,2,1,0,1,18,4.8e-05
G5,C(CC(C)C(CCO)O)=O,4,1,0,1,18,4.8e-05
G5,C(CC(C)C(CO)CO)=O,2,1,0,1,18,4.8e-05
G5,C(CCC(CCO)O)(O)=O,2,1,0,1,18,4.8e-05
G5,C(CCC(CO)CO)(O)=O,1,1,0,1,18,4.8e-05
G5,C(CC(CO)C(CCO)O)(O)=O,4,1,0,1,18,4.8e-05
G5,C(CC(CO)C(CO)CO)(O)=O,2,1,0,1,18,4.8e-05
G5,C1(C(C(CO)CO)CC(C1O)=O)=O,4,1,0,1,18,4.8e-05
G5,C(CC(C(CCO)O)CC=O)=O,2,1,0,1,18,4.8e-05
G5,C(CC(C(CO)CO)CC=O)=O,1,1,0,1,18,4.8e-05
G5,C(CCCC(CO)(CCO)O)=O,2,1,0,1,18,4.8e-05
G5,C(CCC(C(C)(CCO)O)O)=O,4,1,0,1,18,4.8e-05
G5,C(CCC(CO)C(C)(CO)O)=O,4,1,0,1,18,4.8e-05
G5,C(CCC(CC(C)(CO)O)O)=O,4,1,0,1,18,4.8e-05
G5,C(CC(C)CC(CO)(CCO)O)=O,4,1,0,1,18,4.8e-05
G5,C(CC(C)C(C(C)(CCO)O)O)=O,8,1,0,1,18,4.8e-05
G5,C(CC(C)C(CO)C(C)(CO)O)=O,8,1,0,1,18,4.8e-05
G5,C(CC(C)C(CC(C)(CO)O)O)=O,8,1,0,1,18,4.8e-05
G5,C(CCCC(CO)(CCO)O)(O)=O,2,1,0,1,18,4.8e-05
G5,C(CCC(C(C)(CCO)O)O)(O)=O,4,1,0,1,18,4.8e-05
G5,C(CCC(CO)C(C)(CO)O)(O)=O,4,1,0,1,18,4.8e-05
G5,C(CCC(CC(C)(CO)O)O)(O)=O,4,1,0,1,18,4.8e-05
G5,C(C(CCC(CO)C(C)O)=O)(O)=O,4,1,0,1,28,4.8e-05
G5,C(C(CCC(CC(C)O)O)=O)(O)=O,4,1,0,1,28,4.8e-05
G5,C(C(CCCC(CCO)O)=O)(O)=O,2,1,0,1,28,4.8e-05
G5,C(C(CCC(C)(CCO)O)=O)(O)=O,2,1,0,1,28,4.8e-05
G5,C(C(CC(C)C(CO)C(C)O)=O)=O,8,1,0,1,28,4.8e-05
G5,C(C(CC(C)C(CC(C)O)O)=O)=O,8,1,0,1,28,4.8e-05
G5,C(C(CC(C)CC(CCO)O)=O)=O,4,1,0,1,28,4.8e-05
G5,C(C(CC(C)C(C)(CCO)O)=O)=O,4,1,0,1,28,4.8e-05
G5,C(C)(C(C(CO)C(C)O)CC=O)=O,8,1,0,1,28,4.8e-05
G5,C(C)(C(C(CC(C)O)O)CC=O)=O,8,1,0,1,28,4.8e-05
G5,C(C)(C(CC(CCO)O)CC=O)=O,4,1,0,1,28,4.8e-05
G5,C(C)(C(C(C)(CCO)O)CC=O)=O,4,1,0,1,28,4.8e-05
G5,C(C(C(CO)C(C)O)CC(C)=O)=O,8,1,0,1,28,4.8e-05
G5,C(C(C(CC(C)O)O)CC(C)=O)=O,8,1,0,1,28,4.8e-05
G5,C(C(CC(CCO)O)CC(C)=O)=O,4,1,0,1,28,4.8e-05
G5,C(C(C(C)(CCO)O)CC(C)=O)=O,4,1,0,1,28,4.8e-05
G5,C(C(CC(CO)C(C)O)CC=O)=O,8,1,0,1,28,4.8e-05
G5,C(C(CC(CC(C)O)O)CC=O)=O,8,1,0,1,28,4.8e-05
G5,C(C(CCC(CCO)O)CC=O)=O,4,1,0,1,28,4.8e-05
G5,C(C(CC(C)(CCO)O)CC=O)=O,4,1,0,1,28,4.8e-05
G5,C(C(C)(C(CO)C(C)O)CC=O)=O,8,1,0,1,28,4.8e-05
G5,C(C(C)(C(CC(C)O)O)CC=O)=O,8,1,0,1,28,4.8e-05
G5,C(C(C)(CC(CCO)O)CC=O)=O,4,1,0,1,28,4.8e-05
G5,C(C(C)(C(C)(CCO)O)CC=O)=O,4,1,0,1,28,4.8e-05
G5,C(C(C(CO)C(C)O)C(C=O)C)=O,16,1,0,1,28,4.8e-05
G5,C(C(CC(CCO)O)C(C=O)C)=O,8,1,0,1,28,4.8e-05
G5,C(CCC(CO)C(C)O)=O,4,1,0,1,28,4.8e-05
G5,C(CCC(CC(C)O)O)=O,4,1,0,1,28,4.8e-05
G5,C(CCCC(CCO)O)=O,2,1,0,1,28,4.8e-05
G5,C(CCC(C)(CCO)O)=O,2,1,0,1,28,4.8e-05
G5,C(CO)(CC(C)C(CO)C(C)O)=O,8,1,0,1,28,4.8e-05
G5,C(CO)(CC(C)C(CC(C)O)O)=O,8,1,0,1,28,4.8e-05
G5,C(CO)(CC(C)CC(CCO)O)=O,4,1,0,1,28,4.8e-05
G5,C(CO)(CC(C)C(C)(CCO)O)=O,4,1,0,1,28,4.8e-05
G5,C(CC(C)(CO)C(CO)C(C)O)=O,8,1,0,1,28,4.8e-05
G5,C(CC(C)(CO)C(CC(C)O)O)=O,8,1,0,1,28,4.8e-05
G5,C(CC(C)(CO)CC(CCO)O)=O,4,1,0,1,28,4.8e-05
G5,C(CC(C)(CO)C(C)(CCO)O)=O,4,1,0,1,28,4.8e-05
G5,C(CC(C)C(CO)C(C)O)=O,8,1,0,1,28,4.8e-05
G5,C(CC(C)C(CC(C)O)O)=O,8,1,0,1,28,4.8e-05
G5,C(CC(C)CC(CCO)O)=O,4,1,0,1,28,4.8e-05
G5,C(CC(C)C(C)(CCO)O)=O,4,1,0,1,28,4.8e-05
G5,C(CCC(CO)C(C)O)(O)=O,4,1,0,1,28,4.8e-05
G5,C(CCC(CC(C)O)O)(O)=O,4,1,0,1,28,4.8e-05
G5,C(CCCC(CCO)O)(O)=O,2,1,0,1,28,4.8e-05
G5,C(CCC(C)(CCO)O)(O)=O,2,1,0,1,28,4.8e-05
G5,C(CC(CO)C(CO)C(C)O)(O)=O,8,1,0,1,18,4.8e-05
G5,C(CC(CO)C(CC(C)O)O)(O)=O,8,1,0,1,18,4.8e-05
G5,C(CC(CO)CC(CCO)O)(O)=O,4,1,0,1,18,4.8e-05
G5,C(CC(CO)C(C)(CCO)O)(O)=O,4,1,0,1,18,4.8e-05
G5,C(CC(C(CO)C(C)O)CC=O)=O,4,1,0,1,28,4.8e-05
G5,C(CC(C(CC(C)O)O)CC=O)=O,4,1,0,1,28,4.8e-05
G5,C(CC(CC(CCO)O)CC=O)=O,2,1,0,1,28,4.8e-05
G5,C(CC(C(C)(CCO)O)CC=O)=O,2,1,0,1,28,4.8e-05
G5,C(C(C)(C(C(CCC=O)O)O)O)=O,8,1,0,1,0,4.8e-05
G5,C(C(C(CO)O)(CCCC=O)O)=O,4,1,0,1,0,4.8e-05
G5,C(CCC(C(C(C)(CO)O)O)O)=O,8,1,0,1,27,4.8e-05
G5,C(CCC(CO)(C(C)(CO)O)O)=O,4,1,0,1,27,4.8e-05
G5,C(CCCC(CO)(C(CO)O)O)=O,4,1,0,1,27,4.8e-05
G5,C(CCC(C(C)(C(CO)O)O)O)=O,8,1,0,1,27,4.8e-05
G5,C(CCC(C(C(C)O)O)O)=O,8,1,0,1,28,4.8e-05
G5,C(CCC(CO)(C(C)O)O)=O,4,1,0,1,28,4.8e-05
G5,C(CCCC(C(CO)O)O)=O,4,1,0,1,28,4.8e-05
G5,C(CCC(C)(C(CO)O)O)=O,4,1,0,1,28,4.8e-05
G5,C(CC(C)C(C(C(C)O)O)O)=O,16,1,0,1,28,4.8e-05
G5,C(CC(C)C(CO)(C(C)O)O)=O,8,1,0,1,28,4.8e-05
G5,C(CC(C)CC(C(CO)O)O)=O,8,1,0,1,28,4.8e-05
G5,C(CC(C)C(C)(C(CO)O)O)=O,8,1,0,1,28,4.8e-05
G5,C(CCC(C(C(C)O)O)O)(O)=O,8,1,0,1,28,4.8e-05
G5,C(CCC(CO)(C(C)O)O)(O)=O,4,1,0,1,28,4.8e-05
G5,C(CCCC(C(CO)O)O)(O)=O,4,1,0,1,28,4.8e-05
G5,C(CCC(C)(C(CO)O)O)(O)=O,4,1,0,1,28,4.8e-05
G5,C(CCC(CO)(CCO)O)=O,2,1,0,1,29,4.8e-05
G5,C(CCC(C(CCO)O)O)=O,4,1,0,1,29,4.8e-05
G5,C(CCC(CO)C(CO)O)=O,4,1,0,1,29,4.8e-05
G5,C(CCC(CC(CO)O)O)=O,4,1,0,1,29,4.8e-05
G5,C(CC(C)C(CO)(CCO)O)=O,4,1,0,1,29,4.8e-05
G5,C(CC(C)C(C(CCO)O)O)=O,8,1,0,1,29,4.8e-05
G5,C(CC(C)C(CO)C(CO)O)=O,8,1,0,1,29,4.8e-05
G5,C(CC(C)C(CC(CO)O)O)=O,8,1,0,1,29,4.8e-05
G5,C(CCC(CO)(CCO)O)(O)=O,2,1,0,1,29,4.8e-05
G5,C(CCC(C(CCO)O)O)(O)=O,4,1,0,1,29,4.8e-05
G5,C(CCC(CO)C(CO)O)(O)=O,4,1,0,1,29,4.8e-05
G5,C(CCC(CC(CO)O)O)(O)=O,4,1,0,1,29,4.8e-05
G5,C(CC(C(CCC=O)O)O)(O)=O,4,1,0,1,45,4.8e-05
G5,C(CC(CCC=O)(CO)O)(O)=O,2,1,0,1,45,4.8e-05
G5,C(C(CCC=O)C(CO)O)(O)=O,4,1,0,1,45,4.8e-05
G5,C(CC(C(C(C)CC=O)O)O)(O)=O,8,1,0,1,45,4.8e-05
G5,C(CC(CO)(C(C)CC=O)O)(O)=O,4,1,0,1,45,4.8e-05
G5,C(C(C(C)CC=O)C(CO)O)(O)=O,8,1,0,1,45,4.8e-05
G5,C(CCC(C(CC(O)=O)O)O)(O)=O,4,1,0,1,45,4.8e-05
G5,C(CCC(CO)(CC(O)=O)O)(O)=O,2,1,0,1,45,4.8e-05
G5,C(C(CCC(O)=O)C(CO)O)(O)=O,4,1,0,1,45,4.8e-05
G5,C(C(CCCC(CO)O)=O)(O)=O,2,1,0,1,11,4.8e-05
G5,C(C(CCC(C(C)O)O)=O)(O)=O,4,1,0,1,11,4.8e-05
G5,C(CC(CO)(CO)CC(CO)O)=O,2,1,0,1,18,4.8e-05
G5,C(CC(CO)(CO)C(C)(CO)O)=O,2,1,0,1,18,4.8e-05
G5,C(CC(CO)(CO)C(C(C)O)O)=O,4,1,0,1,18,4.8e-05
G5,C(CC(CC(CO)O)C(CO)O)=O,8,1,0,1,46,4.8e-05
G5,C(CC(C(CO)O)C(C)(CO)O)=O,8,1,0,1,46,4.8e-05
G5,C(CC(C(C(C)O)O)C(CO)O)=O,16,1,0,1,46,4.8e-05
G5,C(C(CC(CO)O)CC(C=O)=O)=O,4,2,0,2,46,9.499999999999999e-05
G5,C(C(CC(C)CC(CO)O)=O)=O,4,1,0,1,11,4.8e-05
G5,C(C(CC(C)C(C)(CO)O)=O)=O,4,1,0,1,11,4.8e-05
G5,C(C(CC(C)C(C(C)O)O)=O)=O,8,1,0,1,11,4.8e-05
G5,C(C)(C(CC(CO)O)CC=O)=O,4,1,0,1,11,4.8e-05
G5,C(C)(C(C(C)(CO)O)CC=O)=O,4,1,0,1,11,4.8e-05
G5,C(C)(C(C(C(C)O)O)CC=O)=O,8,1,0,1,11,4.8e-05
G5,C(C(CC(CO)O)CC(C)=O)=O,4,1,0,1,11,4.8e-05
G5,C(C(C(C(C)O)O)CC(C)=O)=O,8,1,0,1,11,4.8e-05
G5,C(C(CCC(CO)O)CC=O)=O,4,1,0,1,11,4.8e-05
G5,C(C(CC(C(C)O)O)CC=O)=O,8,1,0,1,11,4.8e-05
G5,C(C(C)(CC(CO)O)CC=O)=O,4,1,0,1,11,4.8e-05
G5,C(C(C)(C(C)(CO)O)CC=O)=O,4,1,0,1,11,4.8e-05
G5,C(C(C)(C(C(C)O)O)CC=O)=O,8,1,0,1,11,4.8e-05
G5,C(C(CC(CO)O)C(C=O)C)=O,8,1,0,1,11,4.8e-05
G5,C(C(C(CO)=O)CCC(CO)O)=O,4,1,0,1,11,4.8e-05
G5,C(C(C(CO)=O)CC(CO)(C)O)=O,4,1,0,1,11,4.8e-05
G5,C(C(C(CO)=O)CC(C(C)O)O)=O,8,1,0,1,11,4.8e-05
G5,C(C(C(CCCC(CO)O)=O)O)=O,4,1,0,1,11,4.8e-05
G5,C(C(C(CCC(CO)(C)O)=O)O)=O,4,1,0,1,11,4.8e-05
G5,C(C(C(CCC(C(C)O)O)=O)O)=O,8,1,0,1,11,4.8e-05
G5,C(C(C(CO)CCC(CO)O)=O)=O,4,1,0,1,49,4.8e-05
G5,C(C(C(CO)CC(C)(CO)O)=O)=O,4,1,0,1,49,4.8e-05
G5,C(C(C(CO)CC(C(C)O)O)=O)=O,8,1,0,1,49,4.8e-05
G5,C(CO)(C(CO)CCC(CO)O)=O,4,1,0,1,49,4.8e-05
G5,C(CO)(C(CO)CC(CO)(C)O)=O,4,1,0,1,49,4.8e-05
G5,C(CO)(C(CO)CC(C(C)O)O)=O,8,1,0,1,49,4.8e-05
G5,C(C(CCC(CO)O)C(C=O)O)=O,8,1,0,1,16,4.8e-05
G5,C(C(CC(CO)(C)O)C(C=O)O)=O,8,1,0,1,16,4.8e-05
G5,C(C(CC(C(C)O)O)C(C=O)O)=O,16,1,0,1,16,4.8e-05
G5,C(C(CC(CO)O)C(C=O)CO)=O,8,1,0,1,18,4.8e-05
G5,C(C(CO)(CC(CO)O)CC=O)=O,4,1,0,1,18,4.8e-05
G5,C(CCCC(CO)O)=O,2,1,0,1,11,4.8e-05
G5,C(CCC(C)(CO)O)=O,2,1,0,1,11,4.8e-05
G5,C(CCC(C(C)O)O)=O,4,1,0,1,11,4.8e-05
G5,C(CO)(CC(C)CC(CO)O)=O,4,1,0,1,11,4.8e-05
G5,C(CO)(CC(C)C(CO)(C)O)=O,4,1,0,1,11,4.8e-05
G5,C(CO)(CC(C)C(C(C)O)O)=O,8,1,0,1,11,4.8e-05
G5,C(CC(C)(CO)CC(CO)O)=O,4,1,0,1,28,4.8e-05
G5,C(CC(C)(CO)C(C)(CO)O)=O,4,1,0,1,11,4.8e-05
G5,C(CC(C)(CO)C(C(C)O)O)=O,8,1,0,1,28,4.8e-05
G5,C(CC(C)CC(CO)O)=O,4,1,0,1,11,4.8e-05
G5,C(CC(C)C(C)(CO)O)=O,4,1,0,1,11,4.8e-05
G5,C(CC(C)C(C(C)O)O)=O,8,1,0,1,11,4.8e-05
G5,C(CCCC(CO)O)(O)=O,2,1,0,1,11,4.8e-05
G5,C(CCC(C)(CO)O)(O)=O,2,1,0,1,11,4.8e-05
G5,C(CCC(C(C)O)O)(O)=O,4,1,0,1,11,4.8e-05
G5,C(CC(CO)CC(CO)O)(O)=O,4,1,0,1,18,4.8e-05
G5,C(CC(CO)C(C)(CO)O)(O)=O,4,1,0,1,18,4.8e-05
G5,C(CC(CO)C(C(C)O)O)(O)=O,8,1,0,1,18,4.8e-05
G5,C1(C(CC(CO)O)CC(C1O)=O)=O,8,2,0,2,46,9.499999999999999e-05
G5,C(CC(CC(CO)O)CC=O)=O,2,1,0,1,11,4.8e-05
G5,C(CC(C(C)(CO)O)CC=O)=O,2,1,0,1,11,4.8e-05
G5,C(CC(C(C(C)O)O)CC=O)=O,4,1,0,1,11,4.8e-05
G5,C(CCC(C(CO)(CO)O)O)=O,2,1,0,1,18,4.8e-05
G5,C(CC(C)C(C(CO)(CO)O)O)=O,4,1,0,1,18,4.8e-05
G5,C(CCC(C(CO)(CO)O)O)(O)=O,2,1,0,1,18,4.8e-05
G5,C(CCC(C(CO)(C(C)O)O)O)=O,8,1,0,1,27,4.8e-05
G5,C(CCCC(C(CO)(CO)O)O)=O,2,1,0,1,27,4.8e-05
G5,C(CCC(C)(C(CO)(CO)O)O)=O,2,1,0,1,27,4.8e-05
G5,C(C(CO)(C(CO)CCC=O)O)=O,4,1,0,1,29,4.8e-05
G5,C(C(CO)(CC(CCC=O)O)O)=O,4,1,0,1,29,4.8e-05
G5,C(CCC(C(C=CC(C)=O)=O)O)=O,4,1,0,1,45,4.8e-05
G5,C(CCCC(C=CC(CO)=O)=O)=O,2,1,0,1,45,4.8e-05
G5,C(CO)(C(CC(C)=O)CC=CC=O)=O,4,1,0,1,45,4.8e-05
G5,C(C)(C(CC(CO)=O)CC=CC=O)=O,4,1,0,1,45,4.8e-05
G5,C(CC(C)C(C(C=CC(C)=O)=O)O)=O,8,1,0,1,45,4.8e-05
G5,C(CC(C)CC(C=CC(CO)=O)=O)=O,4,1,0,1,45,4.8e-05
G5,C(C(C=C)C(C(CO)=O)CC(C)=O)=O,4,1,0,1,45,4.8e-05
G5,C(C(C=C)C(C(C)=O)CC(CO)=O)=O,4,1,0,1,45,4.8e-05
G5,C(CCC(C(C=CCC=O)=O)O)=O,4,1,0,1,29,4.8e-05
G5,C(CCC(C=O)C=CC(CO)=O)=O,4,1,0,1,29,4.8e-05
G5,C(CC(CC(CO)=O)CC=CC=O)=O,4,2,0,2,45,9.499999999999999e-05
G5,C(CC(C)C(C(C=CCC=O)=O)O)=O,8,1,0,1,29,4.8e-05
G5,C(CC(C)C(C=O)C=CC(CO)=O)=O,8,1,0,1,29,4.8e-05
G5,C(CC(CC(CO)=O)C(C=O)C=C)=O,4,2,0,2,45,9.499999999999999e-05
G5,C(CCC(C=CC(C=O)=O)CO)=O,4,1,0,1,29,4.8e-05
G5,C(CCC(CC=CC(C=O)=O)O)=O,4,1,0,1,29,4.8e-05
G5,C(CC(CCO)CC(C=O)=O)=CC=O,4,1,0,1,29,4.8e-05
G5,C(CC(C)C(C=CC(C=O)=O)CO)=O,8,1,0,1,29,4.8e-05
G5,C(CC(C)C(CC=CC(C=O)=O)O)=O,8,1,0,1,29,4.8e-05
G5,C(C(C=C)C(CCO)CC(C=O)=O)=O,4,1,0,1,29,4.8e-05
G5,C(CCC(C=CC(C(C)=O)=O)O)=O,4,1,0,1,27,4.8e-05
G5,C(CCCC(C(C=CCO)=O)=O)=O,2,1,0,1,27,4.8e-05
G5,C(CC(CO)CC(C(C)=O)=O)=CC=O,4,1,0,1,27,4.8e-05
G5,C(CC(C)C(C=CC(C(C)=O)=O)O)=O,8,1,0,1,27,4.8e-05
G5,C(CC(C)CC(C(C=CCO)=O)=O)=O,4,1,0,1,27,4.8e-05
G5,C(C(C=C)C(CO)CC(C(C)=O)=O)=O,4,1,0,1,27,4.8e-05
G5,C(CCC(C(C=CC=O)=O)CO)=O,4,1,0,1,27,4.8e-05
G5,C(CC(C=O)CC=CC=O)(CCO)=O,4,1,0,1,27,4.8e-05
G5,C(CC(C(CCO)=O)CC=CC=O)=O,4,1,0,1,27,4.8e-05
G5,C(CC(C)C(C(C=CC=O)=O)CO)=O,8,1,0,1,27,4.8e-05
G5,C(CC(C=O)C(C=O)C=C)(CCO)=O,4,1,0,1,27,4.8e-05
G5,C(CC(C(CCO)=O)C(C=O)C=C)=O,4,1,0,1,27,4.8e-05
G5,C(CCC(C(CC(C=C)=O)=O)O)=O,2,1,0,1,27,4.8e-05
G5,C(CCC(C(CO)=O)C(C=C)=O)=O,2,1,0,1,27,4.8e-05
G5,C(CCCC=CC=O)(CC(CO)=O)=O,2,1,0,1,27,4.8e-05
G5,C(CC(C)C(C(CC(C=C)=O)=O)O)=O,4,1,0,1,27,4.8e-05
G5,C(CC(C)C(C(CO)=O)C(C=C)=O)=O,4,1,0,1,27,4.8e-05
G5,C(C(C=C)CCC(CC(CO)=O)=O)=O,2,1,0,1,27,4.8e-05
G5,C(CCC(CC(C(C=C)=O)=O)O)=O,2,1,0,1,45,4.8e-05
G5,C(CCC(C(C(C=C)=O)=O)CO)=O,2,1,0,1,45,4.8e-05
G5,C(CCCC(C(CCO)=O)=O)=CC=O,2,1,0,1,45,4.8e-05
G5,C(CC(C)C(CC(C(C=C)=O)=O)O)=O,4,1,0,1,45,4.8e-05
G5,C(CC(C)C(C(C(C=C)=O)=O)CO)=O,4,1,0,1,45,4.8e-05
G5,C(C(C=C)CCC(C(CCO)=O)=O)=O,2,1,0,1,45,4.8e-05
G5,C(CCC(C(CC=CC=O)=O)O)=O,4,1,0,1,27,4.8e-05
G5,C(CCC(C(CO)=O)C=CC=O)=O,4,1,0,1,27,4.8e-05
G5,C(CC(C)C(C(CC=CC=O)=O)O)=O,8,1,0,1,27,4.8e-05
G5,C(CC(C)C(C(CO)=O)C=CC=O)=O,8,1,0,1,27,4.8e-05
G5,C(CCC(C=CCO)C(C=O)=O)=O,4,1,0,1,27,4.8e-05
G5,C(CCC(C=CCC(C=O)=O)O)=O,4,1,0,1,27,4.8e-05
G5,C(CC(C)C(C=CCO)C(C=O)=O)=O,8,1,0,1,27,4.8e-05
G5,C(CC(C)C(C=CCC(C=O)=O)O)=O,8,1,0,1,27,4.8e-05
G5,C(C)(C(CCC=O)(CC(O)=O)O)=O,2,1,0,1,27,4.8e-05
G5,C(CC(C(CCCC=O)=O)O)(O)=O,2,1,0,1,27,4.8e-05
G5,C(C(CCC=O)C(C(C)=O)O)(O)=O,4,1,0,1,27,4.8e-05
G5,C(CCCC(C=O)(CC(O)=O)O)=O,2,1,0,1,29,4.8e-05
G5,C(C(CCC=O)C(C=O)(C)O)(O)=O,4,1,0,1,29,4.8e-05
G5,C(CC(CCC(C(O)=O)=O)O)(O)=O,2,1,0,1,18,4.8e-05
G5,C(C(CCC(C(O)=O)=O)CO)(O)=O,2,1,0,1,18,4.8e-05
G5,C(CC(C(C)CC(C=O)=O)O)(O)=O,4,1,0,1,18,4.8e-05
G5,C(C(CO)C(C)CC(C=O)=O)(O)=O,4,1,0,1,18,4.8e-05
G5,C(C)(C(C(CC(O)=O)O)CC=O)=O,4,1,0,1,18,4.8e-05
G5,C(C(CO)C(C(C)=O)CC=O)(O)=O,4,1,0,1,18,4.8e-05
G5,C(CC(C(C=O)CC(C)=O)O)(O)=O,4,1,0,1,18,4.8e-05
G5,C(CC(C=O)C(C(O)=O)CO)(C)=O,4,1,0,1,18,4.8e-05
G5,C(C(CC(C=O)CC=O)CO)(O)=O,4,1,0,1,18,4.8e-05
G5,C(CC(C(C=O)(C)CC=O)O)(O)=O,4,1,0,1,18,4.8e-05
G5,C(C(CO)C(C=O)(C)CC=O)(O)=O,4,1,0,1,18,4.8e-05
G5,C(C(CO)C(C=O)C(C=O)C)(O)=O,8,1,0,1,18,4.8e-05
G5,C(CC(CCC=O)O)(O)=O,2,1,0,1,18,4.8e-05
G5,C(C(CCC=O)CO)(O)=O,2,1,0,1,18,4.8e-05
G5,C(CC(C(C)CC(CO)=O)O)(O)=O,4,1,0,1,18,4.8e-05
G5,C(C(CO)C(C)CC(CO)=O)(O)=O,4,1,0,1,18,4.8e-05
G5,C(CC(C(C)(CO)CC=O)O)(O)=O,4,1,0,1,28,4.8e-05
G5,C(C(CO)C(C)(CO)CC=O)(O)=O,4,1,0,1,28,4.8e-05
G5,C(CC(C(C)CC=O)O)(O)=O,4,1,0,1,18,4.8e-05
G5,C(C(CO)C(C)CC=O)(O)=O,4,1,0,1,18,4.8e-05
G5,C(CCC(CC(O)=O)O)(O)=O,2,1,0,1,18,4.8e-05
G5,C(C(CCC(O)=O)CO)(O)=O,2,1,0,1,18,4.8e-05
G5,C(CC(C(CO)CC(O)=O)O)(O)=O,4,1,0,1,18,4.8e-05
G5,C(C(CO)C(CO)CC(O)=O)(O)=O,4,1,0,1,18,4.8e-05
G5,C(CC(C(CC=O)CC=O)O)(O)=O,2,1,0,1,18,4.8e-05
G5,C(C(C(CC=O)CC=O)CO)(O)=O,2,1,0,1,18,4.8e-05
G5,C(CC(CO)(CCCC=O)O)(O)=O,2,1,0,1,29,4.8e-05
G5,C(CC(C)(C(CCC=O)O)O)(O)=O,4,1,0,1,29,4.8e-05
G5,C(C(CCC=O)C(C)(CO)O)(O)=O,4,1,0,1,29,4.8e-05
G5,C(C(CCC=O)C(C)O)(O)=O,4,1,0,1,28,4.8e-05
G5,C(CC(CCCC=O)O)(O)=O,2,1,0,1,28,4.8e-05
G5,C(CC(C)(CCC=O)O)(O)=O,2,1,0,1,28,4.8e-05
G5,C(C(C(C)CC=O)C(C)O)(O)=O,8,1,0,1,28,4.8e-05
G5,C(CC(CC(C)CC=O)O)(O)=O,4,1,0,1,28,4.8e-05
G5,C(CC(C)(C(C)CC=O)O)(O)=O,4,1,0,1,28,4.8e-05
G5,C(C(CCC(O)=O)C(C)O)(O)=O,4,1,0,1,28,4.8e-05
G5,C(CCCC(CC(O)=O)O)(O)=O,2,1,0,1,28,4.8e-05
G5,C(CCC(C)(CC(O)=O)O)(O)=O,2,1,0,1,28,4.8e-05
G5,C(C(C(O)=O)(CCC=O)O)(O)=O,1,1,0,1,17,4.8e-05
G5,C(C(C(O)=O)(C(C)CC=O)O)(O)=O,2,1,0,1,17,4.8e-05
G5,C(C(C(O)=O)(CCC(O)=O)O)(O)=O,1,1,0,1,17,4.8e-05
G5,C(C(CCC=O)(CC(O)=O)O)(O)=O,2,1,0,1,29,4.8e-05
G5,C(C(CCC=O)C(C(O)=O)O)(O)=O,4,1,0,1,29,4.8e-05
G5,C(C(CCCCC(C(O)=O)=O)=O)=O,1,2,0,2,28,9.6e-05
G5,C(C=O)(C(C)CCC(C(O)=O)=O)=O,2,1,0,1,7,4.8e-05
G5,C(CCCC(C(O)=O)=O)=CC(C=O)=O,2,1,0,1,7,4.8e-05
G5,C=CC(C(C=O)=O)CCC(C(O)=O)=O,2,1,0,1,7,4.8e-05
G5,C(C(O)=O)(CCCC(C=CC=O)=O)=O,2,1,0,1,7,4.8e-05
G5,C(C(C(C=O)=C)CCC(C(O)=O)=O)=O,2,1,0,1,7,4.8e-05
G5,C(C(O)=O)(CCCC(C=O)=CC=O)=O,2,1,0,1,7,4.8e-05
G5,C(CCCC(C(O)=O)=O)=CC=O,2,1,0,1,7,4.8e-05
G5,C(C(C=C)CCC(C(O)=O)=O)=O,2,1,0,1,7,4.8e-05
G5,C(C(C=CC=O)CCC(C(O)=O)=O)=O,4,1,0,1,7,4.8e-05
G5,C(CCCC(C=CC(C(O)=O)=O)=O)=O,2,1,0,1,29,4.8e-05
G5,C(C(C=CC(C(O)=O)=O)CCC=O)=O,4,1,0,1,29,4.8e-05
G5,C(CCC(C(O)=O)C=CC(C=O)=O)=O,4,1,0,1,29,4.8e-05
G5,C(CCCC(C(C=CC(O)=O)=O)=O)=O,2,1,0,1,29,4.8e-05
G5,C(C(C(C=CC(O)=O)=O)CCC=O)=O,4,1,0,1,29,4.8e-05
G5,C(CCC(C(O)=O)C(C=CC=O)=O)=O,4,1,0,1,29,4.8e-05
G5,C(CCC(C(C(O)=O)=O)C(C=C)=O)=O,2,1,0,1,29,4.8e-05
G5,C(CCC(C(O)=O)C(C(C=C)=O)=O)=O,2,1,0,1,29,4.8e-05
G5,C(CCC(C=CC=O)C(C(O)=O)=O)=O,4,1,0,1,29,4.8e-05
G5,C(CCC(C=CC(O)=O)C(C=O)=O)=O,4,1,0,1,29,4.8e-05
G5,C1(C(CCC=O)(CO)C(CO1)O)=O,4,1,0,1,27,4.8e-05
G5,C1(C(CO)C(CO1)(CCC=O)O)=O,4,1,0,1,27,4.8e-05
G5,C1(C(CO)C(C(CCC=O)O1)O)=O,8,1,0,1,27,4.8e-05
G5,C(CCC1C(C(CO)(CO1)O)=O)=O,4,1,0,1,10,4.8e-05
G5,C(CCC1C(C(CO1)=O)(CO)O)=O,4,1,0,1,10,4.8e-05
G5,C(C(C(O)=O)(CCCC=O)O)(O)=O,1,1,0,1,29,4.8e-05
G5,C(C(C=O)(CCCC=O)O)(O)=O,2,1,0,1,25,4.8e-05
G5,C(C(C=O)(CC(C)CC=O)O)(O)=O,4,1,0,1,25,4.8e-05
G5,C(C(C=O)(CCCC(O)=O)O)(O)=O,2,1,0,1,25,4.8e-05
G5,C(C(CO)(CCCC=O)O)=O,2,1,0,1,11,4.8e-05
G5,C(C(CO)(CC(C)CC=O)O)=O,4,1,0,1,11,4.8e-05
G5,C(C(C)(C(CCC(O)=O)O)O)=O,4,1,0,1,11,4.8e-05
G5,C(C(CO)(CCCC(O)=O)O)=O,2,1,0,1,11,4.8e-05
G5,C(CCC1C(C(CO)(O)OC1)=O)=O,4,1,0,1,34,4.8e-05
G5,C(CCC1CC(C(CO)(O)O1)=O)=O,4,1,0,1,34,4.8e-05
G5,C(C(C)(C(CCCC=O)O)O)(O)=O,4,1,0,1,27,4.8e-05
G5,C(C(C)(C(C)(CCC=O)O)O)(O)=O,4,1,0,1,27,4.8e-05
G5,C(C(C(C)O)(CCCC=O)O)(O)=O,4,1,0,1,27,4.8e-05
G5,C(C(C)(C(CCCC=O)O)O)=O,4,1,0,1,18,4.8e-05
G5,C(C(C)(C(C)(CCC=O)O)O)=O,4,1,0,1,18,4.8e-05
G5,C(C(C(C)O)(CCCC=O)O)=O,4,1,0,1,18,4.8e-05
G5,C(C(C)(C(CC(C)CC=O)O)O)=O,8,1,0,1,18,4.8e-05
G5,C(C(C)(C(C)(C(C)CC=O)O)O)=O,8,1,0,1,18,4.8e-05
G5,C(C(C(C)O)(CC(C)CC=O)O)=O,8,1,0,1,18,4.8e-05
G5,C(C(C)(C(CCCC(O)=O)O)O)=O,4,1,0,1,18,4.8e-05
G5,C(C(C)(C(C)(CCC(O)=O)O)O)=O,4,1,0,1,18,4.8e-05
G5,C(C(C(C)O)(CCCC(O)=O)O)=O,4,1,0,1,18,4.8e-05
G5,C(CCC1C(C(CC(C1)=O)=O)=O)=O,2,1,0,1,45,4.8e-05
G5,C(CCC1C(CC(C(C1)=O)=O)=O)=O,2,1,0,1,45,4.8e-05
G5,C(CCC1C(CCC(C1=O)=O)=O)=O,2,1,0,1,45,4.8e-05
G5,C(CC(C)C1C(C(CC(C1)=O)=O)=O)=O,4,1,0,1,45,4.8e-05
G5,C(CC(C)C1C(CC(C(C1)=O)=O)=O)=O,4,1,0,1,45,4.8e-05
G5,C(CC(C)C1C(CCC(C1=O)=O)=O)=O,4,1,0,1,45,4.8e-05
G5,C1(CC(C(C(C1)=O)=O)CCC(O)=O)=O,2,1,0,1,45,4.8e-05
G5,C1(C(CCC(O)=O)CC(C(C1)=O)=O)=O,2,1,0,1,45,4.8e-05
G5,C1(CCC(C(C1CCC(O)=O)=O)=O)=O,2,1,0,1,45,4.8e-05
G5,C(C1(C(C(CC1)=O)=O)CCC=O)=O,2,1,0,1,45,4.8e-05
G5,C(C1C(C(CC1CCC=O)=O)=O)=O,4,1,0,1,45,4.8e-05
G5,C(C1C(C(C(C1)CCC=O)=O)=O)=O,4,1,0,1,45,4.8e-05
G5,C(C1(C(C(CC1)=O)=O)C(C)CC=O)=O,4,1,0,1,45,4.8e-05
G5,C(C1C(C(CC1C(C)CC=O)=O)=O)=O,8,1,0,1,45,4.8e-05
G5,C(C1C(C(C(C1)C(C)CC=O)=O)=O)=O,8,1,0,1,45,4.8e-05
G5,C(C1(C(C(CC1)=O)=O)CCC(O)=O)=O,2,1,0,1,45,4.8e-05
G5,C(C1C(C(CC1CCC(O)=O)=O)=O)=O,4,1,0,1,45,4.8e-05
G5,C(C1C(C(C(C1)CCC(O)=O)=O)=O)=O,4,1,0,1,45,4.8e-05
G5,C1(CC(CC(C1CCC=O)=O)=O)=O,1,1,0,1,45,4.8e-05
G5,C1(CC(CC(C1C(C)CC=O)=O)=O)=O,2,1,0,1,45,4.8e-05
G5,C1(CC(CC(C1CCC(O)=O)=O)=O)=O,1,1,0,1,45,4.8e-05
G5,C(CCC1C(C(C=O)CC1=O)=O)=O,4,1,0,1,45,4.8e-05
G5,C(CCC1C(CC(C1C=O)=O)=O)=O,4,1,0,1,45,4.8e-05
G5,C(C1(C(CC(C1)=O)=O)CCC=O)=O,2,1,0,1,45,4.8e-05
G5,C(CC(C)C1C(C(C=O)CC1=O)=O)=O,8,1,0,1,45,4.8e-05
G5,C(CC(C)C1C(CC(C1C=O)=O)=O)=O,8,1,0,1,45,4.8e-05
G5,C(C1(C(CC(C1)=O)=O)C(C)CC=O)=O,4,1,0,1,45,4.8e-05
G5,C1(C(C=O)CC(C1CCC(O)=O)=O)=O,4,1,0,1,45,4.8e-05
G5,C1(C(C=O)C(C(C1)=O)CCC(O)=O)=O,4,1,0,1,45,4.8e-05
G5,C(C1(C(CC(C1)=O)=O)CCC(O)=O)=O,2,1,0,1,45,4.8e-05
G5,C(CCC1C(C(CC1C=O)=O)=O)=O,4,1,0,1,45,4.8e-05
G5,C(CCC1(C=O)CC(C(C1)=O)=O)=O,1,1,0,1,45,4.8e-05
G5,C(CC(C)C1C(C(CC1C=O)=O)=O)=O,8,1,0,1,45,4.8e-05
G5,C(CC(C)C1(C=O)CC(C(C1)=O)=O)=O,2,1,0,1,45,4.8e-05
G5,C(C1CC(C(C1CCC(O)=O)=O)=O)=O,4,1,0,1,45,4.8e-05
G5,C(C1(CCC(O)=O)CC(C(C1)=O)=O)=O,1,1,0,1,45,4.8e-05
G5,C(CCC1C(C(C=O)C(C1)=O)=O)=O,4,1,0,1,45,4.8e-05
G5,C(CC(C)C1C(C(C=O)C(C1)=O)=O)=O,8,1,0,1,45,4.8e-05
G5,C1(C(CCC(O)=O)CC(C1C=O)=O)=O,4,1,0,1,45,4.8e-05
G5,C1(C(C(C=CC1CCC=O)=O)O)=O,4,1,0,1,32,4.8e-05
G5,C1(CC=CC(C1(CCC=O)O)=O)=O,2,1,0,1,32,4.8e-05
G5,C1(CC(CC(C1O)=O)CC=CC=O)=O,2,1,0,1,32,4.8e-05
G5,C1(C(C(C=CC1C(C)CC=O)=O)O)=O,8,1,0,1,32,4.8e-05
G5,C1(CC=CC(C1(C(C)CC=O)O)=O)=O,4,1,0,1,32,4.8e-05
G5,C(C(C=C)C1CC(C(C(C1)=O)O)=O)=O,2,1,0,1,32,4.8e-05
G5,C1(C(C(C=CC1CCC(O)=O)=O)O)=O,4,1,0,1,32,4.8e-05
G5,C1(CC=CC(C1(CCC(O)=O)O)=O)=O,2,1,0,1,32,4.8e-05
G5,C1(CC(C=CC1(CCC=O)O)=O)=O,2,1,0,1,45,4.8e-05
G5,C1(C(C=CC(C1CCC=O)=O)O)=O,4,1,0,1,45,4.8e-05
G5,C1(CC(C(C(C1)=O)O)CC=CC=O)=O,8,1,0,1,45,4.8e-05
G5,C1(CC(C=CC1(C(C)CC=O)O)=O)=O,4,1,0,1,45,4.8e-05
G5,C1(C(C=CC(C1C(C)CC=O)=O)O)=O,8,1,0,1,45,4.8e-05
G5,C(C(C=C)C1C(C(CC(C1)=O)=O)O)=O,8,1,0,1,45,4.8e-05
G5,C1(CC(C=CC1(CCC(O)=O)O)=O)=O,2,1,0,1,45,4.8e-05
G5,C1(C(C=CC(C1CCC(O)=O)=O)O)=O,4,1,0,1,45,4.8e-05
G5,C(CCC(C(C(CC)=O)=O)O)=O,2,1,0,1,42,4.8e-05
G5,C(CCCCC(C(CO)=O)=O)=O,1,1,0,1,42,4.8e-05
G5,C(CCC(C(C(CO)=O)=O)C)=O,2,1,0,1,42,4.8e-05
G5,C(CC(C)C(C(C(CC)=O)=O)O)=O,4,1,0,1,42,4.8e-05
G5,C(CC(C)CCC(C(CO)=O)=O)=O,2,1,0,1,42,4.8e-05
G5,C(CC(C)C(C(C(CO)=O)=O)C)=O,4,1,0,1,42,4.8e-05
G5,C(CCC(C(C(CC)=O)=O)O)(O)=O,2,1,0,1,42,4.8e-05
G5,C(CCCCC(C(CO)=O)=O)(O)=O,1,1,0,1,42,4.8e-05
G5,C(CCC(C(C(CO)=O)=O)C)(O)=O,2,1,0,1,42,4.8e-05
G5,C(C(CCC=O)(CO)CC=O)=O,2,1,0,1,55,4.8e-05
G5,C(CCC(C=O)C(C=O)CO)=O,4,1,0,1,55,4.8e-05
G5,C(C(CO)(C(C)CC=O)CC=O)=O,4,1,0,1,55,4.8e-05
G5,C(CC(C)C(C=O)C(C=O)CO)=O,8,1,0,1,55,4.8e-05
G5,C(CCC(C=O)(CO)CC=O)(O)=O,2,1,0,1,55,4.8e-05
G5,C(CCC(C(C=O)CC=O)O)(O)=O,4,1,0,1,55,4.8e-05
G5,C(CCC(C=O)C(C=O)CO)(O)=O,4,1,0,1,55,4.8e-05
G5,C(CCC(C(C=O)=O)CC(C=O)=O)=O,2,1,0,1,7,4.8e-05
G5,C(CCC(C(C=O)=O)C(C=O)C)=O,4,1,0,1,28,4.8e-05
G5,C(CCCC(C=O)CC(C=O)=O)=O,2,1,0,1,28,4.8e-05
G5,C(C(C)(CCC=O)CC(C=O)=O)=O,2,1,0,1,28,4.8e-05
G5,C(CC(C)C(C(C=O)=O)C(C=O)C)=O,8,1,0,1,28,4.8e-05
G5,C(CC(C)CC(C=O)CC(C=O)=O)=O,4,1,0,1,28,4.8e-05
G5,C(C(C)(C(C)CC=O)CC(C=O)=O)=O,4,1,0,1,28,4.8e-05
G5,C(CCCC(C(CC(C)=O)=O)=O)=O,1,1,0,1,14,4.8e-05
G5,C(CCCC(CC(C(C)=O)=O)=O)=O,1,1,0,1,14,4.8e-05
G5,C(CCC(C(C)=O)C(C(C)=O)=O)=O,2,1,0,1,14,4.8e-05
G5,C(CC(C)CC(C(CC(C)=O)=O)=O)=O,2,1,0,1,14,4.8e-05
G5,C(CC(C)CC(CC(C(C)=O)=O)=O)=O,2,1,0,1,14,4.8e-05
G5,C(CC(C)C(C(C)=O)C(C(C)=O)=O)=O,4,1,0,1,14,4.8e-05
G5,C(CCC(C=O)(C(C(C)=O)=O)C)=O,2,1,0,1,45,4.8e-05
G5,C(CCCC(C=O)C(C(C)=O)=O)=O,2,1,0,1,45,4.8e-05
G5,C(C(C(C(CCCC=O)=O)=O)C)=O,2,1,0,1,45,4.8e-05
G5,C(CC(C)C(C=O)(C(C(C)=O)=O)C)=O,4,1,0,1,45,4.8e-05
G5,C(CC(C)CC(C=O)C(C(C)=O)=O)=O,4,1,0,1,45,4.8e-05
G5,C(C(C(C(CC(C)CC=O)=O)=O)C)=O,4,1,0,1,45,4.8e-05
G5,C(C(C(C(CC=O)=O)=O)CCC=O)=O,2,1,0,1,2,4.8e-05
G5,C(C(C(C(CC)=O)=O)CCC=O)=O,2,1,0,1,27,4.8e-05
G5,C(CC(C(CCCCC=O)=O)=O)=O,1,1,0,1,27,4.8e-05
G5,C(CC(C(C(C)CCC=O)=O)=O)=O,2,1,0,1,27,4.8e-05
G5,C(C(C(C(CC)=O)=O)C(C)CC=O)=O,4,1,0,1,27,4.8e-05
G5,C(CC(C(CCC(C)CC=O)=O)=O)=O,2,1,0,1,27,4.8e-05
G5,C(CC(C(C(C)C(C)CC=O)=O)=O)=O,4,1,0,1,27,4.8e-05
G5,C(CCC(C(C(C)=O)=O)CC=O)=O,2,1,0,1,46,4.8e-05
G5,C(CCCC(C(CCC=O)=O)=O)=O,1,1,0,1,46,4.8e-05
G5,C(CCC(C=O)CC(C(C)=O)=O)=O,2,1,0,1,46,4.8e-05
G5,C(CC(C)C(C(C(C)=O)=O)CC=O)=O,4,1,0,1,46,4.8e-05
G5,C(CC(C)CC(C(CCC=O)=O)=O)=O,2,1,0,1,46,4.8e-05
G5,C(CC(C)C(C=O)CC(C(C)=O)=O)=O,4,1,0,1,46,4.8e-05
G5,C(CCC(C(C=O)=O)(C)CC=O)=O,2,1,0,1,45,4.8e-05
G5,C(CCCC(C(C=O)=O)CC=O)=O,2,1,0,1,45,4.8e-05
G5,C(CCC(C=O)C(C(C=O)=O)C)=O,4,1,0,1,45,4.8e-05
G5,C(CC(C)C(C(C=O)=O)(C)CC=O)=O,4,1,0,1,45,4.8e-05
G5,C(CC(C)CC(C(C=O)=O)CC=O)=O,4,1,0,1,45,4.8e-05
G5,C(CC(C)C(C=O)C(C(C=O)=O)C)=O,8,1,0,1,45,4.8e-05
G5,C(CO)(C(CCCC=O)CC=O)=O,2,1,0,1,0,4.8e-05
G5,C(CO)(C(C)(CCC=O)CC=O)=O,2,1,0,1,0,4.8e-05
G5,C(C(C)CC=O)(C(CCC=O)O)=O,4,1,0,1,0,4.8e-05
G5,C(CCC(C=O)C(C(CO)=O)C)=O,4,1,0,1,0,4.8e-05
G5,C(CCC(C(C(CC)=O)=O)CO)=O,2,1,0,1,27,4.8e-05
G5,C(CCCCC(C(CCO)=O)=O)=O,1,1,0,1,27,4.8e-05
G5,C(CCC(C(C(CCO)=O)=O)C)=O,2,1,0,1,27,4.8e-05
G5,C(CCC(C(CCO)=O)C(C)=O)=O,2,1,0,1,27,4.8e-05
G5,C(CCC(C(CC(C)=O)=O)CO)=O,2,1,0,1,27,4.8e-05
G5,C(CCCC(CC(CCO)=O)=O)=O,1,1,0,1,27,4.8e-05
G5,C(C(CCC=O)(CCO)CC=O)=O,2,1,0,1,46,4.8e-05
G5,C(CCC(CO)C(C=O)CC=O)=O,4,1,0,1,46,4.8e-05
G5,C(CCC(CC(C=O)CC=O)O)=O,4,1,0,1,46,4.8e-05
G5,C(CCC(C=O)C(C=O)CCO)=O,4,1,0,1,46,4.8e-05
G5,C(CCC(C(CO)=O)C(C=O)C)=O,4,1,0,1,28,4.8e-05
G5,C(CCC(C(CC(C=O)C)=O)O)=O,4,1,0,1,28,4.8e-05
G5,C(CCCC(C=O)CC(CO)=O)=O,2,1,0,1,28,4.8e-05
G5,C(C(C)(CCC=O)CC(CO)=O)=O,2,1,0,1,28,4.8e-05
G5,C(CCCC(C(C(C)CO)=O)=O)=O,2,1,0,1,27,4.8e-05
G5,C(CCCC(C(C(C)=O)=O)CO)=O,2,1,0,1,27,4.8e-05
G5,C(CCC(C(C(C)=O)=O)(C)CO)=O,2,1,0,1,27,4.8e-05
G5,C(CCCC(C(C(C=O)C)O)=O)=O,4,1,0,1,27,4.8e-05
G5,C(CCC(C(C)=O)(C(C=O)C)O)=O,4,1,0,1,27,4.8e-05
G5,C(CCCC(C=O)C(C(C)=O)O)=O,4,1,0,1,27,4.8e-05
G5,C(C(C)(CCC=O)C(C(C)=O)O)=O,4,1,0,1,27,4.8e-05
G5,C(C(CC(C)CC(C(CC)=O)=O)=O)=O,2,1,0,1,28,4.8e-05
G5,C(C=O)(CC(C)CCC(C(C)=O)=O)=O,2,1,0,1,28,4.8e-05
G5,C(C(C)=O)(C(C)C(C)CC(C=O)=O)=O,4,1,0,1,28,4.8e-05
G5,C(CC(C(C)=O)CC(C(CC)=O)=O)=O,2,1,0,1,28,4.8e-05
G5,C(C)(C(CCC(C(C)=O)=O)CC=O)=O,2,1,0,1,28,4.8e-05
G5,C(CC(C(C)=O)C(C(C(C)=O)=O)C)=O,4,1,0,1,28,4.8e-05
G5,C(CC(C=O)CC(C(CC)=O)=O)(C)=O,2,1,0,1,28,4.8e-05
G5,C(C(CCC(C(C)=O)=O)CC(C)=O)=O,2,1,0,1,28,4.8e-05
G5,C(CC(C=O)C(C(C(C)=O)=O)C)(C)=O,4,1,0,1,28,4.8e-05
G5,C(C(CCC(C(CC)=O)=O)CC=O)=O,2,1,0,1,28,4.8e-05
G5,C(C(CCCC(C(C)=O)=O)CC=O)=O,2,1,0,1,28,4.8e-05
G5,C(C(CC(C(C(C)=O)=O)C)CC=O)=O,4,1,0,1,28,4.8e-05
G5,C(C(C)(CC=O)CC(C(CC)=O)=O)=O,2,1,0,1,28,4.8e-05
G5,C(C(C)(CCC(C(C)=O)=O)CC=O)=O,2,1,0,1,28,4.8e-05
G5,C(C(C)(CC=O)C(C(C(C)=O)=O)C)=O,4,1,0,1,28,4.8e-05
G5,C(C(C)C(C=O)CC(C(CC)=O)=O)=O,4,1,0,1,28,4.8e-05
G5,C(C(CCC(C(C)=O)=O)C(C=O)C)=O,4,1,0,1,28,4.8e-05
G5,C(C(C)C(C=O)C(C(C(C)=O)=O)C)=O,8,1,0,1,28,4.8e-05
G5,C(CCCC(C(CC)=O)=O)=O,1,1,0,1,28,4.8e-05
G5,C(CCCCC(C(C)=O)=O)=O,1,1,0,1,28,4.8e-05
G5,C(CCC(C(C(C)=O)=O)C)=O,2,1,0,1,28,4.8e-05
G5,C(CC(C)CC(C(CC)=O)=O)=O,2,1,0,1,28,4.8e-05
G5,C(CC(C)CCC(C(C)=O)=O)=O,2,1,0,1,28,4.8e-05
G5,C(CC(C)C(C(C(C)=O)=O)C)=O,4,1,0,1,28,4.8e-05
G5,C(CCCC(C(CC)=O)=O)(O)=O,1,1,0,1,18,4.8e-05
G5,C(CCCCC(C(C)=O)=O)(O)=O,1,1,0,1,18,4.8e-05
G5,C(CCC(C(C(C)=O)=O)C)(O)=O,2,1,0,1,18,4.8e-05
G5,C(CC(CC=O)CC(C(CC)=O)=O)=O,1,1,0,1,28,4.8e-05
G5,C(CC(CCC(C(C)=O)=O)CC=O)=O,1,1,0,1,28,4.8e-05
G5,C(CC(CC=O)C(C(C(C)=O)=O)C)=O,2,1,0,1,28,4.8e-05
G5,C(CC(C)CC(C=O)=O)(CC(C)=O)=O,2,1,0,1,28,4.8e-05
G5,C(C)(C(C(C)=O)C(C)CC(C=O)=O)=O,2,1,0,1,28,4.8e-05
G5,C(CC(C(C)=O)CC(CC(C)=O)=O)=O,2,1,0,1,28,4.8e-05
G5,C(CC(C(C)=O)C(C(C)=O)C(C)=O)=O,2,1,0,1,28,4.8e-05
G5,C(C(CC(CC(C)=O)=O)CC(C)=O)=O,2,1,0,1,28,4.8e-05
G5,C(C(CC(C)=O)C(C(C)=O)C(C)=O)=O,2,1,0,1,28,4.8e-05
G5,C(C(CCC(CC(C)=O)=O)CC=O)=O,2,1,0,1,28,4.8e-05
G5,C(C(CC(C(C)=O)C(C)=O)CC=O)=O,2,1,0,1,28,4.8e-05
G5,C(C(C)(CC(CC(C)=O)=O)CC=O)=O,2,1,0,1,28,4.8e-05
G5,C(C(C)(CC=O)C(C(C)=O)C(C)=O)=O,2,1,0,1,28,4.8e-05
G5,C(C(C)C(C=O)CC(CC(C)=O)=O)=O,4,1,0,1,28,4.8e-05
G5,C(C(C)C(C=O)C(C(C)=O)C(C)=O)=O,4,1,0,1,28,4.8e-05
G5,C(CCCC(CC(C)=O)=O)=O,1,1,0,1,28,4.8e-05
G5,C(CCC(C(C)=O)C(C)=O)=O,1,1,0,1,28,4.8e-05
G5,C(CC(C)CC(CC(C)=O)=O)=O,2,1,0,1,28,4.8e-05
G5,C(CC(C)C(C(C)=O)C(C)=O)=O,2,1,0,1,28,4.8e-05
G5,C(CCCC(O)=O)(CC(C)=O)=O,1,1,0,1,18,4.8e-05
G5,C(C)(C(C(C)=O)CCC(O)=O)=O,1,1,0,1,18,4.8e-05
G5,C(CC(CC=O)CC(CC(C)=O)=O)=O,1,1,0,1,28,4.8e-05
G5,C(CC(CC=O)C(C(C)=O)C(C)=O)=O,1,1,0,1,28,4.8e-05
G5,C(C(CC(C)CC(C=O)=O)CC=O)=O,4,1,0,1,28,4.8e-05
G5,C(C(C)(C(C)CC(C=O)=O)CC=O)=O,4,1,0,1,28,4.8e-05
G5,C(C(C(C)CC(C=O)=O)C(C=O)C)=O,8,1,0,1,28,4.8e-05
G5,C(C)(C(CC(C=O)CC=O)CC=O)=O,4,1,0,1,28,4.8e-05
G5,C(CC(C(C)=O)C(C=O)(C)CC=O)=O,4,1,0,1,28,4.8e-05
G5,C(CC(C(C)=O)C(C=O)C(C=O)C)=O,8,1,0,1,28,4.8e-05
G5,C(C(CC(C=O)CC(C)=O)CC=O)=O,4,1,0,1,28,4.8e-05
G5,C(CC(C=O)C(C=O)(C)CC=O)(C)=O,4,1,0,1,28,4.8e-05
G5,C(CC(C=O)C(C=O)C(C=O)C)(C)=O,8,1,0,1,28,4.8e-05
G5,C(C(CCC(C=O)CC=O)CC=O)=O,3,1,0,1,28,4.8e-05
G5,C(C(C)(CC(C=O)CC=O)CC=O)=O,4,2,0,2,28,9.499999999999999e-05
G5,C(C(CC(C=O)C(C=O)C)CC=O)=O,8,2,0,2,28,9.499999999999999e-05
G5,C(C(C)(CC=O)C(C=O)(C)CC=O)=O,3,1,0,1,28,4.8e-05
G5,C(C(C)C(C=O)C(C=O)(C)CC=O)=O,8,1,0,1,28,4.8e-05
G5,C(C(C)C(C=O)C(C=O)C(C=O)C)=O,10,1,0,1,28,4.8e-05
G5,C(CCCC(C=O)CC=O)=O,2,1,0,1,28,4.8e-05
G5,C(C(C)(CCC=O)CC=O)=O,2,1,0,1,28,4.8e-05
G5,C(CCC(C=O)C(C=O)C)=O,4,1,0,1,28,4.8e-05
G5,C(CC(C)CC(C=O)CC=O)=O,4,1,0,1,28,4.8e-05
G5,C(C(C)(C(C)CC=O)CC=O)=O,4,1,0,1,28,4.8e-05
G5,C(CC(C)C(C=O)C(C=O)C)=O,8,1,0,1,28,4.8e-05
G5,C(C(CCCC(O)=O)CC=O)=O,2,1,0,1,18,4.8e-05
G5,C(C(C)(CCC(O)=O)CC=O)=O,2,1,0,1,18,4.8e-05
G5,C(C(CCC(O)=O)C(C=O)C)=O,4,1,0,1,18,4.8e-05
G5,C(CC(CC(C=O)CC=O)CC=O)=O,2,1,0,1,28,4.8e-05
G5,C(C(C)(C(CC=O)CC=O)CC=O)=O,2,1,0,1,28,4.8e-05
G5,C(CC(C(C=O)C(C=O)C)CC=O)=O,4,1,0,1,28,4.8e-05
G5,C(C(C(C=O)=O)(C)CCC=O)=O,2,1,0,1,49,4.8e-05
G5,C(C(C(C=O)=O)CCCC=O)=O,2,1,0,1,49,4.8e-05
G5,C(C(C(C=O)=O)(C)C(C)CC=O)=O,4,1,0,1,49,4.8e-05
G5,C(C(C(C=O)=O)CC(C)CC=O)=O,4,1,0,1,49,4.8e-05
G5,C(C(C(C=O)=O)(C)CCC(O)=O)=O,2,1,0,1,49,4.8e-05
G5,C(C(C(C=O)=O)CCCC(O)=O)=O,2,1,0,1,49,4.8e-05
G5,C(CCCC(C(C=O)=O)CO)=O,2,1,0,1,28,4.8e-05
G5,C(CCC(C(C=O)=O)(C)CO)=O,2,1,0,1,28,4.8e-05
G5,C(CC(C)CC(C(C=O)=O)CO)=O,4,1,0,1,28,4.8e-05
G5,C(CC(C)C(C(C=O)=O)(C)CO)=O,4,1,0,1,28,4.8e-05
G5,C(CCCC(C(C=O)=O)CO)(O)=O,2,1,0,1,28,4.8e-05
G5,C(CCC(C(C=O)=O)(C)CO)(O)=O,2,1,0,1,28,4.8e-05
G5,C(CCC(C(C(C=O)=O)C)O)(O)=O,4,1,0,1,28,4.8e-05
G5,C(CCC(C=O)(C(C=O)C)O)=O,4,1,0,1,49,4.8e-05
G5,C(CCCC(C=O)C(C=O)O)=O,4,1,0,1,49,4.8e-05
G5,C(C(C)(CCC=O)C(C=O)O)=O,4,1,0,1,49,4.8e-05
G5,C(CC(C)C(C=O)(C(C=O)C)O)=O,8,1,0,1,49,4.8e-05
G5,C(CC(C)CC(C=O)C(C=O)O)=O,8,1,0,1,49,4.8e-05
G5,C(C(C)(C(C)CC=O)C(C=O)O)=O,8,1,0,1,49,4.8e-05
G5,C(CCC(C=O)(C(C=O)C)O)(O)=O,4,1,0,1,49,4.8e-05
G5,C(CCCC(C=O)C(C=O)O)(O)=O,4,1,0,1,49,4.8e-05
G5,C(CCC(C=O)(C)C(C=O)O)(O)=O,4,1,0,1,49,4.8e-05
G5,C(CC(C(C=O)=O)CCC(C=O)=O)=O,2,2,0,2,20,9.6e-05
G5,C(CC(C(C=O)=O)C(C(C=O)=O)C)=O,4,1,0,1,20,4.8e-05
G5,C(C(CCC(C=O)=O)CC(C=O)=O)=O,2,3,0,3,45,0.000144
G5,C(C(CC(C=O)=O)C(C(C=O)=O)C)=O,4,1,0,1,20,4.8e-05
G5,C(C(CCC(C)CC(C=O)=O)=O)=O,2,1,0,1,28,4.8e-05
G5,C(C=O)(C(C)C(C)CC(C=O)=O)=O,4,1,0,1,28,4.8e-05
G5,C(C)(C(CCC(C=O)=O)CC=O)=O,2,1,0,1,28,4.8e-05
G5,C(CC(C(C)=O)C(C(C=O)=O)C)=O,4,1,0,1,28,4.8e-05
G5,C(C(CCC(C=O)=O)CC(C)=O)=O,2,1,0,1,28,4.8e-05
G5,C(CC(C=O)C(C(C=O)=O)C)(C)=O,4,1,0,1,28,4.8e-05
G5,C(C(CCCC(C=O)=O)CC=O)=O,2,2,0,2,28,9.6e-05
G5,C(C(CC(C(C=O)=O)C)CC=O)=O,4,1,0,1,28,4.8e-05
G5,C(C(C)(CCC(C=O)=O)CC=O)=O,2,2,0,2,28,9.6e-05
G5,C(C(C)(CC=O)C(C(C=O)=O)C)=O,4,1,0,1,28,4.8e-05
G5,C(C(CCC(C=O)=O)C(C=O)C)=O,4,2,0,2,28,9.6e-05
G5,C(C(C)C(C=O)C(C(C=O)=O)C)=O,8,1,0,1,28,4.8e-05
G5,C(CCCCC(C=O)=O)=O,1,1,0,1,28,4.8e-05
G5,C(CCC(C(C=O)=O)C)=O,2,1,0,1,28,4.8e-05
G5,C(CO)(CC(C)CCC(C=O)=O)=O,2,1,0,1,28,4.8e-05
G5,C(CO)(CC(C)C(C(C=O)=O)C)=O,4,1,0,1,28,4.8e-05
G5,C(CC(C)(CCC(C=O)=O)CO)=O,2,1,0,1,28,4.8e-05
G5,C(CC(C)(CO)C(C(C=O)=O)C)=O,4,1,0,1,28,4.8e-05
G5,C(CC(C)CCC(C=O)=O)=O,2,1,0,1,28,4.8e-05
G5,C(CC(C)C(C(C=O)=O)C)=O,4,1,0,1,28,4.8e-05
G5,C(CCCCC(C=O)=O)(O)=O,1,1,0,1,18,4.8e-05
G5,C(CCC(C(C=O)=O)C)(O)=O,2,1,0,1,18,4.8e-05
G5,C(CC(CCC(C=O)=O)CO)(O)=O,2,1,0,1,18,4.8e-05
G5,C(CC(CO)C(C(C=O)=O)C)(O)=O,4,1,0,1,18,4.8e-05
G5,C1(C(CCC(C=O)=O)CC(C1O)=O)=O,4,3,0,3,47,0.000144
G5,C1(CC(C(C1O)=O)C(C(C=O)=O)C)=O,8,1,0,1,47,4.8e-05
G5,C(CC(CCC(C=O)=O)CC=O)=O,1,1,0,1,28,4.8e-05
G5,C(CC(CC=O)C(C(C=O)=O)C)=O,2,1,0,1,28,4.8e-05
G5,C(CCCC(C(C(C=C)=O)O)=O)=O,2,1,0,1,9,4.8e-05
G5,C(CCC(C(C)=O)(C(C=C)=O)O)=O,2,1,0,1,9,4.8e-05
G5,C(CCCC=CC=O)(C(C(C)=O)O)=O,4,1,0,1,9,4.8e-05
G5,C(CC(C)CC(C(C(C=C)=O)O)=O)=O,4,1,0,1,9,4.8e-05
G5,C(CC(C)C(C(C)=O)(C(C=C)=O)O)=O,4,1,0,1,9,4.8e-05
G5,C(C(C=C)CCC(C(C(C)=O)O)=O)=O,4,1,0,1,9,4.8e-05
G5,C(CCCC(C(C=CC=O)O)=O)=O,4,1,0,1,45,4.8e-05
G5,C(CCC(C(C)=O)(C=CC=O)O)=O,4,1,0,1,45,4.8e-05
G5,C(CC(C(C(C)=O)O)CC=CC=O)=O,8,1,0,1,45,4.8e-05
G5,C(CC(C)CC(C(C=CC=O)O)=O)=O,8,1,0,1,45,4.8e-05
G5,C(CC(C)C(C(C)=O)(C=CC=O)O)=O,8,1,0,1,45,4.8e-05
G5,C(CC(C(C(C)=O)O)C(C=O)C=C)=O,8,1,0,1,45,4.8e-05
G5,C(CCC1(C(C=CC1=O)=O)CO)=O,1,1,0,1,45,4.8e-05
G5,C(CCC(C1C(C=CC1=O)=O)O)=O,2,1,0,1,45,4.8e-05
G5,C1(CC(C(C1CO)=O)CC=CC=O)=O,8,1,0,1,45,4.8e-05
G5,C(CC(C)C1(C(C=CC1=O)=O)CO)=O,2,1,0,1,45,4.8e-05
G5,C(CC(C)C(C1C(C=CC1=O)=O)O)=O,4,1,0,1,45,4.8e-05
G5,C1(CC(C(C1CO)=O)C(C=O)C=C)=O,8,1,0,1,45,4.8e-05
G5,C(CCC1(C(C=CC1=O)=O)CO)(O)=O,1,1,0,1,45,4.8e-05
G5,C(CCC(C1C(C=CC1=O)=O)O)(O)=O,2,1,0,1,45,4.8e-05
G5,C(C(C=O)C(C(CCCC=O)=O)=O)=O,1,1,0,1,14,4.8e-05
G5,C(C(C(CCCC=O)=O)C(C=O)=O)=O,2,1,0,1,23,4.8e-05
G5,C(C(C=O)C(CCCC=O)=O)=O,1,1,0,1,6,4.8e-05
G5,C(C(C=O)C(CC(C)CC=O)=O)=O,2,1,0,1,6,4.8e-05
G5,C(C(C=O)C(CCCC(O)=O)=O)=O,1,1,0,1,6,4.8e-05
G5,C(CCCC(C(C=O)C(C)=O)=O)=O,2,1,0,1,6,4.8e-05
G5,C(CC(C)CC(C(C=O)C(C)=O)=O)=O,4,1,0,1,6,4.8e-05
G5,C(CCCC(C(C(C)=O)CO)=O)=O,2,1,0,1,28,4.8e-05
G5,C(CCC(C(C)=O)(C(C)=O)CO)=O,1,1,0,1,28,4.8e-05
G5,C(C(C(C(O)=O)=O)(C)CCC=O)=O,2,1,0,1,27,4.8e-05
G5,C(C(C(C(O)=O)=O)CCCC=O)=O,2,1,0,1,27,4.8e-05
G5,C(CCC(C=O)(C(C=O)=O)CC=O)=O,2,1,0,1,33,4.8e-05
G5,C(CCC(C=O)C(C=O)C(C=O)=O)=O,4,1,0,1,33,4.8e-05
G5,C(CCC(C=O)(C=O)CC=O)=O,1,1,0,1,43,4.8e-05
G5,C(CCC(C=O)C(C=O)C=O)=O,2,1,0,1,43,4.8e-05
G5,C(CC(C)C(C=O)(C=O)CC=O)=O,2,1,0,1,43,4.8e-05
G5,C(CC(C)C(C=O)C(C=O)C=O)=O,4,1,0,1,43,4.8e-05
G5,C(C(C=O)(CCC(O)=O)CC=O)=O,1,1,0,1,43,4.8e-05
G5,C(C(C=O)C(C=O)CCC(O)=O)=O,2,1,0,1,43,4.8e-05
G5,C(CCCC(C=O)C(C(O)=O)O)=O,4,1,0,1,49,4.8e-05
G5,C(C(C)(CCC=O)C(C(O)=O)O)=O,4,1,0,1,49,4.8e-05
G5,C(CCC(C(O)=O)(C(C=O)C)O)=O,4,1,0,1,49,4.8e-05
G5,C(CCCC(C(C(O)=O)=O)CO)=O,2,1,0,1,28,4.8e-05
G5,C(CCC(C(C(O)=O)=O)(C)CO)=O,2,1,0,1,28,4.8e-05
G5,C(CCC(C(C)=O)(C=O)CC=O)=O,2,1,0,1,45,4.8e-05
G5,C(CCC(C=O)C(C=O)C(C)=O)=O,4,1,0,1,45,4.8e-05
G5,C(CCCC(C(C=O)CC=O)=O)=O,2,1,0,1,45,4.8e-05
G5,C(CC(C)C(C(C)=O)(C=O)CC=O)=O,4,1,0,1,45,4.8e-05
G5,C(CC(C)C(C=O)C(C=O)C(C)=O)=O,8,1,0,1,45,4.8e-05
G5,C(CC(C)CC(C(C=O)CC=O)=O)=O,4,1,0,1,45,4.8e-05
G5,C(CCCCC(C(O)=O)=O)=O,1,1,0,1,28,4.8e-05
G5,C(CCC(C(C(O)=O)=O)C)=O,2,1,0,1,28,4.8e-05
G5,C(CC(C)CCC(C(O)=O)=O)=O,2,1,0,1,28,4.8e-05
G5,C(CC(C)C(C(C(O)=O)=O)C)=O,4,1,0,1,28,4.8e-05
G5,C(CCCCC(C(O)=O)=O)(O)=O,1,1,0,1,28,4.8e-05
G5,C(CCC(C(C(O)=O)=O)C)(O)=O,2,1,0,1,28,4.8e-05
G5,C(CCC1C(C(OC1C(C)=O)=O)=O)=O,4,1,0,1,27,4.8e-05
G5,C(C)(C1(CCC=O)CC(C(O1)=O)=O)=O,2,1,0,1,27,4.8e-05
G5,C(CCCC(C1CC(C(O1)=O)=O)=O)=O,2,1,0,1,27,4.8e-05
G5,C(CCC1C(C(OC1CC=O)=O)=O)=O,4,1,0,1,27,4.8e-05
G5,C(CCC1(CC=O)CC(C(O1)=O)=O)=O,2,1,0,1,27,4.8e-05
G5,C(C(CCC=O)C1CC(C(O1)=O)=O)=O,4,1,0,1,27,4.8e-05
G5,C(CCC1C(C(C(C)=O)OC1=O)=O)=O,4,1,0,1,27,4.8e-05
G5,C(CCC1(C(CC(O1)=O)=O)C(C)=O)=O,2,1,0,1,27,4.8e-05
G5,C1(C(C(CCCC=O)=O)OC(C1)=O)=O,2,1,0,1,27,4.8e-05
G5,C(CC1C(C(C(O1)=O)CCC=O)=O)=O,4,1,0,1,27,4.8e-05
G5,C(CCC1(C(CC(O1)=O)=O)CC=O)=O,2,1,0,1,27,4.8e-05
G5,C(CCC(C=O)C1C(CC(O1)=O)=O)=O,4,1,0,1,27,4.8e-05
G5,C(CCC1C(CCOC(C1=O)=O)=O)=O,2,1,0,1,27,4.8e-05
G5,C1(C(CCC=O)COC(C(C1)=O)=O)=O,2,1,0,1,27,4.8e-05
G5,C(CCC1CC(CC(C(O1)=O)=O)=O)=O,2,1,0,1,27,4.8e-05
G5,C(CCC1C(C(OCC(C1)=O)=O)=O)=O,2,1,0,1,27,4.8e-05
G5,C1(COC(C(CC1CCC=O)=O)=O)=O,2,1,0,1,27,4.8e-05
G5,C(CCC1C(CCC(C(O1)=O)=O)=O)=O,2,1,0,1,27,4.8e-05
G5,C(CCC1C(OCCC(C1=O)=O)=O)=O,2,1,0,1,27,4.8e-05
G5,C(CCC1C(C(CC(OC1)=O)=O)=O)=O,2,1,0,1,27,4.8e-05
G5,C(CCC1CC(C(CC(O1)=O)=O)=O)=O,2,1,0,1,27,4.8e-05
G5,C(CCC1C(CC(COC1=O)=O)=O)=O,2,1,0,1,27,4.8e-05
G5,C(CCC1C(CC(OCC1=O)=O)=O)=O,2,1,0,1,27,4.8e-05
G5,C(CCC1C(CC(CC(O1)=O)=O)=O)=O,2,1,0,1,27,4.8e-05
G5,C(CCC1C(C=C(C1=O)CO)=O)=O,2,1,0,1,45,4.8e-05
G5,C(CCC(C1C(CC(C=1)=O)=O)O)=O,2,1,0,1,45,4.8e-05
G5,C1(C(CO)C(C(C1)=O)CC=CC=O)=O,8,1,0,1,45,4.8e-05
G5,C1(C(CO)(CC(C1)=O)CC=CC=O)=O,4,1,0,1,45,4.8e-05
G5,C(CC(C)C1C(C=C(C1=O)CO)=O)=O,4,1,0,1,45,4.8e-05
G5,C(CC(C)C(C1C(CC(C=1)=O)=O)O)=O,4,1,0,1,45,4.8e-05
G5,C1(C(CO)C(C(C1)=O)C(C=O)C=C)=O,8,1,0,1,45,4.8e-05
G5,C1(C(CO)(CC(C1)=O)C(C=O)C=C)=O,4,1,0,1,45,4.8e-05
G5,C(CCC1C(C=C(C1=O)CO)=O)(O)=O,2,1,0,1,45,4.8e-05
G5,C(CCC(C1C(CC(C=1)=O)=O)O)(O)=O,2,1,0,1,45,4.8e-05
G5,C(CCC1C=C(C(C1=O)=O)CO)=O,2,1,0,1,45,4.8e-05
G5,C(CCC(C1C(C(CC=1)=O)=O)O)=O,2,1,0,1,45,4.8e-05
G5,C(CC1CC(C(C1CO)=O)=O)=CC=O,8,2,0,2,45,9.499999999999999e-05
G5,C(CC(C)C1C=C(C(C1=O)=O)CO)=O,4,1,0,1,45,4.8e-05
G5,C(CC(C)C(C1C(C(CC=1)=O)=O)O)=O,4,1,0,1,45,4.8e-05
G5,C(C(C=C)C1CC(C(C1CO)=O)=O)=O,8,2,0,2,45,9.499999999999999e-05
G5,C(CCC1C=C(C(C1=O)=O)CO)(O)=O,2,1,0,1,45,4.8e-05
G5,C(CCC(C1C(C(CC=1)=O)=O)O)(O)=O,2,1,0,1,45,4.8e-05
G5,C(CCC1C(C(C(C1O)=O)=C)=O)=O,4,1,0,1,45,4.8e-05
G5,C(CCC1(C(C(C(C1)=O)=C)=O)O)=O,2,1,0,1,45,4.8e-05
G5,C1(CC(C(C1CCC=CC=O)=O)O)=O,8,1,0,1,45,4.8e-05
G5,C(CC(C)C1C(C(C(C1O)=O)=C)=O)=O,8,1,0,1,45,4.8e-05
G5,C(CC(C)C1(C(C(C(C1)=O)=C)=O)O)=O,4,1,0,1,45,4.8e-05
G5,C(C(C=C)CC1C(CC(C1=O)O)=O)=O,8,1,0,1,45,4.8e-05
G5,C(CCC1C(C(C(C1O)=O)=C)=O)(O)=O,4,1,0,1,45,4.8e-05
G5,C(CCC1(C(C(C(C1)=O)=C)=O)O)(O)=O,2,1,0,1,45,4.8e-05
G5,C1(C(C(C(C1CCC=O)=C)=O)O)=O,4,1,0,1,47,4.8e-05
G5,C1(CC(C(C1(CCC=O)O)=O)=C)=O,2,1,0,1,47,4.8e-05
G5,C1(C(CCC=CC=O)CC(C1O)=O)=O,8,1,0,1,47,4.8e-05
G5,C1(C(C(C(C1C(C)CC=O)=C)=O)O)=O,8,1,0,1,47,4.8e-05
G5,C1(CC(C(C1(C(C)CC=O)O)=O)=C)=O,4,1,0,1,47,4.8e-05
G5,C(C(C=C)CC1C(C(C(C1)=O)O)=O)=O,8,1,0,1,47,4.8e-05
G5,C1(C(C(C(C1CCC(O)=O)=C)=O)O)=O,4,1,0,1,47,4.8e-05
G5,C1(CC(C(C1(CCC(O)=O)O)=O)=C)=O,2,1,0,1,47,4.8e-05
G5,C1(CC(C(C1(CCC=O)O)=C)=O)=O,2,1,0,1,45,4.8e-05
G5,C1(C(C(C(C1CCC=O)=O)=C)O)=O,4,1,0,1,45,4.8e-05
G5,C1(C(CCC=CC=O)C(C(C1)=O)O)=O,8,1,0,1,45,4.8e-05
G5,C1(CC(C(C1(C(C)CC=O)O)=C)=O)=O,4,1,0,1,45,4.8e-05
G5,C1(C(C(C(C1C(C)CC=O)=O)=C)O)=O,8,1,0,1,45,4.8e-05
G5,C(C(C=C)CC1C(CC(C1O)=O)=O)=O,8,1,0,1,45,4.8e-05
G5,C1(CC(C(C1(CCC(O)=O)O)=C)=O)=O,2,1,0,1,45,4.8e-05
G5,C1(C(C(C(C1CCC(O)=O)=O)=C)O)=O,4,1,0,1,45,4.8e-05
G5,C(CCC1(C(C(C(C1)=O)=O)=C)O)=O,2,1,0,1,45,4.8e-05
G5,C(CCC1C(C(C(C1O)=C)=O)=O)=O,4,1,0,1,45,4.8e-05
G5,C(CCC1C(C(CC1O)=O)=O)=CC=O,8,1,0,1,45,4.8e-05
G5,C(CC(C)C1(C(C(C(C1)=O)=O)=C)O)=O,4,1,0,1,45,4.8e-05
G5,C(CC(C)C1C(C(C(C1O)=C)=O)=O)=O,8,1,0,1,45,4.8e-05
G5,C(C(C=C)CC1C(C(CC1O)=O)=O)=O,8,1,0,1,45,4.8e-05
G5,C(CCC1(C(C(C(C1)=O)=O)=C)O)(O)=O,2,1,0,1,45,4.8e-05
G5,C(CCC1C(C(C(C1O)=C)=O)=O)(O)=O,4,1,0,1,45,4.8e-05
G5,C(CCC1C(C=C(C=O)C1O)=O)=O,4,1,0,1,45,4.8e-05
G5,C(CCC1(C(C=O)=CC(C1)=O)O)=O,2,1,0,1,45,4.8e-05
G5,C(C1C(CC(C1CC=CC=O)=O)O)=O,16,1,0,1,45,4.8e-05
G5,C(C1(C(CC(C1)=O)O)CC=CC=O)=O,8,1,0,1,45,4.8e-05
G5,C(CC(C)C1C(C=C(C=O)C1O)=O)=O,8,1,0,1,45,4.8e-05
G5,C(CC(C)C1(C(C=O)=CC(C1)=O)O)=O,4,1,0,1,45,4.8e-05
G5,C(C1C(CC(C1C(C=O)C=C)=O)O)=O,16,1,0,1,45,4.8e-05
G5,C(C1(C(CC(C1)=O)O)C(C=O)C=C)=O,8,1,0,1,45,4.8e-05
G5,C(CCC1C(C=C(C=O)C1O)=O)(O)=O,4,1,0,1,45,4.8e-05
G5,C(CCC1(C(C=O)=CC(C1)=O)O)(O)=O,2,1,0,1,45,4.8e-05
G5,C1(C(C(C=O)=CC1CCC=O)O)=O,4,1,0,1,27,4.8e-05
G5,C1(CC=C(C=O)C1(CCC=O)O)=O,2,1,0,1,27,4.8e-05
G5,C1(C(C(C=O)=CC1C(C)CC=O)O)=O,8,1,0,1,27,4.8e-05
G5,C1(CC=C(C=O)C1(C(C)CC=O)O)=O,4,1,0,1,27,4.8e-05
G5,C1(C(C(C=O)=CC1CCC(O)=O)O)=O,4,1,0,1,27,4.8e-05
G5,C1(CC=C(C=O)C1(CCC(O)=O)O)=O,2,1,0,1,27,4.8e-05
G5,C1(CC(C=O)=CC1(CCC=O)O)=O,2,1,0,1,45,4.8e-05
G5,C1(C(C=C(C=O)C1CCC=O)O)=O,4,1,0,1,45,4.8e-05
G5,C(C1C(C(C(C1)=O)O)CC=CC=O)=O,16,1,0,1,45,4.8e-05
G5,C1(CC(C=O)=CC1(C(C)CC=O)O)=O,4,1,0,1,45,4.8e-05
G5,C1(C(C=C(C=O)C1C(C)CC=O)O)=O,8,1,0,1,45,4.8e-05
G5,C(C1C(C(C(C1)=O)O)C(C=O)C=C)=O,16,1,0,1,45,4.8e-05
G5,C1(CC(C=O)=CC1(CCC(O)=O)O)=O,2,1,0,1,45,4.8e-05
G5,C1(C(C=C(C=O)C1CCC(O)=O)O)=O,4,1,0,1,45,4.8e-05
G5,C(CCC1(C=C(C=O)C(C1)=O)O)=O,2,1,0,1,45,4.8e-05
G5,C(CCC1C(C(C=O)=CC1O)=O)=O,4,1,0,1,45,4.8e-05
G5,C(C1C(CC(C1CC=CC=O)O)=O)=O,16,1,0,1,45,4.8e-05
G5,C(CC(C)C1(C=C(C=O)C(C1)=O)O)=O,4,1,0,1,45,4.8e-05
G5,C(CC(C)C1C(C(C=O)=CC1O)=O)=O,8,1,0,1,45,4.8e-05
G5,C(C(C=C)C1C(CC(C1C=O)=O)O)=O,16,1,0,1,45,4.8e-05
G5,C(CCC1(C=C(C=O)C(C1)=O)O)(O)=O,2,1,0,1,45,4.8e-05
G5,C(CCC1C(C(C=O)=CC1O)=O)(O)=O,4,1,0,1,45,4.8e-05
G5,C(CCC(C=C)(CC(C=O)=O)O)=O,2,1,0,1,27,4.8e-05
G5,C(CC(C)C(C(C=O)=O)C(C=C)O)=O,8,1,0,1,27,4.8e-05
G5,C(CC(C)C(C=C)(CC(C=O)=O)O)=O,4,1,0,1,27,4.8e-05
G5,C(C(C(C(C=C)O)=O)CCC=O)=O,4,1,0,1,27,4.8e-05
G5,C(CC=O)(C(C=C)(CCC=O)O)=O,2,1,0,1,27,4.8e-05
G5,C(C(C(C(C=C)O)=O)C(C)CC=O)=O,8,1,0,1,27,4.8e-05
G5,C(CC=O)(C(C=C)(C(C)CC=O)O)=O,4,1,0,1,27,4.8e-05
G5,C(C(C(CC=C)=O)(CCC=O)O)=O,2,1,0,1,4,4.8e-05
G5,C(C(C=O)O)(C(C=C)CCC=O)=O,4,1,0,1,4,4.8e-05
G5,C(C(C(CC=C)=O)(C(C)CC=O)O)=O,4,1,0,1,4,4.8e-05
G5,C(C(C=O)O)(C(C=C)C(C)CC=O)=O,8,1,0,1,4,4.8e-05
G5,C(CCC(C=O)(CC(C=C)=O)O)=O,2,1,0,1,27,4.8e-05
G5,C(CCC(C(C=C)=O)C(C=O)O)=O,4,1,0,1,27,4.8e-05
G5,C(CC(C=O)O)(CCCC=CC=O)=O,4,1,0,1,27,4.8e-05
G5,C(CC(C)C(C=O)(CC(C=C)=O)O)=O,4,1,0,1,27,4.8e-05
G5,C(CC(C)C(C(C=C)=O)C(C=O)O)=O,8,1,0,1,27,4.8e-05
G5,C(CC(C=O)O)(CCC(C=O)C=C)=O,4,1,0,1,27,4.8e-05
G5,C(C1(C(C(C=C1)O)=O)CCC=O)=O,4,1,0,1,45,4.8e-05
G5,C(C1C(C(C=C1)(CCC=O)O)=O)=O,4,1,0,1,45,4.8e-05
G5,C(C1(C(C(C=C1)O)=O)C(C)CC=O)=O,8,1,0,1,45,4.8e-05
G5,C(C1C(C(C=C1)(C(C)CC=O)O)=O)=O,8,1,0,1,45,4.8e-05
G5,C(C1(C(C(C=C1)O)=O)CCC(O)=O)=O,4,1,0,1,45,4.8e-05
G5,C(C1C(C(C=C1)(CCC(O)=O)O)=O)=O,4,1,0,1,45,4.8e-05
G5,C(C1(C(C(C=C1)CCC=O)=O)O)=O,4,1,0,1,45,4.8e-05
G5,C(C1(C(C(C=C1)C(C)CC=O)=O)O)=O,8,1,0,1,45,4.8e-05
G5,C(C1(C(C(C=C1)CCC(O)=O)=O)O)=O,4,1,0,1,45,4.8e-05
G5,C(CCC1(C(C)=O)C=CC(O1)=O)=O,2,1,0,1,48,4.8e-05
G5,C(CCCC(C1C=CC(O1)=O)=O)=O,2,1,0,1,48,4.8e-05
G5,C(C)(C1C(CC(O1)=O)CC=CC=O)=O,8,1,0,1,48,4.8e-05
G5,C(CC(C)C1(C(C)=O)C=CC(O1)=O)=O,4,1,0,1,48,4.8e-05
G5,C(CC(C)CC(C1C=CC(O1)=O)=O)=O,4,1,0,1,48,4.8e-05
G5,C(C(C=C)C1C(C(C)=O)OC(C1)=O)=O,8,1,0,1,48,4.8e-05
G5,C(CCC1(C(C)=O)C=CC(O1)=O)(O)=O,2,1,0,1,48,4.8e-05
G5,C(CCCC(C1C=CC(O1)=O)=O)(O)=O,2,1,0,1,48,4.8e-05
G5,C(CCC1(C=CC(O1)=O)CC=O)=O,2,1,0,1,48,4.8e-05
G5,C(CCC(C=O)C1C=CC(O1)=O)=O,4,1,0,1,48,4.8e-05
G5,C(CC1C(CC(O1)=O)CC=CC=O)=O,8,1,0,1,48,4.8e-05
G5,C(CC(C)C1(C=CC(O1)=O)CC=O)=O,4,1,0,1,48,4.8e-05
G5,C(CC(C)C(C=O)C1C=CC(O1)=O)=O,8,1,0,1,48,4.8e-05
G5,C(C(C=C)C1C(CC=O)OC(C1)=O)=O,8,1,0,1,48,4.8e-05
G5,C(CCC1(C=CC(O1)=O)CC=O)(O)=O,2,1,0,1,48,4.8e-05
G5,C(CCC(C=O)C1C=CC(O1)=O)(O)=O,4,1,0,1,48,4.8e-05
G5,C(CCC1(C(C)=O)C(C=CO1)=O)=O,2,1,0,1,9,4.8e-05
G5,C(CCCC(C1C(C=CO1)=O)=O)=O,2,1,0,1,9,4.8e-05
G5,C(CC(C)C1(C(C)=O)C(C=CO1)=O)=O,4,1,0,1,9,4.8e-05
G5,C(CC(C)CC(C1C(C=CO1)=O)=O)=O,4,1,0,1,9,4.8e-05
G5,C(CCC1(C(C)=O)C(C=CO1)=O)(O)=O,2,1,0,1,9,4.8e-05
G5,C(CCCC(C1C(C=CO1)=O)=O)(O)=O,2,1,0,1,9,4.8e-05
G5,C(CCC1(C(C=CO1)=O)CC=O)=O,2,1,0,1,45,4.8e-05
G5,C(CCC(C=O)C1C(C=CO1)=O)=O,4,1,0,1,45,4.8e-05
G5,C(CC(C)C1(C(C=CO1)=O)CC=O)=O,4,1,0,1,45,4.8e-05
G5,C(CC(C)C(C=O)C1C(C=CO1)=O)=O,8,1,0,1,45,4.8e-05
G5,C(CCC1(C(C=CO1)=O)CC=O)(O)=O,2,1,0,1,45,4.8e-05
G5,C(CCC(C=O)C1C(C=CO1)=O)(O)=O,4,1,0,1,45,4.8e-05
G5,C(CCC1C(C=CC(OC1)=O)=O)=O,2,1,0,1,19,4.8e-05
G5,C(CCC1CC(C=CC(O1)=O)=O)=O,2,1,0,1,19,4.8e-05
G5,C1(CC(C(OCC1)=O)CC=CC=O)=O,4,1,0,1,19,4.8e-05
G5,C1(C(CC(OCC1)=O)CC=CC=O)=O,4,1,0,1,19,4.8e-05
G5,C(CC(C)C1C(C=CC(OC1)=O)=O)=O,4,1,0,1,19,4.8e-05
G5,C(CC(C)C1CC(C=CC(O1)=O)=O)=O,4,1,0,1,19,4.8e-05
G5,C1(CC(C(OCC1)=O)C(C=O)C=C)=O,4,1,0,1,19,4.8e-05
G5,C(C(C=C)C1C(CCOC(C1)=O)=O)=O,4,1,0,1,19,4.8e-05
G5,C(CCC1C(C=CC(OC1)=O)=O)(O)=O,2,1,0,1,19,4.8e-05
G5,C(CCC1CC(C=CC(O1)=O)=O)(O)=O,2,1,0,1,19,4.8e-05
G5,C(CCC1C(COC(C=C1)=O)=O)=O,2,1,0,1,48,4.8e-05
G5,C(CCC1C(CC=CC(O1)=O)=O)=O,2,1,0,1,48,4.8e-05
G5,C1(COC(CC(C1)CC=CC=O)=O)=O,4,2,0,2,45,9.499999999999999e-05
G5,C(CC(C)C1C(COC(C=C1)=O)=O)=O,4,1,0,1,48,4.8e-05
G5,C(CC(C)C1C(CC=CC(O1)=O)=O)=O,4,1,0,1,48,4.8e-05
G5,C(C(C=C)C1CC(COC(C1)=O)=O)=O,4,2,0,2,45,9.499999999999999e-05
G5,C(CCC1C(COC(C=C1)=O)=O)(O)=O,2,1,0,1,48,4.8e-05
G5,C(CCC1C(CC=CC(O1)=O)=O)(O)=O,2,1,0,1,48,4.8e-05
G5,C(CCC1C(C(C=COC1)=O)=O)=O,2,1,0,1,45,4.8e-05
G5,C(CCC1CC(C(C=CO1)=O)=O)=O,2,1,0,1,45,4.8e-05
G5,C(CC(C)C1C(C(C=COC1)=O)=O)=O,4,1,0,1,45,4.8e-05
G5,C(CC(C)C1CC(C(C=CO1)=O)=O)=O,4,1,0,1,45,4.8e-05
G5,C(CCC1C(C(C=COC1)=O)=O)(O)=O,2,1,0,1,45,4.8e-05
G5,C(CCC1CC(C(C=CO1)=O)=O)(O)=O,2,1,0,1,45,4.8e-05
G5,C(CCC1C(COC=CC1=O)=O)=O,2,1,0,1,38,4.8e-05
G5,C(CCC1C(CC(C=CO1)=O)=O)=O,2,1,0,1,38,4.8e-05
G5,C(CC(C)C1C(COC=CC1=O)=O)=O,4,1,0,1,38,4.8e-05
G5,C(CC(C)C1C(CC(C=CO1)=O)=O)=O,4,1,0,1,38,4.8e-05
G5,C(CCC1C(COC=CC1=O)=O)(O)=O,2,1,0,1,38,4.8e-05
G5,C(CCC1C(CC(C=CO1)=O)=O)(O)=O,2,1,0,1,38,4.8e-05
G5,C(CCC1C(OCC=CC1=O)=O)=O,2,1,0,1,19,4.8e-05
G5,C(CCC1C=CC(CC(O1)=O)=O)=O,2,1,0,1,19,4.8e-05
G5,C1(CC(COC(C1)=O)CC=CC=O)=O,4,1,0,1,19,4.8e-05
G5,C(CC(C)C1C(OCC=CC1=O)=O)=O,4,1,0,1,19,4.8e-05
G5,C(CC(C)C1C=CC(CC(O1)=O)=O)=O,4,1,0,1,19,4.8e-05
G5,C(C(C=C)C1COC(CC(C1)=O)=O)=O,4,1,0,1,19,4.8e-05
G5,C(CCC1C(OCC=CC1=O)=O)(O)=O,2,1,0,1,19,4.8e-05
G5,C(CCC1C=CC(CC(O1)=O)=O)(O)=O,2,1,0,1,19,4.8e-05
G5,C(CCC1C(C(C=CCO1)=O)=O)=O,2,1,0,1,36,4.8e-05
G5,C(CCC1C=CC(C(CO1)=O)=O)=O,2,1,0,1,36,4.8e-05
G5,C(CC1COCC(C(C1)=O)=O)=CC=O,4,1,0,1,36,4.8e-05
G5,C(CC(C)C1C(C(C=CCO1)=O)=O)=O,4,1,0,1,36,4.8e-05
G5,C(CC(C)C1C=CC(C(CO1)=O)=O)=O,4,1,0,1,36,4.8e-05
G5,C(C(C=C)C1COCC(C(C1)=O)=O)=O,4,1,0,1,36,4.8e-05
G5,C(CCC1C(C(C=CCO1)=O)=O)(O)=O,2,1,0,1,36,4.8e-05
G5,C(CCC1C=CC(C(CO1)=O)=O)(O)=O,2,1,0,1,36,4.8e-05
G5,C(CCC1C(OCC(C=C1)=O)=O)=O,2,1,0,1,48,4.8e-05
G5,C(CCC1C(C=CCC(O1)=O)=O)=O,2,1,0,1,48,4.8e-05
G5,C(CC(C)C1C(OCC(C=C1)=O)=O)=O,4,1,0,1,48,4.8e-05
G5,C(CC(C)C1C(C=CCC(O1)=O)=O)=O,4,1,0,1,48,4.8e-05
G5,C(CCC1C(OCC(C=C1)=O)=O)(O)=O,2,1,0,1,48,4.8e-05
G5,C(CCC1C(C=CCC(O1)=O)=O)(O)=O,2,1,0,1,48,4.8e-05
G5,C(CCC1C(C=CC(CO1)=O)=O)=O,2,1,0,1,45,4.8e-05
G5,C1(COCC(CC1CC=CC=O)=O)=O,4,1,0,1,45,4.8e-05
G5,C(CC(C)C1C(C=CC(CO1)=O)=O)=O,4,1,0,1,45,4.8e-05
G5,C(C(C=C)C1C(COCC(C1)=O)=O)=O,4,1,0,1,45,4.8e-05
G5,C(CCC1C(C=CC(CO1)=O)=O)(O)=O,2,1,0,1,45,4.8e-05
G5,C(CCC1C(C(OC1)=CC=O)=O)=O,4,1,0,1,45,4.8e-05
G5,C(CCC1CC(C(O1)=CC=O)=O)=O,4,1,0,1,45,4.8e-05
G5,C(CC(C)C1C(C(OC1)=CC=O)=O)=O,8,1,0,1,45,4.8e-05
G5,C(CC(C)C1CC(C(O1)=CC=O)=O)=O,8,1,0,1,45,4.8e-05
G5,C(CCC1C(C(OC1)=CC=O)=O)(O)=O,4,1,0,1,45,4.8e-05
G5,C(CCC1CC(C(O1)=CC=O)=O)(O)=O,4,1,0,1,45,4.8e-05
G5,C(CCC1C(COC1=CC=O)=O)=O,4,1,0,1,45,4.8e-05
G5,C(CCC1C(CC(O1)=CC=O)=O)=O,4,1,0,1,45,4.8e-05
G5,C(CC(C)C1C(COC1=CC=O)=O)=O,8,1,0,1,45,4.8e-05
G5,C(CC(C)C1C(CC(O1)=CC=O)=O)=O,8,1,0,1,45,4.8e-05
G5,C(CCC1C(COC1=CC=O)=O)(O)=O,4,1,0,1,45,4.8e-05
G5,C(CCC1C(CC(O1)=CC=O)=O)(O)=O,4,1,0,1,45,4.8e-05
G5,C(CCC1(C=CCO1)C(C=O)=O)=O,2,1,0,1,39,4.8e-05
G5,C(CCC1C=CC(C(C=O)=O)O1)=O,4,1,0,1,39,4.8e-05
G5,C(CC(C)C1(C=CCO1)C(C=O)=O)=O,4,1,0,1,39,4.8e-05
G5,C(CC(C)C1C=CC(C(C=O)=O)O1)=O,8,1,0,1,39,4.8e-05
G5,C(CCC1(C=CCO1)C(C=O)=O)(O)=O,2,1,0,1,39,4.8e-05
G5,C(CCC1C=CC(C(C=O)=O)O1)(O)=O,4,1,0,1,39,4.8e-05
G5,C(C1(C=CC(C=O)O1)CCC=O)=O,4,1,0,1,40,4.8e-05
G5,C(C1(C=CC(C=O)O1)C(C)CC=O)=O,8,1,0,1,40,4.8e-05
G5,C(C1(C=CC(C=O)O1)CCC(O)=O)=O,4,1,0,1,40,4.8e-05
G5,C(C1(C(CC(O1)=C)=O)CCC=O)=O,2,1,0,1,26,4.8e-05
G5,C1(C(C=O)OC(C1CCC=O)=C)=O,4,1,0,1,26,4.8e-05
G5,C(C1(C(CC(O1)=C)=O)C(C)CC=O)=O,4,1,0,1,26,4.8e-05
G5,C1(C(C=O)OC(C1C(C)CC=O)=C)=O,8,1,0,1,26,4.8e-05
G5,C(C1(C(CC(O1)=C)=O)CCC(O)=O)=O,2,1,0,1,26,4.8e-05
G5,C1(C(C=O)OC(C1CCC(O)=O)=C)=O,4,1,0,1,26,4.8e-05
G5,C(CCC1(C=O)CC(C(O1)=C)=O)=O,2,1,0,1,14,4.8e-05
G5,C(CCC1C(C(OC1C=O)=C)=O)=O,4,1,0,1,14,4.8e-05
G5,C(CC(C)C1(C=O)CC(C(O1)=C)=O)=O,4,1,0,1,14,4.8e-05
G5,C(CC(C)C1C(C(OC1C=O)=C)=O)=O,8,1,0,1,14,4.8e-05
G5,C(CCC1(C=O)CC(C(O1)=C)=O)(O)=O,2,1,0,1,14,4.8e-05
G5,C(CCC1C(C(OC1C=O)=C)=O)(O)=O,4,1,0,1,14,4.8e-05
G5,C(CCC1C(C=C(C=O)OC1)=O)=O,2,1,0,1,30,4.8e-05
G5,C(CCC1CC(C=C(C=O)O1)=O)=O,2,1,0,1,30,4.8e-05
G5,C(CC(C)C1C(C=C(C=O)OC1)=O)=O,4,1,0,1,30,4.8e-05
G5,C(CC(C)C1CC(C=C(C=O)O1)=O)=O,4,1,0,1,30,4.8e-05
G5,C(CCC1C(C=C(C=O)OC1)=O)(O)=O,2,1,0,1,30,4.8e-05
G5,C(CCC1CC(C=C(C=O)O1)=O)(O)=O,2,1,0,1,30,4.8e-05
G5,C(CCC1C(COC(C=O)=C1)=O)=O,2,1,0,1,12,4.8e-05
G5,C(CCC1C(CC=C(C=O)O1)=O)=O,2,1,0,1,12,4.8e-05
G5,C(CC(C)C1C(COC(C=O)=C1)=O)=O,4,1,0,1,12,4.8e-05
G5,C(CC(C)C1C(CC=C(C=O)O1)=O)=O,4,1,0,1,12,4.8e-05
G5,C(CCC1C(COC(C=O)=C1)=O)(O)=O,2,1,0,1,12,4.8e-05
G5,C(CCC1C(CC=C(C=O)O1)=O)(O)=O,2,1,0,1,12,4.8e-05
G5,C(C1(C(CC=CO1)=O)CCC=O)=O,2,1,0,1,37,4.8e-05
G5,C1(C(C=O)OC=CC1CCC=O)=O,4,1,0,1,37,4.8e-05
G5,C(C1(C(CC=CO1)=O)C(C)CC=O)=O,4,1,0,1,37,4.8e-05
G5,C1(C(C=O)OC=CC1C(C)CC=O)=O,8,1,0,1,37,4.8e-05
G5,C(C1(C(CC=CO1)=O)CCC(O)=O)=O,2,1,0,1,37,4.8e-05
G5,C1(C(C=O)OC=CC1CCC(O)=O)=O,4,1,0,1,37,4.8e-05
G5,C(CCC1(C=O)CC(C=CO1)=O)=O,2,1,0,1,37,4.8e-05
G5,C(CCC1C(C=COC1C=O)=O)=O,4,1,0,1,37,4.8e-05
G5,C(CC(C)C1(C=O)CC(C=CO1)=O)=O,4,1,0,1,37,4.8e-05
G5,C(CC(C)C1C(C=COC1C=O)=O)=O,8,1,0,1,37,4.8e-05
G5,C(CCC1(C=O)CC(C=CO1)=O)(O)=O,2,1,0,1,37,4.8e-05
G5,C(CCC1C(C=COC1C=O)=O)(O)=O,4,1,0,1,37,4.8e-05
G5,C(CCC1(C=O)C(CCC(O1)=O)=O)=O,2,1,0,1,27,4.8e-05
G5,C(CCC1C(C(C=O)OC(C1)=O)=O)=O,4,1,0,1,27,4.8e-05
G5,C(CCC1C(OC(C=O)C(C1)=O)=O)=O,4,1,0,1,27,4.8e-05
G5,C(CCC1(C=O)CC(CC(O1)=O)=O)=O,2,1,0,1,27,4.8e-05
G5,C(CCC1C(CC(OC1C=O)=O)=O)=O,4,1,0,1,27,4.8e-05
G5,C(CCC1C(CC(C=O)OC1=O)=O)=O,4,1,0,1,27,4.8e-05
G5,C(CCC1C(C=O)=CC(C1O)=O)=O,4,1,0,1,45,4.8e-05
G5,C(CCC1(C(C=C(C=O)C1)=O)O)=O,2,1,0,1,45,4.8e-05
G5,C(C1(CC(C(C1)=O)O)CC=CC=O)=O,8,1,0,1,45,4.8e-05
G5,C(C1CC(C(C1CC=CC=O)=O)O)=O,16,1,0,1,45,4.8e-05
G5,C(CC(C)C1C(C=O)=CC(C1O)=O)=O,8,1,0,1,45,4.8e-05
G5,C(CC(C)C1(C(C=C(C=O)C1)=O)O)=O,4,1,0,1,45,4.8e-05
G5,C(C1(CC(C(C1)=O)O)C(C=O)C=C)=O,8,1,0,1,45,4.8e-05
G5,C(C1CC(C(C1C(C=O)C=C)=O)O)=O,16,1,0,1,45,4.8e-05
G5,C(CCC1C(C=O)=CC(C1O)=O)(O)=O,4,1,0,1,45,4.8e-05
G5,C(CCC1(C(C=C(C=O)C1)=O)O)(O)=O,2,1,0,1,45,4.8e-05
G5,C(CCC1(C=CC(C1=O)=O)CO)=O,2,1,0,1,45,4.8e-05
G5,C(CCC(C1C=CC(C1=O)=O)O)=O,4,1,0,1,45,4.8e-05
G5,C(CC(C)C1(C=CC(C1=O)=O)CO)=O,4,1,0,1,45,4.8e-05
G5,C(CC(C)C(C1C=CC(C1=O)=O)O)=O,8,1,0,1,45,4.8e-05
G5,C(CCC1(C=CC(C1=O)=O)CO)(O)=O,2,1,0,1,45,4.8e-05
G5,C(CCC(C1C=CC(C1=O)=O)O)(O)=O,4,1,0,1,45,4.8e-05
G5,C(CCC1(C(C(C=O)=CC1)=O)O)=O,2,1,0,1,27,4.8e-05
G5,C(CCC1C=C(C=O)C(C1O)=O)=O,4,1,0,1,27,4.8e-05
G5,C(C1C(C(CC1CC=CC=O)O)=O)=O,16,1,0,1,27,4.8e-05
G5,C(CC(C)C1(C(C(C=O)=CC1)=O)O)=O,4,1,0,1,27,4.8e-05
G5,C(CC(C)C1C=C(C=O)C(C1O)=O)=O,8,1,0,1,27,4.8e-05
G5,C(C(C=C)C1CC(C(C1C=O)=O)O)=O,16,1,0,1,27,4.8e-05
G5,C(CCC1(C(C(C=O)=CC1)=O)O)(O)=O,2,1,0,1,27,4.8e-05
G5,C(CCC1C=C(C=O)C(C1O)=O)(O)=O,4,1,0,1,27,4.8e-05
G5,C(CCC(C(CO)=O)(C=C)O)=O,2,1,0,1,31,4.8e-05
G5,C(CCC(C(C(C=C)O)=O)O)=O,4,1,0,1,31,4.8e-05
G5,C(CC(C)C(C(CO)=O)(C=C)O)=O,4,1,0,1,31,4.8e-05
G5,C(CC(C)C(C(C(C=C)O)=O)O)=O,8,1,0,1,31,4.8e-05
G5,C(CCC(C(CO)=O)(C=C)O)(O)=O,2,1,0,1,31,4.8e-05
G5,C(CCC(C(C(C=C)O)=O)O)(O)=O,4,1,0,1,31,4.8e-05
G5,C(CCC(C(CO)=CC=O)O)=O,4,1,0,1,18,4.8e-05
G5,C(CC(CO)(CO)CC=CC=O)=O,2,1,0,1,18,4.8e-05
G5,C(CC(C)C(C(CO)=CC=O)O)=O,8,1,0,1,18,4.8e-05
G5,C(C(C=C)C(CO)(CO)CC=O)=O,2,1,0,1,18,4.8e-05
G5,C(CCC(C(CO)=CC=O)O)(O)=O,4,1,0,1,18,4.8e-05
G5,C(CCC(C=CC=O)(CO)O)=O,4,1,0,1,46,4.8e-05
G5,C(CCC(C(C=CC=O)O)O)=O,8,1,0,1,46,4.8e-05
G5,C(CC(C(CO)O)CC=CC=O)=O,8,1,0,1,46,4.8e-05
G5,C(CC(C)C(C=CC=O)(CO)O)=O,8,1,0,1,46,4.8e-05
G5,C(CC(C)C(C(C=CC=O)O)O)=O,16,1,0,1,46,4.8e-05
G5,C(C(C=C)C(C(CO)O)CC=O)=O,8,1,0,1,46,4.8e-05
G5,C(CCC(C=CC=O)(CO)O)(O)=O,4,1,0,1,46,4.8e-05
G5,C(CCC(C(C=CC=O)O)O)(O)=O,8,1,0,1,46,4.8e-05
G5,C(CCCC(C=O)=CC(C=O)=O)=O,2,1,0,1,45,4.8e-05
G5,C(C(C)C(C(C=O)=O)CC=CC=O)=O,8,1,0,1,45,4.8e-05
G5,C(C(C)(CC(C=O)=O)CC=CC=O)=O,4,1,0,1,45,4.8e-05
G5,C(CC(C)CC(C=O)=CC(C=O)=O)=O,4,1,0,1,45,4.8e-05
G5,C(C(C)C(C(C=O)=O)C(C=O)C=C)=O,8,1,0,1,45,4.8e-05
G5,C(C(C)(CC(C=O)=O)C(C=O)C=C)=O,4,1,0,1,45,4.8e-05
G5,C(CCCC(C=O)=CC(C=O)=O)(O)=O,2,1,0,1,45,4.8e-05
G5,C(CCC(C(C=O)=O)C(C=O)=C)=O,2,1,0,1,45,4.8e-05
G5,C(C(CCC=CC=O)CC(C=O)=O)=O,4,1,0,1,45,4.8e-05
G5,C(CC(C)C(C(C=O)=O)C(C=O)=C)=O,4,1,0,1,45,4.8e-05
G5,C(C(CC(C=O)C=C)CC(C=O)=O)=O,4,1,0,1,45,4.8e-05
G5,C(CCC(C(C=O)=O)C(C=O)=C)(O)=O,2,1,0,1,45,4.8e-05
G5,C(CC(C(C=O)=O)CC=CC=O)=O,4,1,0,1,20,4.8e-05
G5,C(C(CC(C=O)=O)CC=CC=O)=O,4,1,0,1,20,4.8e-05
G5,C(C(C=C)C(C(C=O)=O)CC=O)=O,4,1,0,1,20,4.8e-05
G5,C(C(C=C)C(C=O)CC(C=O)=O)=O,4,1,0,1,20,4.8e-05
G5,C(C(C=CC(C=O)=O)(CCC=O)O)=O,4,1,0,1,12,4.8e-05
G5,C(CCCC(CO)=CC(C=O)=O)=O,2,1,0,1,49,4.8e-05
G5,C(CCC(C(C)=CC(C=O)=O)O)=O,4,1,0,1,49,4.8e-05
G5,C(CC(C)(CO)CC(C=O)=O)=CC=O,4,1,0,1,49,4.8e-05
G5,C(CC(C)CC(CO)=CC(C=O)=O)=O,4,1,0,1,49,4.8e-05
G5,C(CC(C)C(C(C)=CC(C=O)=O)O)=O,8,1,0,1,49,4.8e-05
G5,C(C(C=C)C(C)(CO)CC(C=O)=O)=O,4,1,0,1,49,4.8e-05
G5,C(CCC(C(CO)=C)C(C=O)=O)=O,2,1,0,1,49,4.8e-05
G5,C(CCC(C(CC(C=O)=O)=C)O)=O,2,1,0,1,49,4.8e-05
G5,C(CC(C)C(C(CO)=C)C(C=O)=O)=O,4,1,0,1,49,4.8e-05
G5,C(CC(C)C(C(CC(C=O)=O)=C)O)=O,4,1,0,1,49,4.8e-05
G5,C(CCC(C(CO)=O)C(C=O)=C)=O,2,1,0,1,16,4.8e-05
G5,C(CCC(C(CC(C=O)=C)=O)O)=O,2,1,0,1,16,4.8e-05
G5,C(C(CCC=CC=O)CC(CO)=O)=O,4,1,0,1,16,4.8e-05
G5,C(CC(C)C(C(CO)=O)C(C=O)=C)=O,4,1,0,1,16,4.8e-05
G5,C(CC(C)C(C(CC(C=O)=C)=O)O)=O,4,1,0,1,16,4.8e-05
G5,C(C(CC(C=O)C=C)CC(CO)=O)=O,4,1,0,1,16,4.8e-05
G5,C(CCCC(C=O)=CC(CO)=O)=O,2,1,0,1,16,4.8e-05
G5,C(CCC(C(C=C(C=O)C)=O)O)=O,4,1,0,1,16,4.8e-05
G5,C(C(C)(CC(CO)=O)CC=CC=O)=O,4,1,0,1,16,4.8e-05
G5,C(C(C)C(C(CO)=O)CC=CC=O)=O,8,1,0,1,16,4.8e-05
G5,C(CC(C)CC(C=O)=CC(CO)=O)=O,4,1,0,1,16,4.8e-05
G5,C(CC(C)C(C(C=C(C=O)C)=O)O)=O,8,1,0,1,16,4.8e-05
G5,C(C(C)(CC(CO)=O)C(C=O)C=C)=O,4,1,0,1,16,4.8e-05
G5,C(C(C)C(C(CO)=O)C(C=O)C=C)=O,8,1,0,1,16,4.8e-05
G5,C(CCCC(C(C(C=O)=C)O)=O)=O,2,1,0,1,45,4.8e-05
G5,C(CCC(C(C)=O)(C(C=O)=C)O)=O,2,1,0,1,45,4.8e-05
G5,C(C(CCC=CC=O)C(C(C)=O)O)=O,8,1,0,1,45,4.8e-05
G5,C(CC(C)CC(C(C(C=O)=C)O)=O)=O,4,1,0,1,45,4.8e-05
G5,C(CC(C)C(C(C)=O)(C(C=O)=C)O)=O,4,1,0,1,45,4.8e-05
G5,C(C(CC(C=O)C=C)C(C(C)=O)O)=O,8,1,0,1,45,4.8e-05
G5,C(CC(C)CC(C=O)=O)=CC(C=O)=O,4,1,0,1,28,4.8e-05
G5,C=CC(C(C=O)=O)C(C)CC(C=O)=O,4,1,0,1,28,4.8e-05
G5,C(C(CC(C)CC(C=CC=O)=O)=O)=O,4,1,0,1,28,4.8e-05
G5,C(CC(C(C)=O)CC=CC(C=O)=O)=O,4,1,0,1,28,4.8e-05
G5,C(C(CC(C)=O)CC=CC(C=O)=O)=O,4,1,0,1,28,4.8e-05
G5,C(C(C(C=O)=C)C(C)CC(C=O)=O)=O,4,1,0,1,28,4.8e-05
G5,C(C(CCC=CC(C=O)=O)CC=O)=O,4,1,0,1,28,4.8e-05
G5,C(C(CC(C)CC(C=O)=CC=O)=O)=O,4,1,0,1,28,4.8e-05
G5,C(C(C)(CC=O)CC=CC(C=O)=O)=O,4,1,0,1,28,4.8e-05
G5,C(C(C)C(C=O)CC=CC(C=O)=O)=O,8,1,0,1,28,4.8e-05
G5,C(CCCC=CC(C=O)=O)=O,2,1,0,1,28,4.8e-05
G5,C(C)=CC(C(C(C)CC(C=O)=O)O)=O,8,1,0,1,28,4.8e-05
G5,C(CC(C)CC(C=O)=O)=CC(CO)=O,4,1,0,1,28,4.8e-05
G5,C(CO)(CC(C)CC=CC(C=O)=O)=O,4,1,0,1,28,4.8e-05
G5,C(CO)(C(C=C)C(C)CC(C=O)=O)=O,4,1,0,1,28,4.8e-05
G5,C(C(C(C)CC(C=O)=O)O)(CC=C)=O,4,1,0,1,28,4.8e-05
G5,C(CC(C)CC(C=O)=O)(C(C=C)O)=O,4,1,0,1,28,4.8e-05
G5,C(C)(C(C=C)(C(C)CC(C=O)=O)O)=O,4,1,0,1,28,4.8e-05
G5,C(CC(C(C(C)CC(C=O)=O)O)=C)=O,4,1,0,1,28,4.8e-05
G5,C(C(C(CO)=C)C(C)CC(C=O)=O)=O,4,1,0,1,28,4.8e-05
G5,C(CO)(CC(C)CC(C=O)=O)=CC=O,4,1,0,1,28,4.8e-05
G5,C(C)(C(C(C)CC(C=O)=O)O)=CC=O,8,1,0,1,28,4.8e-05
G5,C(CC(C)(CO)CC=CC(C=O)=O)=O,4,1,0,1,28,4.8e-05
G5,C(CC(C)CC(C=O)=O)=CC=O,4,1,0,1,28,4.8e-05
G5,C(CC(C)CC=CC(C=O)=O)=O,4,1,0,1,28,4.8e-05
G5,C(C(C=C)C(C)CC(C=O)=O)=O,4,1,0,1,28,4.8e-05
G5,C(CCCC=CC(C=O)=O)(O)=O,2,1,0,1,18,4.8e-05
G5,C(C(C=CC=O)C(C)CC(C=O)=O)=O,8,1,0,1,28,4.8e-05
G5,C(CC(CC=O)CC=CC(C=O)=O)=O,2,1,0,1,28,4.8e-05
G5,C(CC(C(C)=O)C(C=C)C(C=O)=O)=O,4,1,0,1,28,4.8e-05
G5,C(C(CC(C)=O)C(C=C)C(C=O)=O)=O,4,1,0,1,28,4.8e-05
G5,C(C(CC(C=C)C(C=O)=O)CC=O)=O,4,1,0,1,28,4.8e-05
G5,C(C(C)(CC=O)C(C=C)C(C=O)=O)=O,4,1,0,1,28,4.8e-05
G5,C(C(C)C(C=O)C(C=C)C(C=O)=O)=O,8,1,0,1,28,4.8e-05
G5,C(CCC(C=C)C(C=O)=O)=O,2,1,0,1,28,4.8e-05
G5,C(CO)(CC(C)C(C=C)C(C=O)=O)=O,4,1,0,1,28,4.8e-05
G5,C(CC(C)(CO)C(C=C)C(C=O)=O)=O,4,1,0,1,28,4.8e-05
G5,C(CC(C)C(C=C)C(C=O)=O)=O,4,1,0,1,28,4.8e-05
G5,C(CCC(C=C)C(C=O)=O)(O)=O,2,1,0,1,18,4.8e-05
G5,C(CC(CC=O)C(C=C)C(C=O)=O)=O,2,1,0,1,28,4.8e-05
G5,C(CC(C(C)=O)CC(C=CC=O)=O)=O,4,1,0,1,28,4.8e-05
G5,C(C(CC(C=CC=O)=O)CC(C)=O)=O,4,1,0,1,28,4.8e-05
G5,C(C(C(C=O)=C)C(C(C)=O)CC=O)=O,4,1,0,1,28,4.8e-05
G5,C(C(C(C=O)=C)C(C=O)CC(C)=O)=O,4,1,0,1,28,4.8e-05
G5,C(C(CCC(C=CC=O)=O)CC=O)=O,4,1,0,1,28,4.8e-05
G5,C(CC(C(C)=O)CC(C=O)=CC=O)=O,4,1,0,1,28,4.8e-05
G5,C(C(CC(C=O)=CC=O)CC(C)=O)=O,4,1,0,1,28,4.8e-05
G5,C(C(C)(CC=O)CC(C=CC=O)=O)=O,4,1,0,1,28,4.8e-05
G5,C(C(C)C(C=O)CC(C=CC=O)=O)=O,8,1,0,1,28,4.8e-05
G5,C(CCCC(C=CC=O)=O)=O,2,1,0,1,28,4.8e-05
G5,C(CC(C(C)=O)C(C(C=CC)=O)O)=O,8,1,0,1,28,4.8e-05
G5,C(C(CC(C)=O)C(C(C=CC)=O)O)=O,8,1,0,1,28,4.8e-05
G5,C(CC(C(C)=O)CC=CC(CO)=O)=O,4,1,0,1,28,4.8e-05
G5,C(C(CC(C)=O)CC=CC(CO)=O)=O,4,1,0,1,28,4.8e-05
G5,C(CO)(CC(C)CC(C=CC=O)=O)=O,4,1,0,1,28,4.8e-05
G5,C(CC(C(C)=O)C(C(CO)=O)C=C)=O,4,1,0,1,28,4.8e-05
G5,C(C(CC(C)=O)C(C(CO)=O)C=C)=O,4,1,0,1,28,4.8e-05
G5,C(CC(C(C)=O)C(C(CC=C)=O)O)=O,4,1,0,1,28,4.8e-05
G5,C(C(CC(C)=O)C(C(CC=C)=O)O)=O,4,1,0,1,28,4.8e-05
G5,C(CC(C(C)=O)CC(C(C=C)O)=O)=O,4,1,0,1,28,4.8e-05
G5,C(C(CC(C(C=C)O)=O)CC(C)=O)=O,4,1,0,1,28,4.8e-05
G5,C(CC(C(C)=O)C(C(C)=O)(C=C)O)=O,4,1,0,1,28,4.8e-05
G5,C(C(CC(C)=O)C(C(C)=O)(C=C)O)=O,4,1,0,1,28,4.8e-05
G5,C(CC(C(C(C(C)=O)CC=O)O)=C)=O,4,1,0,1,28,4.8e-05
G5,C(CC(C(C(C=O)CC(C)=O)O)=C)=O,4,1,0,1,28,4.8e-05
G5,C(C(C(CO)=C)C(C(C)=O)CC=O)=O,4,1,0,1,28,4.8e-05
G5,C(C(C(CO)=C)C(C=O)CC(C)=O)=O,4,1,0,1,28,4.8e-05
G5,C(CC(C(C)=O)CC(CO)=CC=O)=O,4,1,0,1,28,4.8e-05
G5,C(C(CC(C)=O)CC(CO)=CC=O)=O,4,1,0,1,28,4.8e-05
G5,C(CC(C(C)=O)C(C(C)=CC=O)O)=O,8,1,0,1,28,4.8e-05
G5,C(C(CC(C)=O)C(C(C)=CC=O)O)=O,8,1,0,1,28,4.8e-05
G5,C(CC(C)(CO)CC(C=CC=O)=O)=O,4,1,0,1,28,4.8e-05
G5,C(CC(C(C)=O)CC=CC=O)=O,4,1,0,1,28,4.8e-05
G5,C(C(CC(C)=O)CC=CC=O)=O,4,1,0,1,28,4.8e-05
G5,C(CC(C)CC(C=CC=O)=O)=O,4,1,0,1,28,4.8e-05
G5,C(C(C=C)C(C(C)=O)CC=O)=O,4,1,0,1,28,4.8e-05
G5,C(C(C=C)C(C=O)CC(C)=O)=O,4,1,0,1,28,4.8e-05
G5,C(CCCC(C=CC=O)=O)(O)=O,2,1,0,1,18,4.8e-05
G5,C(C(C=CC=O)C(C(C)=O)CC=O)=O,8,1,0,1,28,4.8e-05
G5,C(C(C=CC=O)C(C=O)CC(C)=O)=O,8,1,0,1,28,4.8e-05
G5,C(CC(CC=O)CC(C=CC=O)=O)=O,2,1,0,1,28,4.8e-05
G5,C(C(CC(C=O)C(C=O)=C)CC=O)=O,4,1,0,1,28,4.8e-05
G5,C(C(CCC(C=O)=CC=O)CC=O)=O,4,1,0,1,28,4.8e-05
G5,C(C(C)(CC=O)C(C=O)C(C=O)=C)=O,4,1,0,1,28,4.8e-05
G5,C(C(C)C(C=O)C(C=O)C(C=O)=C)=O,8,1,0,1,28,4.8e-05
G5,C(C(C(C=O)=C)CCC=O)=O,2,1,0,1,28,4.8e-05
G5,C(C(CC(C(C=CC)=O)O)CC=O)=O,8,1,0,1,28,4.8e-05
G5,C(C(CCC=CC(CO)=O)CC=O)=O,4,1,0,1,28,4.8e-05
G5,C(C(C(C=O)=C)C(C)CC(CO)=O)=O,4,1,0,1,28,4.8e-05
G5,C(C(CC(C(CO)=O)C=C)CC=O)=O,4,1,0,1,28,4.8e-05
G5,C(C(CC(C(CC=C)=O)O)CC=O)=O,4,1,0,1,28,4.8e-05
G5,C(C(CCC(C(C=C)O)=O)CC=O)=O,4,1,0,1,28,4.8e-05
G5,C(C(CC(C(C)=O)(C=C)O)CC=O)=O,4,1,0,1,28,4.8e-05
G5,C(C(CC(C(CC=O)=C)O)CC=O)=O,4,1,0,1,28,4.8e-05
G5,C(C(CC(C=O)C(CO)=C)CC=O)=O,4,1,0,1,28,4.8e-05
G5,C(C(CCC(CO)=CC=O)CC=O)=O,4,1,0,1,28,4.8e-05
G5,C(C(CC(C(C)=CC=O)O)CC=O)=O,8,1,0,1,28,4.8e-05
G5,C(C(C(C=O)=C)C(C)(CO)CC=O)=O,4,1,0,1,28,4.8e-05
G5,C(C(CCC=CC=O)CC=O)=O,4,1,0,1,28,4.8e-05
G5,C(C(C(C=O)=C)C(C)CC=O)=O,4,1,0,1,28,4.8e-05
G5,C(C(CC(C=O)C=C)CC=O)=O,4,1,0,1,28,4.8e-05
G5,C(C(C(C=O)=C)CCC(O)=O)=O,2,1,0,1,18,4.8e-05
G5,C(C(CC(C=O)C=CC=O)CC=O)=O,8,1,0,1,28,4.8e-05
G5,C(C(C(C=O)=C)C(CC=O)CC=O)=O,2,1,0,1,28,4.8e-05
G5,C(C(C)(CC=O)CC(C=O)=CC=O)=O,4,1,0,1,28,4.8e-05
G5,C(C(C)C(C=O)CC(C=O)=CC=O)=O,8,1,0,1,28,4.8e-05
G5,C(CCCC(C=O)=CC=O)=O,2,1,0,1,28,4.8e-05
G5,C(CC(C=O)(C)C(C(C=CC)=O)O)=O,8,1,0,1,28,4.8e-05
G5,C(C(C)(CC=O)CC=CC(CO)=O)=O,4,1,0,1,28,4.8e-05
G5,C(C(C)C(C=O)CC=CC(CO)=O)=O,8,1,0,1,28,4.8e-05
G5,C(CO)(CC(C)CC(C=O)=CC=O)=O,4,1,0,1,28,4.8e-05
G5,C(C(C)(CC=O)C(C(CO)=O)C=C)=O,4,1,0,1,28,4.8e-05
G5,C(C(C)C(C=O)C(C(CO)=O)C=C)=O,8,1,0,1,28,4.8e-05
G5,C(CC(C=O)(C)C(C(CC=C)=O)O)=O,4,1,0,1,28,4.8e-05
G5,C(C(C)(CC=O)CC(C(C=C)O)=O)=O,4,1,0,1,28,4.8e-05
G5,C(C(C)C(C=O)CC(C(C=C)O)=O)=O,8,1,0,1,28,4.8e-05
G5,C(C(C)(CC=O)C(C(C)=O)(C=C)O)=O,4,1,0,1,28,4.8e-05
G5,C(C(C)C(C=O)C(C(C)=O)(C=C)O)=O,8,1,0,1,28,4.8e-05
G5,C(CC(C=O)(C)C(C(CC=O)=C)O)=O,4,1,0,1,28,4.8e-05
G5,C(C(C)(CC=O)C(C=O)C(CO)=C)=O,4,1,0,1,28,4.8e-05
G5,C(C(C)C(C=O)C(C=O)C(CO)=C)=O,8,1,0,1,28,4.8e-05
G5,C(C(C)(CC=O)CC(CO)=CC=O)=O,4,1,0,1,28,4.8e-05
G5,C(C(C)C(C=O)CC(CO)=CC=O)=O,8,1,0,1,28,4.8e-05
G5,C(CC(C=O)(C)C(C(C)=CC=O)O)=O,8,1,0,1,28,4.8e-05
G5,C(CC(C)(CO)CC(C=O)=CC=O)=O,4,1,0,1,28,4.8e-05
G5,C(C(C)(CC=O)CC=CC=O)=O,4,1,0,1,28,4.8e-05
G5,C(C(C)C(C=O)CC=CC=O)=O,8,1,0,1,28,4.8e-05
G5,C(CC(C)CC(C=O)=CC=O)=O,4,1,0,1,28,4.8e-05
G5,C(C(C)(CC=O)C(C=O)C=C)=O,4,1,0,1,28,4.8e-05
G5,C(C(C)C(C=O)C(C=O)C=C)=O,8,1,0,1,28,4.8e-05
G5,C(CCCC(C=O)=CC=O)(O)=O,2,1,0,1,18,4.8e-05
G5,C(C(C)(CC=O)C(C=O)C=CC=O)=O,8,1,0,1,28,4.8e-05
G5,C(C(C)C(C=O)C(C=O)C=CC=O)=O,16,1,0,1,28,4.8e-05
G5,C(CC(CC=O)CC(C=O)=CC=O)=O,2,1,0,1,28,4.8e-05
G5,C(CCC(C(C(C=O)=CC=O)=O)O)=O,4,1,0,1,55,4.8e-05
G5,C(CCC(C(C(C=O)=C)=O)O)=O,2,1,0,1,9,4.8e-05
G5,C(C(C(CO)=O)CCC=CC=O)=O,4,1,0,1,9,4.8e-05
G5,C(CC(C)C(C(C(C=O)=C)=O)O)=O,4,1,0,1,9,4.8e-05
G5,C(C(C=C)CC(C=O)C(CO)=O)=O,4,1,0,1,9,4.8e-05
G5,C(CCC(C(C(C=O)=C)=O)O)(O)=O,2,1,0,1,9,4.8e-05
G5,C(CCC(C(C(C=O)=CC)=O)O)=O,4,1,0,1,45,4.8e-05
G5,C(CCCC=C(C=O)C(CO)=O)=O,2,1,0,1,45,4.8e-05
G5,C(C(C(CO)=O)C(C)CC=CC=O)=O,8,1,0,1,45,4.8e-05
G5,C(CC(C)C(C(C(C=O)=CC)=O)O)=O,8,1,0,1,45,4.8e-05
G5,C(CC(C)CC=C(C=O)C(CO)=O)=O,4,1,0,1,45,4.8e-05
G5,C(C(C=C)C(C)C(C=O)C(CO)=O)=O,8,1,0,1,45,4.8e-05
G5,C(CCC(C=O)(C(CO)=O)C=C)=O,2,1,0,1,45,4.8e-05
G5,C(CCC(C(C(C=O)C=C)=O)O)=O,4,1,0,1,45,4.8e-05
G5,C(CC(C)C(C=O)(C(CO)=O)C=C)=O,4,1,0,1,45,4.8e-05
G5,C(CC(C)C(C(C(C=O)C=C)=O)O)=O,8,1,0,1,45,4.8e-05
G5,C(CCC(C(CC=O)=CC=O)O)=O,4,1,0,1,46,4.8e-05
G5,C(CCC(C=O)C(CO)=CC=O)=O,4,1,0,1,46,4.8e-05
G5,C(CC(CO)(CC=O)CC=CC=O)=O,2,1,0,1,46,4.8e-05
G5,C(CC(C)C(C(CC=O)=CC=O)O)=O,8,1,0,1,46,4.8e-05
G5,C(CC(C)C(C=O)C(CO)=CC=O)=O,8,1,0,1,46,4.8e-05
G5,C(C(C=C)C(CO)(CC=O)CC=O)=O,2,1,0,1,46,4.8e-05
G5,C(C(C(C=CC=O)=O)(CCC=O)O)=O,4,1,0,1,46,4.8e-05
G5,C(C(C(C=C)=O)(CCC=O)O)=O,2,1,0,1,0,4.8e-05
G5,C(C(C(CCCC=CC=O)=O)O)=O,4,1,0,1,0,4.8e-05
G5,C(C(C(C=C)=O)(C(C)CC=O)O)=O,4,1,0,1,0,4.8e-05
G5,C(C(C=C)CCC(C(C=O)O)=O)=O,4,1,0,1,0,4.8e-05
G5,C(C(C(C=C)=O)(CCC(O)=O)O)=O,2,1,0,1,0,4.8e-05
G5,C(CCC(C=O)(C(C=CC)=O)O)=O,4,1,0,1,28,4.8e-05
G5,C(C(C(C=CCCCC=O)=O)O)=O,4,1,0,1,28,4.8e-05
G5,C(C(C(CC(C)CC=CC=O)=O)O)=O,8,1,0,1,28,4.8e-05
G5,C(CC(C)C(C=O)(C(C=CC)=O)O)=O,8,1,0,1,28,4.8e-05
G5,C(C(C(C=CCC(C)CC=O)=O)O)=O,8,1,0,1,28,4.8e-05
G5,C(C(C=C)C(C)CC(C(C=O)O)=O)=O,8,1,0,1,28,4.8e-05
G5,C(C(C(CC=O)=C)(CCC=O)O)=O,2,1,0,1,6,4.8e-05
G5,C(C(C(C(C=O)O)=C)CCC=O)=O,4,1,0,1,6,4.8e-05
G5,C(C(C(CC=O)=C)(C(C)CC=O)O)=O,4,1,0,1,6,4.8e-05
G5,C(C(C(C(C=O)O)=C)C(C)CC=O)=O,8,1,0,1,6,4.8e-05
G5,C(CCC(C=O)(C(C)=CC=O)O)=O,4,1,0,1,6,4.8e-05
G5,C(C(C(CCCC=O)=CC=O)O)=O,4,1,0,1,6,4.8e-05
G5,C(CC(C)(C(C=O)O)CC=CC=O)=O,8,1,0,1,6,4.8e-05
G5,C(CC(C)C(C=O)(C(C)=CC=O)O)=O,8,1,0,1,6,4.8e-05
G5,C(C(C(CC(C)CC=O)=CC=O)O)=O,8,1,0,1,6,4.8e-05
G5,C(CC(C)(C(C=O)O)C(C=O)C=C)=O,8,1,0,1,6,4.8e-05
G5,C(CCC(C(C(C=O)=O)=CC=O)O)=O,4,1,0,1,55,4.8e-05
G5,C(C(C(C(C=O)=O)=C)(CCC=O)O)=O,2,1,0,1,0,4.8e-05
G5,C(C(C(C=O)=CC=O)(CCC=O)O)=O,4,1,0,1,43,4.8e-05
G5,C(CCC(C(C=CC)=O)(CO)O)=O,4,1,0,1,28,4.8e-05
G5,C(CCCC=CC(C(CO)O)=O)=O,4,1,0,1,28,4.8e-05
G5,C(CCC(C(C(CO)O)=O)C=C)=O,4,1,0,1,28,4.8e-05
G5,C(C(CO)(CCC=O)O)(CC=C)=O,2,1,0,1,28,4.8e-05
G5,C(CC(C(CO)(CCC=O)O)=C)=O,2,1,0,1,27,4.8e-05
G5,C(CCC(C(C(CC=O)=C)O)O)=O,4,1,0,1,27,4.8e-05
G5,C(CCC(C=O)C(C(CO)O)=C)=O,4,1,0,1,27,4.8e-05
G5,C(CCCC(C(CO)O)=CC=O)=O,4,1,0,1,46,4.8e-05
G5,C(CCC(C(C)=CC=O)(CO)O)=O,4,1,0,1,46,4.8e-05
G5,C(CCC(C(C(C)=CC=O)O)O)=O,8,1,0,1,46,4.8e-05
G5,C(CCC(C(C(C=O)=O)=C)O)=O,2,1,0,1,49,4.8e-05
G5,C(CCC(C(C=O)=O)CO)=CC=O,4,1,0,1,49,4.8e-05
G5,C(CC(C)C(C(C(C=O)=O)=C)O)=O,4,1,0,1,49,4.8e-05
G5,C(C(C=C)CC(C(C=O)=O)CO)=O,4,1,0,1,49,4.8e-05
G5,C(CCC(C(C(C=O)=O)=C)O)(O)=O,2,1,0,1,49,4.8e-05
G5,C(CCC(C(C(CO)=C)=O)O)=O,2,1,0,1,49,4.8e-05
G5,C(CCC(C(C(CO)=O)=C)O)=O,2,1,0,1,49,4.8e-05
G5,C(CO)(C(CO)CCC=CC=O)=O,4,1,0,1,49,4.8e-05
G5,C(CC(C)C(C(C(CO)=C)=O)O)=O,4,1,0,1,49,4.8e-05
G5,C(CC(C)C(C(C(CO)=O)=C)O)=O,4,1,0,1,49,4.8e-05
G5,C(C(C=C)CC(C(CO)=O)CO)=O,4,1,0,1,49,4.8e-05
G5,C(CCC(C(C(CO)=C)=O)O)(O)=O,2,1,0,1,49,4.8e-05
G5,C(CCC(C(C(CO)=O)=C)O)(O)=O,2,1,0,1,49,4.8e-05
G5,C(C(C(C=O)=C)(CCC=O)O)=O,2,1,0,1,16,4.8e-05
G5,C(C(CCC=CC=O)C(C=O)O)=O,8,1,0,1,16,4.8e-05
G5,C(C(C(C=O)=C)(C(C)CC=O)O)=O,4,1,0,1,16,4.8e-05
G5,C(C(CC(C=O)C=C)C(C=O)O)=O,8,1,0,1,16,4.8e-05
G5,C(C(C(C=O)=C)(CCC(O)=O)O)=O,2,1,0,1,16,4.8e-05
G5,C(C(CO)C(C=O)CC=CC=O)=O,8,1,0,1,18,4.8e-05
G5,C(C(CO)(CC=O)CC=CC=O)=O,4,1,0,1,18,4.8e-05
G5,C(CC(C)C(C(C=O)=CC=O)O)=O,8,1,0,1,18,4.8e-05
G5,C(C(CO)C(C=O)C(C=O)C=C)=O,8,1,0,1,18,4.8e-05
G5,C(C(CO)(CC=O)C(C=O)C=C)=O,4,1,0,1,18,4.8e-05
G5,C(CCC(C(C=O)=CC=O)O)(O)=O,4,1,0,1,18,4.8e-05
G5,C(CCCC(C(C(C=O)=O)=C)O)=O,2,1,0,1,4,4.8e-05
G5,C(CCC(C(C(C=O)=O)=C)(C)O)=O,2,1,0,1,4,4.8e-05
G5,C(CCC(C(C(C=O)=O)=CC)O)=O,4,1,0,1,27,4.8e-05
G5,C(CCCC=C(C(C=O)=O)CO)=O,2,1,0,1,27,4.8e-05
G5,C(CCC(C=C)(C(C=O)=O)CO)=O,2,1,0,1,28,4.8e-05
G5,C(CCC(C=C(C=O)CC=O)O)=O,4,1,0,1,3,4.8e-05
G5,C(CCC(C=O)C(C=O)=CCO)=O,4,1,0,1,3,4.8e-05
G5,C(CCC(C(C=O)=CC=O)CO)=O,4,1,0,1,46,4.8e-05
G5,C(CCC(CC(C=O)=CC=O)O)=O,4,1,0,1,46,4.8e-05
G5,C(CCC(C(CCO)=O)(C=C)O)=O,2,1,0,1,27,4.8e-05
G5,C(C(CO)CCC=O)(C(C=C)O)=O,4,1,0,1,27,4.8e-05
G5,C(CCC(C(C(C(C)O)=C)=O)O)=O,4,1,0,1,4,4.8e-05
G5,C(CCCC(C(C(CO)=O)=C)O)=O,2,1,0,1,4,4.8e-05
G5,C(CCC(C(C(CO)=O)=C)(C)O)=O,2,1,0,1,4,4.8e-05
G5,C(CCC(C(C(CO)=CC)=O)O)=O,4,1,0,1,27,4.8e-05
G5,C(CCC(C(C(CO)=O)=CC)O)=O,4,1,0,1,27,4.8e-05
G5,C(CCCC=C(C(CO)=O)CO)=O,2,1,0,1,27,4.8e-05
G5,C(CCC(C(C(C=C)CO)=O)O)=O,4,1,0,1,28,4.8e-05
G5,C(CCC(C(CO)=O)(C=C)CO)=O,2,1,0,1,28,4.8e-05
G5,C(CCC(C(CC=O)=CCO)O)=O,4,1,0,1,3,4.8e-05
G5,C(CCC(C=C(CO)CC=O)O)=O,4,1,0,1,3,4.8e-05
G5,C(CCC(C=O)C(CO)=CCO)=O,4,1,0,1,3,4.8e-05
G5,C(CCC(C(CCO)=CC=O)O)=O,4,1,0,1,46,4.8e-05
G5,C(CCC(C(CO)=CC=O)CO)=O,4,1,0,1,46,4.8e-05
G5,C(CCC(CC(CO)=CC=O)O)=O,4,1,0,1,46,4.8e-05
G5,C(CCC(C(C=C(CO)C)=O)O)=O,4,1,0,1,49,4.8e-05
G5,C(CCCC(CO)=CC(CO)=O)=O,2,1,0,1,49,4.8e-05
G5,C(CCC(C(C)=CC(CO)=O)O)=O,4,1,0,1,49,4.8e-05
G5,C(CCC(C(CO)=O)C(CO)=C)=O,2,1,0,1,49,4.8e-05
G5,C(CCC(C(CC(CO)=C)=O)O)=O,2,1,0,1,49,4.8e-05
G5,C(CCC(C(CC(CO)=O)=C)O)=O,2,1,0,1,49,4.8e-05
G5,C(CCCC(C(C(CO)=C)O)=O)=O,2,1,0,1,49,4.8e-05
G5,C(CCC(C(C)=O)(C(CO)=C)O)=O,2,1,0,1,49,4.8e-05
G5,C(CCC(C(C(C(C)=O)O)=C)O)=O,4,1,0,1,49,4.8e-05
G5,C(CCC(C(C=CC)=O)O)=O,4,1,0,1,28,4.8e-05
G5,C(CCCC=CC(CO)=O)=O,2,1,0,1,28,4.8e-05
G5,C(CCC(C(CO)=O)C=C)=O,2,1,0,1,28,4.8e-05
G5,C(CCC(C(CC=C)=O)O)=O,2,1,0,1,28,4.8e-05
G5,C(CCCC(C(C=C)O)=O)=O,2,1,0,1,28,4.8e-05
G5,C(CCC(C(C)=O)(C=C)O)=O,2,1,0,1,28,4.8e-05
G5,C(CCC(C(CC=O)=C)O)=O,2,1,0,1,28,4.8e-05
G5,C(CCC(C=O)C(CO)=C)=O,2,1,0,1,28,4.8e-05
G5,C(CCCC(CO)=CC=O)=O,2,1,0,1,28,4.8e-05
G5,C(CCC(C(C)=CC=O)O)=O,4,1,0,1,28,4.8e-05
G5,C(CCCC(C(C=O)=CC=O)O)=O,4,1,0,1,28,4.8e-05
G5,C(CCC(C(C=O)=CC=O)(C)O)=O,4,1,0,1,28,4.8e-05
G5,C(CCC(C=O)(C(C=O)=CC)O)=O,4,1,0,1,45,4.8e-05
G5,C(C(C(C=O)=CCCCC=O)O)=O,4,1,0,1,45,4.8e-05
G5,C(CCC(C=O)(C=C)C(C=O)O)=O,4,1,0,1,45,4.8e-05
G5,C(C(C=CCC=O)(CCC=O)O)=O,4,1,0,1,43,4.8e-05
G5,C(C(C=CC(C=O)O)CCC=O)=O,8,1,0,1,43,4.8e-05
G5,C(CCC(C=O)(CC=CC=O)O)=O,4,1,0,1,27,4.8e-05
G5,C(CCC(C=CC=O)C(C=O)O)=O,8,1,0,1,27,4.8e-05
G5,C(CCCC=CC=O)=O,2,1,0,1,45,4.8e-05
G5,C(C(C=C)CCC=O)=O,2,1,0,1,45,4.8e-05
G5,C(CCC(C=O)(C(CO)=C)O)=O,2,1,0,1,49,4.8e-05
G5,C(CCC(C(C(C=O)O)=C)O)=O,4,1,0,1,49,4.8e-05
G5,C(CCC(C=CC(O)=O)O)=O,4,1,0,1,18,4.8e-05
G5,C(C(C(CCCC=O)=O)(C=C)O)=O,2,1,0,1,27,4.8e-05
G5,C(CCCC(C(C=C)(CO)O)=O)=O,2,1,0,1,27,4.8e-05
G5,C(C(C(C=O)=C)(CCC=O)O)(O)=O,2,1,0,1,33,4.8e-05
G5,C(CCC(C(C(C(O)=O)O)=C)O)=O,4,1,0,1,49,4.8e-05
G5,C(CCC(C(O)=O)(C(CO)=C)O)=O,2,1,0,1,49,4.8e-05
G5,C(CCC(C=O)C1OCC(C=1)=O)=O,2,1,0,1,48,4.8e-05
G5,C(CCC1C(C=C(CC=O)O1)=O)=O,2,1,0,1,48,4.8e-05
G5,C(CCC1(C=O)C(C=C(C)O1)=O)=O,2,1,0,1,26,4.8e-05
G5,C(C1C(C=C(CCCC=O)O1)=O)=O,2,1,0,1,26,4.8e-05
G5,C(CCC1(C=CC(C(O1)=O)=O)CO)=O,2,1,0,1,50,4.8e-05
G5,C(CCC(C1C=CC(C(O1)=O)=O)O)=O,4,1,0,1,50,4.8e-05
G5,C(CCC1(C(C=CC(O1)=O)=O)CO)=O,2,1,0,1,2,4.8e-05
G5,C(CCC(C1C(C=CC(O1)=O)=O)O)=O,4,1,0,1,2,4.8e-05
G5,C(CCC1(C=CC(C(OC1)=O)=O)O)=O,2,1,0,1,27,4.8e-05
G5,C(CCC1C(C=CC(C(O1)=O)=O)O)=O,4,1,0,1,27,4.8e-05
G5,C(CCC1(C(OCC=CC1=O)=O)O)=O,2,1,0,1,2,4.8e-05
G5,C(CCC1C=CC(C(C(O1)=O)O)=O)=O,4,1,0,1,2,4.8e-05
G5,C(CCC1(C(C=CC(OC1)=O)=O)O)=O,2,1,0,1,46,4.8e-05
G5,C(CCC1C(C(C=CC(O1)=O)=O)O)=O,4,1,0,1,46,4.8e-05
G5,C(CCC1(C(OCC(C=C1)=O)=O)O)=O,2,1,0,1,27,4.8e-05
G5,C(CCC1C(C=CC(C(O1)=O)O)=O)=O,4,1,0,1,27,4.8e-05
G5,C(CCC(C=O)(C1C=CC(O1)=O)O)=O,4,1,0,1,8,4.8e-05
G5,C(CCC1(C=CC(O1)=O)C(C=O)O)=O,4,1,0,1,8,4.8e-05
G5,C(CCC1(C=O)C(C=CC(O1)=O)O)=O,4,1,0,1,8,4.8e-05
G5,C(CCC1(C=CC(OC1C=O)=O)O)=O,4,1,0,1,8,4.8e-05
G5,C(CCC(C(C)O)(C(CO)O)O)=O,8,1,0,1,27,4.8e-05
G5,C(CCC(CO)(C(C(C)O)O)O)=O,8,1,0,1,27,4.8e-05
G5,C(CCC(C(C(C(C)O)O)O)O)=O,16,1,0,1,27,4.8e-05
G5,C(CCCC(C(C(CO)O)O)O)=O,8,1,0,1,27,4.8e-05
G5,C(CCC(C)(C(C(CO)O)O)O)=O,8,1,0,1,27,4.8e-05
G5,C(CCC(C=O)(C(C=C)O)O)=O,4,1,0,1,27,4.8e-05
G5,C(CCC(C=C)(C(CO)O)O)=O,4,1,0,1,27,4.8e-05
G5,C(CCC(CO)(C(C=C)O)O)=O,4,1,0,1,27,4.8e-05
G5,C(CCC(C(C(C=C)O)O)O)=O,8,1,0,1,27,4.8e-05
G5,C(CCC(C=CC(CO)O)O)=O,8,1,0,1,27,4.8e-05
G5,C(CCC(C=CCO)(CO)O)=O,4,1,0,1,27,4.8e-05
G5,C(CCC(C(C=CCO)O)O)=O,8,1,0,1,27,4.8e-05
G5,C(CCC1C(CO)(CC(O)O1)O)=O,8,1,0,1,27,4.8e-05
G5,C(CCC(C1(COC(C1)O)O)O)=O,8,1,0,1,27,4.8e-05
G5,C(CCC1C(O)OCC1(CO)O)=O,8,1,0,1,27,4.8e-05
G5,C(CCC1(CC(CO1)(CO)O)O)=O,4,1,0,1,27,4.8e-05
G5,C(CCC1(CO)C(CC(O)O1)O)=O,8,1,0,1,27,4.8e-05
G5,C(CCC(C1C(CC(O)O1)O)O)=O,16,1,0,1,27,4.8e-05
G5,C(CCC1C(O)OC(CO)C1O)=O,16,1,0,1,27,4.8e-05
G5,C(CCC1(CC(C(CO)O1)O)O)=O,8,1,0,1,27,4.8e-05
G5,C1(CC(C=O)OC1(CCC=O)O)=O,4,1,0,1,0,4.8e-05
G5,C(CCC1C(C(OC1C=O)O)=O)=O,8,1,0,1,0,4.8e-05
G5,C(CCC1(C=O)CC(C(O1)O)=O)=O,4,1,0,1,0,4.8e-05
G5,C(CCC1(C(CC(C)O1)=O)O)=O,4,1,0,1,45,4.8e-05
G5,C(CCC1C(C(O)OC1C)=O)=O,8,1,0,1,45,4.8e-05
G5,C(CCCC1CC(C(O)O1)=O)=O,4,1,0,1,45,4.8e-05
G5,C(CCC1(C)CC(C(O)O1)=O)=O,4,1,0,1,45,4.8e-05
G5,C(C1C(CCC=O)OC(C1O)O)=O,16,1,0,1,27,4.8e-05
G5,C(C1COC(CCC=O)(C1O)O)=O,8,1,0,1,27,4.8e-05
G5,C(C1COC(C1(CCC=O)O)O)=O,8,1,0,1,27,4.8e-05
G5,C(C1(COC(C1O)O)CCC=O)=O,8,1,0,1,27,4.8e-05
G5,C(C1(CCC=O)C(CC(O1)O)O)=O,8,1,0,1,0,4.8e-05
G5,C(CCC1C(C(C=O)OC1O)O)=O,16,1,0,1,0,4.8e-05
G5,C(CCC1(CC(C(C=O)O1)O)O)=O,8,1,0,1,0,4.8e-05
G5,C(CCCC1(COC(C1)O)O)=O,4,1,0,1,18,4.8e-05
G5,C(CCC1C(C)(CC(O)O1)O)=O,8,1,0,1,18,4.8e-05
G5,C(CCC1C(O)OCC1(C)O)=O,8,1,0,1,18,4.8e-05
G5,C(CCC1(CC(CO1)(C)O)O)=O,4,1,0,1,18,4.8e-05
G5,C(CCC1(COC(C=O)(C1)O)O)=O,4,1,0,1,0,4.8e-05
G5,C(CCC1C(CC(C=O)(O)O1)O)=O,8,1,0,1,0,4.8e-05
G5,C(CCC1C(COC1(C=O)O)O)=O,8,1,0,1,0,4.8e-05
G5,C(CCC1(C(C(CO1)(C)O)O)O)=O,8,1,0,1,27,4.8e-05
G5,C(CCC1(C(O)OCC1(C)O)O)=O,8,1,0,1,27,4.8e-05
G5,C(CCCC1(COC(C1O)O)O)=O,8,1,0,1,27,4.8e-05
G5,C(CCC1C(C)(C(C(O)O1)O)O)=O,16,1,0,1,27,4.8e-05
G5,C(CCC1(COC(CO)(C1)O)O)=O,4,1,0,1,27,4.8e-05
G5,C(CCC1C(CC(CO)(O)O1)O)=O,8,1,0,1,27,4.8e-05
G5,C(CCC1C(COC1(CO)O)O)=O,8,1,0,1,27,4.8e-05
G5,C(CCC(C1(CC(CO1)O)O)O)=O,8,1,0,1,27,4.8e-05
G5,C(CCC1(COC(C)(C1O)O)O)=O,8,1,0,1,27,4.8e-05
G5,C(CCC1C(C(C(C)(O)O1)O)O)=O,16,1,0,1,27,4.8e-05
G5,C(CCC1(C(COC1(C)O)O)O)=O,8,1,0,1,27,4.8e-05
G5,C(CCC1(COC(C1)O)O)=O,4,1,0,1,43,4.8e-05
G5,C(CCC1C(CC(O)O1)O)=O,8,1,0,1,43,4.8e-05
G5,C(CCC1C(O)OCC1O)=O,8,1,0,1,43,4.8e-05
G5,C(CCC1(CC(CO1)O)O)=O,4,1,0,1,43,4.8e-05
G5,C(CCC1C(C(C(O)O1)=O)O)=O,8,1,0,1,0,4.8e-05
G5,C(CCC1C(C(C(C)(O1)O)O)=O)=O,8,1,0,1,0,4.8e-05
G5,C(CCC1(C(COC1(C)O)=O)O)=O,4,1,0,1,0,4.8e-05
G5,C(CCC1C(C(C(O1)O)O)=O)=O,8,1,0,1,5,4.8e-05
G5,C(CCC1(C(COC1O)=O)O)=O,4,1,0,1,5,4.8e-05
G5,C(CCC1(C(CCO1)O)O)=O,4,1,0,1,28,4.8e-05
G5,C(CCC1(C(O)OCC1)O)=O,4,1,0,1,28,4.8e-05
G5,C(CCC1COC(C1O)O)=O,8,1,0,1,28,4.8e-05
G5,C(CCC1CC(C(O)O1)O)=O,8,1,0,1,28,4.8e-05
G5,C1(C(CCC=O)(C(C(O)O1)O)O)=O,8,1,0,1,0,4.8e-05
G5,C(CCC1(C(O)OC(C1O)=O)O)=O,8,1,0,1,0,4.8e-05
G5,C(CCC1(C(C(C(O1)=O)O)O)O)=O,8,1,0,1,0,4.8e-05
G5,C1(CC(C(CCC=O)(O)O1)O)=O,4,1,0,1,45,4.8e-05
G5,C1(CC(CCC=O)(C(O)O1)O)=O,4,1,0,1,45,4.8e-05
G5,C1(C(CCC=O)C(C(O)O1)O)=O,8,1,0,1,45,4.8e-05
G5,C(C1(CCC=O)CC(C(O1)O)O)=O,8,1,0,1,27,4.8e-05
G5,C(CCC1C(C(OC1C=O)O)O)=O,16,1,0,1,27,4.8e-05
G5,C(CCC1(CC(C=O)OC1O)O)=O,8,1,0,1,27,4.8e-05
G5,C(CCC1(C(CC(C=O)O1)O)O)=O,8,1,0,1,27,4.8e-05
G5,C(CCC1(C(C(C(C)O1)=O)O)O)=O,8,1,0,1,0,4.8e-05
G5,C(CCC1(C(C(C)OC1O)=O)O)=O,8,1,0,1,0,4.8e-05
G5,C(CCC1(C(C(C(O1)O)O)=O)C)=O,8,1,0,1,0,4.8e-05
G5,C1(C(CCC=O)(CC(O)O1)O)=O,4,1,0,1,45,4.8e-05
G5,C(CCC1C(O)OC(C1O)=O)=O,8,1,0,1,45,4.8e-05
G5,C(CCC1(CC(C(O1)=O)O)O)=O,4,1,0,1,45,4.8e-05
G5,C(C1(COC(C1CCC=O)O)O)=O,8,1,0,1,27,4.8e-05
G5,C(C1(COC(C1)(CCC=O)O)O)=O,4,1,0,1,27,4.8e-05
G5,C(CCC1(COC(CC1O)O)O)=O,8,1,0,1,27,4.8e-05
G5,C(CCC1C(C(CC(O)O1)O)O)=O,16,1,0,1,27,4.8e-05
G5,C(CCC1C(O)OCC(C1O)O)=O,16,1,0,1,27,4.8e-05
G5,C(CCC1(CC(C(CO1)O)O)O)=O,8,1,0,1,27,4.8e-05
G5,C(CCC1(CC(C(CO1)O)=O)O)=O,4,1,0,1,27,4.8e-05
G5,C(CCC1C(C(COC1O)O)=O)=O,8,1,0,1,27,4.8e-05
G5,C1(CC(O)OCC1(CCC=O)O)=O,4,1,0,1,27,4.8e-05
G5,C(CCC1C(C(CC(O)O1)=O)O)=O,8,1,0,1,27,4.8e-05
G5,C(CCC1(C(C(CCO1)=O)O)O)=O,4,1,0,1,27,4.8e-05
G5,C1(CCOC(C1(CCC=O)O)O)=O,4,1,0,1,27,4.8e-05
G5,C(CCC1C(C(C(O)OC1)O)=O)=O,8,1,0,1,27,4.8e-05
G5,C(CCC1CC(C(C(O)O1)O)=O)=O,8,1,0,1,27,4.8e-05
G5,C(CCCC1(COC(C1O)=O)O)=O,4,1,0,1,27,4.8e-05
G5,C(CCC1C(C)(C(C(O1)=O)O)O)=O,8,1,0,1,27,4.8e-05
G5,C1(C(CCC=O)(C(C)(CO1)O)O)=O,4,1,0,1,27,4.8e-05
G5,C(CCC(CO)CC(C=O)=O)=O,2,1,0,1,55,4.8e-05
G5,C(CCC(CCC(C=O)=O)O)=O,2,1,0,1,55,4.8e-05
G5,C(CCC(C(C=O)=O)CCCO)=O,2,1,0,1,46,4.8e-05
G5,C(CCC(CCO)CC(C=O)=O)=O,2,1,0,1,46,4.8e-05
G5,C(CCC(CCC(C=O)=O)CO)=O,2,1,0,1,46,4.8e-05
G5,C(CCC(CCCC(C=O)=O)O)=O,2,1,0,1,46,4.8e-05
G5,C(CCC(C(C=O)=O)CC(C)O)=O,4,1,0,1,27,4.8e-05
G5,C(CCC(C(C)O)CC(C=O)=O)=O,4,1,0,1,27,4.8e-05
G5,C(CCCC(CCC(C=O)=O)O)=O,2,1,0,1,27,4.8e-05
G5,C(CCC(C)(CCC(C=O)=O)O)=O,2,1,0,1,27,4.8e-05
G5,C(CCC(C(CCCO)=O)O)=O,2,1,0,1,55,4.8e-05
G5,C(CCC(C(CO)=O)CCO)=O,2,1,0,1,55,4.8e-05
G5,C(CCC(CO)CC(CO)=O)=O,2,1,0,1,55,4.8e-05
G5,C(CCC(CCC(CO)=O)O)=O,2,1,0,1,55,4.8e-05
G5,C(CCC(C(CCCCO)=O)O)=O,2,1,0,1,27,4.8e-05
G5,C(CCC(C(CO)=O)CCCO)=O,2,1,0,1,27,4.8e-05
G5,C(CCC(CCO)CC(CO)=O)=O,2,1,0,1,27,4.8e-05
G5,C(CCC(CO)CCC(CO)=O)=O,2,1,0,1,27,4.8e-05
G5,C(CCC(CCCC(CO)=O)O)=O,2,1,0,1,27,4.8e-05
G5,C(CCC(C(CCC(C)O)=O)O)=O,4,1,0,1,27,4.8e-05
G5,C(CCC(C(CO)=O)CC(C)O)=O,4,1,0,1,27,4.8e-05
G5,C(CCC(C(C)O)CC(CO)=O)=O,4,1,0,1,27,4.8e-05
G5,C(CCCC(CCC(CO)=O)O)=O,2,1,0,1,27,4.8e-05
G5,C(CCC(C)(CCC(CO)=O)O)=O,2,1,0,1,27,4.8e-05
G5,C(C(CCC=O)(C(C)O)CC=O)=O,4,1,0,1,27,4.8e-05
G5,C(CCC(C=O)C(C=O)C(C)O)=O,8,1,0,1,27,4.8e-05
G5,C(CCCC(C(C=O)CC=O)O)=O,4,1,0,1,27,4.8e-05
G5,C(CCC(C)(C(C=O)CC=O)O)=O,4,1,0,1,27,4.8e-05
G5,C(CCC1(C(C=CC1=O)=O)O)=O,1,1,0,1,47,4.8e-05
G5,C(C(C=CC=O)CCC=O)=O,4,1,0,1,28,4.8e-05
G5,C(CCC(C(C=O)=O)C(C)O)=CC=O,8,1,0,1,4,4.8e-05
G5,C(CC(C)CC(C(C(C=O)=O)=C)O)=O,4,1,0,1,4,4.8e-05
G5,C(CC(C)C(C(C(C=O)=O)=C)(C)O)=O,4,1,0,1,4,4.8e-05
G5,C(C(C=C)CC(C(C=O)=O)C(C)O)=O,8,1,0,1,4,4.8e-05
G5,C(CC(C)C(C(C=O)=O)CO)=CC=O,8,1,0,1,27,4.8e-05
G5,C(CC(C)C(C(C(C=O)=O)=CC)O)=O,8,1,0,1,27,4.8e-05
G5,C(CC(C)CC=C(C(C=O)=O)CO)=O,4,1,0,1,27,4.8e-05
G5,C(C(C=C)C(C)C(C(C=O)=O)CO)=O,8,1,0,1,27,4.8e-05
G5,C(CC(C)C(C=C)(C(C=O)=O)CO)=O,4,1,0,1,28,4.8e-05
G5,C(C(C(CO)CC=CC=O)CC=O)=O,8,1,0,1,3,4.8e-05
G5,C(CC(C)C(C=C(C=O)CC=O)O)=O,8,1,0,1,3,4.8e-05
G5,C(CC(C)C(C=O)C(C=O)=CCO)=O,8,1,0,1,3,4.8e-05
G5,C(C(C(CO)C(C=O)C=C)CC=O)=O,8,1,0,1,3,4.8e-05
G5,C(C(CCO)(CC=O)CC=CC=O)=O,4,1,0,1,46,4.8e-05
G5,C(C(CCO)C(C=O)CC=CC=O)=O,8,1,0,1,46,4.8e-05
G5,C(CC(C)C(C(C=O)=CC=O)CO)=O,8,1,0,1,46,4.8e-05
G5,C(CC(C)C(CC(C=O)=CC=O)O)=O,8,1,0,1,46,4.8e-05
G5,C(C(CCO)(CC=O)C(C=O)C=C)=O,4,1,0,1,46,4.8e-05
G5,C(C(CCO)C(C=O)C(C=O)C=C)=O,8,1,0,1,46,4.8e-05
G5,C(CO)(CC(C)CC=CC=O)=O,4,1,0,1,28,4.8e-05
G5,C(CC(C)C(C(C=CC)=O)O)=O,8,1,0,1,28,4.8e-05
G5,C(CC(C)CC=CC(CO)=O)=O,4,1,0,1,28,4.8e-05
G5,C(C(C=C)C(C)CC(CO)=O)=O,4,1,0,1,28,4.8e-05
G5,C(CCC(C(C=CC)=O)O)(O)=O,4,1,0,1,18,4.8e-05
G5,C(CCCC=CC(CO)=O)(O)=O,2,1,0,1,18,4.8e-05
G5,C(C(C=CC=O)C(C)CC(CO)=O)=O,8,1,0,1,28,4.8e-05
G5,C(CC(C(C(C=CC)=O)O)CC=O)=O,4,1,0,1,28,4.8e-05
G5,C(CC(CC=O)CC=CC(CO)=O)=O,2,1,0,1,28,4.8e-05
G5,C(CC(C)C(C(CO)=O)C=C)=O,4,1,0,1,28,4.8e-05
G5,C(CC(C)C(C(CC=C)=O)O)=O,4,1,0,1,28,4.8e-05
G5,C(CCC(C(CO)=O)C=C)(O)=O,2,1,0,1,18,4.8e-05
G5,C(CCC(C(CC=C)=O)O)(O)=O,2,1,0,1,18,4.8e-05
G5,C(CC(CC=O)C(C(CO)=O)C=C)=O,2,1,0,1,28,4.8e-05
G5,C(CC(C(C(CC=C)=O)O)CC=O)=O,2,1,0,1,28,4.8e-05
G5,C(CC(C)CC(C(C=C)O)=O)=O,4,1,0,1,28,4.8e-05
G5,C(CC(C)C(C(C)=O)(C=C)O)=O,4,1,0,1,28,4.8e-05
G5,C(CCCC(C(C=C)O)=O)(O)=O,2,1,0,1,18,4.8e-05
G5,C(CCC(C(C)=O)(C=C)O)(O)=O,2,1,0,1,18,4.8e-05
G5,C(CC(CC=O)CC(C(C=C)O)=O)=O,2,1,0,1,28,4.8e-05
G5,C(CC(CC=O)C(C(C)=O)(C=C)O)=O,2,1,0,1,28,4.8e-05
G5,C(CC(C)C(C(CC=O)=C)O)=O,4,1,0,1,28,4.8e-05
G5,C(CC(C)C(C=O)C(CO)=C)=O,4,1,0,1,28,4.8e-05
G5,C(CCC(C(CC=O)=C)O)(O)=O,2,1,0,1,28,4.8e-05
G5,C(CCC(C=O)C(CO)=C)(O)=O,2,1,0,1,28,4.8e-05
G5,C(CC(C(C(CC=O)=C)O)CC=O)=O,2,1,0,1,28,4.8e-05
G5,C(CC(CC=O)C(C=O)C(CO)=C)=O,2,1,0,1,28,4.8e-05
G5,C(CC(C)(CO)CC=CC=O)=O,4,1,0,1,28,4.8e-05
G5,C(CC(C)CC(CO)=CC=O)=O,4,1,0,1,28,4.8e-05
G5,C(CC(C)C(C(C)=CC=O)O)=O,8,1,0,1,28,4.8e-05
G5,C(C(C=C)C(C)(CO)CC=O)=O,4,1,0,1,28,4.8e-05
G5,C(CCCC(CO)=CC=O)(O)=O,2,1,0,1,28,4.8e-05
G5,C(CCC(C(C)=CC=O)O)(O)=O,4,1,0,1,28,4.8e-05
G5,C(C(C=CC=O)C(C)(CO)CC=O)=O,8,1,0,1,28,4.8e-05
G5,C(CC(CC=O)CC(CO)=CC=O)=O,2,1,0,1,28,4.8e-05
G5,C(CC(C(C(C)=CC=O)O)CC=O)=O,4,1,0,1,28,4.8e-05
G5,C(C(C(C)O)C(C=O)CC=CC=O)=O,16,1,0,1,28,4.8e-05
G5,C(C(C(C)O)(CC=O)CC=CC=O)=O,8,1,0,1,28,4.8e-05
G5,C(CC(C)CC(C(C=O)=CC=O)O)=O,8,1,0,1,28,4.8e-05
G5,C(CC(C)C(C(C=O)=CC=O)(C)O)=O,8,1,0,1,28,4.8e-05
G5,C(C(C(C)O)C(C=O)C(C=O)C=C)=O,16,1,0,1,28,4.8e-05
G5,C(C(C(C)O)(CC=O)C(C=O)C=C)=O,8,1,0,1,28,4.8e-05
G5,C(C(C(C)CC=CC=O)C(C=O)O)=O,16,1,0,1,45,4.8e-05
G5,C(CC(C)C(C=O)(C(C=O)=CC)O)=O,8,1,0,1,45,4.8e-05
G5,C(C(C(C=O)=CCC(C)CC=O)O)=O,8,1,0,1,45,4.8e-05
G5,C(C(C(C)C(C=O)C=C)C(C=O)O)=O,16,1,0,1,45,4.8e-05
G5,C(CC(C)C(C=O)(C=C)C(C=O)O)=O,8,1,0,1,45,4.8e-05
G5,C(C(C=CCC=O)(C(C)CC=O)O)=O,8,1,0,1,43,4.8e-05
G5,C(C(C=CC(C=O)O)C(C)CC=O)=O,16,1,0,1,43,4.8e-05
G5,C(CC(CC(C=O)O)CC=CC=O)=O,8,1,0,1,27,4.8e-05
G5,C(CC(C)C(C=O)(CC=CC=O)O)=O,8,1,0,1,27,4.8e-05
G5,C(CC(C)C(C=CC=O)C(C=O)O)=O,16,1,0,1,27,4.8e-05
G5,C(CC(CC(C=O)O)C(C=O)C=C)=O,8,1,0,1,27,4.8e-05
G5,C(CC(C)CC=CC=O)=O,4,1,0,1,45,4.8e-05
G5,C(C(C=C)C(C)CC=O)=O,4,1,0,1,45,4.8e-05
G5,C(CC(C)C(C=O)(C(CO)=C)O)=O,4,1,0,1,49,4.8e-05
G5,C(CC(C)C(C(C(C=O)O)=C)O)=O,8,1,0,1,49,4.8e-05
G5,C(CCCC=CC=O)(O)=O,2,1,0,1,18,4.8e-05
G5,C(CC(C)C(C=CC(O)=O)O)=O,8,1,0,1,18,4.8e-05
G5,C(CC(CO)CC=CC=O)(O)=O,4,1,0,1,18,4.8e-05
G5,C(C(C(CC(C)CC=O)=O)(C=C)O)=O,4,1,0,1,27,4.8e-05
G5,C(CC(C)C(C=O)C1OCC(C=1)=O)=O,4,1,0,1,48,4.8e-05
G5,C(CC(C)C1C(C=C(CC=O)O1)=O)=O,4,1,0,1,48,4.8e-05
G5,C(CC(C)C1(C=O)C(C=C(C)O1)=O)=O,4,1,0,1,26,4.8e-05
G5,C(C1C(C=C(CC(C)CC=O)O1)=O)=O,4,1,0,1,26,4.8e-05
G5,C(CC(C)C(C=O)(C(C=C)O)O)=O,8,1,0,1,27,4.8e-05
G5,C(CC(C)C(C=C)(C(C=O)O)O)=O,8,1,0,1,27,4.8e-05
G5,C(CC(C)C(C=C)(C(CO)O)O)=O,8,1,0,1,27,4.8e-05
G5,C(CC(C)C(CO)(C(C=C)O)O)=O,8,1,0,1,27,4.8e-05
G5,C(CC(C)C(C(C(C=C)O)O)O)=O,16,1,0,1,27,4.8e-05
G5,C(CC(C)C(C=CC(CO)O)O)=O,16,1,0,1,27,4.8e-05
G5,C(CC(C)C(C=CCO)(CO)O)=O,8,1,0,1,27,4.8e-05
G5,C(CC(C)C(C(C=CCO)O)O)=O,16,1,0,1,27,4.8e-05
G5,C(CC(C)C1(C(CC(C)O1)=O)O)=O,8,1,0,1,45,4.8e-05
G5,C(CC(C)C1C(C(O)OC1C)=O)=O,16,1,0,1,45,4.8e-05
G5,C(CC(C)CC1CC(C(O)O1)=O)=O,8,1,0,1,45,4.8e-05
G5,C(CC(C)C1(C)CC(C(O)O1)=O)=O,8,1,0,1,45,4.8e-05
G5,C(CC(C)CC1(COC(C1)O)O)=O,8,1,0,1,18,4.8e-05
G5,C(CC(C)C1C(C)(CC(O)O1)O)=O,16,1,0,1,18,4.8e-05
G5,C(CC(C)C1C(O)OCC1(C)O)=O,16,1,0,1,18,4.8e-05
G5,C(CC(C)C1(CC(CO1)(C)O)O)=O,8,1,0,1,18,4.8e-05
G5,C(CC(C)C1(COC(C1)O)O)=O,8,1,0,1,43,4.8e-05
G5,C(CC(C)C1C(CC(O)O1)O)=O,16,1,0,1,43,4.8e-05
G5,C(CC(C)C1C(O)OCC1O)=O,16,1,0,1,43,4.8e-05
G5,C(CC(C)C1(CC(CO1)O)O)=O,8,1,0,1,43,4.8e-05
G5,C(CC(C)C1(C(C(CO1)O)=O)O)=O,8,1,0,1,0,4.8e-05
G5,C(CC(C)C1(C(C(O)OC1)=O)O)=O,8,1,0,1,0,4.8e-05
G5,C(CC(C)C1C(C(C(O)O1)=O)O)=O,16,1,0,1,0,4.8e-05
G5,C(CC(C)C1C(C(C(O1)O)O)=O)=O,16,1,0,1,5,4.8e-05
G5,C(CC(C)C1(C(COC1O)=O)O)=O,8,1,0,1,5,4.8e-05
G5,C(CC(C)C1(C(C(CO1)=O)O)O)=O,8,1,0,1,5,4.8e-05
G5,C(CC(C)C1(C(CCO1)O)O)=O,8,1,0,1,28,4.8e-05
G5,C(CC(C)C1(C(O)OCC1)O)=O,8,1,0,1,28,4.8e-05
G5,C(CC(C)C1COC(C1O)O)=O,16,1,0,1,28,4.8e-05
G5,C(CC(C)C1CC(C(O)O1)O)=O,16,1,0,1,28,4.8e-05
G5,C1(CC(C(C(C)CC=O)(O)O1)O)=O,8,1,0,1,45,4.8e-05
G5,C1(CC(C(O)O1)(C(C)CC=O)O)=O,8,1,0,1,45,4.8e-05
G5,C1(C(C(C)CC=O)C(C(O)O1)O)=O,16,1,0,1,45,4.8e-05
G5,C1(C(CC(O)O1)(C(C)CC=O)O)=O,8,1,0,1,45,4.8e-05
G5,C(CC(C)C1C(O)OC(C1O)=O)=O,16,1,0,1,45,4.8e-05
G5,C(CC(C)C1(CC(C(O1)=O)O)O)=O,8,1,0,1,45,4.8e-05
G5,C(CC(C)C(C(C=O)=O)CCO)=O,4,1,0,1,55,4.8e-05
G5,C(CC(C)C(CO)CC(C=O)=O)=O,4,1,0,1,55,4.8e-05
G5,C(CC(C)C(CCC(C=O)=O)O)=O,4,1,0,1,55,4.8e-05
G5,C(CC(C)C(C(CCCO)=O)O)=O,4,1,0,1,55,4.8e-05
G5,C(CC(C)C(C(CO)=O)CCO)=O,4,1,0,1,55,4.8e-05
G5,C(CC(C)C(CO)CC(CO)=O)=O,4,1,0,1,55,4.8e-05
G5,C(CC(C)C(CCC(CO)=O)O)=O,4,1,0,1,55,4.8e-05
G5,C(CC(C)C1(C(C=CC1=O)=O)O)=O,2,1,0,1,47,4.8e-05
G5,C1(CC(C(C1O)=O)CC=CC=O)=O,8,1,0,1,47,4.8e-05
G5,C(C(C=CC=O)C(C)CC=O)=O,8,1,0,1,28,4.8e-05
G5,C(CC(CC=O)CC=CC=O)=O,2,1,0,1,28,4.8e-05
G5,C(C(C=C)CCC(O)=O)=O,2,1,0,1,18,4.8e-05
G5,C(C(C=C)C(CO)CC(O)=O)=O,4,1,0,1,18,4.8e-05
G5,C(C(C=C)C1C(C(C(C1)=O)O)=O)=O,8,1,0,1,47,4.8e-05
G5,C(C(C=C)C(CC=O)CC=O)=O,2,1,0,1,28,4.8e-05
G5,C(CCC(C=O)(C(CO)=C)O)(O)=O,2,1,0,1,49,4.8e-05
G5,C(CCC(C(C(C=O)O)=C)O)(O)=O,4,1,0,1,49,4.8e-05
G5,C(CCC(C=CC(O)=O)O)(O)=O,4,1,0,1,18,4.8e-05
G5,C(C(C=C)(C(CCC(O)=O)O)O)=O,4,1,0,1,29,4.8e-05
G5,C(CCC(C=O)C1OCC(C=1)=O)(O)=O,2,1,0,1,48,4.8e-05
G5,C(CCC1C(C=C(CC=O)O1)=O)(O)=O,2,1,0,1,48,4.8e-05
G5,C(CCC1(C=O)C(C=C(C)O1)=O)(O)=O,2,1,0,1,26,4.8e-05
G5,C(C1C(C=C(CCCC(O)=O)O1)=O)=O,2,1,0,1,26,4.8e-05
G5,C(CCC(C=O)(C(C=C)O)O)(O)=O,4,1,0,1,27,4.8e-05
G5,C(CCC(C=C)(C(C=O)O)O)(O)=O,4,1,0,1,27,4.8e-05
G5,C(CCC(C=C)(C(CO)O)O)(O)=O,4,1,0,1,27,4.8e-05
G5,C(CCC(CO)(C(C=C)O)O)(O)=O,4,1,0,1,27,4.8e-05
G5,C(CCC(C(C(C=C)O)O)O)(O)=O,8,1,0,1,27,4.8e-05
G5,C(CCC(C=CC(CO)O)O)(O)=O,8,1,0,1,27,4.8e-05
G5,C(CCC(C=CCO)(CO)O)(O)=O,4,1,0,1,27,4.8e-05
G5,C(CCC(C(C=CCO)O)O)(O)=O,8,1,0,1,27,4.8e-05
G5,C(CCC1(C(CC(C)O1)=O)O)(O)=O,4,1,0,1,45,4.8e-05
G5,C(CCC1C(C(O)OC1C)=O)(O)=O,8,1,0,1,45,4.8e-05
G5,C(CCCC1CC(C(O)O1)=O)(O)=O,4,1,0,1,45,4.8e-05
G5,C(CCC1(C)CC(C(O)O1)=O)(O)=O,4,1,0,1,45,4.8e-05
G5,C(CCCC1(COC(C1)O)O)(O)=O,4,1,0,1,18,4.8e-05
G5,C(CCC1C(C)(CC(O)O1)O)(O)=O,8,1,0,1,18,4.8e-05
G5,C(CCC1C(O)OCC1(C)O)(O)=O,8,1,0,1,18,4.8e-05
G5,C(CCC1(CC(CO1)(C)O)O)(O)=O,4,1,0,1,18,4.8e-05
G5,C(CCC1(COC(C1)O)O)(O)=O,4,1,0,1,43,4.8e-05
G5,C(CCC1C(CC(O)O1)O)(O)=O,8,1,0,1,43,4.8e-05
G5,C(CCC1C(O)OCC1O)(O)=O,8,1,0,1,43,4.8e-05
G5,C(CCC1(CC(CO1)O)O)(O)=O,4,1,0,1,43,4.8e-05
G5,C(CCC1(C(C(CO1)O)=O)O)(O)=O,4,1,0,1,0,4.8e-05
G5,C(CCC1(C(C(O)OC1)=O)O)(O)=O,4,1,0,1,0,4.8e-05
G5,C(CCC1C(C(C(O)O1)=O)O)(O)=O,8,1,0,1,0,4.8e-05
G5,C(CCC1C(C(C(O1)O)O)=O)(O)=O,8,1,0,1,5,4.8e-05
G5,C(CCC1(C(COC1O)=O)O)(O)=O,4,1,0,1,5,4.8e-05
G5,C(CCC1(C(C(CO1)=O)O)O)(O)=O,4,1,0,1,5,4.8e-05
G5,C(CCC1(C(CCO1)O)O)(O)=O,4,1,0,1,28,4.8e-05
G5,C(CCC1(C(O)OCC1)O)(O)=O,4,1,0,1,28,4.8e-05
G5,C(CCC1COC(C1O)O)(O)=O,8,1,0,1,28,4.8e-05
G5,C(CCC1CC(C(O)O1)O)(O)=O,8,1,0,1,28,4.8e-05
G5,C1(CC(C(CCC(O)=O)(O)O1)O)=O,4,1,0,1,45,4.8e-05
G5,C1(CC(CCC(O)=O)(C(O)O1)O)=O,4,1,0,1,45,4.8e-05
G5,C1(C(CCC(O)=O)C(C(O)O1)O)=O,8,1,0,1,45,4.8e-05
G5,C1(C(CCC(O)=O)(CC(O)O1)O)=O,4,1,0,1,45,4.8e-05
G5,C(CCC1C(O)OC(C1O)=O)(O)=O,8,1,0,1,45,4.8e-05
G5,C(CCC1(CC(C(O1)=O)O)O)(O)=O,4,1,0,1,45,4.8e-05
G5,C(CCC(C(C=O)=O)CCO)(O)=O,2,1,0,1,55,4.8e-05
G5,C(CCC(CO)CC(C=O)=O)(O)=O,2,1,0,1,55,4.8e-05
G5,C(CCC(CCC(C=O)=O)O)(O)=O,2,1,0,1,55,4.8e-05
G5,C(CCC(C(CCCO)=O)O)(O)=O,2,1,0,1,55,4.8e-05
G5,C(CCC(C(CO)=O)CCO)(O)=O,2,1,0,1,55,4.8e-05
G5,C(CCC(CO)CC(CO)=O)(O)=O,2,1,0,1,55,4.8e-05
G5,C(CCC(CCC(CO)=O)O)(O)=O,2,1,0,1,55,4.8e-05
G5,C(CCC1(C(C=CC1=O)=O)O)(O)=O,1,1,0,1,47,4.8e-05
G5,C(C(C=CC=O)CCC(O)=O)=O,4,1,0,1,18,4.8e-05
G5,C(C(C=CC=O)C(CC=O)CC=O)=O,4,1,0,1,28,4.8e-05
G5,C1(CC(CO1)C(C=O)O)=O,4,1,0,1,28,4.8e-05
G5,C1(CC(C(C=O)O)CC(C1O)=O)=O,2,1,0,1,32,4.8e-05
G5,C1(CC(C(C=O)O)C(C(C1)=O)O)=O,8,1,0,1,45,4.8e-05
G5,C(C(C1C(C(C(C1)=O)CO)=O)O)=O,8,1,0,1,45,4.8e-05
G5,C(C(C1C(CC(C1CO)=O)=O)O)=O,8,1,0,1,45,4.8e-05
G5,C1(CC(C(C1)=O)(CO)C(C=O)O)=O,4,1,0,1,45,4.8e-05
G5,C(C(C1CC(C(C1CO)=O)=O)O)=O,8,2,0,2,0,9.7e-05
G5,C(C(CC1C(CC(C1=O)O)=O)O)=O,8,1,0,1,45,4.8e-05
G5,C(C(CC1C(C(C(C1)=O)O)=O)O)=O,8,2,0,2,47,9.6e-05
G5,C(C(C1C(C=O)CC(C1O)=O)O)=O,16,1,0,1,45,4.8e-05
G5,C1(CC(C(C(C=O)O)C1C=O)O)=O,16,1,0,1,45,4.8e-05
G5,C1(CC(C(C(C)=O)O1)C(C=O)O)=O,8,1,0,1,48,4.8e-05
G5,C1(CC(C(CC=O)O1)C(C=O)O)=O,8,1,0,1,48,4.8e-05
G5,C1(CC(C(OCC1)=O)C(C=O)O)=O,4,1,0,1,19,4.8e-05
G5,C1(CC(C(CCO1)=O)C(C=O)O)=O,4,1,0,1,19,4.8e-05
G5,C1(CC(C(C=O)O)CC(CO1)=O)=O,4,2,0,2,0,9.7e-05
G5,C1(CC(COC(C1)=O)C(C=O)O)=O,4,1,0,1,19,4.8e-05
G5,C(C(C1COCC(C(C1)=O)=O)O)=O,4,1,0,1,36,4.8e-05
G5,C(C(C1C(COCC(C1)=O)=O)O)=O,4,1,0,1,45,4.8e-05
G5,C1(CC(C=O)(CC1O)C(C=O)O)=O,8,1,0,1,45,4.8e-05
G5,C(C(C1C(C(CC1C=O)O)=O)O)=O,16,1,0,1,45,4.8e-05
G5,C(C1C(C(CC1C(C=O)O)O)=O)=O,16,1,0,1,27,4.8e-05
G5,C(CC(CO)(CO)C(C=O)O)=O,2,2,0,2,29,9.6e-05
G5,C(C(C)(C(C=O)O)CC(C=O)=O)=O,4,1,0,1,45,4.8e-05
G5,C(C(C(CO)(C)CC(C=O)=O)O)=O,4,2,0,2,26,9.6e-05
G5,C(CC(C=O)(C)C(C=O)O)(CO)=O,4,1,0,1,16,4.8e-05
G5,C(CC(C=O)(C)C(C=O)O)=O,4,1,0,1,28,4.8e-05
G5,C(C(C(C)C(C=O)C(CO)=O)O)=O,8,1,0,1,45,4.8e-05
G5,C(CC(CO)(C(C=O)O)CC=O)=O,2,2,0,2,29,9.7e-05
G5,C(CC(C)(C(C=O)O)C(C=O)O)=O,3,1,0,1,6,4.8e-05
G5,C(C(CO)O)(CC(C)C(C=O)O)=O,8,1,0,1,28,4.8e-05
G5,C(CC(C)(C(CO)O)C(C=O)O)=O,8,2,0,2,46,9.6e-05
G5,C(C(C(C)C(C(C=O)=O)CO)O)=O,8,1,0,1,27,4.8e-05
G5,C(CC(C=O)(CCO)C(C=O)O)=O,4,2,0,2,43,9.6e-05
G5,C(C(C(C)C(C(CO)=O)CO)O)=O,8,1,0,1,27,4.8e-05
G5,C(CC(CO)(CCO)C(C=O)O)=O,4,2,0,2,29,9.6e-05
G5,C(C(C(CO)(C)CC(CO)=O)O)=O,4,2,0,2,0,9.6e-05
G5,C(CC(CO)(C)C(C=O)O)=O,4,2,0,2,6,9.6e-05
G5,C(C(C(C)C(C=O)C(C=O)O)O)=O,16,1,0,1,45,4.8e-05
G5,C(CCC(C=O)O)(O)=O,2,1,0,1,18,4.8e-05
G5,C(CC(CO)C(C=O)O)(O)=O,4,1,0,1,18,4.8e-05
G5,C(C(CCC=O)(C(CO)O)O)=O,4,1,0,1,0,4.8e-05
G5,C(CCC(C(C(C=O)O)O)O)=O,8,1,0,1,0,4.8e-05
G5,C(C(C(CO)O)(C(C)CC=O)O)=O,8,1,0,1,0,4.8e-05
G5,C(CC(C)C(C(C(C=O)O)O)O)=O,16,1,0,1,0,4.8e-05
G5,C(C(CCC(O)=O)(C(CO)O)O)=O,4,1,0,1,0,4.8e-05
G5,C(CCC(CO)(C(C=O)O)O)(O)=O,4,1,0,1,0,4.8e-05
G5,C(CCC(C(C(C=O)O)O)O)(O)=O,8,1,0,1,0,4.8e-05
G5,C1(CC(CO1)C(C(CO)=O)O)=O,4,1,0,1,5,4.8e-05
G5,C(CO)(C(C(C)CC(C=O)=O)O)=O,4,1,0,1,5,4.8e-05
G5,C(CC(C(C)=O)C(C(CO)=O)O)=O,4,1,0,1,5,4.8e-05
G5,C(C(CC(C)=O)C(C(CO)=O)O)=O,4,1,0,1,5,4.8e-05
G5,C(CC(C=O)(C)C(C(CO)=O)O)=O,4,1,0,1,5,4.8e-05
G5,C(CO)(CC(C)C(C(CO)=O)O)=O,4,1,0,1,5,4.8e-05
G5,C(CC(CO)(C)C(C(CO)=O)O)=O,4,1,0,1,28,4.8e-05
G5,C(CC(C)C(C(CO)=O)O)=O,4,1,0,1,5,4.8e-05
G5,C(C(CO)(C1COC(C1)=O)O)=O,4,1,0,1,41,4.8e-05
G5,C(C(CO)(C(C)CC(C=O)=O)O)=O,4,1,0,1,41,4.8e-05
G5,C(CC(C(C)=O)C(C=O)(CO)O)=O,4,1,0,1,41,4.8e-05
G5,C(CC(C=O)C(C=O)(CO)O)(C)=O,4,1,0,1,41,4.8e-05
G5,C(C(C(C(C=O)CC(C)=O)O)O)=O,8,1,0,1,41,4.8e-05
G5,C(C(CO)(C(C=O)(C)CC=O)O)=O,4,1,0,1,41,4.8e-05
G5,C(C(C)(C(C(C=O)O)O)CC=O)=O,8,1,0,1,41,4.8e-05
G5,C(C(CO)(CCC=O)O)=O,2,1,0,1,41,4.8e-05
G5,C(C(CO)(C(C)CC(CO)=O)O)=O,4,1,0,1,41,4.8e-05
G5,C(C(CO)(C(CO)(C)CC=O)O)=O,4,1,0,1,28,4.8e-05
G5,C(CC(CO)(C)C(C(C=O)O)O)=O,8,2,0,2,28,9.6e-05
G5,C(C(CO)(C(C)CC=O)O)=O,4,1,0,1,41,4.8e-05
G5,C(C(CO)(CCC(O)=O)O)=O,2,1,0,1,18,4.8e-05
G5,C(C(CO)(C(CO)CC(O)=O)O)=O,4,1,0,1,18,4.8e-05
G5,C(C(CO)(C(CC=O)CC=O)O)=O,2,1,0,1,41,4.8e-05
G5,C(C(CC(CO)CC(C=O)=O)=O)=O,1,1,0,1,55,4.8e-05
G5,C1(CC(CO1)CC(C=O)=O)=O,2,1,0,1,28,4.8e-05
G5,C1(CC(CC(C1O)=O)CC(C=O)=O)=O,1,1,0,1,32,4.8e-05
G5,C1(CC(C(C(C1)=O)O)CC(C=O)=O)=O,4,1,0,1,45,4.8e-05
G5,C1(CC(C(C1CO)=O)CC(C=O)=O)=O,4,1,0,1,45,4.8e-05
G5,C1(C(CO)C(C(C1)=O)CC(C=O)=O)=O,4,1,0,1,45,4.8e-05
G5,C1(C(CO)(CC(C1)=O)CC(C=O)=O)=O,2,1,0,1,45,4.8e-05
G5,C1(C(CC(CC(C=O)=O)C1CO)=O)=O,4,2,0,2,45,9.6e-05
G5,C(C1(C(CC(C1)=O)O)CC(C=O)=O)=O,4,1,0,1,45,4.8e-05
G5,C(C1C(CC(C1CC(C=O)=O)O)=O)=O,8,1,0,1,45,4.8e-05
G5,C(C)(C1C(CC(O1)=O)CC(C=O)=O)=O,4,1,0,1,48,4.8e-05
G5,C(CC1C(CC(O1)=O)CC(C=O)=O)=O,4,1,0,1,48,4.8e-05
G5,C1(CC(C(OCC1)=O)CC(C=O)=O)=O,2,1,0,1,19,4.8e-05
G5,C1(C(CC(OCC1)=O)CC(C=O)=O)=O,2,1,0,1,19,4.8e-05
G5,C1(COC(CC(C1)CC(C=O)=O)=O)=O,2,2,0,2,45,9.6e-05
G5,C1(CC(COC(C1)=O)CC(C=O)=O)=O,2,1,0,1,19,4.8e-05
G5,C(C=O)(CC1COCC(C(C1)=O)=O)=O,2,1,0,1,36,4.8e-05
G5,C1(COCC(CC1CC(C=O)=O)=O)=O,2,1,0,1,45,4.8e-05
G5,C(C1(CC(C(C1)=O)O)CC(C=O)=O)=O,4,1,0,1,45,4.8e-05
G5,C(C1CC(C(C1CC(C=O)=O)=O)O)=O,8,1,0,1,45,4.8e-05
G5,C(C1C(C(CC1CC(C=O)=O)O)=O)=O,8,1,0,1,27,4.8e-05
G5,C(CC(CO)(CO)CC(C=O)=O)=O,1,4,0,4,55,0.000192
G5,C(C(C)C(C(C=O)=O)CC(C=O)=O)=O,4,1,0,1,45,4.8e-05
G5,C(C(C)(CC(C=O)=O)CC(C=O)=O)=O,1,1,0,1,45,4.8e-05
G5,C(CC(C(C=O)=O)CC(C=O)=O)=O,2,1,0,1,20,4.8e-05
G5,C(C(CC(C=O)=O)CC(C=O)=O)=O,1,1,0,1,20,4.8e-05
G5,C(C(CC(C)CC(C=O)=O)=O)=O,1,1,0,1,28,4.8e-05
G5,C(C(C)(CC=O)CC(C=O)=O)=O,2,2,0,2,45,9.7e-05
G5,C(C(C)C(C=O)CC(C=O)=O)=O,4,1,0,1,28,4.8e-05
G5,C(C(CO)(CC=O)CC(C=O)=O)=O,2,1,0,1,18,4.8e-05
G5,C(CO)(CC(C)CC(C=O)=O)=O,2,2,0,2,28,9.6e-05
G5,C(CC(C)(CO)CC(C=O)=O)=O,2,2,0,2,49,9.7e-05
G5,C(CC(C)CC(C=O)=O)=O,2,2,0,2,28,9.7e-05
G5,C1(CC(C(C1O)=O)CC(C=O)=O)=O,4,1,0,1,47,4.8e-05
G5,C1(CC(CO1)C(C=O)C(CO)=O)=O,4,1,0,1,49,4.8e-05
G5,C1(CC(CO1)C(C(CC=O)=O)O)=O,4,1,0,1,49,4.8e-05
G5,C(CCC(C=O)C(CO)=O)=O,2,2,0,2,9,9.7e-05
G5,C(CCC(C(CC=O)=O)O)=O,2,1,0,1,49,4.8e-05
G5,C(CC(C)C(C=O)C(CO)=O)=O,4,2,0,2,45,9.7e-05
G5,C(CC(C)C(C(CC=O)=O)O)=O,4,1,0,1,49,4.8e-05
G5,C(CCC(C=O)C(CO)=O)(O)=O,2,2,0,2,18,9.499999999999999e-05
G5,C(CCC(C(CC=O)=O)O)(O)=O,2,1,0,1,18,4.8e-05
G5,C1(CC(CO1)C(C=O)(C(C)=O)O)=O,4,1,0,1,1,4.8e-05
G5,C(C(C(CC1COC(C1)=O)=O)O)=O,4,1,0,1,1,4.8e-05
G5,C(CCC(C=O)(C(C)=O)O)=O,2,1,0,1,1,4.8e-05
G5,C(C(C(CCCC=O)=O)O)=O,2,2,0,2,0,9.7e-05
G5,C(CC(C)C(C=O)(C(C)=O)O)=O,4,1,0,1,1,4.8e-05
G5,C(C(C(CC(C)CC=O)=O)O)=O,4,2,0,2,28,9.7e-05
G5,C(CCC(C=O)(C(C)=O)O)(O)=O,2,1,0,1,1,4.8e-05
G5,C(C(C(CCCC(O)=O)=O)O)=O,2,2,0,2,18,9.499999999999999e-05
G5,C1(CC(CO1)CC(C(CO)O)=O)=O,4,1,0,1,28,4.8e-05
G5,C1(CC(CO1)C(C(C)=O)(CO)O)=O,4,1,0,1,28,4.8e-05
G5,C1(CC(C(C(C(C)=O)O)O)CO1)=O,8,1,0,1,28,4.8e-05
G5,C(CCC(C(C)=O)(CO)O)=O,2,1,0,1,28,4.8e-05
G5,C(CC(C)CC(C(CO)O)=O)=O,4,2,0,2,28,9.7e-05
G5,C(CC(C)C(C(C)=O)(CO)O)=O,4,1,0,1,28,4.8e-05
G5,C(CCC(C(C)=O)(CO)O)(O)=O,2,1,0,1,18,4.8e-05
G5,C(CCC(C(C(C)=O)O)O)(O)=O,4,1,0,1,18,4.8e-05
G5,C1(CC(CO1)C(C(C=O)=O)CO)=O,4,1,0,1,3,4.8e-05
G5,C1(CC(CO1)C(CC(C=O)=O)O)=O,4,1,0,1,3,4.8e-05
G5,C(CC(C)C(C(C=O)=O)CO)=O,4,2,0,2,27,9.7e-05
G5,C(CCC(CC(C=O)=O)O)(O)=O,2,1,0,1,3,4.8e-05
G5,C1(CC(CO1)C(C(CCO)=O)O)=O,4,1,0,1,3,4.8e-05
G5,C1(CC(CO1)C(C(CO)=O)CO)=O,4,1,0,1,3,4.8e-05
G5,C1(CC(C(CC(CO)=O)O)CO1)=O,4,1,0,1,3,4.8e-05
G5,C(CCC(C(CCO)=O)O)=O,2,1,0,1,3,4.8e-05
G5,C(CC(C)C(C(CCO)=O)O)=O,4,1,0,1,3,4.8e-05
G5,C(CC(C)C(C(CO)=O)CO)=O,4,2,0,2,27,9.7e-05
G5,C(CCC(C(CCO)=O)O)(O)=O,2,1,0,1,3,4.8e-05
G5,C(CCC(CC(CO)=O)O)(O)=O,2,1,0,1,3,4.8e-05
G5,C(C(C=O)(C1COC(C1)=O)O)=O,2,1,0,1,1,4.8e-05
G5,C(C(C=O)(C(C)CC(C=O)=O)O)=O,2,1,0,1,1,4.8e-05
G5,C(C(C=O)(C(C(C)=O)CC=O)O)=O,2,1,0,1,1,4.8e-05
G5,C(C(C=O)(C(C=O)CC(C)=O)O)=O,2,1,0,1,1,4.8e-05
G5,C(C(CC(C=O)(C=O)O)CC=O)=O,2,1,0,1,1,4.8e-05
G5,C(C(C)(CC=O)C(C=O)(C=O)O)=O,2,1,0,1,1,4.8e-05
G5,C(C(C=O)(CCC=O)O)=O,1,1,0,1,1,4.8e-05
G5,C(C(C=O)(C(C)CC(CO)=O)O)=O,2,1,0,1,1,4.8e-05
G5,C(C(C=O)(C(CO)(C)CC=O)O)=O,2,1,0,1,28,4.8e-05
G5,C(C(C=O)(C(C)CC=O)O)=O,2,1,0,1,1,4.8e-05
G5,C(C(C=O)(CCC(O)=O)O)=O,1,1,0,1,18,4.8e-05
G5,C(C(C=O)(C(CO)CC(O)=O)O)=O,2,1,0,1,18,4.8e-05
G5,C(C(C=O)(C(CC=O)CC=O)O)=O,1,1,0,1,1,4.8e-05
G5,C(C)(C(C(CO)CC(C=O)=O)O)=O,4,2,0,2,49,9.6e-05
G5,C(C)(C(CCC(C(CO)=O)=O)O)=O,2,1,0,1,7,4.8e-05
G5,C1(CC(CO1)CC(CO)=O)=O,2,1,0,1,28,4.8e-05
G5,C1(CC(CO1)C(C(C)=O)O)=O,4,1,0,1,28,4.8e-05
G5,C(CC(CO)(CO)CC(CO)=O)=O,1,4,0,4,55,0.000192
G5,C(CC(CO)(CO)C(C(C)=O)O)=O,2,2,0,2,49,9.6e-05
G5,C(CC(C(CO)O)C(C(C)=O)O)=O,8,2,0,2,45,9.6e-05
G5,C(CC(C(C=O)=O)CC(CO)=O)=O,2,2,0,2,12,9.7e-05
G5,C(C)(C(C(C)CC(C=O)=O)O)=O,4,1,0,1,28,4.8e-05
G5,C(CC(C(C)=O)C(C(C)=O)O)=O,4,1,0,1,28,4.8e-05
G5,C(C(CC(C)=O)CC(CO)=O)=O,2,2,0,2,11,9.6e-05
G5,C(C(C)(CC(CO)=O)CC=O)=O,2,2,0,2,16,9.7e-05
G5,C(CC(C=O)(C)C(C(C)=O)O)=O,4,1,0,1,28,4.8e-05
G5,C(CC(C=O)C(C=O)C)(CO)=O,4,1,0,1,28,4.8e-05
G5,C(C)(C(CC(C=O)C(CO)=O)O)=O,4,1,0,1,9,4.8e-05
G5,C(CCC(C(C)=O)O)(C(C=O)O)=O,4,1,0,1,0,4.8e-05
G5,C(C(CO)(CC(CO)=O)CC=O)=O,2,2,0,2,46,9.7e-05
G5,C(CCC(C(C)=O)O)=O,2,1,0,1,49,4.8e-05
G5,C(CO)(CC(C)CC(CO)=O)=O,1,1,0,1,28,4.8e-05
G5,C(C)(C(C(C)CC(CO)=O)O)=O,4,1,0,1,28,4.8e-05
G5,C(CC(CO)(C)CC(CO)=O)=O,2,2,0,2,49,9.7e-05
G5,C(CC(CO)(C)C(C(C)=O)O)=O,4,1,0,1,28,4.8e-05
G5,C(CC(C)CC(CO)=O)=O,2,2,0,2,28,9.7e-05
G5,C(CC(C)C(C(C)=O)O)=O,4,1,0,1,45,4.8e-05
G5,C(CCC(C(C)=O)O)(O)=O,2,1,0,1,18,4.8e-05
G5,C1(CC(C(C1O)=O)CC(CO)=O)=O,4,1,0,1,47,4.8e-05
G5,C1(CC(CO1)C(C=O)(CC=O)O)=O,4,1,0,1,43,4.8e-05
G5,C1(CC(CO1)C(C=O)C(C=O)O)=O,8,1,0,1,43,4.8e-05
G5,C(CCC(C=O)C(C=O)O)=O,4,2,0,2,16,9.7e-05
G5,C(CC(C)C(C=O)C(C=O)O)=O,8,2,0,2,45,9.7e-05
G5,C(CCC(C=O)(CC=O)O)(O)=O,2,1,0,1,43,4.8e-05
G5,C(CCC(C=O)C(C=O)O)(O)=O,4,2,0,2,18,9.499999999999999e-05
G5,C(CCC(C=O)(C(C=O)O)O)(O)=O,4,1,0,1,0,4.8e-05
G5,C(CC(C(C(C=O)=O)O)CC=O)=O,2,2,0,2,43,9.7e-05
G5,C(CCCC(C(CO)=O)=O)=O,1,2,0,2,7,9.7e-05
G5,C(CO)(C(CO)(CC=O)CC=O)=O,1,1,0,1,2,4.9e-05
G5,C(CC(C(OCC=O)O)CC=O)=O,2,1,0,1,37,4.9e-05
G5,C1(C(CO)(CC=O)CC(C1)=O)=O,2,1,0,1,45,4.9e-05
G5,C(CC(C(C(C)=O)O)CC=O)(O)=O,4,2,0,2,45,9.6e-05
G5,C(CC1(CO)C(C(C(C1)=O)O)O)=O,8,1,0,1,46,4.9e-05
G5,C(CC1C(C(CC1C=O)O)=O)=O,8,1,0,1,45,4.9e-05
G5,C(CCC(C=O)C(C(CO)=O)O)=O,4,2,0,2,2,9.6e-05
G5,C(CC(CO)(CO)CC=O)=O,1,2,0,2,46,9.7e-05
G5,C(CC(C(CO)O)CC=O)=O,2,2,0,2,46,9.6e-05
G5,C(CC(C(C=O)=O)C(C=O)C)=O,4,1,0,1,45,4.9e-05
G5,C(CC(C(C=O)=O)CC=O)=O,1,1,0,1,20,4.9e-05
G5,C(CC(C(CO)=O)C(C=O)C)=O,4,1,0,1,4,4.9e-05
G5,C(CCC(C=O)C(C(C)=O)O)=O,4,2,0,2,45,9.7e-05
G5,C(CC(C(C)=O)CC=O)=O,1,1,0,1,28,4.9e-05
G5,C(CC(C=O)CC(C)=O)=O,2,2,0,2,43,9.7e-05
G5,C(C(C)(CC=O)CC=O)=O,1,1,0,1,28,4.9e-05
G5,C(CC(C=O)C(C=O)C)=O,4,1,0,1,28,4.9e-05
G5,C(C(C(CO)=O)(CC=O)CC=O)=O,1,1,0,1,55,4.9e-05
G5,C(CC(CO)(CC=O)CC=O)=O,1,1,0,1,46,4.9e-05
G5,C(C(C(C(CC=O)CC=O)=O)O)=O,2,1,0,1,46,4.9e-05
G5,C(CC(C)(C(C=O)O)CC=O)=O,2,1,0,1,6,4.9e-05
G5,C(CC(C(C=O)=O)(CO)CC=O)=O,1,1,0,1,55,4.9e-05
G5,C(CC(C=O)(CC=O)C(C=O)O)=O,2,1,0,1,43,4.9e-05
G5,C(CC(C)(C(CO)O)CC=O)=O,2,1,0,1,46,4.9e-05
G5,C(C(CO)(CC=O)CC=O)=O,1,1,0,1,18,4.9e-05
G5,C(CCCC=O)=O,1,1,0,1,27,4.9e-05
G5,C(C(CCO)(CC=O)CC=O)=O,1,1,0,1,46,4.9e-05
G5,C(CC(C=O)C(C=O)CCO)=O,4,1,0,1,46,4.9e-05
G5,C(CC(CO)(CCO)CC=O)=O,1,2,0,2,46,9.6e-05
G5,C(CC(C)(CO)CC=O)=O,1,1,0,1,28,4.9e-05
G5,C(C(C(C)O)(CC=O)CC=O)=O,2,1,0,1,28,4.9e-05
G5,C(CC(CC(C=O)O)CC=O)=O,2,2,0,2,27,9.7e-05
G5,C(CC(C)CC=O)=O,1,1,0,1,45,4.9e-05
G5,C(CC(CO)(C(CO)O)CC=O)=O,2,2,0,2,46,9.6e-05
G5,C(C(C(CO)O)(CC=O)CC=O)=O,2,1,0,1,46,4.9e-05
G5,C(CCCC(O)=O)=O,1,2,0,2,18,9.6e-05
G5,C(C(CCO)C(C=O)CC=O)(O)=O,4,1,0,1,46,4.9e-05
G5,C(C(CCO)(CC=O)CC=O)(O)=O,1,1,0,1,46,4.9e-05
G5,C(C(C(CO)CC=O)CC=O)(O)=O,4,1,0,1,7,4.9e-05
G5,C(C(C)C(C(C=O)O)CC=O)(O)=O,8,1,0,1,14,4.9e-05
G5,C(C(CCC=O)CC(C=O)O)(O)=O,4,1,0,1,14,4.9e-05
G5,C(CCC(C=O)C(C=O)(CO)O)=O,4,2,0,2,16,9.6e-05
G5,C(CCC(C=O)C(C(O)=O)O)=O,4,2,0,2,33,9.6e-05
G5,C(CC1C(CO)OC(C(C1)=O)=O)=O,4,1,0,1,50,4.9e-05
G5,C1(CC(C(OC1CO)=O)CC=O)=O,4,1,0,1,2,4.9e-05
G5,C1(CC(C(C(CO)O1)=O)CC=O)=O,4,1,0,1,2,4.9e-05
G5,C(CC1C(COC(C(C1)=O)=O)O)=O,4,1,0,1,27,4.9e-05
G5,C1(C(C(CC(CO1)CC=O)=O)O)=O,4,1,0,1,2,4.9e-05
G5,C1(CC(C(OCC1O)=O)CC=O)=O,4,1,0,1,46,4.9e-05
G5,C1(CC(C(C(CO1)O)=O)CC=O)=O,4,1,0,1,46,4.9e-05
G5,C1(C(C(CC=O)CC(CO1)=O)O)=O,4,1,0,1,27,4.9e-05
G5,C1(CC(C(C(C=O)O)O1)CC=O)=O,8,1,0,1,8,4.9e-05
G5,C1(CC(C(C(C=O)O1)O)CC=O)=O,8,1,0,1,8,4.9e-05
G5,C(C(C(CCCC=O)=O)(CO)O)=O,2,2,0,2,2,9.6e-05
G5,C(C(C(CCCC=O)=O)OCO)=O,2,1,0,1,37,4.9e-05
G5,C(CC(CC=O)CC=O)=O,1,1,0,1,28,4.9e-05
G5,C(CC(C)C(C(C(CO)O)=O)O)=O,8,1,0,1,2,4.8e-05
G5,C(CC(C)C(C(CO)=O)(CO)O)=O,4,1,0,1,2,4.8e-05
G5,C(CCC(C(C(CO)O)=O)O)(O)=O,4,1,0,1,2,4.8e-05
G5,C(CCC(C(CO)=O)(CO)O)(O)=O,2,1,0,1,2,4.8e-05
G5,C(CCC(C(C(CO)=O)O)O)(O)=O,4,1,0,1,2,4.8e-05
G5,C(C(C(C)O)=O)(CCC(CO)O)=O,4,1,0,1,7,4.8e-05
G5,C1(CC(CO1)C(CO)O)=O,4,1,0,1,46,4.8e-05
G5,C1(CC(C(CO)O)CC(C1O)=O)=O,2,1,0,1,32,4.8e-05
G5,C1(CC(C(CO)O)C(C(C1)=O)O)=O,8,1,0,1,46,4.8e-05
G5,C(CCC(CO)O)(C(C(C)=O)O)=O,4,1,0,1,46,4.8e-05
G5,C1(C(C(CO)O)CC(C1CO)=O)=O,8,1,0,1,45,4.8e-05
G5,C1(C(C(CO)O)C(C(C1)=O)CO)=O,8,1,0,1,45,4.8e-05
G5,C1(C(CO)(C(CO)O)CC(C1)=O)=O,4,1,0,1,46,4.8e-05
G5,C1(C(CC(C(CO)O)C1CO)=O)=O,8,2,0,2,46,9.499999999999999e-05
G5,C1(CC(C(C1CC(CO)O)=O)O)=O,8,1,0,1,46,4.8e-05
G5,C(C1C(C(CO)O)C(C(C1)=O)O)=O,16,1,0,1,45,4.8e-05
G5,C(C1C(CC(C1C(CO)O)O)=O)=O,16,1,0,1,46,4.8e-05
G5,C(CC(C=O)O)(CCC(CO)O)=O,4,1,0,1,46,4.8e-05
G5,C1(CC(C(CO)O)C(C(C)=O)O1)=O,8,1,0,1,48,4.8e-05
G5,C1(CC(C(CC=O)O1)C(CO)O)=O,8,1,0,1,46,4.8e-05
G5,C1(C(C(CO)O)CC(CCO1)=O)=O,4,1,0,1,19,4.8e-05
G5,C1(C(C(CO)O)CC(OCC1)=O)=O,4,1,0,1,46,4.8e-05
G5,C1(CC(C(CO)O)CC(CO1)=O)=O,4,2,0,2,46,9.499999999999999e-05
G5,C1(CC(CC(CO1)C(CO)O)=O)=O,4,1,0,1,46,4.8e-05
G5,C1(C(COCC(C(CO)O)C1)=O)=O,4,1,0,1,46,4.8e-05
G5,C1(COCC(CC1C(CO)O)=O)=O,4,1,0,1,45,4.8e-05
G5,C(C1(CC(C(C1)=O)O)C(CO)O)=O,8,1,0,1,45,4.8e-05
G5,C1(C(C(CO)O)C(C=O)CC1O)=O,16,1,0,1,45,4.8e-05
G5,C(CC(CO)(CO)C(CO)O)=O,2,2,0,2,46,9.499999999999999e-05
G5,C(CC(C(CO)O)C(CO)O)=O,3,1,0,1,46,4.8e-05
G5,C(C(C)(C(CO)O)CC(C=O)=O)=O,4,1,0,1,45,4.8e-05
G5,C(C(CC(C)(CO)C(CO)O)=O)=O,4,2,0,2,29,9.499999999999999e-05
G5,C(C(C)(C(CO)O)CC(CO)=O)=O,4,1,0,1,16,4.8e-05
G5,C(C(CC(CO)O)C(C(C)=O)O)=O,8,1,0,1,45,4.8e-05
G5,C(C(CC(C)C(CO)O)=O)=O,4,1,0,1,46,4.8e-05
G5,C(C)(C(C(CO)O)CC=O)=O,4,1,0,1,46,4.8e-05
G5,C(C(C)(C(CO)O)CC=O)=O,4,1,0,1,46,4.8e-05
G5,C(C(C(CO)=O)C(C)C(CO)O)=O,8,1,0,1,45,4.8e-05
G5,C(C(C(CCC(CO)O)=O)O)=O,4,1,0,1,0,4.8e-05
G5,C(C(C(CC(C)C(CO)O)=O)O)=O,8,1,0,1,28,4.8e-05
G5,C(C(CO)O)(CC(C)C(CO)O)=O,8,1,0,1,28,4.8e-05
G5,C(CC(C)(C(CO)O)C(CO)O)=O,3,1,0,1,46,4.8e-05
G5,C(C(C(CO)C(C)C(CO)O)=O)=O,8,1,0,1,27,4.8e-05
G5,C(C(CCO)(C(CO)O)CC=O)=O,4,2,0,2,46,9.499999999999999e-05
G5,C(CO)(C(CO)C(C)C(CO)O)=O,8,1,0,1,27,4.8e-05
G5,C(CC(CO)(CCO)C(CO)O)=O,4,2,0,2,46,9.499999999999999e-05
G5,C(CO)(CC(CO)(C)C(CO)O)=O,4,2,0,2,52,9.499999999999999e-05
G5,C(CO)(CC(C)C(CO)O)=O,4,1,0,1,46,4.8e-05
G5,C(CC(C)(CO)C(CO)O)=O,4,2,0,2,46,9.499999999999999e-05
G5,C(C(C(C)C(CO)O)C(C=O)O)=O,16,1,0,1,45,4.8e-05
G5,C(CC(C)C(CO)O)=O,4,1,0,1,46,4.8e-05
G5,C(CCC(CO)O)(O)=O,2,1,0,1,46,4.8e-05
G5,C(CC(CO)C(CO)O)(O)=O,4,1,0,1,18,4.8e-05
G5,C(CCC(C(C(CO)O)O)O)=O,8,1,0,1,6,4.8e-05
G5,C(CCC(CO)(C(CO)O)O)=O,4,1,0,1,6,4.8e-05
G5,C(CC(C)C(C(C(CO)O)O)O)=O,16,1,0,1,6,4.8e-05
G5,C(CC(C)C(CO)(C(CO)O)O)=O,8,1,0,1,6,4.8e-05
G5,C(CCC(C(C(CO)O)O)O)(O)=O,8,1,0,1,6,4.8e-05
G5,C(CCC(CO)(C(CO)O)O)(O)=O,4,1,0,1,6,4.8e-05
G5,C1(CC(CO1)C(C(O)=O)O)=O,4,1,0,1,33,4.8e-05
G5,C(CC(CO)(CO)C(C(O)=O)O)=O,2,2,0,2,18,9.6e-05
G5,C(CC(C(CO)O)C(C(O)=O)O)=O,8,1,0,1,46,4.8e-05
G5,C(C(C(C(C)=O)CC=O)O)(O)=O,4,1,0,1,33,4.8e-05
G5,C(CC(C=O)(C)C(C(O)=O)O)=O,4,1,0,1,33,4.8e-05
G5,C(CC(CO)(C)C(C(O)=O)O)=O,4,1,0,1,33,4.8e-05
G5,C(CCC(C(O)=O)O)(O)=O,2,1,0,1,33,4.8e-05
G5,C(CC(CO)C(C(O)=O)O)(O)=O,4,1,0,1,18,4.8e-05
G5,C(CC(C(C(O)=O)O)CC=O)=O,2,1,0,1,33,4.8e-05
G5,C(CCC(C(C(C(O)=O)O)O)O)=O,8,1,0,1,0,4.8e-05
G5,C(CCC1(C(C(CO1)O)O)O)=O,8,1,0,1,18,4.8e-05
G5,C(CCC1(C(O)OCC1O)O)=O,8,1,0,1,18,4.8e-05
G5,C(CCC1(COC(C1O)O)O)=O,8,1,0,1,18,4.8e-05
G5,C(CCC1C(C(C(O)O1)O)O)=O,16,1,0,1,18,4.8e-05
G5,C(CC(C)C1(C(C(CO1)O)O)O)=O,16,1,0,1,18,4.8e-05
G5,C(CC(C)C1(C(O)OCC1O)O)=O,16,1,0,1,18,4.8e-05
G5,C(CC(C)C1(COC(C1O)O)O)=O,16,1,0,1,18,4.8e-05
G5,C(CC(C)C1C(C(C(O)O1)O)O)=O,32,1,0,1,18,4.8e-05
G5,C(CCC1(C(C(CO1)O)O)O)(O)=O,8,1,0,1,18,4.8e-05
G5,C(CCC1(C(O)OCC1O)O)(O)=O,8,1,0,1,18,4.8e-05
G5,C(CCC1(COC(C1O)O)O)(O)=O,8,1,0,1,18,4.8e-05
G5,C(CCC1C(C(C(O)O1)O)O)(O)=O,16,1,0,1,18,4.8e-05
G5,C(CCC1(C(CC(C1O)=O)O)O)=O,8,1,0,1,4,4.8e-05
G5,C(CCC1(C(C(C(C1)=O)O)O)O)=O,8,1,0,1,4,4.8e-05
G5,C1(CC(C(C1(CCC=O)O)O)O)=O,8,1,0,1,4,4.8e-05
G5,C(CCCC(C(C(CO)=O)O)O)=O,4,1,0,1,2,4.8e-05
G5,C(CCC(C)(C(C(CO)=O)O)O)=O,4,1,0,1,2,4.8e-05
G5,C(C(CCC=O)C(CO)(CO)O)=O,2,1,0,1,5,4.8e-05
G5,C(CC(C(CCC=O)(CO)O)O)=O,4,1,0,1,41,4.8e-05
G5,C(C(CCC=O)C(C(CO)O)O)=O,8,1,0,1,41,4.8e-05
G5,C(CCCC(CC(C=O)=O)O)=O,2,1,0,1,4,4.8e-05
G5,C(CCC(C)(CC(C=O)=O)O)=O,2,1,0,1,4,4.8e-05
G5,C(CC(C)C(C(C=O)=O)C(C)O)=O,8,1,0,1,4,4.8e-05
G5,C(CC(C)CC(CC(C=O)=O)O)=O,4,1,0,1,4,4.8e-05
G5,C(CC(C)C(C)(CC(C=O)=O)O)=O,4,1,0,1,4,4.8e-05
G5,C(CCCC(CC(C=O)=O)O)(O)=O,2,1,0,1,4,4.8e-05
G5,C(CCC(C)(CC(C=O)=O)O)(O)=O,2,1,0,1,4,4.8e-05
G5,C(C)(C(C(C)CC=O)(CC=O)O)=O,4,1,0,1,45,4.8e-05
G5,C(CC(C(CC(C)CC=O)=O)O)=O,4,1,0,1,45,4.8e-05
G5,C(CC(C)C(C=O)C(C(C)=O)O)=O,8,1,0,1,45,4.8e-05
G5,C(C)(C(CCC(O)=O)(CC=O)O)=O,2,1,0,1,45,4.8e-05
G5,C(CCC(C=O)C(C(C)=O)O)(O)=O,4,2,0,2,45,9.499999999999999e-05
G5,C(CCC(C=O)C(C=O)(C)O)=O,4,1,0,1,45,4.8e-05
G5,C(CC(C)CC(C=O)(CC=O)O)=O,4,1,0,1,45,4.8e-05
G5,C(CC(C)C(C=O)C(C=O)(C)O)=O,8,1,0,1,45,4.8e-05
G5,C(CCC(C=O)C(C=O)(C)O)(O)=O,4,1,0,1,45,4.8e-05
G5,C(CCC(C=O)(C(CO)=O)CO)=O,2,1,0,1,2,4.8e-05
G5,C(CCC(C(C(C=O)CO)=O)O)=O,4,1,0,1,2,4.8e-05
G5,C(CCC(C=O)C(C(CO)O)=O)=O,4,1,0,1,2,4.8e-05
G5,C(C(CO)(CCC=O)O)(CC=O)=O,2,1,0,1,2,4.8e-05
G5,C(C(C(CCO)=O)(CCC=O)O)=O,2,1,0,1,27,4.8e-05
G5,C(C(CO)CCC=O)(C(C=O)O)=O,4,1,0,1,27,4.8e-05
G5,C(CCC(C(C(CO)O)=O)CO)=O,4,1,0,1,2,4.8e-05
G5,C(CCO)(C(CO)(CCC=O)O)=O,2,1,0,1,2,4.8e-05
G5,C(CCC(C(C=O)=O)(CO)CO)=O,1,1,0,1,2,4.8e-05
G5,C(CCC(C(C(CO)CO)=O)O)=O,2,1,0,1,2,4.8e-05
G5,C(CCC(C(CO)=O)(CO)CO)=O,1,1,0,1,2,4.8e-05
G5,C(C(CO)(CCC=O)C(C=O)O)=O,4,1,0,1,43,4.8e-05
G5,C(C(CO)CCC(C(CO)=O)=O)=O,2,1,0,1,7,4.8e-05
G5,C1(CC(CO1)C(CC=O)O)=O,4,1,0,1,28,4.8e-05
G5,C(C(CO)C1COC(C1)=O)=O,4,1,0,1,28,4.8e-05
G5,C(CC(C(CO)(CO)CC=O)O)=O,2,1,0,1,18,4.8e-05
G5,C(C(CO)C(CO)(CO)CC=O)=O,2,1,0,1,18,4.8e-05
G5,C(C(CO)C(C(CO)O)CC=O)=O,8,1,0,1,46,4.8e-05
G5,C(CC(C(C=O)=O)C(C=O)CO)=O,4,1,0,1,20,4.8e-05
G5,C(C(CO)C(C)CC(C=O)=O)=O,4,1,0,1,28,4.8e-05
G5,C(CC(C(C)=O)C(C=O)CO)=O,4,1,0,1,28,4.8e-05
G5,C(CC(C(C=O)CC(C)=O)O)=O,4,1,0,1,28,4.8e-05
G5,C(C(CC(C=O)CC=O)CO)=O,4,1,0,1,28,4.8e-05
G5,C(C(C)(C(CC=O)O)CC=O)=O,4,1,0,1,28,4.8e-05
G5,C(C(CO)C(C=O)(C)CC=O)=O,4,1,0,1,28,4.8e-05
G5,C(C(C)C(C=O)C(C=O)CO)=O,8,1,0,1,28,4.8e-05
G5,C(C(CO)CC(C=O)C(CO)=O)=O,4,1,0,1,9,4.8e-05
G5,C(C(CO)CCC(C(C=O)O)=O)=O,4,1,0,1,0,4.8e-05
G5,C(C(CO)CC(C=O)C(C=O)O)=O,8,1,0,1,16,4.8e-05
G5,C(C(CO)C(C=O)(CO)CC=O)=O,4,1,0,1,18,4.8e-05
G5,C(C(CCC=O)CO)=O,2,1,0,1,18,4.8e-05
G5,C(C(CO)C(C)CC(CO)=O)=O,4,1,0,1,28,4.8e-05
G5,C(CC(C(C)(CO)CC=O)O)=O,4,1,0,1,28,4.8e-05
G5,C(C(CO)C(C)(CO)CC=O)=O,4,1,0,1,28,4.8e-05
G5,C(C(CO)C(C)CC=O)=O,4,1,0,1,18,4.8e-05
G5,C(CCC(CC=O)O)(O)=O,2,1,0,1,18,4.8e-05
G5,C(C(CCC(O)=O)CO)=O,2,1,0,1,18,4.8e-05
G5,C(C(CO)C(CO)CC(O)=O)=O,4,1,0,1,18,4.8e-05
G5,C(C(CO)C1C(C(C(C1)=O)O)=O)=O,8,1,0,1,47,4.8e-05
G5,C(C(C(CC=O)CC=O)CO)=O,2,1,0,1,28,4.8e-05
G5,C(C(C(CC=O)O)(CCC=O)O)=O,4,1,0,1,0,4.8e-05
G5,C(CCC(C=O)C(C(C=O)O)O)=O,8,1,0,1,0,4.8e-05
G5,C(CCC(C(CC(C)O)=O)O)=O,4,1,0,1,11,4.8e-05
G5,C(CCCC(CC(CO)=O)O)=O,2,1,0,1,11,4.8e-05
G5,C(CCC(C)(CC(CO)=O)O)=O,2,1,0,1,11,4.8e-05
G5,C(CC(C)C(C(CO)=O)C(C)O)=O,8,1,0,1,11,4.8e-05
G5,C(CC(C)C(C(CC(C)O)=O)O)=O,8,1,0,1,11,4.8e-05
G5,C(CC(C)CC(CC(CO)=O)O)=O,4,1,0,1,11,4.8e-05
G5,C(CC(C)C(C)(CC(CO)=O)O)=O,4,1,0,1,11,4.8e-05
G5,C(CCC(C(CC(C)O)=O)O)(O)=O,4,1,0,1,11,4.8e-05
G5,C(CCCC(CC(CO)=O)O)(O)=O,2,1,0,1,11,4.8e-05
G5,C(CCC(C)(CC(CO)=O)O)(O)=O,2,1,0,1,11,4.8e-05
G5,C(CCC(C(C)=O)(C(C)O)O)=O,4,1,0,1,4,4.8e-05
G5,C(CCCC(C(C(C)=O)O)O)=O,4,1,0,1,4,4.8e-05
G5,C(CCC(C)(C(C(C)=O)O)O)=O,4,1,0,1,4,4.8e-05
G5,C(CC(C)CC(C(C(C)O)O)=O)=O,8,1,0,1,4,4.8e-05
G5,C(CC(C)C(C(C)=O)(C(C)O)O)=O,8,1,0,1,4,4.8e-05
G5,C(CC(C)CC(C(C(C)=O)O)O)=O,8,1,0,1,4,4.8e-05
G5,C(CC(C)C(C)(C(C(C)=O)O)O)=O,8,1,0,1,4,4.8e-05
G5,C(CCC(C(C)=O)(C(C)O)O)(O)=O,4,1,0,1,4,4.8e-05
G5,C(CCCC(C(C(C)=O)O)O)(O)=O,4,1,0,1,4,4.8e-05
G5,C(CCC(C)(C(C(C)=O)O)O)(O)=O,4,1,0,1,4,4.8e-05
G5,C(CC(C)(C(CCC=O)O)O)=O,4,1,0,1,49,4.8e-05
G5,C(C(CCC=O)C(C)(CO)O)=O,4,1,0,1,49,4.8e-05
G5,C(CC(C)CC(CO)(CC=O)O)=O,4,1,0,1,49,4.8e-05
G5,C(CC(C)(C(C(C)CC=O)O)O)=O,8,1,0,1,49,4.8e-05
G5,C(C(C(C)CC=O)C(C)(CO)O)=O,8,1,0,1,49,4.8e-05
G5,C(CCC(C(C)(CC=O)O)O)(O)=O,4,1,0,1,49,4.8e-05
G5,C(C(CCC(O)=O)C(C)(CO)O)=O,4,1,0,1,49,4.8e-05
G5,C(C(C1COC(C1)=O)C(C)O)=O,8,1,0,1,28,4.8e-05
G5,C1(CC(CO1)CC(CC=O)O)=O,4,1,0,1,28,4.8e-05
G5,C1(CC(CO1)C(C)(CC=O)O)=O,4,1,0,1,28,4.8e-05
G5,C(C(C(C)CC(C=O)=O)C(C)O)=O,8,1,0,1,28,4.8e-05
G5,C(CC(CC(C)CC(C=O)=O)O)=O,4,1,0,1,28,4.8e-05
G5,C(CC(C)(C(C)CC(C=O)=O)O)=O,4,1,0,1,28,4.8e-05
G5,C(CC(C(C)=O)C(C=O)C(C)O)=O,8,1,0,1,28,4.8e-05
G5,C(C)(C(CC(CC=O)O)CC=O)=O,4,1,0,1,28,4.8e-05
G5,C(C)(C(C(C)(CC=O)O)CC=O)=O,4,1,0,1,28,4.8e-05
G5,C(CC(CC(C=O)CC(C)=O)O)=O,4,1,0,1,28,4.8e-05
G5,C(CC(C)(C(C=O)CC(C)=O)O)=O,4,1,0,1,28,4.8e-05
G5,C(C(CC(C=O)CC=O)C(C)O)=O,8,1,0,1,28,4.8e-05
G5,C(CC(CCC(C=O)CC=O)O)=O,4,1,0,1,28,4.8e-05
G5,C(CC(C)(CC(C=O)CC=O)O)=O,4,1,0,1,28,4.8e-05
G5,C(C(C(C)O)C(C=O)(C)CC=O)=O,8,1,0,1,28,4.8e-05
G5,C(C(C)(CC(CC=O)O)CC=O)=O,4,1,0,1,28,4.8e-05
G5,C(C(C)(C(C)(CC=O)O)CC=O)=O,4,1,0,1,28,4.8e-05
G5,C(C(C)C(C=O)C(C=O)C(C)O)=O,16,1,0,1,28,4.8e-05
G5,C(CC(CC(C=O)C(C=O)C)O)=O,8,1,0,1,28,4.8e-05
G5,C(C(CCC=O)C(C)O)=O,4,1,0,1,28,4.8e-05
G5,C(CCCC(CC=O)O)=O,2,1,0,1,28,4.8e-05
G5,C(CCC(C)(CC=O)O)=O,2,1,0,1,28,4.8e-05
G5,C(C(C(C)O)C(C)CC(CO)=O)=O,8,1,0,1,28,4.8e-05
G5,C(CC(CC(C)CC(CO)=O)O)=O,4,1,0,1,28,4.8e-05
G5,C(CC(C)(C(C)CC(CO)=O)O)=O,4,1,0,1,28,4.8e-05
G5,C(C(C(C)O)C(C)(CO)CC=O)=O,8,1,0,1,28,4.8e-05
G5,C(CC(CC(C)(CO)CC=O)O)=O,4,1,0,1,28,4.8e-05
G5,C(CC(C)(CO)C(C)(CC=O)O)=O,4,1,0,1,28,4.8e-05
G5,C(C(C(C)CC=O)C(C)O)=O,8,1,0,1,28,4.8e-05
G5,C(CC(C)CC(CC=O)O)=O,4,1,0,1,28,4.8e-05
G5,C(CC(C)(C(C)CC=O)O)=O,4,1,0,1,28,4.8e-05
G5,C(C(CCC(O)=O)C(C)O)=O,4,1,0,1,18,4.8e-05
G5,C(CCCC(CC=O)O)(O)=O,2,1,0,1,18,4.8e-05
G5,C(CCC(C)(CC=O)O)(O)=O,2,1,0,1,18,4.8e-05
G5,C(C(C(CO)CC(O)=O)C(C)O)=O,8,1,0,1,18,4.8e-05
G5,C(CC(CO)CC(CC=O)O)(O)=O,4,1,0,1,18,4.8e-05
G5,C(CC(CO)C(C)(CC=O)O)(O)=O,4,1,0,1,18,4.8e-05
G5,C(C(C(CC=O)CC=O)C(C)O)=O,4,1,0,1,28,4.8e-05
G5,C(CC(CC(CC=O)O)CC=O)=O,2,1,0,1,28,4.8e-05
G5,C(CC(C(C)(CC=O)O)CC=O)=O,2,1,0,1,28,4.8e-05
G5,C(C(CCC=O)(C(CO)(C)O)O)=O,4,1,0,1,49,4.8e-05
G5,C(CCC(C(C)(C(C=O)O)O)O)=O,8,1,0,1,49,4.8e-05
G5,C(CCC(C(CC(CO)=O)O)O)=O,4,1,0,1,0,4.8e-05
G5,C(CCC(C(CC(CO)O)=O)O)=O,4,1,0,1,0,4.8e-05
G5,C(CCC(C(C(C(C)=O)O)O)O)=O,8,1,0,1,0,4.8e-05
G5,C(CCC(C(C)=O)(C(CO)O)O)=O,4,1,0,1,0,4.8e-05
G5,C(C(C(C)O)(C1COC(C1)=O)O)=O,8,1,0,1,28,4.8e-05
G5,C1(CC(CO1)CC(C(C=O)O)O)=O,8,1,0,1,28,4.8e-05
G5,C1(CC(CO1)C(C)(C(C=O)O)O)=O,8,1,0,1,28,4.8e-05
G5,C(C(CCC=O)(C(C)O)O)=O,4,1,0,1,28,4.8e-05
G5,C(CCCC(C(C=O)O)O)=O,4,1,0,1,28,4.8e-05
G5,C(CCC(C)(C(C=O)O)O)=O,4,1,0,1,28,4.8e-05
G5,C(C(C(C)O)(C(C)CC=O)O)=O,8,1,0,1,28,4.8e-05
G5,C(CC(C)CC(C(C=O)O)O)=O,8,1,0,1,28,4.8e-05
G5,C(CC(C)C(C)(C(C=O)O)O)=O,8,1,0,1,28,4.8e-05
G5,C(C(CCC(O)=O)(C(C)O)O)=O,4,1,0,1,18,4.8e-05
G5,C(CCCC(C(C=O)O)O)(O)=O,4,1,0,1,18,4.8e-05
G5,C(CCC(C)(C(C=O)O)O)(O)=O,4,1,0,1,18,4.8e-05
G5,C1(CC(CO1)C(CO)(CC=O)O)=O,4,1,0,1,6,4.8e-05
G5,C1(CC(CO1)C(C(CC=O)O)O)=O,8,1,0,1,6,4.8e-05
G5,C(C(C1COC(C1)=O)C(CO)O)=O,8,1,0,1,6,4.8e-05
G5,C(CCC(C(CC=O)O)O)=O,4,1,0,1,6,4.8e-05
G5,C(C(CCC=O)C(CO)O)=O,4,1,0,1,6,4.8e-05
G5,C(CC(C(C(C)CC=O)O)O)=O,8,1,0,1,6,4.8e-05
G5,C(C(C(C)CC=O)C(CO)O)=O,8,1,0,1,6,4.8e-05
G5,C(CCC(CO)(CC=O)O)(O)=O,2,1,0,1,6,4.8e-05
G5,C(CCC(C(CC=O)O)O)(O)=O,4,1,0,1,6,4.8e-05
G5,C(C(CCC(O)=O)C(CO)O)=O,4,1,0,1,6,4.8e-05
G5,C(C(C)(C1COC(C1)=O)O)(O)=O,4,1,0,1,25,4.8e-05
G5,C1(CC(CO1)CC(C(O)=O)O)=O,4,1,0,1,25,4.8e-05
G5,C(C(C)(C(C)CC(C=O)=O)O)(O)=O,4,1,0,1,25,4.8e-05
G5,C(C(CC(C)CC(C=O)=O)O)(O)=O,4,1,0,1,25,4.8e-05
G5,C(C(C)(C(C(C)=O)CC=O)O)(O)=O,4,1,0,1,25,4.8e-05
G5,C(CC(C=O)C(C(O)=O)(C)O)(C)=O,4,1,0,1,25,4.8e-05
G5,C(C(CC(C=O)CC(C)=O)O)(O)=O,4,1,0,1,25,4.8e-05
G5,C(C(C)(C(C=O)(C)CC=O)O)(O)=O,4,1,0,1,25,4.8e-05
G5,C(C(CC(C=O)(C)CC=O)O)(O)=O,4,1,0,1,25,4.8e-05
G5,C(C(CC(C=O)C(C=O)C)O)(O)=O,8,1,0,1,25,4.8e-05
G5,C(C(C)(C(C)CC(CO)=O)O)(O)=O,4,1,0,1,25,4.8e-05
G5,C(C(CC(C)CC(CO)=O)O)(O)=O,4,1,0,1,25,4.8e-05
G5,C(C(C)(C(CO)(C)CC=O)O)(O)=O,4,1,0,1,25,4.8e-05
G5,C(CC(CO)(C)CC(C(O)=O)O)=O,4,1,0,1,25,4.8e-05
G5,C(C(C)(C(C)CC=O)O)(O)=O,4,1,0,1,25,4.8e-05
G5,C(CC(C)CC(C(O)=O)O)=O,4,1,0,1,25,4.8e-05
G5,C(C(C)(CCC(O)=O)O)(O)=O,2,1,0,1,25,4.8e-05
G5,C(C(C)(C(CO)CC(O)=O)O)(O)=O,4,1,0,1,18,4.8e-05
G5,C(CC(CO)CC(C(O)=O)O)(O)=O,4,1,0,1,18,4.8e-05
G5,C(C(CCC=O)(CCO)O)(O)=O,2,1,0,1,45,4.8e-05
G5,C(CCC(CO)C(C(O)=O)O)=O,4,1,0,1,45,4.8e-05
G5,C(CCC(CC(C(O)=O)O)O)=O,4,1,0,1,45,4.8e-05
G5,C(C(CCO)(C(C)CC=O)O)(O)=O,4,1,0,1,45,4.8e-05
G5,C(CC(C)C(CO)C(C(O)=O)O)=O,8,1,0,1,45,4.8e-05
G5,C(CC(C)C(CC(C(O)=O)O)O)=O,8,1,0,1,45,4.8e-05
G5,C(C(CCC(O)=O)(CCO)O)(O)=O,2,1,0,1,45,4.8e-05
G5,C(CCC(CO)C(C(O)=O)O)(O)=O,4,1,0,1,45,4.8e-05
G5,C(CCC(CC(C(O)=O)O)O)(O)=O,4,1,0,1,45,4.8e-05
G5,C(CC(C)C(C(C=O)=O)(CO)O)=O,4,1,0,1,0,4.8e-05
G5,C(CCC(C(C(C=O)=O)O)O)(O)=O,4,1,0,1,0,4.8e-05
G5,C1(CC(CO1)C(C(C=O)=O)O)=O,4,1,0,1,28,4.8e-05
G5,C(C=O)(CC(C)C(C(C=O)=O)O)=O,4,1,0,1,28,4.8e-05
G5,C(CC(C(C)=O)C(C(C=O)=O)O)=O,4,1,0,1,28,4.8e-05
G5,C(C(CC(C)=O)C(C(C=O)=O)O)=O,4,1,0,1,28,4.8e-05
G5,C(CC(C=O)(C)C(C(C=O)=O)O)=O,4,1,0,1,28,4.8e-05
G5,C(CO)(CC(C)C(C(C=O)=O)O)=O,4,1,0,1,28,4.8e-05
G5,C(CC(CO)(C)C(C(C=O)=O)O)=O,4,1,0,1,28,4.8e-05
G5,C1(CC(CO1)C(C(C(C)=O)=O)O)=O,4,1,0,1,25,4.8e-05
G5,C1(CC(CO1)CC(C(CO)=O)=O)=O,2,1,0,1,25,4.8e-05
G5,C(CC(C)C(C(C(C)=O)=O)O)=O,4,1,0,1,25,4.8e-05
G5,C(CC(C)CC(C(CO)=O)=O)=O,2,1,0,1,25,4.8e-05
G5,C(CCC(C(C(C)=O)=O)O)(O)=O,2,1,0,1,25,4.8e-05
G5,C(CCCC(C(CO)=O)=O)(O)=O,1,2,0,2,18,9.499999999999999e-05
G5,C(CCC(C(CO)=O)C(CO)=O)=O,1,1,0,1,27,4.8e-05
G5,C(CCC(C(C)=O)(C(CO)=O)O)=O,2,1,0,1,0,4.8e-05
G5,C1(CC(CO1)C(C(C=O)=O)(C)O)=O,4,1,0,1,25,4.8e-05
G5,C1(CC(CO1)CC(C(C=O)=O)O)=O,4,1,0,1,25,4.8e-05
G5,C(CCC(C(C=O)=O)(C)O)=O,2,1,0,1,25,4.8e-05
G5,C(CCCC(C(C=O)=O)O)=O,2,1,0,1,25,4.8e-05
G5,C(CC(C)C(C(C=O)=O)(C)O)=O,4,1,0,1,25,4.8e-05
G5,C(CC(C)CC(C(C=O)=O)O)=O,4,1,0,1,25,4.8e-05
G5,C(CCC(C(C=O)=O)(C)O)(O)=O,2,1,0,1,25,4.8e-05
G5,C(CCCC(C(C=O)=O)O)(O)=O,2,1,0,1,25,4.8e-05
G5,C1(CC(CO1)C(C(C(C)O)=O)O)=O,8,1,0,1,25,4.8e-05
G5,C1(CC(CO1)C(C(CO)=O)(C)O)=O,4,1,0,1,25,4.8e-05
G5,C1(CC(CC(C(CO)=O)O)CO1)=O,4,1,0,1,25,4.8e-05
G5,C(CCC(C(C(C)O)=O)O)=O,4,1,0,1,25,4.8e-05
G5,C(CCC(C(CO)=O)(C)O)=O,2,1,0,1,25,4.8e-05
G5,C(CCCC(C(CO)=O)O)=O,2,1,0,1,25,4.8e-05
G5,C(CC(C)C(C(C(C)O)=O)O)=O,8,1,0,1,25,4.8e-05
G5,C(CC(C)C(C(CO)=O)(C)O)=O,4,1,0,1,25,4.8e-05
G5,C(CC(C)CC(C(CO)=O)O)=O,4,1,0,1,25,4.8e-05
G5,C(CCC(C(C(C)O)=O)O)(O)=O,4,1,0,1,25,4.8e-05
G5,C(CCC(C(CO)=O)(C)O)(O)=O,2,1,0,1,25,4.8e-05
G5,C(CCCC(C(CO)=O)O)(O)=O,2,1,0,1,25,4.8e-05
G5,C(C(C=O)C(CO)CC(C=O)=O)=O,2,1,0,1,55,4.8e-05
G5,C(C(C=O)CCC(C(CO)=O)=O)=O,1,1,0,1,7,4.8e-05
G5,C(C(C=O)C1COC(C1)=O)=O,2,1,0,1,28,4.8e-05
G5,C(C(C=O)C1CC(C(C(C1)=O)O)=O)=O,1,1,0,1,32,4.8e-05
G5,C(C(C=O)C1C(C(CC(C1)=O)=O)O)=O,4,1,0,1,45,4.8e-05
G5,C1(CC(C(C1CO)=O)C(C=O)C=O)=O,4,1,0,1,45,4.8e-05
G5,C1(C(CO)C(C(C1)=O)C(C=O)C=O)=O,4,1,0,1,45,4.8e-05
G5,C1(C(CO)(CC(C1)=O)C(C=O)C=O)=O,2,1,0,1,45,4.8e-05
G5,C(C(C=O)C1CC(C(C1CO)=O)=O)=O,4,2,0,2,45,9.6e-05
G5,C1(CC(C(C1CC(C=O)C=O)=O)O)=O,4,1,0,1,45,4.8e-05
G5,C(C(C=O)CC1C(C(C(C1)=O)O)=O)=O,4,1,0,1,47,4.8e-05
G5,C(C1(C(CC(C1)=O)O)C(C=O)C=O)=O,4,1,0,1,45,4.8e-05
G5,C(C1C(C(C(C1)=O)O)C(C=O)C=O)=O,8,1,0,1,45,4.8e-05
G5,C(C(C=O)C1C(CC(C1C=O)=O)O)=O,8,1,0,1,45,4.8e-05
G5,C(C(C=O)C1C(C(C)=O)OC(C1)=O)=O,4,1,0,1,48,4.8e-05
G5,C(C(C=O)C1C(CC=O)OC(C1)=O)=O,4,1,0,1,48,4.8e-05
G5,C1(CC(C(OCC1)=O)C(C=O)C=O)=O,2,1,0,1,19,4.8e-05
G5,C(C(C=O)C1C(CCOC(C1)=O)=O)=O,2,1,0,1,19,4.8e-05
G5,C(C(C=O)C1CC(COC(C1)=O)=O)=O,2,2,0,2,45,9.6e-05
G5,C(C(C=O)C1COC(CC(C1)=O)=O)=O,2,1,0,1,19,4.8e-05
G5,C(C(C=O)C1COCC(C(C1)=O)=O)=O,2,1,0,1,36,4.8e-05
G5,C(C(C=O)C1C(COCC(C1)=O)=O)=O,2,1,0,1,45,4.8e-05
G5,C(C1(CC(C(C1)=O)O)C(C=O)C=O)=O,4,1,0,1,45,4.8e-05
G5,C(C1CC(C(C1C(C=O)C=O)=O)O)=O,8,1,0,1,45,4.8e-05
G5,C(C(C=O)C1CC(C(C1C=O)=O)O)=O,8,1,0,1,27,4.8e-05
G5,C(C(C=O)C(CO)(CO)CC=O)=O,1,1,0,1,18,4.8e-05
G5,C(C(C=O)C(C(CO)O)CC=O)=O,4,1,0,1,46,4.8e-05
G5,C(C(C)C(C(C=O)=O)C(C=O)C=O)=O,4,1,0,1,45,4.8e-05
G5,C(C(C)(CC(C=O)=O)C(C=O)C=O)=O,2,1,0,1,45,4.8e-05
G5,C(C(CC(C=O)C=O)CC(C=O)=O)=O,2,1,0,1,45,4.8e-05
G5,C(C(C=O)C(C(C=O)=O)CC=O)=O,2,1,0,1,20,4.8e-05
G5,C(C(C=O)C(C=O)CC(C=O)=O)=O,2,1,0,1,20,4.8e-05
G5,C(C(C=O)C(C)CC(C=O)=O)=O,2,1,0,1,28,4.8e-05
G5,C(C(C=O)C(C(C)=O)CC=O)=O,2,1,0,1,28,4.8e-05
G5,C(C(C=O)C(C=O)CC(C)=O)=O,2,1,0,1,28,4.8e-05
G5,C(C(CC(C=O)C=O)CC=O)=O,2,1,0,1,28,4.8e-05
G5,C(C(C)(CC=O)C(C=O)C=O)=O,2,1,0,1,28,4.8e-05
G5,C(C(C)C(C=O)C(C=O)C=O)=O,4,1,0,1,28,4.8e-05
G5,C(C(C=O)CC(C=O)C(CO)=O)=O,2,1,0,1,9,4.8e-05
G5,C(C(C=O)CCC(C(C=O)O)=O)=O,2,1,0,1,0,4.8e-05
G5,C(C(CC(C=O)C=O)C(C=O)O)=O,4,1,0,1,16,4.8e-05
G5,C(C(CO)(CC=O)C(C=O)C=O)=O,2,1,0,1,18,4.8e-05
G5,C(C(C=O)CCC=O)=O,1,1,0,1,45,4.8e-05
G5,C(C(C=O)C(C)CC(CO)=O)=O,2,1,0,1,28,4.8e-05
G5,C(C(C=O)C(C)(CO)CC=O)=O,2,1,0,1,28,4.8e-05
G5,C(C(C=O)C(C)CC=O)=O,2,1,0,1,45,4.8e-05
G5,C(C(C=O)CCC(O)=O)=O,1,1,0,1,18,4.8e-05
G5,C(C(C=O)C(CO)CC(O)=O)=O,2,1,0,1,18,4.8e-05
G5,C(C(C=O)C1C(C(C(C1)=O)O)=O)=O,4,1,0,1,47,4.8e-05
G5,C(C(C=O)C(CC=O)CC=O)=O,1,1,0,1,28,4.8e-05
G5,C(CCC(C=O)(C(CO)=O)O)=O,2,1,0,1,5,4.8e-05
G5,C(CC(C)C(C=O)(C(CO)=O)O)=O,4,1,0,1,5,4.8e-05
G5,C(CCC(C(C(C=O)O)=O)O)(O)=O,4,1,0,1,5,4.8e-05
G5,C(CCC(C=O)(C(CO)=O)O)(O)=O,2,1,0,1,5,4.8e-05
G5,C(C(CCO)(C1COC(C1)=O)O)=O,4,1,0,1,29,4.8e-05
G5,C1(CC(CO1)C(CO)C(C=O)O)=O,8,1,0,1,29,4.8e-05
G5,C1(CC(CO1)C(CC(C=O)O)O)=O,8,1,0,1,29,4.8e-05
G5,C(C(CCC=O)(CCO)O)=O,2,1,0,1,29,4.8e-05
G5,C(CCC(CO)C(C=O)O)=O,4,1,0,1,29,4.8e-05
G5,C(CCC(CC(C=O)O)O)=O,4,1,0,1,29,4.8e-05
G5,C(C(CCO)(C(C)CC=O)O)=O,4,1,0,1,29,4.8e-05
G5,C(CC(C)C(CO)C(C=O)O)=O,8,1,0,1,29,4.8e-05
G5,C(CC(C)C(CC(C=O)O)O)=O,8,1,0,1,29,4.8e-05
G5,C(C(CCC(O)=O)(CCO)O)=O,2,1,0,1,29,4.8e-05
G5,C(CCC(CO)C(C=O)O)(O)=O,4,1,0,1,29,4.8e-05
G5,C(CCC(CC(C=O)O)O)(O)=O,4,1,0,1,29,4.8e-05
G5,C1(CC(CO1)CC(C(O)=O)=O)=O,2,1,0,1,28,4.8e-05
G5,C(C(CC(C)CC(C(O)=O)=O)=O)=O,2,1,0,1,28,4.8e-05
G5,C(C(CC(C(O)=O)=O)CC(C)=O)=O,2,1,0,1,28,4.8e-05
G5,C(C(C)(CC=O)CC(C(O)=O)=O)=O,2,1,0,1,28,4.8e-05
G5,C(C(C)C(C=O)CC(C(O)=O)=O)=O,4,1,0,1,28,4.8e-05
G5,C(CO)(CC(C)CC(C(O)=O)=O)=O,2,1,0,1,28,4.8e-05
G5,C(CC(C)(CO)CC(C(O)=O)=O)=O,2,1,0,1,28,4.8e-05
G5,C(CC(C)CC(C(O)=O)=O)=O,2,1,0,1,28,4.8e-05
G5,C(CC(CO)CC(C(O)=O)=O)(O)=O,2,1,0,1,18,4.8e-05
G5,C(CCC(C(CC(O)=O)=O)O)=O,2,1,0,1,0,4.8e-05
G5,C(CC(C)C(C(O)=O)C(CO)=O)=O,4,1,0,1,0,4.8e-05
G5,C(CC(C)C(C(CC(O)=O)=O)O)=O,4,1,0,1,0,4.8e-05
G5,C(CCC(C(CC(O)=O)=O)O)(O)=O,2,1,0,1,0,4.8e-05
G5,C(CCC(C(O)=O)(C(C)=O)O)=O,2,1,0,1,0,4.8e-05
G5,C(CC(C)C(C(O)=O)(C(C)=O)O)=O,4,1,0,1,0,4.8e-05
G5,C(C(C(CC(C)CC=O)=O)O)(O)=O,4,1,0,1,0,4.8e-05
G5,C(CCC(C(O)=O)(C(C)=O)O)(O)=O,2,1,0,1,0,4.8e-05
G5,C(C(C=O)(C1COC(C1)=O)O)(O)=O,4,1,0,1,17,4.8e-05
G5,C(C(C=O)(C(C)CC=O)O)(O)=O,4,1,0,1,17,4.8e-05
G5,C(C(C=O)(CCC(O)=O)O)(O)=O,2,1,0,1,17,4.8e-05
G5,C(C(CCC=O)(C(C=O)O)O)(O)=O,4,1,0,1,33,4.8e-05
G5,C(CCC(C=O)(CC(O)=O)O)=O,2,1,0,1,29,4.8e-05
G5,C(C(CCC=O)C(C=O)O)(O)=O,4,1,0,1,29,4.8e-05
G5,C(CC(C)C(C=O)(CC(O)=O)O)=O,4,1,0,1,29,4.8e-05
G5,C(C(C(C)CC=O)C(C=O)O)(O)=O,8,1,0,1,29,4.8e-05
G5,C(CCC(C=O)(CC(O)=O)O)(O)=O,2,1,0,1,29,4.8e-05
G5,C(CCC(C(O)=O)C(C=O)O)(O)=O,4,1,0,1,29,4.8e-05
G5,C(C)(C(C(C=O)=O)C1COC(C1)=O)=O,4,1,0,1,26,4.8e-05
G5,C(CC1COC(C1)=O)(CC(C=O)=O)=O,2,1,0,1,26,4.8e-05
G5,C(CC(C)C(C(C)=O)C(C=O)=O)=O,4,1,0,1,26,4.8e-05
G5,C(CC(C)CC(CC(C=O)=O)=O)=O,2,1,0,1,26,4.8e-05
G5,C(C)(C(C(C=O)=O)CCC(O)=O)=O,2,1,0,1,26,4.8e-05
G5,C(C(C(C=O)=O)C1COC(C1)=O)=O,4,1,0,1,23,4.8e-05
G5,C(C(C(C=O)=O)C(C)CC(C=O)=O)=O,4,1,0,1,23,4.8e-05
G5,C(C(C(C=O)=O)C(C(C)=O)CC=O)=O,4,1,0,1,23,4.8e-05
G5,C(C(C(C=O)=O)C(C=O)CC(C)=O)=O,4,1,0,1,23,4.8e-05
G5,C(C(CC(C=O)C(C=O)=O)CC=O)=O,4,2,0,2,49,9.6e-05
G5,C(C(C)(CC=O)C(C=O)C(C=O)=O)=O,4,1,0,1,23,4.8e-05
G5,C(C(C)C(C=O)C(C=O)C(C=O)=O)=O,8,1,0,1,23,4.8e-05
G5,C(C(C(C=O)=O)C(C)CC=O)=O,4,1,0,1,23,4.8e-05
G5,C(C(C(C=O)=O)CCC(O)=O)=O,2,1,0,1,18,4.8e-05
G5,C(C(C(C=O)=O)C(CC=O)CC=O)=O,2,1,0,1,23,4.8e-05
G5,C(C(C(C(C)=O)=O)C1COC(C1)=O)=O,4,1,0,1,14,4.8e-05
G5,C(CC(C(CC1COC(C1)=O)=O)=O)=O,2,1,0,1,14,4.8e-05
G5,C(CCC(C=O)C(C(C)=O)=O)=O,2,1,0,1,14,4.8e-05
G5,C(CC(C)C(C=O)C(C(C)=O)=O)=O,4,1,0,1,14,4.8e-05
G5,C(CC(C(CC(C)CC=O)=O)=O)=O,2,1,0,1,14,4.8e-05
G5,C(C(C(C(C)=O)=O)CCC(O)=O)=O,2,1,0,1,14,4.8e-05
G5,C1(CC(CO1)CC(C(C)=O)=O)=O,2,1,0,1,14,4.8e-05
G5,C(CC(C(C=O)=O)CC(C(C)=O)=O)=O,2,1,0,1,20,4.8e-05
G5,C(C=O)(CC(C)CC(C(C)=O)=O)=O,2,1,0,1,14,4.8e-05
G5,C(CC(C(C)=O)CC(C(C)=O)=O)=O,2,1,0,1,14,4.8e-05
G5,C(C(CC(C)=O)CC(C(C)=O)=O)=O,2,2,0,2,45,9.6e-05
G5,C(C(CCC(C(C)=O)=O)CC=O)=O,2,2,0,2,14,9.6e-05
G5,C(C(C)(CC=O)CC(C(C)=O)=O)=O,2,1,0,1,14,4.8e-05
G5,C(C(C)C(C=O)CC(C(C)=O)=O)=O,4,1,0,1,14,4.8e-05
G5,C(CCCC(C(C)=O)=O)=O,1,1,0,1,14,4.8e-05
G5,C(CO)(CC(C)CC(C(C)=O)=O)=O,2,1,0,1,14,4.8e-05
G5,C(CC(C)(CO)CC(C(C)=O)=O)=O,2,1,0,1,28,4.8e-05
G5,C(CC(C)CC(C(C)=O)=O)=O,2,1,0,1,14,4.8e-05
G5,C(CCCC(C(C)=O)=O)(O)=O,1,1,0,1,14,4.8e-05
G5,C1(CC(C(C1O)=O)CC(C(C)=O)=O)=O,4,1,0,1,47,4.8e-05
G5,C(CC(CC=O)CC(C(C)=O)=O)=O,1,1,0,1,14,4.8e-05
G5,C(CC(CC1COC(C1)=O)=O)=O,2,1,0,1,28,4.8e-05
G5,C(C(C(C)=O)C1COC(C1)=O)=O,4,1,0,1,28,4.8e-05
G5,C(CC(CC(C(C=O)=O)CC=O)=O)=O,2,1,0,1,20,4.8e-05
G5,C(C(C(C)=O)C(C(C=O)=O)CC=O)=O,4,1,0,1,20,4.8e-05
G5,C(C(C(C)=O)C(C=O)CC(C=O)=O)=O,4,1,0,1,20,4.8e-05
G5,C(CC(CC(C)CC(C=O)=O)=O)=O,2,1,0,1,28,4.8e-05
G5,C(C(C(C)=O)C(C)CC(C=O)=O)=O,4,1,0,1,28,4.8e-05
G5,C(CC(CC(C(C)=O)CC=O)=O)=O,2,1,0,1,28,4.8e-05
G5,C(C(C(C)=O)C(C(C)=O)CC=O)=O,4,1,0,1,28,4.8e-05
G5,C(CC(CC(C=O)CC(C)=O)=O)=O,2,2,0,2,45,9.6e-05
G5,C(C(C(C)=O)C(C=O)CC(C)=O)=O,4,1,0,1,28,4.8e-05
G5,C(C(CCC(CC=O)=O)CC=O)=O,2,1,0,1,28,4.8e-05
G5,C(C(CC(C(C)=O)C=O)CC=O)=O,4,1,0,1,28,4.8e-05
G5,C(C(C)(CC(CC=O)=O)CC=O)=O,2,1,0,1,28,4.8e-05
G5,C(C(C)(CC=O)C(C(C)=O)C=O)=O,4,1,0,1,28,4.8e-05
G5,C(C(C)C(C=O)CC(CC=O)=O)=O,4,1,0,1,28,4.8e-05
G5,C(C(C)C(C=O)C(C(C)=O)C=O)=O,8,1,0,1,28,4.8e-05
G5,C(CC(CCCC=O)=O)=O,1,1,0,1,6,4.8e-05
G5,C(CCC(C=O)C(C)=O)=O,2,1,0,1,6,4.8e-05
G5,C(CC(C)CC(CO)=O)(CC=O)=O,2,1,0,1,28,4.8e-05
G5,C(C)(C(C=O)C(C)CC(CO)=O)=O,4,1,0,1,28,4.8e-05
G5,C(CC(CC(C)(CO)CC=O)=O)=O,2,1,0,1,28,4.8e-05
G5,C(CC(C)(CO)C(C=O)C(C)=O)=O,4,1,0,1,28,4.8e-05
G5,C(CC(CC(C)CC=O)=O)=O,2,1,0,1,6,4.8e-05
G5,C(CC(C)C(C=O)C(C)=O)=O,4,1,0,1,6,4.8e-05
G5,C(CC(CCCC(O)=O)=O)=O,1,1,0,1,18,4.8e-05
G5,C(C(C(C)=O)CCC(O)=O)=O,2,1,0,1,18,4.8e-05
G5,C(CC(CO)C(C=O)C(C)=O)(O)=O,4,1,0,1,18,4.8e-05
G5,C(CC(CC1C(C(C(C1)=O)O)=O)=O)=O,4,1,0,1,47,4.8e-05
G5,C(C(C(C)=O)C1C(C(C(C1)=O)O)=O)=O,8,1,0,1,47,4.8e-05
G5,C(CC(CC(CC=O)CC=O)=O)=O,1,1,0,1,28,4.8e-05
G5,C(CC(CC=O)C(C=O)C(C)=O)=O,2,1,0,1,28,4.8e-05
G5,C1(CC(CO1)C2(CC(CO2)=O)O)=O,4,1,0,1,35,4.8e-05
G5,C1(CC(CO1)C2C(COC2O)=O)=O,8,1,0,1,35,4.8e-05
G5,C1(CC(CO1)C2C(CC(O2)O)=O)=O,8,1,0,1,35,4.8e-05
G5,C(CCC1C(COC1O)=O)=O,4,1,0,1,35,4.8e-05
G5,C(CCC1C(CC(O1)O)=O)=O,4,1,0,1,35,4.8e-05
G5,C(CC(C)C1(CC(CO1)=O)O)=O,4,1,0,1,35,4.8e-05
G5,C(CC(C)C1C(COC1O)=O)=O,8,1,0,1,35,4.8e-05
G5,C(CC(C)C1C(CC(O1)O)=O)=O,8,1,0,1,35,4.8e-05
G5,C(CCC1(CC(CO1)=O)O)(O)=O,2,1,0,1,35,4.8e-05
G5,C(CCC1C(COC1O)=O)(O)=O,4,1,0,1,35,4.8e-05
G5,C(CCC1C(CC(O1)O)=O)(O)=O,4,1,0,1,35,4.8e-05
G5,C(CCC1(C(CC(CO1)=O)O)O)=O,4,1,0,1,27,4.8e-05
G5,C(CCC1(C(OCC(C1)=O)O)O)=O,4,1,0,1,27,4.8e-05
G5,C(CCC1C(COC(C1O)O)=O)=O,8,1,0,1,27,4.8e-05
G5,C(CCC1C(CC(C(O1)O)O)=O)=O,8,1,0,1,27,4.8e-05
G5,C(C(CC(CO)=O)C1C(C=CO1)=O)=O,4,1,0,1,11,4.8e-05
G5,C(CC(C(CO)=O)C1C(C=CO1)=O)=O,4,1,0,1,11,4.8e-05
G5,C(C(CC(CO)=O)C1C=CC(O1)=O)=O,4,1,0,1,11,4.8e-05
G5,C(CC(C(CO)=O)C1C=CC(O1)=O)=O,4,1,0,1,11,4.8e-05
G5,C1(CC(CO1)C(C(C=CC=O)=O)O)=O,8,1,0,1,11,4.8e-05
G5,C(C(CC(CO)=O)CC=CC=O)=O,4,1,0,1,11,4.8e-05
G5,C(CC(C(CO)=O)CC=CC=O)=O,4,1,0,1,11,4.8e-05
G5,C(CC(C)C(C(C=CC=O)=O)O)=O,8,1,0,1,11,4.8e-05
G5,C(C(C=C)C(C=O)CC(CO)=O)=O,4,1,0,1,11,4.8e-05
G5,C(C(C=C)C(C(CO)=O)CC=O)=O,4,1,0,1,11,4.8e-05
G5,C(CCC(C(C=CC=O)=O)O)(O)=O,4,1,0,1,11,4.8e-05
G5,C1(C(CCC(C=O)=O)(CC(C1)=O)O)=O,2,1,0,1,26,4.8e-05
G5,C(C(CCC1(CC(C(C1)=O)=O)O)=O)=O,1,1,0,1,45,4.8e-05
G5,C1C(CCC(C=O)=O)(C(C(C=1)=O)O)O,4,1,0,1,28,4.8e-05
G5,C(C(C=C)(CCC(C=O)=O)O)(O)=O,2,1,0,1,7,4.8e-05
G5,C(C(CCCC(C(C=O)=O)=O)=O)=O,1,1,0,1,25,4.8e-05
G5,C(C(C(CC=O)=O)CCC(C=O)=O)=O,2,1,0,1,9,4.8e-05
G5,C(C)(CCCC(C=O)=O)=O,1,1,0,1,7,4.8e-05
G5,C(C(CCC(C=O)=O)OC=O)=O,2,1,0,1,7,4.8e-05
G5,C(C(CCC(C=O)=O)OC(C)=O)=O,2,1,0,1,28,4.8e-05
G5,C(COC(CCCC(C=O)=O)=O)=O,1,1,0,1,28,4.8e-05
G5,C(C(CCC(C=O)=O)O)=CC(C=O)=O,4,1,0,1,55,4.8e-05
G5,C=CC(C(C(CCC(C=O)=O)O)=O)=O,2,1,0,1,7,4.8e-05
G5,C1(CCC(C1(CCC(C=O)=O)O)=O)=O,1,1,0,1,47,4.8e-05
G5,C1(CC(C(OC1)=O)CCC(C=O)=O)=O,2,1,0,1,7,4.8e-05
G5,C1(COC(CC1CCC(C=O)=O)=O)=O,2,1,0,1,7,4.8e-05
G5,C1(CCC(OC1CCC(C=O)=O)=O)=O,2,1,0,1,7,4.8e-05
G5,C1(C(CCC(C=O)=O)OCC(C1)=O)=O,2,1,0,1,54,4.8e-05
G5,C1(COCC(C1CCC(C=O)=O)=O)=O,1,1,0,1,54,4.8e-05
G5,C1(C(OCC1CCC(C=O)=O)=O)=O,2,1,0,1,28,4.8e-05
G5,C(C(CCC1CC(C(O1)=O)=O)=O)=O,2,1,0,1,28,4.8e-05
G5,C1(COC(C1CCC(C=O)=O)=O)=O,2,1,0,1,28,4.8e-05
G5,C1(C(CCC(C=O)=O)OC(C1)=O)=O,2,1,0,1,7,4.8e-05
G5,C1C(CCC(C=O)=O)(OCC(C=1)=O)O,2,1,0,1,27,4.8e-05
G5,C1C(OC(C(C=1)=O)CCC(C=O)=O)O,4,1,0,1,27,4.8e-05
G5,C1(C(CCC(C=O)=O)(CCO1)O)=O,2,1,0,1,28,4.8e-05
G5,C(C(C=CC=O)(CCC(C=O)=O)O)=O,4,1,0,1,20,4.8e-05
G5,C(C(CCC(CC(C)O)O)=O)=O,4,1,0,1,28,4.8e-05
G5,C(C(CCC(C(C(C)O)O)O)=O)=O,8,1,0,1,28,4.8e-05
G5,C(C(CCC(C(C)O)O)=O)=O,4,1,0,1,11,4.8e-05
G5,C(C(CCCC(C(CC)=O)=O)=O)=O,1,1,0,1,28,4.8e-05
G5,C(C=O)(CCCCC(C(C)=O)=O)=O,1,1,0,1,28,4.8e-05
G5,C(C(C)=O)(C(C)CCC(C=O)=O)=O,2,1,0,1,28,4.8e-05
G5,C(CCCC(C=O)=O)(CC(C)=O)=O,1,1,0,1,28,4.8e-05
G5,C(C)(C(C(C)=O)CCC(C=O)=O)=O,1,1,0,1,28,4.8e-05
G5,C(C(C(C=O)=O)(C)CCC(C=O)=O)=O,2,1,0,1,49,4.8e-05
G5,C(C(C(C=O)=O)CCCC(C=O)=O)=O,2,1,0,1,49,4.8e-05
G5,C(C(C=O)C(CCCC(C=O)=O)=O)=O,1,1,0,1,6,4.8e-05
G5,C(C(C=O)(CCC(C=O)=O)CC=O)=O,1,1,0,1,43,4.8e-05
G5,C(C(C=O)C(C=O)CCC(C=O)=O)=O,2,1,0,1,43,4.8e-05
G5,C(C(O)=O)(C(C)CCC(C=O)=O)=O,2,1,0,1,28,4.8e-05
G5,C(CCCC(C=O)=O)=CC(C=O)=O,2,1,0,1,28,4.8e-05
G5,C=CC(C(C=O)=O)CCC(C=O)=O,2,1,0,1,28,4.8e-05
G5,C(C(CCCC(C=CC=O)=O)=O)=O,2,1,0,1,7,4.8e-05
G5,C(C(C(C=O)=C)CCC(C=O)=O)=O,2,1,0,1,28,4.8e-05
G5,C(C(CCCC(C=O)=CC=O)=O)=O,2,1,0,1,7,4.8e-05
G5,C=C(C=O)C(C(CCC(C=O)=O)O)=O,2,1,0,1,9,4.8e-05
G5,C(C(C(C=C)=O)(CCC(C=O)=O)O)=O,2,1,0,1,0,4.8e-05
G5,C=C(C(C=O)=O)C(CCC(C=O)=O)O,2,1,0,1,49,4.8e-05
G5,C(C(C(C=O)=C)(CCC(C=O)=O)O)=O,2,1,0,1,16,4.8e-05
G5,C(C=O)(CCC(C(C=O)=CC=O)O)=O,4,1,0,1,18,4.8e-05
G5,C(C)=CC(C(CCC(C=O)=O)O)=O,4,1,0,1,7,4.8e-05
G5,C(CCCC(C=O)=O)=CC(CO)=O,2,1,0,1,7,4.8e-05
G5,C(CO)(C(C=C)CCC(C=O)=O)=O,2,1,0,1,28,4.8e-05
G5,C(C(CCC(C=O)=O)O)(CC=C)=O,2,1,0,1,28,4.8e-05
G5,C(CCCC(C=O)=O)(C(C=C)O)=O,2,1,0,1,28,4.8e-05
G5,C(C)(C(C=C)(CCC(C=O)=O)O)=O,2,1,0,1,28,4.8e-05
G5,C(CC(C(CCC(C=O)=O)O)=C)=O,2,1,0,1,28,4.8e-05
G5,C(C(C(CO)=C)CCC(C=O)=O)=O,2,1,0,1,28,4.8e-05
G5,C(CO)(CCCC(C=O)=O)=CC=O,2,1,0,1,28,4.8e-05
G5,C(C)(C(CCC(C=O)=O)O)=CC=O,4,1,0,1,28,4.8e-05
G5,C(C(CCC(C=O)=O)O)=CC(O)=O,4,1,0,1,18,4.8e-05
G5,C(C(CCC1(CC(CO1)O)O)=O)=O,4,1,0,1,43,4.8e-05
G5,C(C(CCC1(C(CCO1)O)O)=O)=O,4,1,0,1,28,4.8e-05
G5,C(C(CCC1(C(C=CC1=O)=O)O)=O)=O,1,1,0,1,47,4.8e-05
G5,C(C(C=CC=O)CCC(C=O)=O)=O,4,1,0,1,28,4.8e-05
G5,C(C(C=C)(CCC(CO)=O)O)(O)=O,2,1,0,1,7,4.8e-05
G5,C(CO)(CCCC(C(C=O)=O)=O)=O,1,1,0,1,25,4.8e-05
G5,C(C)(CCCC(CO)=O)=O,1,1,0,1,27,4.8e-05
G5,C(C(CCC(CO)=O)OC=O)=O,2,1,0,1,7,4.8e-05
G5,C(C)(OC(C=O)CCC(CO)=O)=O,2,1,0,1,28,4.8e-05
G5,C(CO)(CCCC(OCC=O)=O)=O,1,1,0,1,28,4.8e-05
G5,C(CO)(CCC1C(C(OC1)=O)=O)=O,2,1,0,1,28,4.8e-05
G5,C(CO)(CCC1CC(C(O1)=O)=O)=O,2,1,0,1,28,4.8e-05
G5,C(CO)(CCC1C(OCC1=O)=O)=O,2,1,0,1,7,4.8e-05
G5,C1(C(CCC(CO)=O)OC(C1)=O)=O,2,1,0,1,7,4.8e-05
G5,C1(CC(CO1)C(C(C=C)=O)O)=O,4,1,0,1,28,4.8e-05
G5,C1(C(CCC(CO)=O)(CCO1)O)=O,2,1,0,1,28,4.8e-05
G5,C(CO)(CCC(CC(C)O)O)=O,4,1,0,1,28,4.8e-05
G5,C(CO)(CCC(C(C(C)O)O)O)=O,8,1,0,1,28,4.8e-05
G5,C(CO)(CCC(C(C)O)O)=O,4,1,0,1,11,4.8e-05
G5,C(CO)(CCCC(C(CC)=O)=O)=O,1,1,0,1,28,4.8e-05
G5,C(CO)(CCCCC(C(C)=O)=O)=O,1,1,0,1,28,4.8e-05
G5,C(CO)(CCC(C(C(C)=O)=O)C)=O,2,1,0,1,28,4.8e-05
G5,C(C)(CC(CCCC(CO)=O)=O)=O,1,1,0,1,28,4.8e-05
G5,C(C)(C(C(C)=O)CCC(CO)=O)=O,1,1,0,1,28,4.8e-05
G5,C(CO)(CCCC(C=O)CC=O)=O,2,1,0,1,28,4.8e-05
G5,C(CO)(CCC(C=O)(C)CC=O)=O,2,1,0,1,28,4.8e-05
G5,C(C(CCC(CO)=O)C(C=O)C)=O,4,1,0,1,28,4.8e-05
G5,C(CO)(CCCCC(C(O)=O)=O)=O,1,1,0,1,28,4.8e-05
G5,C(CO)(CCC(C(C(O)=O)=O)C)=O,2,1,0,1,28,4.8e-05
G5,C(CO)(CCCC=CC(C=O)=O)=O,2,1,0,1,28,4.8e-05
G5,C=CC(C(C(C)CC(C=O)=O)O)=O,4,1,0,1,28,4.8e-05
G5,C(CO)(CCC(C=C)C(C=O)=O)=O,2,1,0,1,28,4.8e-05
G5,C(CO)(CCCC(C=CC=O)=O)=O,2,1,0,1,28,4.8e-05
G5,C(CC(C(C)=O)C(C(C=C)=O)O)=O,4,1,0,1,28,4.8e-05
G5,C(C(CC(C)=O)C(C(C=C)=O)O)=O,4,1,0,1,28,4.8e-05
G5,C(C(C(C=O)=C)CCC(CO)=O)=O,2,1,0,1,28,4.8e-05
G5,C(C(CC(C(C=C)=O)O)CC=O)=O,4,1,0,1,28,4.8e-05
G5,C(CO)(CCCC(C=O)=CC=O)=O,2,1,0,1,28,4.8e-05
G5,C(CC(C=O)(C)C(C(C=C)=O)O)=O,4,1,0,1,28,4.8e-05
G5,C(CCC(C(C=C)=O)O)=O,2,1,0,1,7,4.8e-05
G5,C(CO)(CCC(C(C=CC)=O)O)=O,4,1,0,1,28,4.8e-05
G5,C(CO)(CCCC=CC(CO)=O)=O,2,1,0,1,28,4.8e-05
G5,C(CO)(CC(C)C(C(C=C)=O)O)=O,4,1,0,1,28,4.8e-05
G5,C(CO)(CCC(C(CO)=O)C=C)=O,2,1,0,1,28,4.8e-05
G5,C(C(CCC(CO)=O)O)(CC=C)=O,2,1,0,1,28,4.8e-05
G5,C(CCCC(CO)=O)(C(C=C)O)=O,2,1,0,1,28,4.8e-05
G5,C(C)(C(C=C)(CCC(CO)=O)O)=O,2,1,0,1,28,4.8e-05
G5,C(CC(C(CCC(CO)=O)O)=C)=O,2,1,0,1,28,4.8e-05
G5,C(C(C(CO)=C)CCC(CO)=O)=O,2,1,0,1,28,4.8e-05
G5,C(CO)(CCCC(CO)=CC=O)=O,2,1,0,1,28,4.8e-05
G5,C(CO)(CCC(C(C)=CC=O)O)=O,4,1,0,1,28,4.8e-05
G5,C(CC(CO)(C)C(C(C=C)=O)O)=O,4,1,0,1,28,4.8e-05
G5,C(CC(C)C(C(C=C)=O)O)=O,4,1,0,1,7,4.8e-05
G5,C(CCC(C(C=C)=O)O)(O)=O,2,1,0,1,18,4.8e-05
G5,C(CO)(CCC(C=CC(O)=O)O)=O,4,1,0,1,18,4.8e-05
G5,C(CC(CO)C(C(C=C)=O)O)(O)=O,4,1,0,1,18,4.8e-05
G5,C(CO)(CCC1(CC(CO1)O)O)=O,4,1,0,1,43,4.8e-05
G5,C(CO)(CCC1(C(C=CC1=O)=O)O)=O,1,1,0,1,47,4.8e-05
G5,C(C(C=CC=O)CCC(CO)=O)=O,4,1,0,1,28,4.8e-05
G5,C(CC(C(C(C=C)=O)O)CC=O)=O,2,1,0,1,28,4.8e-05
G5,C(CC(C=O)C1(C(CC(C1)=O)=O)O)=O,4,1,0,1,43,4.8e-05
G5,C(C(C1(CC(C(C1)=O)=O)O)CC=O)=O,2,1,0,1,45,4.8e-05
G5,C(CC(C=O)CC(C(C=O)=O)=O)=O,2,1,0,1,25,4.8e-05
G5,C(C(C(CC=O)=O)C(C=O)CC=O)=O,4,1,0,1,9,4.8e-05
G5,C(OC(C=O)C(C=O)CC=O)=O,4,1,0,1,43,4.8e-05
G5,C(C(C(C=O)CC=O)OC(C)=O)=O,4,1,0,1,28,4.8e-05
G5,C(CC(C=O)CC(OCC=O)=O)=O,2,1,0,1,28,4.8e-05
G5,C(CC(C=O)C(C(C(C=C)=O)=O)O)=O,4,1,0,1,7,4.8e-05
G5,C(CC(C=O)C1(C(CCC1=O)=O)O)=O,2,1,0,1,47,4.8e-05
G5,C(CC(C=O)C1C(OCC(C1)=O)=O)=O,4,1,0,1,7,4.8e-05
G5,C(CC(C=O)C1C(COC(C1)=O)=O)=O,4,1,0,1,7,4.8e-05
G5,C(CC(C=O)C1C(CCC(O1)=O)=O)=O,4,1,0,1,7,4.8e-05
G5,C(CC(C=O)C1C(CC(CO1)=O)=O)=O,4,1,0,1,54,4.8e-05
G5,C(C(CC=O)C1C(COCC1=O)=O)=O,2,1,0,1,54,4.8e-05
G5,C(CC(C=O)C1C(C(OC1)=O)=O)=O,4,1,0,1,43,4.8e-05
G5,C(C(C1CC(C(O1)=O)=O)CC=O)=O,4,1,0,1,43,4.8e-05
G5,C1(C(C(CO1)=O)C(C=O)CC=O)=O,4,1,0,1,43,4.8e-05
G5,C1(CC(C(C(C=O)CC=O)O1)=O)=O,4,1,0,1,43,4.8e-05
G5,C(CC(C=O)C1(C=CC(CO1)=O)O)=O,4,1,0,1,27,4.8e-05
G5,C(CC(C=O)C1C(C=CC(O)O1)=O)=O,8,1,0,1,27,4.8e-05
G5,C(CC(C=O)CC(C(CC)=O)=O)=O,2,1,0,1,43,4.8e-05
G5,C(CC(C=O)C(C(C(C)=O)=O)C)=O,4,1,0,1,43,4.8e-05
G5,C(CC(C=O)CC(CC(C)=O)=O)=O,2,1,0,1,43,4.8e-05
G5,C(C(CC=O)C(C(C)=O)C(C)=O)=O,2,1,0,1,43,4.8e-05
G5,C(CC(C=O)C(C=O)(C(C=O)=O)C)=O,4,1,0,1,49,4.8e-05
G5,C(C(C=O)C(CC(C=O)CC=O)=O)=O,2,1,0,1,6,4.8e-05
G5,C(C(C=O)(CC=O)C(C=O)CC=O)=O,2,1,0,1,43,4.8e-05
G5,C(C(C=O)C(C=O)C(C=O)CC=O)=O,4,1,0,1,43,4.8e-05
G5,C(CC(C=O)C(C(C(O)=O)=O)C)=O,4,1,0,1,28,4.8e-05
G5,C(CC(C=O)CC=CC(C=O)=O)=O,4,1,0,1,43,4.8e-05
G5,C(CC(C=O)C(C=C)C(C=O)=O)=O,4,1,0,1,43,4.8e-05
G5,C(CC(C=O)CC(C=CC=O)=O)=O,4,1,0,1,43,4.8e-05
G5,C(C(C(C=O)=C)C(C=O)CC=O)=O,4,1,0,1,43,4.8e-05
G5,C(CC(C=O)CC(C=O)=CC=O)=O,4,1,0,1,43,4.8e-05
G5,C(CC(C=O)C(C(C(C=O)=C)=O)O)=O,4,1,0,1,9,4.8e-05
G5,C(C(C(C=C)=O)(C(C=O)CC=O)O)=O,4,1,0,1,0,4.8e-05
G5,C(CC(C=O)C(C(C(C=O)=O)=C)O)=O,4,1,0,1,49,4.8e-05
G5,C(C(C(C=O)=C)(C(C=O)CC=O)O)=O,4,1,0,1,16,4.8e-05
G5,C(CC(C=O)C(C(C=O)=CC=O)O)=O,8,1,0,1,18,4.8e-05
G5,C(CC(C=O)CC=CC(CO)=O)=O,4,1,0,1,43,4.8e-05
G5,C(CC(C=O)C(C(CO)=O)C=C)=O,4,1,0,1,43,4.8e-05
G5,C(CC(C=O)CC(C(C=C)O)=O)=O,4,1,0,1,28,4.8e-05
G5,C(CC(C=O)C(C(C)=O)(C=C)O)=O,4,1,0,1,28,4.8e-05
G5,C(C(C(CO)=C)C(C=O)CC=O)=O,4,1,0,1,28,4.8e-05
G5,C(CC(C=O)CC(CO)=CC=O)=O,4,1,0,1,28,4.8e-05
G5,C(C(C1(CC(CO1)O)O)CC=O)=O,8,1,0,1,43,4.8e-05
G5,C(C(C1(C(CCO1)O)O)CC=O)=O,8,1,0,1,28,4.8e-05
G5,C(CC(C=O)C1(C(C=CC1=O)=O)O)=O,2,1,0,1,47,4.8e-05
G5,C(C(C=CC=O)C(C=O)CC=O)=O,8,1,0,1,43,4.8e-05
G5,C1(C(CCC=O)(C(CO1)O)O)=O,4,1,0,1,40,4.8e-05
G5,C(CCC1(COC(C1O)=O)O)=O,4,1,0,1,40,4.8e-05
G5,C(CCC1C(C(C(O1)=O)O)O)=O,8,1,0,1,40,4.8e-05
G5,C1(C(C(CO1)O)(C(C)CC=O)O)=O,8,1,0,1,40,4.8e-05
G5,C(CC(C)C1(COC(C1O)=O)O)=O,8,1,0,1,40,4.8e-05
G5,C(CC(C)C1C(C(C(O1)=O)O)O)=O,16,1,0,1,40,4.8e-05
G5,C1(C(CCC(O)=O)(C(CO1)O)O)=O,4,1,0,1,40,4.8e-05
G5,C(CCC1(COC(C1O)=O)O)(O)=O,4,1,0,1,40,4.8e-05
G5,C(CCC1C(C(C(O1)=O)O)O)(O)=O,8,1,0,1,40,4.8e-05
G5,C1(C(C2COC(C2)=O)C(CO1)O)=O,8,1,0,1,8,4.8e-05
G5,C1(CC(CO1)(C2COC(C2)=O)O)=O,4,1,0,1,8,4.8e-05
G5,C1(CC(CO1)C2C(CC(O2)=O)O)=O,8,1,0,1,8,4.8e-05
G5,C1(C(CCC=O)C(CO1)O)=O,4,1,0,1,8,4.8e-05
G5,C1(CC(CO1)(CCC=O)O)=O,2,1,0,1,8,4.8e-05
G5,C1(CC(C(CCC=O)O1)O)=O,4,1,0,1,8,4.8e-05
G5,C1(C(C(C)CC=O)C(CO1)O)=O,8,1,0,1,8,4.8e-05
G5,C1(CC(CO1)(C(C)CC=O)O)=O,4,1,0,1,8,4.8e-05
G5,C1(CC(C(C(C)CC=O)O1)O)=O,8,1,0,1,8,4.8e-05
G5,C1(C(CCC(O)=O)C(CO1)O)=O,4,1,0,1,8,4.8e-05
G5,C1(CC(CO1)(CCC(O)=O)O)=O,2,1,0,1,8,4.8e-05
G5,C1(CC(C(CCC(O)=O)O1)O)=O,4,1,0,1,8,4.8e-05
G5,C(CCC(C=O)(CC(C=O)O)O)=O,4,1,0,1,0,4.8e-05
G5,C(CCC(C=O)(C(C(C)O)=O)O)=O,4,1,0,1,0,4.8e-05
G5,C(C(C)(CCC=O)O)(C(C=O)O)=O,4,1,0,1,0,4.8e-05
G5,C(C(CC(CO)CC(C=O)=O)O)=O,4,2,0,2,20,9.6e-05
G5,C(C(C)(C(CO)CC(C=O)=O)O)=O,4,1,0,1,55,4.8e-05
G5,C(C(C)(CCC(C(CO)=O)=O)O)=O,2,1,0,1,7,4.8e-05
G5,C1(CC(CO1)CC(C=O)O)=O,4,1,0,1,28,4.8e-05
G5,C(C(C)(C1COC(C1)=O)O)=O,4,1,0,1,28,4.8e-05
G5,C(CC(CO)(CO)CC(C=O)O)=O,2,2,0,2,21,9.6e-05
G5,C(C(C)(C(CO)(CO)CC=O)O)=O,2,1,0,1,18,4.8e-05
G5,C(C(C)(C(C(CO)O)CC=O)O)=O,8,1,0,1,46,4.8e-05
G5,C(C(CC(C(C=O)=O)CC=O)O)=O,4,1,0,1,20,4.8e-05
G5,C(C(CC(C)CC(C=O)=O)O)=O,4,1,0,1,28,4.8e-05
G5,C(C(C)(C(C)CC(C=O)=O)O)=O,4,1,0,1,28,4.8e-05
G5,C(C)(C(CC(C=O)O)CC=O)=O,4,1,0,1,28,4.8e-05
G5,C(CC(C(C)=O)C(C=O)(C)O)=O,4,1,0,1,28,4.8e-05
G5,C(C(CC(C=O)CC(C)=O)O)=O,4,1,0,1,28,4.8e-05
G5,C(C(CCC(C=O)CC=O)O)=O,4,1,0,1,28,4.8e-05
G5,C(C(C)(CC(C=O)O)CC=O)=O,4,1,0,1,28,4.8e-05
G5,C(C(C)(C(C=O)(C)CC=O)O)=O,4,1,0,1,28,4.8e-05
G5,C(C(CC(C=O)C(C=O)C)O)=O,8,1,0,1,28,4.8e-05
G5,C(C(C)(CC(C=O)C(CO)=O)O)=O,4,1,0,1,9,4.8e-05
G5,C(C(C)(CCC(C(C=O)O)=O)O)=O,4,1,0,1,0,4.8e-05
G5,C(C(C)(CC(C=O)C(C=O)O)O)=O,8,1,0,1,16,4.8e-05
G5,C(C(CO)(CC(C=O)O)CC=O)=O,4,1,0,1,18,4.8e-05
G5,C(C(C)(CCC=O)O)=O,2,1,0,1,11,4.8e-05
G5,C(C(CC(C)CC(CO)=O)O)=O,4,1,0,1,28,4.8e-05
G5,C(C(C)(C(C)CC(CO)=O)O)=O,4,1,0,1,28,4.8e-05
G5,C(CC(CO)(C)CC(C=O)O)=O,4,1,0,1,28,4.8e-05
G5,C(C(C)(C(CO)(C)CC=O)O)=O,4,1,0,1,28,4.8e-05
G5,C(CC(C)CC(C=O)O)=O,4,1,0,1,11,4.8e-05
G5,C(C(C)(C(C)CC=O)O)=O,4,1,0,1,11,4.8e-05
G5,C(C(C)(CCC(O)=O)O)=O,2,1,0,1,18,4.8e-05
G5,C(CC(CO)CC(C=O)O)(O)=O,4,1,0,1,18,4.8e-05
G5,C(C(C)(C(CO)CC(O)=O)O)=O,4,1,0,1,18,4.8e-05
G5,C(C(C)(C(CC=O)CC=O)O)=O,2,1,0,1,28,4.8e-05
G5,C1(CC(CO1)C(CO)(CO)O)=O,2,1,0,1,28,4.8e-05
G5,C(C(CC(C)C(C(CO)O)O)=O)=O,8,1,0,1,28,4.8e-05
G5,C(C(CC(C)C(CO)(CO)O)=O)=O,2,1,0,1,28,4.8e-05
G5,C(C)(C(C(C(CO)O)O)CC=O)=O,8,1,0,1,28,4.8e-05
G5,C(C)(C(C(CO)(CO)O)CC=O)=O,2,1,0,1,28,4.8e-05
G5,C(C(C(C(CO)O)O)CC(C)=O)=O,8,1,0,1,28,4.8e-05
G5,C(C(C(CO)(CO)O)CC(C)=O)=O,2,1,0,1,28,4.8e-05
G5,C(C(CC(CO)(CO)O)CC=O)=O,2,1,0,1,28,4.8e-05
G5,C(C(C)(C(C(CO)O)O)CC=O)=O,8,1,0,1,28,4.8e-05
G5,C(C(C)(C(CO)(CO)O)CC=O)=O,2,1,0,1,28,4.8e-05
G5,C(CCC(CO)(CO)O)=O,1,1,0,1,28,4.8e-05
G5,C(CO)(CC(C)C(C(CO)O)O)=O,8,1,0,1,28,4.8e-05
G5,C(CO)(CC(C)C(CO)(CO)O)=O,2,1,0,1,28,4.8e-05
G5,C(CC(C)(CO)C(C(CO)O)O)=O,8,1,0,1,28,4.8e-05
G5,C(CC(C)(CO)C(CO)(CO)O)=O,2,1,0,1,28,4.8e-05
G5,C(CC(C)C(C(CO)O)O)=O,8,1,0,1,28,4.8e-05
G5,C(CC(C)C(CO)(CO)O)=O,2,1,0,1,28,4.8e-05
G5,C(CCC(CO)(CO)O)(O)=O,1,1,0,1,28,4.8e-05
G5,C(CC(CO)C(CO)(CO)O)(O)=O,2,1,0,1,28,4.8e-05
G5,C(CC(C(CO)(CO)O)CC=O)=O,1,1,0,1,28,4.8e-05
G5,C1(CC(CO1)CO)=O,2,1,0,1,55,4.8e-05
G5,C(CC(CO)C(OCC=O)O)=O,4,1,0,1,37,4.8e-05
G5,C(C(C=O)C(CC(CO)CO)=O)=O,1,1,0,1,29,4.8e-05
G5,C(CCCO)(C(C=O)C(C=O)O)=O,4,1,0,1,7,4.8e-05
G5,C1(C(CO)(CO)CC(C1)=O)=O,1,1,0,1,45,4.8e-05
G5,C(C(CO)CC(CCO)=O)(O)=O,2,1,0,1,46,4.8e-05
G5,C(CC(C=O)O)(CCCO)=O,2,1,0,1,27,4.8e-05
G5,C1(C(CO)CC(CCO1)=O)=O,2,1,0,1,19,4.8e-05
G5,C(C1(CO)CC(C(C1)=O)O)=O,4,1,0,1,45,4.8e-05
G5,C(C1C(C(CC1CO)O)=O)=O,8,1,0,1,27,4.8e-05
G5,C(C(CC(CO)(CO)CO)=O)=O,1,1,0,1,55,4.8e-05
G5,C(CO)(CC(CO)(CO)CO)=O,1,1,0,1,49,4.8e-05
G5,C(CC(CO)(CO)CO)=O,1,1,0,1,18,4.8e-05
G5,C(C(C)(CO)CC(C=O)=O)=O,2,1,0,1,45,4.8e-05
G5,C(C)(C(CO)C(C=O)C(CO)=O)=O,4,1,0,1,55,4.8e-05
G5,C(CO)(C(C=O)(CO)CC(C)=O)=O,2,1,0,1,55,4.8e-05
G5,C(C(CO)(C)C(C=O)C(CO)=O)=O,4,1,0,1,49,4.8e-05
G5,C(C(CO)CC(C)=O)(C(C=O)O)=O,4,1,0,1,29,4.8e-05
G5,C(C(CO)(C)CC(C(C=O)O)=O)=O,4,1,0,1,16,4.8e-05
G5,C(C)(C(CO)CC(C(CO)O)=O)=O,4,1,0,1,45,4.8e-05
G5,C(C(CO)CC(C)=O)(C(CO)O)=O,4,1,0,1,45,4.8e-05
G5,C(C(CO)(C)CC(C(CO)O)=O)=O,4,1,0,1,16,4.8e-05
G5,C(C(CO)(CCO)CC(C=O)=O)=O,2,1,0,1,29,4.8e-05
G5,C(C(C)(CO)C(C(C=O)=O)CO)=O,4,1,0,1,29,4.8e-05
G5,C(C(CC(CO)(CO)CCO)=O)=O,1,2,0,2,55,9.499999999999999e-05
G5,C(C)(C(CO)C(C(CO)=O)CO)=O,4,1,0,1,45,4.8e-05
G5,C(CO)(C(CO)(CO)CC(C)=O)=O,1,1,0,1,45,4.8e-05
G5,C(C(CO)(C)C(C(CO)=O)CO)=O,4,1,0,1,3,4.8e-05
G5,C(C(CC(C)(CO)CO)=O)=O,1,1,0,1,49,4.8e-05
G5,C(C(CO)(C)CC(CO)=O)=O,2,1,0,1,16,4.8e-05
G5,C(C)(C(CO)C(C=O)C(C=O)O)=O,8,1,0,1,55,4.8e-05
G5,C(CC(C=O)(CO)C(C=O)O)(C)=O,4,1,0,1,55,4.8e-05
G5,C(C(C(C=O)C(C=O)(CO)C)O)=O,8,1,0,1,49,4.8e-05
G5,C(C(C)(CO)CC=O)=O,2,1,0,1,55,4.8e-05
G5,C(C(C(CO)=O)C(CO)(CO)C)=O,2,1,0,1,49,4.8e-05
G5,C(C(C(CC(CO)(CO)C)=O)O)=O,2,1,0,1,49,4.8e-05
G5,C(C(CO)O)(CC(CO)(CO)C)=O,2,1,0,1,49,4.8e-05
G5,C(CO)(C(C(CO)C)C(C=O)O)=O,8,1,0,1,11,4.8e-05
G5,C(C(C(CO)C(C)(CO)CO)=O)=O,2,1,0,1,29,4.8e-05
G5,C(C(CO)CC(CO)=O)(CCO)=O,2,1,0,1,2,4.8e-05
G5,C(CO)(C(CO)CC(CCO)=O)=O,2,1,0,1,2,4.8e-05
G5,C(C(CO)(CCO)CC(CO)=O)=O,2,2,0,2,3,9.6e-05
G5,C(C(C(CO)CO)C(C(C)=O)O)=O,4,1,0,1,3,4.8e-05
G5,C(C(CO)(CCO)CC=O)=O,2,2,0,2,46,9.6e-05
G5,C(CO)(C(CO)C(CO)(CO)C)=O,2,1,0,1,49,4.8e-05
G5,C(CO)(CC(CO)(CO)CCO)=O,1,2,0,2,2,9.6e-05
G5,C(CC(CO)(CO)CCO)=O,1,2,0,2,46,9.499999999999999e-05
G5,C(C(C(C=O)O)O)(CC(CO)C)=O,8,1,0,1,28,4.8e-05
G5,C(CO)(CC(CO)(CO)C)=O,1,1,0,1,49,4.8e-05
G5,C(C(C(CO)(CO)C)C(C=O)O)=O,4,1,0,1,49,4.8e-05
G5,C(CC(C)(CO)CO)=O,1,1,0,1,28,4.8e-05
G5,C(CCCO)(O)=O,1,1,0,1,18,4.8e-05
G5,C(CC(CO)CO)(O)=O,1,1,0,1,18,4.8e-05
G5,C(C(CO)C(CO)C(CO)O)(O)=O,8,1,0,1,29,4.8e-05
G5,C(C(CCO)C(C=O)CO)(O)=O,4,1,0,1,46,4.8e-05
G5,C(C(CO)(CCO)CC=O)(O)=O,2,1,0,1,46,4.8e-05
G5,C(C(C)C(CO)C(C=O)O)(O)=O,8,1,0,1,14,4.8e-05
G5,C(C(CC(C=O)O)CCO)(O)=O,4,1,0,1,14,4.8e-05
G5,C(C(C(CO)CO)C(C(O)=O)O)=O,4,1,0,1,29,4.8e-05
G5,C(COC(C=O)O)(CCCO)=O,2,1,0,1,4,4.8e-05
G5,C(C(C(CCCO)=O)OCO)=O,2,1,0,1,37,4.8e-05
G5,C(C(C(CC(CO)CCO)=O)=O)=O,2,1,0,1,17,4.8e-05
G5,C(C(C(CC(CO)C(C)O)=O)=O)=O,4,1,0,1,17,4.8e-05
G5,C(CCCCO)(C(C(C=O)=O)O)=O,2,1,0,1,33,4.8e-05
G5,C(CCC(C)O)(C(C(C=O)=O)O)=O,4,1,0,1,33,4.8e-05
G5,C(C(CO)=O)(CCCCO)=O,1,1,0,1,7,4.8e-05
G5,C(C(C(C)O)=O)(CCCCO)=O,2,1,0,1,7,4.8e-05
G5,C(CO)(C(CO)(CCO)CC=O)=O,2,1,0,1,2,4.8e-05
G5,C1(CC(CO1)CCO)=O,2,1,0,1,46,4.8e-05
G5,C1(CC(CO1)C(C)O)=O,4,1,0,1,46,4.8e-05
G5,C(CC(C(OCC=O)O)CCO)=O,4,1,0,1,37,4.8e-05
G5,C(CC(C(OCC=O)O)C(C)O)=O,8,1,0,1,37,4.8e-05
G5,C1(C(CO)(CCO)CC(C1)=O)=O,2,1,0,1,45,4.8e-05
G5,C1(C(CO)(C(C)O)CC(C1)=O)=O,4,1,0,1,45,4.8e-05
G5,C(C1(C(CC(C1)=O)O)CCO)=O,4,1,0,1,45,4.8e-05
G5,C(C(CCO)CC(CCO)=O)(O)=O,2,1,0,1,46,4.8e-05
G5,C(C(C(C)O)CC(CCO)=O)(O)=O,4,1,0,1,46,4.8e-05
G5,C(C(CCO)CC(O)=O)(CCO)=O,2,1,0,1,46,4.8e-05
G5,C(C(C(C)O)CC(O)=O)(CCO)=O,4,1,0,1,46,4.8e-05
G5,C(CC(CCO)CC(CO)=O)(O)=O,2,1,0,1,12,4.8e-05
G5,C(CC(C(C)O)CC(CO)=O)(O)=O,4,1,0,1,12,4.8e-05
G5,C(CC(CCO)C(C(C)=O)O)(O)=O,4,1,0,1,45,4.8e-05
G5,C(CC(C(C)O)C(C(C)=O)O)(O)=O,8,1,0,1,45,4.8e-05
G5,C(CC(C(CC=O)O)CCO)(O)=O,4,1,0,1,18,4.8e-05
G5,C(CC(C(CC=O)O)C(C)O)(O)=O,8,1,0,1,18,4.8e-05
G5,C(CC(C=O)O)(CCCCO)=O,2,1,0,1,27,4.8e-05
G5,C(CC(C=O)O)(CCC(C)O)=O,4,1,0,1,27,4.8e-05
G5,C1(C(CCO)CC(CCO1)=O)=O,2,1,0,1,19,4.8e-05
G5,C1(C(C(C)O)CC(CCO1)=O)=O,4,1,0,1,19,4.8e-05
G5,C1(C(C(C(CO)(CCO)C1)O)O)=O,8,1,0,1,46,4.8e-05
G5,C(C1(CC(C(C1)=O)O)CCO)=O,4,1,0,1,45,4.8e-05
G5,C(C1(CC(C(C1)=O)O)C(C)O)=O,8,1,0,1,45,4.8e-05
G5,C1(C(CCO)C(C=O)CC1O)=O,8,1,0,1,45,4.8e-05
G5,C1(C(C(C)O)C(C=O)CC1O)=O,16,1,0,1,45,4.8e-05
G5,C(C1C(C(CC1CCO)O)=O)=O,8,1,0,1,27,4.8e-05
G5,C(C1C(C(CC1C(C)O)O)=O)=O,16,1,0,1,27,4.8e-05
G5,C(C(CCCO)C(C(CO)=O)O)=O,4,1,0,1,2,4.8e-05
G5,C(C(CC(C)O)C(C(CO)=O)O)=O,8,1,0,1,2,4.8e-05
G5,C(C(CC(CO)(CO)C(C)O)=O)=O,2,1,0,1,55,4.8e-05
G5,C(CO)(CC(CO)(CO)C(C)O)=O,2,1,0,1,49,4.8e-05
G5,C(CC(CO)(CO)C(C)O)=O,2,1,0,1,18,4.8e-05
G5,C(CC(CCO)C(CO)O)=O,4,1,0,1,46,4.8e-05
G5,C(CC(C(CO)O)C(C)O)=O,8,1,0,1,46,4.8e-05
G5,C(C(C)C(C(C=O)=O)CCO)=O,4,1,0,1,45,4.8e-05
G5,C(C(C)(CCO)CC(C=O)=O)=O,2,1,0,1,45,4.8e-05
G5,C(C(C)(C(C)O)CC(C=O)=O)=O,4,1,0,1,45,4.8e-05
G5,C(C(CCCO)CC(C=O)=O)=O,2,1,0,1,45,4.8e-05
G5,C(C(CC(C)(CO)CCO)=O)=O,2,1,0,1,49,4.8e-05
G5,C(C(CC(C)(CO)C(C)O)=O)=O,4,1,0,1,49,4.8e-05
G5,C(C(CCCO)CC(CO)=O)=O,2,1,0,1,16,4.8e-05
G5,C(C(C)(CCO)CC(CO)=O)=O,2,1,0,1,16,4.8e-05
G5,C(C(C)(C(C)O)CC(CO)=O)=O,4,1,0,1,16,4.8e-05
G5,C(C(C)C(C(CO)=O)CCO)=O,4,1,0,1,16,4.8e-05
G5,C(C(CCCO)C(C(C)=O)O)=O,4,1,0,1,45,4.8e-05
G5,C(C(CC(C)CCO)=O)=O,2,1,0,1,46,4.8e-05
G5,C(C(CC(C)C(C)O)=O)=O,4,1,0,1,46,4.8e-05
G5,C(C)(C(CCO)CC=O)=O,2,1,0,1,46,4.8e-05
G5,C(C)(C(C(C)O)CC=O)=O,4,1,0,1,46,4.8e-05
G5,C(C(CCO)CC(C)=O)=O,2,1,0,1,46,4.8e-05
G5,C(C(CCCO)CC=O)=O,2,1,0,1,46,4.8e-05
G5,C(C(C)(CCO)CC=O)=O,2,1,0,1,46,4.8e-05
G5,C(C(C)(C(C)O)CC=O)=O,4,1,0,1,46,4.8e-05
G5,C(C(CCO)C(C=O)C)=O,4,1,0,1,46,4.8e-05
G5,C(CO)(C(C=O)(CCO)CC=O)=O,2,1,0,1,55,4.8e-05
G5,C(C(C(CO)=O)CCCO)=O,2,1,0,1,9,4.8e-05
G5,C(C(C(CO)=O)CC(C)O)=O,4,1,0,1,9,4.8e-05
G5,C(C(C(CO)=O)C(C)CCO)=O,4,1,0,1,45,4.8e-05
G5,C(C(C(CO)=O)C(C)C(C)O)=O,8,1,0,1,45,4.8e-05
G5,C(CC(CO)(C(C)O)CC=O)=O,2,1,0,1,46,4.8e-05
G5,C(C(C(CCCCO)=O)O)=O,2,1,0,1,0,4.8e-05
G5,C(C(C(CCC(C)O)=O)O)=O,4,1,0,1,0,4.8e-05
G5,C(C(C(CC(C)CCO)=O)O)=O,4,1,0,1,28,4.8e-05
G5,C(C(C(CC(C)C(C)O)=O)O)=O,8,1,0,1,28,4.8e-05
G5,C(CC(C)(CCO)C(C=O)O)=O,4,1,0,1,6,4.8e-05
G5,C(CC(C)(C(C)O)C(C=O)O)=O,8,1,0,1,6,4.8e-05
G5,C(CC(C(C=O)=O)(CO)CCO)=O,2,1,0,1,55,4.8e-05
G5,C(C(CO)O)(CC(C)CCO)=O,4,1,0,1,28,4.8e-05
G5,C(C(CO)O)(CC(C)C(C)O)=O,8,1,0,1,28,4.8e-05
G5,C(CC(C)(CCO)C(CO)O)=O,4,1,0,1,46,4.8e-05
G5,C(CC(C)(C(C)O)C(CO)O)=O,8,1,0,1,46,4.8e-05
G5,C(C(CCCO)C(C=O)O)=O,4,1,0,1,16,4.8e-05
G5,C(CCCCO)=O,1,1,0,1,46,4.8e-05
G5,C(CCC(C)O)=O,2,1,0,1,46,4.8e-05
G5,C(C(C(CO)C(C)CCO)=O)=O,4,1,0,1,27,4.8e-05
G5,C(C(C(CO)C(C)C(C)O)=O)=O,8,1,0,1,27,4.8e-05
G5,C(C(C(CO)CCO)CC=O)=O,4,1,0,1,3,4.8e-05
G5,C(C(CCO)(CCO)CC=O)=O,1,1,0,1,46,4.8e-05
G5,C(C(CCO)(C(C)O)CC=O)=O,4,2,0,2,46,9.499999999999999e-05
G5,C(C(CCO)C(C=O)CCO)=O,3,1,0,1,46,4.8e-05
G5,C(CO)(C(CO)C(C)CCO)=O,4,1,0,1,27,4.8e-05
G5,C(CO)(C(CO)C(C)C(C)O)=O,8,1,0,1,27,4.8e-05
G5,C(CC(CO)(CCO)CCO)=O,1,1,0,1,46,4.8e-05
G5,C(CC(CO)(CCO)C(C)O)=O,4,1,0,1,46,4.8e-05
G5,C(CO)(CC(CO)(C)CCO)=O,2,1,0,1,49,4.8e-05
G5,C(CO)(CC(CO)(C)C(C)O)=O,4,1,0,1,49,4.8e-05
G5,C(CO)(CC(C)CCO)=O,2,1,0,1,46,4.8e-05
G5,C(CO)(CC(C)C(C)O)=O,4,1,0,1,46,4.8e-05
G5,C(CC(C)(CO)CCO)=O,2,1,0,1,28,4.8e-05
G5,C(CC(C)(CO)C(C)O)=O,4,1,0,1,28,4.8e-05
G5,C(C(C(C)CCO)C(C=O)O)=O,8,1,0,1,45,4.8e-05
G5,C(C(C(C)C(C)O)C(C=O)O)=O,16,1,0,1,45,4.8e-05
G5,C(CC(CC(C=O)O)CCO)=O,4,1,0,1,27,4.8e-05
G5,C(CC(CC(C=O)O)C(C)O)=O,8,1,0,1,27,4.8e-05
G5,C(CC(C)CCO)=O,2,1,0,1,46,4.8e-05
G5,C(CC(C)C(C)O)=O,4,1,0,1,46,4.8e-05
G5,C(CC(CO)(C(CO)O)C(C)O)=O,8,1,0,1,46,4.8e-05
G5,C(CC(CO)(C(C)O)C(C=O)O)=O,8,1,0,1,29,4.8e-05
G5,C(C(C(CO)=O)C(CO)CCO)=O,4,1,0,1,55,4.8e-05
G5,C(C(C(CO)=O)C(CO)C(C)O)=O,8,1,0,1,55,4.8e-05
G5,C(C(C(CO)CCO)C(C=O)O)=O,8,1,0,1,43,4.8e-05
G5,C(C(C(CO)C(C)O)C(C=O)O)=O,16,1,0,1,43,4.8e-05
G5,C(C(C(CO)C(CO)CCO)=O)=O,4,1,0,1,29,4.8e-05
G5,C(C(C(CO)C(CO)C(C)O)=O)=O,8,1,0,1,29,4.8e-05
G5,C(CO)(C(CO)C(CO)CCO)=O,4,1,0,1,2,4.8e-05
G5,C(CO)(C(CO)C(CO)C(C)O)=O,8,1,0,1,2,4.8e-05
G5,C(CCCCO)(O)=O,1,1,0,1,18,4.8e-05
G5,C(CCC(C)O)(O)=O,2,1,0,1,18,4.8e-05
G5,C(CC(CO)CCO)(O)=O,2,1,0,1,18,4.8e-05
G5,C(CC(CO)C(C)O)(O)=O,4,1,0,1,18,4.8e-05
G5,C(C(CCO)C(C=O)CCO)(O)=O,4,1,0,1,46,4.8e-05
G5,C(C(CCO)C(C=O)C(C)O)(O)=O,8,1,0,1,46,4.8e-05
G5,C(C(CCO)(CCO)CC=O)(O)=O,1,1,0,1,46,4.8e-05
G5,C(C(CCO)(C(C)O)CC=O)(O)=O,4,1,0,1,46,4.8e-05
G5,C(C(C(CO)CCO)CC=O)(O)=O,4,1,0,1,7,4.8e-05
G5,C(C(C)C(CCO)C(C=O)O)(O)=O,8,1,0,1,14,4.8e-05
G5,C(C(C)C(C(C)O)C(C=O)O)(O)=O,16,1,0,1,14,4.8e-05
G5,C(C(CC(C=O)O)CCCO)(O)=O,4,1,0,1,14,4.8e-05
G5,C(C(CC(C=O)O)CC(C)O)(O)=O,8,1,0,1,14,4.8e-05
G5,C(C(CCCO)C(C=O)(CO)O)=O,4,1,0,1,16,4.8e-05
G5,C(C(CC(C)O)C(C=O)(CO)O)=O,8,1,0,1,16,4.8e-05
G5,C(C(C=O)(C(C=O)CCCO)O)=O,2,1,0,1,1,4.8e-05
G5,C(C(C=O)(C(C=O)CC(C)O)O)=O,4,1,0,1,1,4.8e-05
G5,C(C(CCCO)C(C(O)=O)O)=O,4,1,0,1,33,4.8e-05
G5,C1(C(CC(CCO)C(CO)O1)=O)=O,4,1,0,1,50,4.8e-05
G5,C1(C(CC(C(CO)O1)C(C)O)=O)=O,8,1,0,1,50,4.8e-05
G5,C1(C(CCO)CC(C(CO)O1)=O)=O,4,1,0,1,2,4.8e-05
G5,C1(C(C(C)O)CC(C(CO)O1)=O)=O,8,1,0,1,2,4.8e-05
G5,C1(C(CO)OC(CC1CCO)=O)=O,4,1,0,1,2,4.8e-05
G5,C1(C(CC(CCO)C(CO1)O)=O)=O,4,1,0,1,27,4.8e-05
G5,C1(C(CC(C(CO1)O)C(C)O)=O)=O,8,1,0,1,27,4.8e-05
G5,C1(C(C(CC(CO1)CCO)=O)O)=O,4,1,0,1,2,4.8e-05
G5,C1(C(C(CC(CO1)C(C)O)=O)O)=O,8,1,0,1,2,4.8e-05
G5,C1(C(CCO)CC(C(CO1)O)=O)=O,4,1,0,1,46,4.8e-05
G5,C1(C(C(C)O)CC(C(CO1)O)=O)=O,8,1,0,1,46,4.8e-05
G5,C1(C(CCO)CC(OCC1O)=O)=O,4,1,0,1,46,4.8e-05
G5,C1(C(C(CCO)CC(CO1)=O)O)=O,4,1,0,1,27,4.8e-05
G5,C1(CC(C(C(C=O)O)O1)CCO)=O,8,1,0,1,8,4.8e-05
G5,C1(CC(C(C(C=O)O)O1)C(C)O)=O,16,1,0,1,8,4.8e-05
G5,C1(CC(C(C(C=O)O1)O)CCO)=O,8,1,0,1,8,4.8e-05
G5,C1(CC(C(C(C=O)O1)O)C(C)O)=O,16,1,0,1,8,4.8e-05
G5,C(C(C(CCCCO)=O)(CO)O)=O,2,1,0,1,2,4.8e-05
G5,C(C(C(CCC(C)O)=O)(CO)O)=O,4,1,0,1,2,4.8e-05
G5,C(COC(C=O)O)(CCCCO)=O,2,1,0,1,4,4.8e-05
G5,C(COC(C=O)O)(CCC(C)O)=O,4,1,0,1,4,4.8e-05
G5,C(C(C(CCCCO)=O)OCO)=O,2,1,0,1,37,4.8e-05
G5,C(C(C(CCC(C)O)=O)OCO)=O,4,1,0,1,37,4.8e-05
G5,C(CC(CCO)CC=O)=O,1,1,0,1,46,4.8e-05
G5,C(CC(C(C)O)CC=O)=O,2,1,0,1,46,4.8e-05
G5,C(C(CO)(C1COC(C1)=O)O)(O)=O,4,1,0,1,33,4.8e-05
G5,C1(CC(CO1)C(C(C(O)=O)O)O)=O,8,1,0,1,33,4.8e-05
G5,C(C(CO)(C(C)CC=O)O)(O)=O,4,1,0,1,33,4.8e-05
G5,C(CCC(C(C(O)=O)=O)CO)=O,2,1,0,1,7,4.8e-05
G5,C(CC(C)C(C(C(O)=O)=O)CO)=O,4,1,0,1,7,4.8e-05
G5,C(CCC(C(C(O)=O)=O)CO)(O)=O,2,1,0,1,7,4.8e-05
G5,C(CCC(CC(C(O)=O)=O)O)(O)=O,2,1,0,1,7,4.8e-05
G5,C(C(CCC=O)(CC=O)O)(O)=O,2,1,0,1,33,4.8e-05
G5,C(CC(C)C(C=O)C(C(O)=O)O)=O,8,1,0,1,33,4.8e-05
G5,C(CCC(C(O)=O)(CC=O)O)(O)=O,2,1,0,1,33,4.8e-05
G5,C(CCC(C=O)C(C(O)=O)O)(O)=O,4,2,0,2,33,9.499999999999999e-05
G5,C1(CC(CO1)CC(O)=O)=O,2,1,0,1,18,4.8e-05
G5,C(CC1CC(C(C(C1)=O)O)=O)(O)=O,1,1,0,1,18,4.8e-05
G5,C(CC1C(C(CC(C1)=O)=O)O)(O)=O,4,1,0,1,18,4.8e-05
G5,C(CC1C(C(C(C1)=O)CO)=O)(O)=O,4,1,0,1,45,4.8e-05
G5,C(CC1C(CC(C1CO)=O)=O)(O)=O,4,1,0,1,18,4.8e-05
G5,C1(C(CO)(CC(O)=O)CC(C1)=O)=O,2,1,0,1,18,4.8e-05
G5,C(CC1CC(C(C1CO)=O)=O)(O)=O,4,2,0,2,18,9.499999999999999e-05
G5,C(C1(C(CC(C1)=O)O)CC(O)=O)=O,4,1,0,1,18,4.8e-05
G5,C(CC1C(C=O)CC(C1O)=O)(O)=O,8,1,0,1,45,4.8e-05
G5,C(C1C(CC(C1CC(O)=O)O)=O)=O,8,1,0,1,45,4.8e-05
G5,C(CC1C(C(C)=O)OC(C1)=O)(O)=O,4,1,0,1,48,4.8e-05
G5,C1(CC(C(CC=O)O1)CC(O)=O)=O,4,1,0,1,48,4.8e-05
G5,C1(CC(C(OCC1)=O)CC(O)=O)=O,2,1,0,1,18,4.8e-05
G5,C1(CC(C(CCO1)=O)CC(O)=O)=O,2,1,0,1,18,4.8e-05
G5,C(CC1CC(COC(C1)=O)=O)(O)=O,2,2,0,2,18,9.499999999999999e-05
G5,C1(CC(CC(CO1)CC(O)=O)=O)=O,2,1,0,1,19,4.8e-05
G5,C(CC1COCC(C(C1)=O)=O)(O)=O,2,1,0,1,36,4.8e-05
G5,C(CC1C(COCC(C1)=O)=O)(O)=O,2,1,0,1,45,4.8e-05
G5,C(C1(CC(C(C1)=O)O)CC(O)=O)=O,4,1,0,1,45,4.8e-05
G5,C(CC1C(C(CC1C=O)O)=O)(O)=O,8,1,0,1,45,4.8e-05
G5,C(CC1CC(C(C1C=O)=O)O)(O)=O,8,1,0,1,27,4.8e-05
G5,C(CC(CO)(CO)CC=O)(O)=O,1,1,0,1,18,4.8e-05
G5,C(CC(C(CO)O)CC=O)(O)=O,4,1,0,1,46,4.8e-05
G5,C(C(C)C(C(C=O)=O)CC(O)=O)=O,4,1,0,1,45,4.8e-05
G5,C(C(C)(CC(O)=O)CC(C=O)=O)=O,2,1,0,1,45,4.8e-05
G5,C(CC(C(C=O)=O)CC(O)=O)=O,2,1,0,1,18,4.8e-05
G5,C(CC(C)(CO)CC(C=O)=O)(O)=O,2,1,0,1,49,4.8e-05
G5,C(C(C)(CC(CO)=O)CC(O)=O)=O,2,1,0,1,16,4.8e-05
G5,C(CC(C(CO)=O)C(C=O)C)(O)=O,4,1,0,1,16,4.8e-05
G5,C(CC(C)CC(C=O)=O)(O)=O,2,1,0,1,18,4.8e-05
G5,C(CC(C(C)=O)CC(O)=O)=O,2,1,0,1,18,4.8e-05
G5,C(C(C)(CC=O)CC(O)=O)=O,2,1,0,1,18,4.8e-05
G5,C(C(C)C(C=O)CC(O)=O)=O,4,1,0,1,18,4.8e-05
G5,C(CC(C)C(C=O)C(CO)=O)(O)=O,4,1,0,1,45,4.8e-05
G5,C(CC(CO)(CC=O)CC=O)(O)=O,1,1,0,1,46,4.8e-05
G5,C(C(C(CC(C)CC(O)=O)=O)O)=O,4,1,0,1,28,4.8e-05
G5,C(CC(C)(C(C=O)O)CC=O)(O)=O,4,1,0,1,6,4.8e-05
G5,C(CC(C)CC(C(CO)O)=O)(O)=O,4,1,0,1,28,4.8e-05
G5,C(CC(C)(C(CO)O)CC=O)(O)=O,4,1,0,1,46,4.8e-05
G5,C(C(CO)(CC(O)=O)CC=O)=O,2,1,0,1,18,4.8e-05
G5,C(CC(C)C(C(C=O)=O)CO)(O)=O,4,1,0,1,27,4.8e-05
G5,C(C(CCO)(CC(O)=O)CC=O)=O,2,1,0,1,46,4.8e-05
G5,C(CC(C=O)C(C=O)CCO)(O)=O,4,1,0,1,46,4.8e-05
G5,C(CC(C)C(C(CO)=O)CO)(O)=O,4,1,0,1,27,4.8e-05
G5,C(CC(CO)(CCO)CC=O)(O)=O,2,1,0,1,46,4.8e-05
G5,C(CC(CO)(C)CC(CO)=O)(O)=O,2,1,0,1,49,4.8e-05
G5,C(CC(C)CC(CO)=O)(O)=O,2,1,0,1,18,4.8e-05
G5,C(CC(C)(CO)CC=O)(O)=O,2,1,0,1,18,4.8e-05
G5,C(C(C(C)O)(CC(O)=O)CC=O)=O,4,1,0,1,28,4.8e-05
G5,C(CC(C)C(C=O)C(C=O)O)(O)=O,8,1,0,1,45,4.8e-05
G5,C(CC(CC(C=O)O)CC=O)(O)=O,4,1,0,1,27,4.8e-05
G5,C(CC(C)CC(O)=O)=O,2,1,0,1,18,4.8e-05
G5,C(CCCC(O)=O)(O)=O,1,1,0,1,18,4.8e-05
G5,C(CC(CO)CC(O)=O)(O)=O,1,1,0,1,18,4.8e-05
G5,C(CC1C(C(C(C1)=O)O)=O)(O)=O,4,1,0,1,18,4.8e-05
G5,C(CC(CC=O)CC(O)=O)=O,1,1,0,1,18,4.8e-05
G5,C(C(CO)(C(CCC(O)=O)O)O)=O,4,1,0,1,41,4.8e-05
G5,C(C(CO)(C(CCCC=O)O)O)=O,4,1,0,1,41,4.8e-05
G5,C(C(CO)(C(C)(CCC=O)O)O)=O,4,1,0,1,41,4.8e-05
G5,C(CCCC=O)(C(CO)(CO)O)=O,1,1,0,1,2,4.8e-05
G5,C(C(C=O)(C(CCC(O)=O)O)O)=O,2,1,0,1,1,4.8e-05
G5,C(C(C=O)(C(CCCC=O)O)O)=O,2,1,0,1,1,4.8e-05
G5,C(C(C=O)(C(C)(CCC=O)O)O)=O,2,1,0,1,1,4.8e-05
G5,C(CCCC(C(C(O)=O)O)O)=O,4,1,0,1,4,4.8e-05
G5,C(CCC(C)(C(C(O)=O)O)O)=O,4,1,0,1,4,4.8e-05
G5,C(C(CCC=O)(C(C)O)O)(O)=O,4,1,0,1,4,4.8e-05
G5,C(CC(C)CC(C(C(O)=O)O)O)=O,8,1,0,1,4,4.8e-05
G5,C(CC(C)C(C)(C(C(O)=O)O)O)=O,8,1,0,1,4,4.8e-05
G5,C(C(C(C)O)(C(C)CC=O)O)(O)=O,8,1,0,1,4,4.8e-05
G5,C(CCCC(C(C(O)=O)O)O)(O)=O,4,1,0,1,4,4.8e-05
G5,C(CCC(C)(C(C(O)=O)O)O)(O)=O,4,1,0,1,4,4.8e-05
G5,C(C(CCC(O)=O)(C(C)O)O)(O)=O,4,1,0,1,4,4.8e-05
G5,C(C)(CC(C(C=O)=O)CC(C)=O)=O,1,1,0,1,45,4.8e-05
G5,C(C)(C(CC(C)=O)CC(C=O)=O)=O,2,1,0,1,45,4.8e-05
G5,C(CCCC(C=CC(C=O)=O)=O)=O,2,1,0,1,45,4.8e-05
G5,C(C)(CC(C(C=O)=O)CC=CC=O)=O,4,1,0,1,45,4.8e-05
G5,C(C)(C(CC(C=O)=O)CC=CC=O)=O,4,1,0,1,45,4.8e-05
G5,C(CC(C)CC(C=CC(C=O)=O)=O)=O,4,1,0,1,45,4.8e-05
G5,C(C(C=C)C(C(C=O)=O)CC(C)=O)=O,4,1,0,1,45,4.8e-05
G5,C(C(C=C)C(C(C)=O)CC(C=O)=O)=O,4,1,0,1,45,4.8e-05
G5,C(CCCC(C=CC(C=O)=O)=O)(O)=O,2,1,0,1,45,4.8e-05
G5,C(CC(CC(C)=O)CC(C=O)=O)=O,2,2,0,2,27,9.499999999999999e-05
G5,C(C(C=CC(C=O)=O)CCC=O)=O,4,1,0,1,45,4.8e-05
G5,C(CC(CC(C=O)=O)CC=CC=O)=O,4,2,0,2,45,9.499999999999999e-05
G5,C(C(C=CC(C=O)=O)C(C)CC=O)=O,8,1,0,1,45,4.8e-05
G5,C(C(C=C)C(CC=O)CC(C=O)=O)=O,4,2,0,2,45,9.499999999999999e-05
G5,C(C(C=CC(C=O)=O)CCC(O)=O)=O,4,1,0,1,45,4.8e-05
G5,C(CC(C(C(C)=O)=O)CC(C)=O)=O,2,1,0,1,45,4.8e-05
G5,C(CCCC(C(C=CC=O)=O)=O)=O,2,1,0,1,45,4.8e-05
G5,C(C(CC(C(C)=O)=O)CC=CC=O)=O,4,1,0,1,45,4.8e-05
G5,C(CC(C(C(C)=O)=O)CC=CC=O)=O,4,1,0,1,45,4.8e-05
G5,C(CC(C)CC(C(C=CC=O)=O)=O)=O,4,1,0,1,45,4.8e-05
G5,C(C(C=C)C(C=O)CC(C(C)=O)=O)=O,4,1,0,1,45,4.8e-05
G5,C(C(C=C)C(C(C(C)=O)=O)CC=O)=O,4,1,0,1,45,4.8e-05
G5,C(CCCC(C(C=CC=O)=O)=O)(O)=O,2,1,0,1,45,4.8e-05
G5,C(CC(C(CC=O)CC(C)=O)=O)=O,2,1,0,1,45,4.8e-05
G5,C(C(C(C=CC=O)=O)CCC=O)=O,4,1,0,1,45,4.8e-05
G5,C(CC(CC(C=O)CC=CC=O)=O)=O,4,1,0,1,45,4.8e-05
G5,C(CC(C(CC=O)CC=CC=O)=O)=O,4,1,0,1,45,4.8e-05
G5,C(C(C(C=CC=O)=O)C(C)CC=O)=O,8,1,0,1,45,4.8e-05
G5,C(C(C=C)C(C=O)CC(CC=O)=O)=O,4,1,0,1,45,4.8e-05
G5,C(C(C=C)C(C(CC=O)=O)CC=O)=O,4,1,0,1,45,4.8e-05
G5,C(C(C(C=CC=O)=O)CCC(O)=O)=O,4,1,0,1,45,4.8e-05
G5,C(CCCC(C)=O)(CC(C=O)=O)=O,1,1,0,1,45,4.8e-05
G5,C(CCC(C(C=O)=O)C(C=C)=O)=O,2,1,0,1,45,4.8e-05
G5,C(CCCC=CC=O)(CC(C=O)=O)=O,2,1,0,1,45,4.8e-05
G5,C(CC(C)C(C(C=O)=O)C(C=C)=O)=O,4,1,0,1,45,4.8e-05
G5,C(C(C=C)CCC(CC(C=O)=O)=O)=O,2,1,0,1,45,4.8e-05
G5,C(CCC(C(C=O)=O)C(C=C)=O)(O)=O,2,1,0,1,45,4.8e-05
G5,C(CC(C(CCCC(C)=O)=O)=O)=O,1,1,0,1,45,4.8e-05
G5,C(C(C(C(C=C)=O)=O)CCC=O)=O,2,1,0,1,45,4.8e-05
G5,C(CC(C(CCCC=CC=O)=O)=O)=O,2,1,0,1,45,4.8e-05
G5,C(C(C(C(C=C)=O)=O)C(C)CC=O)=O,4,1,0,1,45,4.8e-05
G5,C(C(C=C)CCC(C(CC=O)=O)=O)=O,2,1,0,1,45,4.8e-05
G5,C(C(C(C(C=C)=O)=O)CCC(O)=O)=O,2,1,0,1,45,4.8e-05
G5,C(CCC(C=CC=O)C(C=O)=O)=O,4,1,0,1,27,4.8e-05
G5,C(CC(C)C(C=CC=O)C(C=O)=O)=O,8,1,0,1,27,4.8e-05
G5,C(CCC(C=CC=O)C(C=O)=O)(O)=O,4,1,0,1,27,4.8e-05
G5,C1(CC(CO1)C2C(C(CO2)O)=O)=O,8,1,0,1,10,4.8e-05
G5,C1(CC(CO1)C2(C(COC2)=O)O)=O,4,1,0,1,10,4.8e-05
G5,C1(CC(C2C(C(CO2)=O)O)CO1)=O,8,1,0,1,10,4.8e-05
G5,C(CCC1C(C(CO1)O)=O)=O,4,1,0,1,10,4.8e-05
G5,C(CCC1(C(COC1)=O)O)=O,2,1,0,1,10,4.8e-05
G5,C(CCC1C(C(CO1)=O)O)=O,4,1,0,1,10,4.8e-05
G5,C(CC(C)C1C(C(CO1)O)=O)=O,8,1,0,1,10,4.8e-05
G5,C(CC(C)C1(C(COC1)=O)O)=O,4,1,0,1,10,4.8e-05
G5,C(CC(C)C1C(C(CO1)=O)O)=O,8,1,0,1,10,4.8e-05
G5,C(CCC1C(C(CO1)O)=O)(O)=O,4,1,0,1,10,4.8e-05
G5,C(CCC1(C(COC1)=O)O)(O)=O,2,1,0,1,18,4.8e-05
G5,C(CCC1C(C(CO1)=O)O)(O)=O,4,1,0,1,10,4.8e-05
G5,C1(CC(CO1)C2(C(CCO2)=O)O)=O,4,1,0,1,34,4.8e-05
G5,C1(CC(CO1)C2C(C(O)OC2)=O)=O,8,1,0,1,34,4.8e-05
G5,C1(CC(C2CC(C(O)O2)=O)CO1)=O,8,1,0,1,34,4.8e-05
G5,C(CCC1(C(CCO1)=O)O)=O,2,1,0,1,34,4.8e-05
G5,C(CCC1C(C(O)OC1)=O)=O,4,1,0,1,34,4.8e-05
G5,C(CCC1CC(C(O)O1)=O)=O,4,1,0,1,34,4.8e-05
G5,C(CC(C)C1(C(CCO1)=O)O)=O,4,1,0,1,34,4.8e-05
G5,C(CC(C)C1C(C(O)OC1)=O)=O,8,1,0,1,34,4.8e-05
G5,C(CC(C)C1CC(C(O)O1)=O)=O,8,1,0,1,34,4.8e-05
G5,C(CCC1(C(CCO1)=O)O)(O)=O,2,1,0,1,34,4.8e-05
G5,C(CCC1C(C(O)OC1)=O)(O)=O,4,1,0,1,34,4.8e-05
G5,C(CCC1CC(C(O)O1)=O)(O)=O,4,1,0,1,34,4.8e-05
G5,C(C=CC(CO)=O)(C(CCO)O)=O,4,2,0,2,7,9.499999999999999e-05
G5,C(C(CC(C(C(CO)=O)=C)O)O)=O,4,1,0,1,29,4.7e-05
G5,C=C(C(C=O)=O)C(CC(CO)O)O,4,1,0,1,29,4.7e-05
G5,C(C(C(C(C=CC(C)O)=O)O)O)=O,16,1,0,1,12,4.7e-05
G5,C(C(C(CC(C(C=O)=C)O)O)O)=O,8,1,0,1,44,4.7e-05
G5,C(CC(C(C(C(C=O)=C)O)O)O)=O,8,1,0,1,44,4.7e-05
G5,C(C(C(C(C(CCO)O)=C)=O)O)=O,4,1,0,1,44,4.7e-05
G5,C(C)(C(C(C=O)=CC(CO)O)O)=O,8,1,0,1,46,4.7e-05
G5,C(C)(C(C(C(C=O)=CCO)O)O)=O,8,1,0,1,11,4.7e-05
G5,C1(C(C(C(C=O)=CC1)O)O)=O,4,1,0,1,11,4.7e-05
G5,C(CC=C(C=O)C(C(CO)O)O)=O,8,1,0,1,4,4.7e-05
G5,C(C(C(C(C(C(O)=O)=C)=O)O)O)=O,4,1,0,1,12,4.7e-05
G5,C(C(C(C(CO)O)=O)=CC=O)(O)=O,4,1,0,1,17,4.7e-05
G5,C(C(C(C(C(O)=O)=C)=O)(CO)O)=O,2,1,0,1,17,4.7e-05
G5,C(C1C(C(C(C=1)=O)O)=O)(O)=O,2,2,0,2,55,9.499999999999999e-05
G5,C(C(O)OCC(C(C(O)=O)=C)=O)=O,2,1,0,1,17,4.7e-05
G5,C(C(C(C(C(O)=O)=C)=O)OCO)=O,2,1,0,1,17,4.7e-05
G5,C(C(C(C(CO)=C)=O)(CO)O)=O,2,1,0,1,43,4.7e-05
G5,C(C(O)OCC(C(CO)=C)=O)=O,2,1,0,1,12,4.7e-05
G5,C(C(C(C(CO)=C)=O)OCO)=O,2,1,0,1,2,4.7e-05
G5,C(C(C(C(C(C)O)=C)=O)(CO)O)=O,4,1,0,1,4,4.7e-05
G5,C1(C=C(C(C1O)=O)C(C)O)=O,4,2,0,2,55,9.499999999999999e-05
G5,C(CC(C(CO)OC(C=C)=O)O)=O,4,1,0,1,4,4.7e-05
G5,C(CC(C(COC(C=C)=O)O)O)=O,4,1,0,1,4,4.7e-05
G5,C(CC(COC(C(C=C)=O)O)O)=O,4,1,0,1,29,4.7e-05
G5,C(C(OCC(C(C(C)O)=C)=O)O)=O,4,1,0,1,12,4.7e-05
G5,C(C(C(C(C(C)O)=C)=O)OCO)=O,4,1,0,1,4,4.7e-05
G5,C(C(C(C=CC(C)O)=O)(CO)O)=O,8,1,0,1,46,4.7e-05
G5,C(C(CO)(CO)O)(CC=CC=O)=O,2,1,0,1,43,4.7e-05
G5,C(CC=CC(C(CO)(CO)O)=O)=O,2,1,0,1,43,4.7e-05
G5,C(CC(C(C(CO)(CO)O)=O)=C)=O,1,1,0,1,46,4.7e-05
G5,C(C(C=O)=CC(C(CO)O)=O)(O)=O,4,1,0,1,17,4.7e-05
G5,C=C(C=O)C(C(CO)=O)=O,1,1,0,1,5,4.7e-05
G5,C(C(C=CC(C=O)=O)=O)=O,2,3,0,3,45,0.00014199999999999998
G5,C,1,18,0,18,45,0.0008539999999999999
G5,C=C(C=O)C(C(O)=O)=O,1,1,0,1,29,4.7e-05
G5,C1C(C(C(C=1)=O)OCO)O,4,1,0,1,2,4.7e-05
G5,C=CC(C(OC(CO)O)=O)=O,2,1,0,1,17,4.7e-05
G5,C=CC(C(COCO)=O)=O,1,1,0,1,17,4.7e-05
G5,C=CC(C(COCO)O)=O,2,1,0,1,7,4.7e-05
G5,C=CC(C(C(O)OC)O)=O,4,1,0,1,29,4.7e-05
G5,C(C(C(C=C)=O)O)(OCO)=O,2,1,0,1,17,4.7e-05
G5,C(C=CC(C(O)OC)=O)(CO)=O,4,2,0,2,12,9.499999999999999e-05
G5,C=C(C(C=O)=O)COC(CO)O,2,1,0,1,12,4.7e-05
G5,C(C(C(C(COCO)=C)=O)O)=O,2,1,0,1,43,4.7e-05
G5,C(C(C(OCC(C=O)=C)O)O)=O,4,1,0,1,55,4.7e-05
G5,C(C=CC(C(O)OCC)=O)(CO)=O,4,2,0,2,12,9.499999999999999e-05
G5,C=C(C(C=O)=O)C(C)OC(CO)O,4,1,0,1,12,4.7e-05
G5,C(C(OC(C(C(CO)=O)=C)C)O)=O,4,1,0,1,12,4.7e-05
G5,C(C(C(C(C(C)OCO)=C)=O)O)=O,4,1,0,1,46,4.7e-05
G5,C(C(C(OC(C(C=O)=C)C)O)O)=O,8,1,0,1,46,4.7e-05
G5,C(C(C(O)OC(C=C)=O)O)=O,4,1,0,1,45,4.7e-05
G5,C=C1C(C(C(OC1)O)O)=O,4,1,0,1,47,4.7e-05
G5,C(C(CO)OC(C)O)=CC(C=O)=O,8,1,0,1,46,4.7e-05
G5,C(CC(O)OCCO)=CC(C=O)=O,4,2,0,2,46,9.499999999999999e-05
G5,C(C(C)(OC(C=CC=O)CO)O)=O,8,1,0,1,46,4.7e-05
G5,C(C(CC=CC=O)(O)OCCO)=O,4,2,0,2,46,9.499999999999999e-05
G5,C(C(C(C=CCOC(C)O)=O)O)=O,8,1,0,1,55,4.7e-05
G5,C(C(C(C=CCC(O)OC)=O)O)=O,8,1,0,1,55,4.7e-05
G5,C(C(C(C)(OCC=CC=O)O)O)=O,8,1,0,1,55,4.7e-05
G5,C(C(C(CC=CC=O)(O)OC)O)=O,8,1,0,1,55,4.7e-05
G5,C(C(C=CC(CO)=O)OC(C)O)=O,8,1,0,1,32,4.7e-05
G5,C(COC(CC=CC(CO)=O)O)=O,4,1,0,1,32,4.7e-05
G5,C(COC(CO)(CC=CC=O)O)=O,4,1,0,1,32,4.7e-05
G5,C(C(C=CC=O)OC(CO)(C)O)=O,8,1,0,1,32,4.7e-05
G5,C(C(C(C=CC=O)OC(C)O)O)=O,16,1,0,1,43,4.7e-05
G5,C(C(COC(CC=CC=O)O)O)=O,8,1,0,1,43,4.7e-05
G5,C(C(O)OCC(C=CCO)=O)=O,4,1,0,1,12,4.7e-05
G5,C(C=CC(C(C(O)OC)O)=O)=O,8,2,0,2,55,9.499999999999999e-05
G5,C(C(C(C=CCO)=O)OCO)=O,4,1,0,1,55,4.7e-05
G5,C(CC(C(C=C)=O)OC(CO)O)=O,4,1,0,1,7,4.7e-05
G5,C(CC(CO)OC(C(C=C)=O)O)=O,4,1,0,1,29,4.7e-05
G5,C(C(OCC(C=CC(C)O)=O)O)=O,8,1,0,1,12,4.7e-05
G5,C(C=CC(C(C(O)OCC)O)=O)=O,8,2,0,2,46,9.499999999999999e-05
G5,C(C(C(C=CC(C)O)=O)OCO)=O,8,1,0,1,46,4.7e-05
G5,C(C(OC(C=CC=O)CO)O)(C)=O,8,1,0,1,46,4.7e-05
G5,C(C(O)OCCO)(CC=CC=O)=O,4,2,0,2,46,9.499999999999999e-05
G5,C(CC=CC(C(O)OCCO)=O)=O,4,2,0,2,46,9.499999999999999e-05
G5,C(C(COC(C)O)O)=CC(C=O)=O,8,1,0,1,46,4.7e-05
G5,C(C(C)(O)OCC(C=CC=O)O)=O,8,1,0,1,46,4.7e-05
G5,C(C(CO)OCO)(CC=CC=O)=O,4,1,0,1,43,4.7e-05
G5,C(C)(C(CO)OC(C=CC=O)O)=O,8,1,0,1,43,4.7e-05
G5,C(CC=CC(C(CO)OCO)=O)=O,4,1,0,1,43,4.7e-05
G5,C(CC(C(C(CO)OCO)=O)=C)=O,2,1,0,1,46,4.7e-05
G5,C(C=CC(C(CO)OC(C)O)=O)=O,8,2,0,2,46,9.499999999999999e-05
G5,C(C(C(C=CC=O)O)OC(C)O)=O,16,1,0,1,43,4.7e-05
G5,C(C(CO)OC(CC=CC=O)O)=O,8,1,0,1,43,4.7e-05
G5,C(CC(C(C(C=C)=O)O)OCO)=O,4,1,0,1,45,4.7e-05
G5,C(CCOC(C(C(C=C)=O)O)O)=O,4,1,0,1,44,4.7e-05
G5,C(C(C(C=C)=O)(COCO)O)=O,2,1,0,1,38,4.7e-05
G5,C(C(C(C=C)=O)(C(C)OCO)O)=O,4,1,0,1,4,4.7e-05
G5,C(C(O)OCC(C=CC=O)O)(C)=O,8,1,0,1,46,4.7e-05
G5,C(C(C(C=CCO)=O)OC(C)O)=O,8,1,0,1,55,4.7e-05
G5,C(C1C(C=CCC(O1)O)=O)=O,4,1,0,1,55,4.7e-05
G5,C(C)(C(C(OCC=CC=O)O)O)=O,8,1,0,1,55,4.7e-05
G5,C(C(C(O)OC)O)(CC=CC=O)=O,8,1,0,1,55,4.7e-05
G5,C(CC=CC(C(C(O)OC)O)=O)=O,8,1,0,1,55,4.7e-05
G5,C(C(CO)OCO)(CC(C=O)=C)=O,2,1,0,1,43,4.7e-05
G5,C(C(COCO)O)(CC=CC=O)=O,4,1,0,1,38,4.7e-05
G5,C(C)(C(COC(C=CC=O)O)O)=O,8,1,0,1,38,4.7e-05
G5,C(CC=CC(C(COCO)O)=O)=O,4,1,0,1,38,4.7e-05
G5,C(CC(C(C(COCO)O)=O)=C)=O,2,1,0,1,46,4.7e-05
G5,C(C=CC(C(COC(C)O)O)=O)=O,8,1,0,1,46,4.7e-05
G5,C(C(C(C(C=C)=O)OC(C)O)O)=O,8,1,0,1,27,4.7e-05
G5,C(C(C=CC(COC(C)O)=O)O)=O,8,1,0,1,32,4.7e-05
G5,C(COC(CO)O)(CC=CC=O)=O,4,1,0,1,32,4.7e-05
G5,C(COC(C(C=CC=O)O)O)(C)=O,8,1,0,1,32,4.7e-05
G5,C(CC=CC(COC(CO)O)=O)=O,4,1,0,1,32,4.7e-05
G5,C(CCO)=CC(C(C(CO)O)O)=O,8,1,0,1,46,4.7e-05
G5,C(C(C)O)=CC(C(C(CO)O)O)=O,16,1,0,1,46,4.7e-05
G5,C(CC(C=O)=CC(COCO)=O)=O,2,1,0,1,35,4.7e-05
G5,C(CC(C=O)=CC(OCCO)=O)=O,2,1,0,1,8,4.7e-05
G5,C(CC(C=O)=CC(C(O)OC)=O)=O,4,1,0,1,34,4.7e-05
G5,C(CO)=CC(OCC(CO)O)=O,4,2,0,2,55,9.499999999999999e-05
G5,C(CO)=CC(OC(CO)CO)=O,2,1,0,1,55,4.7e-05
G5,C(CO)=CC(C(O)OCCO)=O,4,2,0,2,41,9.499999999999999e-05
G5,C(CO)=CC(C(CO)OCO)=O,4,1,0,1,55,4.7e-05
G5,C(CO)=CC(C(C(O)OC)O)=O,8,1,0,1,55,4.7e-05
G5,C(CO)=CC(C(COCO)O)=O,4,1,0,1,38,4.7e-05
G5,C(CO)=CC(COC(CO)O)=O,4,1,0,1,55,4.7e-05
G5,C(CCO)=CC(C(CO)(CO)O)=O,2,1,0,1,46,4.7e-05
G5,C(C(C)O)=CC(C(CO)(CO)O)=O,4,1,0,1,46,4.7e-05
G5,C(CCO)=C(C(C(CO)O)=O)CO,4,1,0,1,46,4.7e-05
G5,C(C(C)O)=C(C(C(CO)O)=O)CO,8,1,0,1,46,4.7e-05
G5,C(CCO)=C(C=O)C(C(CO)O)O,8,1,0,1,46,4.7e-05
G5,C(C(C)O)=C(C=O)C(C(CO)O)O,16,1,0,1,46,4.7e-05
G5,C(CCO)=CC(OCC(CO)O)=O,4,2,0,2,46,9.499999999999999e-05
G5,C(C(C)O)=CC(OCC(CO)O)=O,8,2,0,2,46,9.499999999999999e-05
G5,C(CCO)=CC(OC(CO)CO)=O,2,1,0,1,46,4.7e-05
G5,C(C(C)O)=CC(OC(CO)CO)=O,4,1,0,1,46,4.7e-05
G5,C(CCO)=CC(C(O)OCCO)=O,4,2,0,2,46,9.499999999999999e-05
G5,C(C(C)O)=CC(C(O)OCCO)=O,8,2,0,2,46,9.499999999999999e-05
G5,C(CCO)=CC(C(CO)OCO)=O,4,1,0,1,46,4.7e-05
G5,C(C(C)O)=CC(C(CO)OCO)=O,8,1,0,1,46,4.7e-05
G5,C(CCO)=CC(C(C(O)OC)O)=O,8,1,0,1,46,4.7e-05
G5,C(C(C)O)=CC(C(C(O)OC)O)=O,16,1,0,1,46,4.7e-05
G5,C(CCO)=CC(C(COCO)O)=O,4,1,0,1,38,4.7e-05
G5,C(C(C)O)=CC(C(COCO)O)=O,8,1,0,1,38,4.7e-05
G5,C(CCO)=CC(COC(CO)O)=O,4,1,0,1,46,4.7e-05
G5,C(C(C)O)=CC(COC(CO)O)=O,8,1,0,1,46,4.7e-05
G5,C(C(C=CC(C(C)=O)=O)=O)=O,2,1,0,1,45,4.7e-05
G5,C(C(CO)O)(C(C=CC=O)CO)=O,8,1,0,1,43,4.7e-05
G5,C(CC=C(C(C(CO)O)=O)CO)=O,4,1,0,1,43,4.7e-05
G5,C(C)(OC(C=CC=O)C(CO)O)=O,8,1,0,1,4,4.7e-05
G5,C(CC=CC=O)(OCC(CO)O)=O,4,2,0,2,4,9.499999999999999e-05
G5,C(CC=CC(OCC(CO)O)=O)=O,4,2,0,2,4,9.499999999999999e-05
G5,C(C)(OC(CO)C(C=CC=O)O)=O,8,1,0,1,4,4.7e-05
G5,C(CC=CC=O)(OC(CO)CO)=O,2,1,0,1,4,4.7e-05
G5,C(CC=CC(OC(CO)CO)=O)=O,2,1,0,1,4,4.7e-05
G5,C(C)(OCC(C(C=CC=O)O)O)=O,8,1,0,1,4,4.7e-05
